C행정구역별(읍면동),행정구역별(읍면동),C연령별,연령별,시점,총인구(명),총인구_남자(명),총인구_여자(명),총인구_성비,내국인(명),내국인_남자(명),내국인_여자(명),내국인_성비
00,전국,000,합계,2018,51629512,25877195,25752317,100.5,49977951,24931554,25046397,99.5
00,전국,005,0~4세,2018,2000217,1025394,974823,105.2,1967942,1008953,958989,105.2
00,전국,005001, 0세,2018,336309,172776,163533,105.7,329921,169468,160453,105.6
00,전국,005002, 1세,2018,369138,189708,179430,105.7,361937,186079,175858,105.8
00,전국,005003, 2세,2018,418971,214333,204638,104.7,411683,210583,201100,104.7
00,전국,005004, 3세,2018,440155,225606,214549,105.2,434236,222586,211650,105.2
00,전국,005005, 4세,2018,435644,222971,212673,104.8,430165,220237,209928,104.9
00,전국,010,5~9세,2018,2279824,1172145,1107679,105.8,2261032,1162616,1098416,105.8
00,전국,010001, 5세,2018,440871,225721,215150,104.9,436187,223400,212787,105
00,전국,010002, 6세,2018,478358,245688,232670,105.6,474034,243505,230529,105.6
00,전국,010003, 7세,2018,470894,241877,229017,105.6,467352,240043,227309,105.6
00,전국,010004, 8세,2018,451932,233145,218787,106.6,448756,231500,217256,106.6
00,전국,010005, 9세,2018,437769,225714,212055,106.4,434703,224168,210535,106.5
00,전국,015,10~14세,2018,2262767,1169008,1093759,106.9,2250907,1163024,1087883,106.9
00,전국,015001, 10세,2018,461694,237471,224223,105.9,458823,236004,222819,105.9
00,전국,015002, 11세,2018,472725,243371,229354,106.1,470099,242080,228019,106.2
00,전국,015003, 12세,2018,434119,224749,209370,107.3,431891,223638,208253,107.4
00,전국,015004, 13세,2018,427807,221431,206376,107.3,425810,220395,205415,107.3
00,전국,015005, 14세,2018,466422,241986,224436,107.8,464284,240907,223377,107.8
00,전국,020,15~19세,2018,2772966,1445280,1327686,108.9,2735274,1427114,1308160,109.1
00,전국,020001, 15세,2018,475000,246840,228160,108.2,473198,245943,227255,108.2
00,전국,020002, 16세,2018,490347,255744,234603,109,488182,254640,233542,109
00,전국,020003, 17세,2018,562714,293260,269454,108.8,559399,291599,267800,108.9
00,전국,020004, 18세,2018,625687,326004,299683,108.8,616562,321695,294867,109.1
00,전국,020005, 19세,2018,619218,323432,295786,109.3,597933,313237,284696,110
00,전국,025,20~24세,2018,3484744,1851798,1632946,113.4,3290233,1744884,1545349,112.9
00,전국,025001, 20세,2018,653549,342147,311402,109.9,622183,327056,295127,110.8
00,전국,025002, 21세,2018,679469,357335,322134,110.9,645242,339737,305505,111.2
00,전국,025003, 22세,2018,704618,375902,328716,114.4,665618,354359,311259,113.8
00,전국,025004, 23세,2018,718178,384301,333877,115.1,674344,359158,315186,114
00,전국,025005, 24세,2018,728930,392113,336817,116.4,682846,364574,318272,114.5
00,전국,030,25~29세,2018,3520222,1884327,1635895,115.2,3259284,1721877,1537407,112
00,전국,030001, 25세,2018,734460,394855,339605,116.3,685587,364865,320722,113.8
00,전국,030002, 26세,2018,744183,397972,346211,115,693403,366177,327226,111.9
00,전국,030003, 27세,2018,703979,375497,328482,114.3,652580,343398,309182,111.1
00,전국,030004, 28세,2018,677808,363139,314669,115.4,622273,328553,293720,111.9
00,전국,030005, 29세,2018,659792,352864,306928,115,605441,318884,286557,111.3
00,전국,035,30~34세,2018,3339755,1755850,1583905,110.9,3080835,1592897,1487938,107.1
00,전국,035001, 30세,2018,648332,343313,305019,112.6,593192,309070,284122,108.8
00,전국,035002, 31세,2018,653907,343034,310873,110.3,598043,307984,290059,106.2
00,전국,035003, 32세,2018,663383,350031,313352,111.7,610686,316958,293728,107.9
00,전국,035004, 33세,2018,671141,352361,318780,110.5,622039,321207,300832,106.8
00,전국,035005, 34세,2018,702992,367111,335881,109.3,656875,337678,319197,105.8
00,전국,040,35~39세,2018,4106922,2120795,1986127,106.8,3915428,1999417,1916011,104.4
00,전국,040001, 35세,2018,770865,399896,370969,107.8,727541,372287,355254,104.8
00,전국,040002, 36세,2018,837148,432324,404824,106.8,794470,405326,389144,104.2
00,전국,040003, 37세,2018,836695,435085,401610,108.3,800141,411868,388273,106.1
00,전국,040004, 38세,2018,853119,438088,415031,105.6,818300,416069,402231,103.4
00,전국,040005, 39세,2018,809095,415402,393693,105.5,774976,393867,381109,103.3
00,전국,045,40~44세,2018,3910064,2001842,1908222,104.9,3775918,1920059,1855859,103.5
00,전국,045001, 40세,2018,741888,381899,359989,106.1,711403,362863,348540,104.1
00,전국,045002, 41세,2018,764489,390726,373763,104.5,737224,373840,363384,102.9
00,전국,045003, 42세,2018,752657,387694,364963,106.2,726057,371358,354699,104.7
00,전국,045004, 43세,2018,789646,401560,388086,103.5,764853,386784,378069,102.3
00,전국,045005, 44세,2018,861384,439963,421421,104.4,836381,425214,411167,103.4
00,전국,050,45~49세,2018,4498819,2282577,2216242,103,4362254,2206233,2156021,102.3
00,전국,050001, 45세,2018,873375,441289,432086,102.1,847343,426155,421188,101.2
00,전국,050002, 46세,2018,876517,449675,426842,105.3,849149,433925,415224,104.5
00,전국,050003, 47세,2018,933243,475047,458196,103.7,904989,459250,445739,103
00,전국,050004, 48세,2018,902320,457112,445208,102.7,873919,441585,432334,102.1
00,전국,050005, 49세,2018,913364,459454,453910,101.2,886854,445318,441536,100.9
00,전국,055,50~54세,2018,4196221,2109486,2086735,101.1,4071272,2044989,2026283,100.9
00,전국,055001, 50세,2018,910750,454211,456539,99.5,884433,440211,444222,99.1
00,전국,055002, 51세,2018,833488,414126,419362,98.8,811297,402608,408689,98.5
00,전국,055003, 52세,2018,819368,419804,399564,105.1,795158,407405,387753,105.1
00,전국,055004, 53세,2018,841868,421497,420371,100.3,815504,408030,407474,100.1
00,전국,055005, 54세,2018,790747,399848,390899,102.3,764880,386735,378145,102.3
00,전국,060,55~59세,2018,4319504,2154401,2165103,99.5,4212132,2101462,2110670,99.6
00,전국,060001, 55세,2018,835267,423692,411575,102.9,805133,408660,396473,103.1
00,전국,060002, 56세,2018,855705,433073,422632,102.5,832496,421615,410881,102.6
00,전국,060003, 57세,2018,913387,452328,461059,98.1,898061,444988,453073,98.2
00,전국,060004, 58세,2018,906039,445400,460639,96.7,884286,434639,449647,96.7
00,전국,060005, 59세,2018,809106,399908,409198,97.7,792156,391560,400596,97.7
00,전국,065,60~64세,2018,3482338,1715950,1766388,97.1,3401325,1675784,1725541,97.1
00,전국,065001, 60세,2018,764368,381532,382836,99.7,745621,372273,373348,99.7
00,전국,065002, 61세,2018,747566,371086,376480,98.6,728695,361598,367097,98.5
00,전국,065003, 62세,2018,685928,338265,347663,97.3,670283,330542,339741,97.3
00,전국,065004, 63세,2018,696867,337404,359463,93.9,682000,329984,352016,93.7
00,전국,065005, 64세,2018,587609,287663,299946,95.9,574726,281387,293339,95.9
00,전국,070,65~69세,2018,2372155,1139381,1232774,92.4,2335461,1121855,1213606,92.4
00,전국,070001, 65세,2018,513280,247945,265335,93.4,502966,242866,260100,93.4
00,전국,070002, 66세,2018,556456,268951,287505,93.5,547824,264794,283030,93.6
00,전국,070003, 67세,2018,412281,197895,214386,92.3,405261,194569,210692,92.3
00,전국,070004, 68세,2018,442523,211536,230987,91.6,436806,208880,227926,91.6
00,전국,070005, 69세,2018,447615,213054,234561,90.8,442604,210746,231858,90.9
00,전국,075,70~74세,2018,1829392,844189,985203,85.7,1817370,839242,978128,85.8
00,전국,075001, 70세,2018,433583,205717,227866,90.3,430245,204256,225989,90.4
00,전국,075002, 71세,2018,428328,199351,228977,87.1,425349,198083,227266,87.2
00,전국,075003, 72세,2018,323755,150983,172772,87.4,321418,150049,171369,87.6
00,전국,075004, 73세,2018,319312,144988,174324,83.2,317547,144295,173252,83.3
00,전국,075005, 74세,2018,324414,143150,181264,79,322811,142559,180252,79.1
00,전국,080,75~79세,2018,1585750,666909,918841,72.6,1579289,664879,914410,72.7
00,전국,080001, 75세,2018,333309,145515,187794,77.5,331869,145019,186850,77.6
00,전국,080002, 76세,2018,385796,166734,219062,76.1,384427,166281,218146,76.2
00,전국,080003, 77세,2018,309398,130092,179306,72.6,308062,129671,178391,72.7
00,전국,080004, 78세,2018,280801,114234,166567,68.6,279585,113872,165713,68.7
00,전국,080005, 79세,2018,276446,110334,166112,66.4,275346,110036,165310,66.6
00,전국,085,80~84세,2018,1005673,363891,641782,56.7,1001715,362776,638939,56.8
00,전국,085001, 80세,2018,245095,94757,150338,63,244007,94456,149551,63.2
00,전국,085002, 81세,2018,221738,83255,138483,60.1,220860,82991,137869,60.2
00,전국,085003, 82세,2018,199003,71699,127304,56.3,198197,71478,126719,56.4
00,전국,085004, 83세,2018,184921,63230,121691,52,184278,63037,121241,52
00,전국,085005, 84세,2018,154916,50950,103966,49,154373,50814,103559,49.1
00,전국,090,85~89세,2018,467681,132006,335675,39.3,466247,131650,334597,39.3
00,전국,090001, 85세,2018,128771,40065,88706,45.2,128331,39957,88374,45.2
00,전국,090002, 86세,2018,111766,32944,78822,41.8,111456,32864,78592,41.8
00,전국,090003, 87세,2018,85329,23289,62040,37.5,85067,23228,61839,37.6
00,전국,090004, 88세,2018,77797,19321,58476,33,77560,19268,58292,33.1
00,전국,090005, 89세,2018,64018,16387,47631,34.4,63833,16333,47500,34.4
00,전국,095,90~94세,2018,153410,33938,119472,28.4,153039,33849,119190,28.4
00,전국,095001, 90세,2018,51017,11854,39163,30.3,50898,11818,39080,30.2
00,전국,095002, 91세,2018,39393,8792,30601,28.7,39287,8770,30517,28.7
00,전국,095003, 92세,2018,26434,5615,20819,27,26367,5596,20771,26.9
00,전국,095004, 93세,2018,21700,4395,17305,25.4,21651,4388,17263,25.4
00,전국,095005, 94세,2018,14866,3282,11584,28.3,14836,3277,11559,28.4
00,전국,100,95~99세,2018,36839,7427,29412,25.3,36762,7402,29360,25.2
00,전국,100001, 95세,2018,14333,2998,11335,26.4,14304,2989,11315,26.4
00,전국,100002, 96세,2018,9813,1958,7855,24.9,9795,1953,7842,24.9
00,전국,100003, 97세,2018,6031,1172,4859,24.1,6022,1167,4855,24
00,전국,100004, 98세,2018,4132,773,3359,23,4118,769,3349,23
00,전국,100005, 99세,2018,2530,526,2004,26.2,2523,524,1999,26.2
00,전국,101,100세이상,2018,4249,601,3648,16.5,4232,592,3640,16.3
00,전국,102,15세미만,2018,6542808,3366547,3176261,106,6479881,3334593,3145288,106
00,전국,103,15~64세,2018,37631555,19322306,18309249,105.5,36103955,18434716,17669239,104.3
00,전국,104,65세이상,2018,7455149,3188342,4266807,74.7,7394115,3162245,4231870,74.7
00,전국,086,85세이상,2018,662179,173972,488207,35.6,660280,173493,486787,35.6
00,전국,126,평균연령,2018,41.8,40.6,43,,42,40.8,43.2,
00,전국,127,중위연령,2018,42.7,41.3,44.1,,43.1,41.8,44.3,
04,읍부,000,합계,2018,4984023,2557807,2426216,105.4,4787535,2431315,2356220,103.2
04,읍부,005,0~4세,2018,216349,110635,105714,104.7,213614,109246,104368,104.7
04,읍부,005001, 0세,2018,36233,18392,17841,103.1,35724,18142,17582,103.2
04,읍부,005002, 1세,2018,39876,20301,19575,103.7,39254,19997,19257,103.8
04,읍부,005003, 2세,2018,45155,23095,22060,104.7,44540,22773,21767,104.6
04,읍부,005004, 3세,2018,47703,24604,23099,106.5,47191,24320,22871,106.3
04,읍부,005005, 4세,2018,47382,24243,23139,104.8,46905,24014,22891,104.9
04,읍부,010,5~9세,2018,250189,128579,121610,105.7,248434,127696,120738,105.8
04,읍부,010001, 5세,2018,48427,24830,23597,105.2,47998,24615,23383,105.3
04,읍부,010002, 6세,2018,52556,26949,25607,105.2,52161,26760,25401,105.4
04,읍부,010003, 7세,2018,52208,26824,25384,105.7,51886,26661,25225,105.7
04,읍부,010004, 8세,2018,49375,25528,23847,107,49080,25376,23704,107.1
04,읍부,010005, 9세,2018,47623,24448,23175,105.5,47309,24284,23025,105.5
04,읍부,015,10~14세,2018,238628,123679,114949,107.6,237447,123090,114357,107.6
04,읍부,015001, 10세,2018,50079,25857,24222,106.8,49781,25700,24081,106.7
04,읍부,015002, 11세,2018,50176,25748,24428,105.4,49921,25628,24293,105.5
04,읍부,015003, 12세,2018,46002,23970,22032,108.8,45786,23860,21926,108.8
04,읍부,015004, 13세,2018,45055,23463,21592,108.7,44834,23353,21481,108.7
04,읍부,015005, 14세,2018,47316,24641,22675,108.7,47125,24549,22576,108.7
04,읍부,020,15~19세,2018,280768,147357,133411,110.5,277076,145504,131572,110.6
04,읍부,020001, 15세,2018,48260,25175,23085,109.1,48070,25082,22988,109.1
04,읍부,020002, 16세,2018,51681,26909,24772,108.6,51474,26811,24663,108.7
04,읍부,020003, 17세,2018,58017,30071,27946,107.6,57674,29883,27791,107.5
04,읍부,020004, 18세,2018,63175,33001,30174,109.4,62198,32499,29699,109.4
04,읍부,020005, 19세,2018,59635,32201,27434,117.4,57660,31229,26431,118.2
04,읍부,025,20~24세,2018,307040,175149,131891,132.8,284188,160000,124188,128.8
04,읍부,025001, 20세,2018,61011,33546,27465,122.1,58196,31986,26210,122
04,읍부,025002, 21세,2018,61904,34420,27484,125.2,58307,32240,26067,123.7
04,읍부,025003, 22세,2018,61934,35546,26388,134.7,57323,32450,24873,130.5
04,읍부,025004, 23세,2018,61343,35840,25503,140.5,55832,32021,23811,134.5
04,읍부,025005, 24세,2018,60848,35797,25051,142.9,54530,31303,23227,134.8
04,읍부,030,25~29세,2018,293032,168206,124826,134.8,255080,141262,113818,124.1
04,읍부,030001, 25세,2018,60128,34870,25258,138.1,53082,29830,23252,128.3
04,읍부,030002, 26세,2018,61022,34989,26033,134.4,53525,29608,23917,123.8
04,읍부,030003, 27세,2018,58106,33382,24724,135,50557,28017,22540,124.3
04,읍부,030004, 28세,2018,57230,32670,24560,133,49229,27082,22147,122.3
04,읍부,030005, 29세,2018,56546,32295,24251,133.2,48687,26725,21962,121.7
04,읍부,035,30~34세,2018,304796,166334,138462,120.1,268383,140958,127425,110.6
04,읍부,035001, 30세,2018,56622,31505,25117,125.4,48849,26054,22795,114.3
04,읍부,035002, 31세,2018,58959,32285,26674,121,51148,26878,24270,110.7
04,읍부,035003, 32세,2018,60386,33013,27373,120.6,53061,27929,25132,111.1
04,읍부,035004, 33세,2018,62191,33782,28409,118.9,55126,28874,26252,110
04,읍부,035005, 34세,2018,66638,35749,30889,115.7,60199,31223,28976,107.8
04,읍부,040,35~39세,2018,402730,212545,190185,111.8,376135,194267,181868,106.8
04,읍부,040001, 35세,2018,73634,39118,34516,113.3,67488,34802,32686,106.5
04,읍부,040002, 36세,2018,81721,42971,38750,110.9,75813,38878,36935,105.3
04,읍부,040003, 37세,2018,82042,43994,38048,115.6,76769,40360,36409,110.9
04,읍부,040004, 38세,2018,85080,44521,40559,109.8,80242,41243,38999,105.8
04,읍부,040005, 39세,2018,80253,41941,38312,109.5,75823,38984,36839,105.8
04,읍부,045,40~44세,2018,389756,206081,183675,112.2,372435,194821,177614,109.7
04,읍부,045001, 40세,2018,74816,39336,35480,110.9,70693,36548,34145,107
04,읍부,045002, 41세,2018,76802,40491,36311,111.5,73197,38087,35110,108.5
04,읍부,045003, 42세,2018,75015,39910,35105,113.7,71563,37654,33909,111
04,읍부,045004, 43세,2018,78178,41056,37122,110.6,75075,39123,35952,108.8
04,읍부,045005, 44세,2018,84945,45288,39657,114.2,81907,43409,38498,112.8
04,읍부,050,45~49세,2018,426891,227506,199385,114.1,411989,218838,193151,113.3
04,읍부,050001, 45세,2018,84870,44872,39998,112.2,81889,43075,38814,111
04,읍부,050002, 46세,2018,83776,44973,38803,115.9,80733,43157,37576,114.9
04,읍부,050003, 47세,2018,88559,47462,41097,115.5,85506,45664,39842,114.6
04,읍부,050004, 48세,2018,84335,44925,39410,114,81274,43207,38067,113.5
04,읍부,050005, 49세,2018,85351,45274,40077,113,82587,43735,38852,112.6
04,읍부,055,50~54세,2018,388784,205170,183614,111.7,376747,198656,178091,111.5
04,읍부,055001, 50세,2018,84937,44774,40163,111.5,82232,43272,38960,111.1
04,읍부,055002, 51세,2018,76927,40184,36743,109.4,74716,38995,35721,109.2
04,읍부,055003, 52세,2018,76887,41270,35617,115.9,74518,39999,34519,115.9
04,읍부,055004, 53세,2018,77427,40499,36928,109.7,74994,39195,35799,109.5
04,읍부,055005, 54세,2018,72606,38443,34163,112.5,70287,37195,33092,112.4
04,읍부,060,55~59세,2018,396889,204485,192404,106.3,388059,199940,188119,106.3
04,읍부,060001, 55세,2018,75987,39916,36071,110.7,73559,38635,34924,110.6
04,읍부,060002, 56세,2018,79153,41648,37505,111,77189,40607,36582,111
04,읍부,060003, 57세,2018,84753,43451,41302,105.2,83401,42780,40621,105.3
04,읍부,060004, 58세,2018,82700,41963,40737,103,80952,41067,39885,103
04,읍부,060005, 59세,2018,74296,37507,36789,102,72958,36851,36107,102.1
04,읍부,065,60~64세,2018,322574,161389,161185,100.1,316724,158297,158427,99.9
04,읍부,065001, 60세,2018,70683,35995,34688,103.8,69252,35226,34026,103.5
04,읍부,065002, 61세,2018,68959,34932,34027,102.7,67582,34190,33392,102.4
04,읍부,065003, 62세,2018,63745,32074,31671,101.3,62613,31486,31127,101.2
04,읍부,065004, 63세,2018,64123,31406,32717,96,63115,30856,32259,95.7
04,읍부,065005, 64세,2018,55064,26982,28082,96.1,54162,26539,27623,96.1
04,읍부,070,65~69세,2018,226450,109272,117178,93.3,223904,108015,115889,93.2
04,읍부,070001, 65세,2018,47793,23438,24355,96.2,47092,23076,24016,96.1
04,읍부,070002, 66세,2018,52833,25751,27082,95.1,52266,25481,26785,95.1
04,읍부,070003, 67세,2018,39970,19194,20776,92.4,39485,18947,20538,92.3
04,읍부,070004, 68세,2018,42247,20101,22146,90.8,41820,19893,21927,90.7
04,읍부,070005, 69세,2018,43607,20788,22819,91.1,43241,20618,22623,91.1
04,읍부,075,70~74세,2018,180545,83594,96951,86.2,179593,83172,96421,86.3
04,읍부,075001, 70세,2018,42183,20151,22032,91.5,41928,20035,21893,91.5
04,읍부,075002, 71세,2018,41996,19979,22017,90.7,41747,19871,21876,90.8
04,읍부,075003, 72세,2018,31824,14910,16914,88.2,31650,14835,16815,88.2
04,읍부,075004, 73세,2018,31949,14456,17493,82.6,31807,14394,17413,82.7
04,읍부,075005, 74세,2018,32593,14098,18495,76.2,32461,14037,18424,76.2
04,읍부,080,75~79세,2018,168538,68572,99966,68.6,168073,68426,99647,68.7
04,읍부,080001, 75세,2018,34402,14578,19824,73.5,34280,14530,19750,73.6
04,읍부,080002, 76세,2018,40114,16829,23285,72.3,40009,16796,23213,72.4
04,읍부,080003, 77세,2018,32918,13366,19552,68.4,32819,13332,19487,68.4
04,읍부,080004, 78세,2018,30405,12000,18405,65.2,30323,11981,18342,65.3
04,읍부,080005, 79세,2018,30699,11799,18900,62.4,30642,11787,18855,62.5
04,읍부,085,80~84세,2018,113328,39944,73384,54.4,113039,39853,73186,54.5
04,읍부,085001, 80세,2018,27283,10264,17019,60.3,27209,10242,16967,60.4
04,읍부,085002, 81세,2018,24573,8970,15603,57.5,24496,8940,15556,57.5
04,읍부,085003, 82세,2018,22599,8009,14590,54.9,22549,7997,14552,55
04,읍부,085004, 83세,2018,21000,6952,14048,49.5,20945,6933,14012,49.5
04,읍부,085005, 84세,2018,17873,5749,12124,47.4,17840,5741,12099,47.5
04,읍부,090,85~89세,2018,54260,14721,39539,37.2,54174,14700,39474,37.2
04,읍부,090001, 85세,2018,14827,4490,10337,43.4,14800,4482,10318,43.4
04,읍부,090002, 86세,2018,13169,3658,9511,38.5,13154,3654,9500,38.5
04,읍부,090003, 87세,2018,9790,2577,7213,35.7,9773,2574,7199,35.8
04,읍부,090004, 88세,2018,9044,2161,6883,31.4,9029,2157,6872,31.4
04,읍부,090005, 89세,2018,7430,1835,5595,32.8,7418,1833,5585,32.8
04,읍부,095,90~94세,2018,17547,3692,13855,26.6,17519,3681,13838,26.6
04,읍부,095001, 90세,2018,5752,1240,4512,27.5,5740,1233,4507,27.4
04,읍부,095002, 91세,2018,4505,935,3570,26.2,4496,933,3563,26.2
04,읍부,095003, 92세,2018,3030,613,2417,25.4,3025,611,2414,25.3
04,읍부,095004, 93세,2018,2529,510,2019,25.3,2527,510,2017,25.3
04,읍부,095005, 94세,2018,1731,394,1337,29.5,1731,394,1337,29.5
04,읍부,100,95~99세,2018,4425,831,3594,23.1,4418,827,3591,23
04,읍부,100001, 95세,2018,1754,320,1434,22.3,1752,319,1433,22.3
04,읍부,100002, 96세,2018,1196,237,959,24.7,1193,235,958,24.5
04,읍부,100003, 97세,2018,719,148,571,25.9,719,148,571,25.9
04,읍부,100004, 98세,2018,455,72,383,18.8,454,71,383,18.5
04,읍부,100005, 99세,2018,301,54,247,21.9,300,54,246,22
04,읍부,101,100세이상,2018,504,66,438,15.1,504,66,438,15.1
04,읍부,102,15세미만,2018,705166,362893,342273,106,699495,360032,339463,106.1
04,읍부,103,15~64세,2018,3513260,1874222,1639038,114.3,3326816,1752543,1574273,111.3
04,읍부,104,65세이상,2018,765597,320692,444905,72.1,761224,318740,442484,72
04,읍부,086,85세이상,2018,76736,19310,57426,33.6,76615,19274,57341,33.6
04,읍부,126,평균연령,2018,41.8,40.4,43.2,,42,40.6,43.4,
04,읍부,127,중위연령,2018,42.6,41.2,44.2,,43.2,42,44.5,
05,면부,000,합계,2018,4730290,2453691,2276599,107.8,4464067,2263139,2200928,102.8
05,면부,005,0~4세,2018,124135,63480,60655,104.7,122622,62697,59925,104.6
05,면부,005001, 0세,2018,21409,10933,10476,104.4,21117,10778,10339,104.2
05,면부,005002, 1세,2018,23452,12008,11444,104.9,23115,11840,11275,105
05,면부,005003, 2세,2018,25766,13129,12637,103.9,25403,12942,12461,103.9
05,면부,005004, 3세,2018,26878,13777,13101,105.2,26627,13652,12975,105.2
05,면부,005005, 4세,2018,26630,13633,12997,104.9,26360,13485,12875,104.7
05,면부,010,5~9세,2018,137389,71377,66012,108.1,136347,70872,65475,108.2
05,면부,010001, 5세,2018,26927,13966,12961,107.8,26700,13853,12847,107.8
05,면부,010002, 6세,2018,28410,14682,13728,106.9,28172,14563,13609,107
05,면부,010003, 7세,2018,28419,14839,13580,109.3,28212,14749,13463,109.6
05,면부,010004, 8세,2018,27146,14125,13021,108.5,26960,14040,12920,108.7
05,면부,010005, 9세,2018,26487,13765,12722,108.2,26303,13667,12636,108.2
05,면부,015,10~14세,2018,132439,69249,63190,109.6,131712,68872,62840,109.6
05,면부,015001, 10세,2018,27644,14288,13356,107,27477,14206,13271,107
05,면부,015002, 11세,2018,27773,14379,13394,107.4,27611,14292,13319,107.3
05,면부,015003, 12세,2018,24989,13087,11902,110,24855,13014,11841,109.9
05,면부,015004, 13세,2018,24845,13052,11793,110.7,24724,12987,11737,110.7
05,면부,015005, 14세,2018,27188,14443,12745,113.3,27045,14373,12672,113.4
05,면부,020,15~19세,2018,183252,99480,83772,118.8,180118,97669,82449,118.5
05,면부,020001, 15세,2018,27900,14811,13089,113.2,27790,14757,13033,113.2
05,면부,020002, 16세,2018,30394,16315,14079,115.9,30232,16223,14009,115.8
05,면부,020003, 17세,2018,36130,19236,16894,113.9,35833,19073,16760,113.8
05,면부,020004, 18세,2018,41692,22518,19174,117.4,40929,22050,18879,116.8
05,면부,020005, 19세,2018,47136,26600,20536,129.5,45334,25566,19768,129.3
05,면부,025,20~24세,2018,253624,152495,101129,150.8,217312,126562,90750,139.5
05,면부,025001, 20세,2018,47322,26633,20689,128.7,43590,24370,19220,126.8
05,면부,025002, 21세,2018,49090,28020,21070,133,43720,24459,19261,127
05,면부,025003, 22세,2018,51143,30758,20385,150.9,43722,25433,18289,139.1
05,면부,025004, 23세,2018,52730,33111,19619,168.8,43461,26256,17205,152.6
05,면부,025005, 24세,2018,53339,33973,19366,175.4,42819,26044,16775,155.3
05,면부,030,25~29세,2018,258754,163233,95521,170.9,196413,115590,80823,143
05,면부,030001, 25세,2018,53282,33765,19517,173,41356,24748,16608,149
05,면부,030002, 26세,2018,53830,33740,20090,167.9,41281,24173,17108,141.3
05,면부,030003, 27세,2018,51318,32165,19153,167.9,38889,22656,16233,139.6
05,면부,030004, 28세,2018,51373,32429,18944,171.2,38216,22401,15815,141.6
05,면부,030005, 29세,2018,48951,31134,17817,174.7,36671,21612,15059,143.5
05,면부,035,30~34세,2018,242069,148772,93297,159.5,186663,106268,80395,132.2
05,면부,035001, 30세,2018,48681,30477,18204,167.4,36402,21130,15272,138.4
05,면부,035002, 31세,2018,48657,29974,18683,160.4,36730,20812,15918,130.7
05,면부,035003, 32세,2018,48020,29745,18275,162.8,36992,21284,15708,135.5
05,면부,035004, 33세,2018,47671,29190,18481,157.9,37171,21052,16119,130.6
05,면부,035005, 34세,2018,49040,29386,19654,149.5,39368,21990,17378,126.5
05,면부,040,35~39세,2018,268769,158441,110328,143.6,230755,129700,101055,128.3
05,면부,040001, 35세,2018,52175,30860,21315,144.8,43256,23991,19265,124.5
05,면부,040002, 36세,2018,55410,32771,22639,144.8,46945,26391,20554,128.4
05,면부,040003, 37세,2018,54080,31863,22217,143.4,46793,26370,20423,129.1
05,면부,040004, 38세,2018,55142,32217,22925,140.5,48224,27039,21185,127.6
05,면부,040005, 39세,2018,51962,30730,21232,144.7,45537,25909,19628,132
05,면부,045,40~44세,2018,254145,150196,103949,144.5,231832,134347,97485,137.8
05,면부,045001, 40세,2018,48342,28674,19668,145.8,42931,24679,18252,135.2
05,면부,045002, 41세,2018,49394,28992,20402,142.1,44552,25486,19066,133.7
05,면부,045003, 42세,2018,49433,29562,19871,148.8,44928,26372,18556,142.1
05,면부,045004, 43세,2018,50993,30025,20968,143.2,47114,27347,19767,138.3
05,면부,045005, 44세,2018,55983,32943,23040,143,52307,30463,21844,139.5
05,면부,050,45~49세,2018,309728,177533,132195,134.3,293247,167042,126205,132.4
05,면부,050001, 45세,2018,58001,33630,24371,138,54504,31323,23181,135.1
05,면부,050002, 46세,2018,57730,33762,23968,140.9,54196,31465,22731,138.4
05,면부,050003, 47세,2018,63615,36762,26853,136.9,60239,34598,25641,134.9
05,면부,050004, 48세,2018,62715,35632,27083,131.6,59522,33640,25882,130
05,면부,050005, 49세,2018,67667,37747,29920,126.2,64786,36016,28770,125.2
05,면부,055,50~54세,2018,358356,193939,164417,118,346325,187057,159268,117.4
05,면부,055001, 50세,2018,70837,38743,32094,120.7,68120,37133,30987,119.8
05,면부,055002, 51세,2018,68135,36619,31516,116.2,65771,35248,30523,115.5
05,면부,055003, 52세,2018,70774,39066,31708,123.2,68475,37751,30724,122.9
05,면부,055004, 53세,2018,75727,40780,34947,116.7,73293,39428,33865,116.4
05,면부,055005, 54세,2018,72883,38731,34152,113.4,70666,37497,33169,113
05,면부,060,55~59세,2018,457254,236770,220484,107.4,448928,232248,216680,107.2
05,면부,060001, 55세,2018,78834,41940,36894,113.7,76444,40619,35825,113.4
05,면부,060002, 56세,2018,87109,46057,41052,112.2,85280,45053,40227,112
05,면부,060003, 57세,2018,98959,50938,48021,106.1,97659,50254,47405,106
05,면부,060004, 58세,2018,100331,50767,49564,102.4,98747,49892,48855,102.1
05,면부,060005, 59세,2018,92021,47068,44953,104.7,90798,46430,44368,104.6
05,면부,065,60~64세,2018,431863,221072,210791,104.9,426866,218310,208556,104.7
05,면부,065001, 60세,2018,89525,46320,43205,107.2,88288,45628,42660,107
05,면부,065002, 61세,2018,89974,46615,43359,107.5,88816,45971,42845,107.3
05,면부,065003, 62세,2018,86171,44330,41841,105.9,85238,43801,41437,105.7
05,면부,065004, 63세,2018,88200,44465,43735,101.7,87299,43972,43327,101.5
05,면부,065005, 64세,2018,77993,39342,38651,101.8,77225,38938,38287,101.7
05,면부,070,65~69세,2018,336709,166737,169972,98.1,334619,165621,168998,98
05,면부,070001, 65세,2018,68396,34232,34164,100.2,67815,33913,33902,100
05,면부,070002, 66세,2018,77673,38567,39106,98.6,77199,38311,38888,98.5
05,면부,070003, 67세,2018,59572,29240,30332,96.4,59204,29047,30157,96.3
05,면부,070004, 68세,2018,64657,31709,32948,96.2,64292,31515,32777,96.1
05,면부,070005, 69세,2018,66411,32989,33422,98.7,66109,32835,33274,98.7
05,면부,075,70~74세,2018,287125,134110,153015,87.6,286347,133744,152603,87.6
05,면부,075001, 70세,2018,65340,32239,33101,97.4,65111,32125,32986,97.4
05,면부,075002, 71세,2018,65611,31646,33965,93.2,65425,31551,33874,93.1
05,면부,075003, 72세,2018,49428,23559,25869,91.1,49279,23493,25786,91.1
05,면부,075004, 73세,2018,51992,23299,28693,81.2,51871,23246,28625,81.2
05,면부,075005, 74세,2018,54754,23367,31387,74.4,54661,23329,31332,74.5
05,면부,080,75~79세,2018,311682,125874,185808,67.7,311289,125715,185574,67.7
05,면부,080001, 75세,2018,59544,25045,34499,72.6,59450,25001,34449,72.6
05,면부,080002, 76세,2018,74693,30983,43710,70.9,74610,30954,43656,70.9
05,면부,080003, 77세,2018,60959,24754,36205,68.4,60873,24718,36155,68.4
05,면부,080004, 78세,2018,57168,22405,34763,64.5,57096,22372,34724,64.4
05,면부,080005, 79세,2018,59318,22687,36631,61.9,59260,22670,36590,62
05,면부,085,80~84세,2018,228780,80446,148334,54.2,228575,80380,148195,54.2
05,면부,085001, 80세,2018,53325,19745,33580,58.8,53254,19728,33526,58.8
05,면부,085002, 81세,2018,49707,18191,31516,57.7,49656,18172,31484,57.7
05,면부,085003, 82세,2018,45579,16273,29306,55.5,45545,16261,29284,55.5
05,면부,085004, 83세,2018,43166,14323,28843,49.7,43141,14315,28826,49.7
05,면부,085005, 84세,2018,37003,11914,25089,47.5,36979,11904,25075,47.5
05,면부,090,85~89세,2018,110098,30756,79342,38.8,110003,30721,79282,38.7
05,면부,090001, 85세,2018,30691,9355,21336,43.8,30665,9344,21321,43.8
05,면부,090002, 86세,2018,26285,7711,18574,41.5,26268,7707,18561,41.5
05,면부,090003, 87세,2018,20200,5458,14742,37,20178,5449,14729,37
05,면부,090004, 88세,2018,18317,4542,13775,33,18298,4535,13763,33
05,면부,090005, 89세,2018,14605,3690,10915,33.8,14594,3686,10908,33.8
05,면부,095,90~94세,2018,34848,8023,26825,29.9,34827,8018,26809,29.9
05,면부,095001, 90세,2018,11672,2753,8919,30.9,11664,2751,8913,30.9
05,면부,095002, 91세,2018,8822,2060,6762,30.5,8815,2059,6756,30.5
05,면부,095003, 92세,2018,6079,1364,4715,28.9,6076,1363,4713,28.9
05,면부,095004, 93세,2018,4971,1084,3887,27.9,4969,1084,3885,27.9
05,면부,095005, 94세,2018,3304,762,2542,30,3303,761,2542,29.9
05,면부,100,95~99세,2018,8342,1585,6757,23.5,8338,1583,6755,23.4
05,면부,100001, 95세,2018,3234,657,2577,25.5,3232,656,2576,25.5
05,면부,100002, 96세,2018,2248,424,1824,23.2,2247,424,1823,23.3
05,면부,100003, 97세,2018,1343,249,1094,22.8,1343,249,1094,22.8
05,면부,100004, 98세,2018,933,152,781,19.5,933,152,781,19.5
05,면부,100005, 99세,2018,584,103,481,21.4,583,102,481,21.2
05,면부,101,100세이상,2018,929,123,806,15.3,929,123,806,15.3
05,면부,102,15세미만,2018,393963,204106,189857,107.5,390681,202441,188240,107.5
05,면부,103,15~64세,2018,3017814,1701931,1315883,129.3,2758459,1514793,1243666,121.8
05,면부,104,65세이상,2018,1318513,547654,770859,71,1314927,545905,769022,71
05,면부,086,85세이상,2018,154217,40487,113730,35.6,154097,40445,113652,35.6
05,면부,126,평균연령,2018,49.7,47,52.5,,50.5,48.1,53,
05,면부,127,중위연령,2018,52.9,49.3,56.7,,54.4,51.4,57.4,
03,동부,000,합계,2018,41915199,20865697,21049502,99.1,40726349,20237100,20489249,98.8
03,동부,005,0~4세,2018,1659733,851279,808454,105.3,1631706,837010,794696,105.3
03,동부,005001, 0세,2018,278667,143451,135216,106.1,273080,140548,132532,106
03,동부,005002, 1세,2018,305810,157399,148411,106.1,299568,154242,145326,106.1
03,동부,005003, 2세,2018,348050,178109,169941,104.8,341740,174868,166872,104.8
03,동부,005004, 3세,2018,365574,187225,178349,105,360418,184614,175804,105
03,동부,005005, 4세,2018,361632,185095,176537,104.8,356900,182738,174162,104.9
03,동부,010,5~9세,2018,1892246,972189,920057,105.7,1876251,964048,912203,105.7
03,동부,010001, 5세,2018,365517,186925,178592,104.7,361489,184932,176557,104.7
03,동부,010002, 6세,2018,397392,204057,193335,105.5,393701,202182,191519,105.6
03,동부,010003, 7세,2018,390267,200214,190053,105.3,387254,198633,188621,105.3
03,동부,010004, 8세,2018,375411,193492,181919,106.4,372716,192084,180632,106.3
03,동부,010005, 9세,2018,363659,187501,176158,106.4,361091,186217,174874,106.5
03,동부,015,10~14세,2018,1891700,976080,915620,106.6,1881748,971062,910686,106.6
03,동부,015001, 10세,2018,383971,197326,186645,105.7,381565,196098,185467,105.7
03,동부,015002, 11세,2018,394776,203244,191532,106.1,392567,202160,190407,106.2
03,동부,015003, 12세,2018,363128,187692,175436,107,361250,186764,174486,107
03,동부,015004, 13세,2018,357907,184916,172991,106.9,356252,184055,172197,106.9
03,동부,015005, 14세,2018,391918,202902,189016,107.3,390114,201985,188129,107.4
03,동부,020,15~19세,2018,2308946,1198443,1110503,107.9,2278080,1183941,1094139,108.2
03,동부,020001, 15세,2018,398840,206854,191986,107.7,397338,206104,191234,107.8
03,동부,020002, 16세,2018,408272,212520,195752,108.6,406476,211606,194870,108.6
03,동부,020003, 17세,2018,468567,243953,224614,108.6,465892,242643,223249,108.7
03,동부,020004, 18세,2018,520820,270485,250335,108,513435,267146,246289,108.5
03,동부,020005, 19세,2018,512447,264631,247816,106.8,494939,256442,238497,107.5
03,동부,025,20~24세,2018,2924080,1524154,1399926,108.9,2788733,1458322,1330411,109.6
03,동부,025001, 20세,2018,545216,281968,263248,107.1,520397,270700,249697,108.4
03,동부,025002, 21세,2018,568475,294895,273580,107.8,543215,283038,260177,108.8
03,동부,025003, 22세,2018,591541,309598,281943,109.8,564573,296476,268097,110.6
03,동부,025004, 23세,2018,604105,315350,288755,109.2,575051,300881,274170,109.7
03,동부,025005, 24세,2018,614743,322343,292400,110.2,585497,307227,278270,110.4
03,동부,030,25~29세,2018,2968436,1552888,1415548,109.7,2807791,1465025,1342766,109.1
03,동부,030001, 25세,2018,621050,326220,294830,110.6,591149,310287,280862,110.5
03,동부,030002, 26세,2018,629331,329243,300088,109.7,598597,312396,286201,109.2
03,동부,030003, 27세,2018,594555,309950,284605,108.9,563134,292725,270409,108.3
03,동부,030004, 28세,2018,569205,298040,271165,109.9,534828,279070,255758,109.1
03,동부,030005, 29세,2018,554295,289435,264860,109.3,520083,270547,249536,108.4
03,동부,035,30~34세,2018,2792890,1440744,1352146,106.6,2625789,1345671,1280118,105.1
03,동부,035001, 30세,2018,543029,281331,261698,107.5,507941,261886,246055,106.4
03,동부,035002, 31세,2018,546291,280775,265516,105.7,510165,260294,249871,104.2
03,동부,035003, 32세,2018,554977,287273,267704,107.3,520633,267745,252888,105.9
03,동부,035004, 33세,2018,561279,289389,271890,106.4,529742,271281,258461,105
03,동부,035005, 34세,2018,587314,301976,285338,105.8,557308,284465,272843,104.3
03,동부,040,35~39세,2018,3435423,1749809,1685614,103.8,3308538,1675450,1633088,102.6
03,동부,040001, 35세,2018,645056,329918,315138,104.7,616797,313494,303303,103.4
03,동부,040002, 36세,2018,700017,356582,343435,103.8,671712,340057,331655,102.5
03,동부,040003, 37세,2018,700573,359228,341345,105.2,676579,345138,331441,104.1
03,동부,040004, 38세,2018,712897,361350,351547,102.8,689834,347787,342047,101.7
03,동부,040005, 39세,2018,676880,342731,334149,102.6,653616,328974,324642,101.3
03,동부,045,40~44세,2018,3266163,1645565,1620598,101.5,3171651,1590891,1580760,100.6
03,동부,045001, 40세,2018,618730,313889,304841,103,597779,301636,296143,101.9
03,동부,045002, 41세,2018,638293,321243,317050,101.3,619475,310267,309208,100.3
03,동부,045003, 42세,2018,628209,318222,309987,102.7,609566,307332,302234,101.7
03,동부,045004, 43세,2018,660475,330479,329996,100.1,642664,320314,322350,99.4
03,동부,045005, 44세,2018,720456,361732,358724,100.8,702167,351342,350825,100.1
03,동부,050,45~49세,2018,3762200,1877538,1884662,99.6,3657018,1820353,1836665,99.1
03,동부,050001, 45세,2018,730504,362787,367717,98.7,710950,351757,359193,97.9
03,동부,050002, 46세,2018,735011,370940,364071,101.9,714220,359303,354917,101.2
03,동부,050003, 47세,2018,781069,390823,390246,100.1,759244,378988,380256,99.7
03,동부,050004, 48세,2018,755270,376555,378715,99.4,733123,364738,368385,99
03,동부,050005, 49세,2018,760346,376433,383913,98.1,739481,365567,373914,97.8
03,동부,055,50~54세,2018,3449081,1710377,1738704,98.4,3348200,1659276,1688924,98.2
03,동부,055001, 50세,2018,754976,370694,384282,96.5,734081,359806,374275,96.1
03,동부,055002, 51세,2018,688426,337323,351103,96.1,670810,328365,342445,95.9
03,동부,055003, 52세,2018,671707,339468,332239,102.2,652165,329655,322510,102.2
03,동부,055004, 53세,2018,688714,340218,348496,97.6,667217,329407,337810,97.5
03,동부,055005, 54세,2018,645258,322674,322584,100,623927,312043,311884,100.1
03,동부,060,55~59세,2018,3465361,1713146,1752215,97.8,3375145,1669274,1705871,97.9
03,동부,060001, 55세,2018,680446,341836,338610,101,655130,329406,325724,101.1
03,동부,060002, 56세,2018,689443,345368,344075,100.4,670027,335955,334072,100.6
03,동부,060003, 57세,2018,729675,357939,371736,96.3,717001,351954,365047,96.4
03,동부,060004, 58세,2018,723008,352670,370338,95.2,704587,343680,360907,95.2
03,동부,060005, 59세,2018,642789,315333,327456,96.3,628400,308279,320121,96.3
03,동부,065,60~64세,2018,2727901,1333489,1394412,95.6,2657735,1299177,1358558,95.6
03,동부,065001, 60세,2018,604160,299217,304943,98.1,588081,291419,296662,98.2
03,동부,065002, 61세,2018,588633,289539,299094,96.8,572297,281437,290860,96.8
03,동부,065003, 62세,2018,536012,261861,274151,95.5,522432,255255,267177,95.5
03,동부,065004, 63세,2018,544544,261533,283011,92.4,531586,255156,276430,92.3
03,동부,065005, 64세,2018,454552,221339,233213,94.9,443339,215910,227429,94.9
03,동부,070,65~69세,2018,1808996,863372,945624,91.3,1776938,848219,928719,91.3
03,동부,070001, 65세,2018,397091,190275,206816,92,388059,185877,202182,91.9
03,동부,070002, 66세,2018,425950,204633,221317,92.5,418359,201002,217357,92.5
03,동부,070003, 67세,2018,312739,149461,163278,91.5,306572,146575,159997,91.6
03,동부,070004, 68세,2018,335619,159726,175893,90.8,330694,157472,173222,90.9
03,동부,070005, 69세,2018,337597,159277,178320,89.3,333254,157293,175961,89.4
03,동부,075,70~74세,2018,1361722,626485,735237,85.2,1351430,622326,729104,85.4
03,동부,075001, 70세,2018,326060,153327,172733,88.8,323206,152096,171110,88.9
03,동부,075002, 71세,2018,320721,147726,172995,85.4,318177,146661,171516,85.5
03,동부,075003, 72세,2018,242503,112514,129989,86.6,240489,111721,128768,86.8
03,동부,075004, 73세,2018,235371,107233,128138,83.7,233869,106655,127214,83.8
03,동부,075005, 74세,2018,237067,105685,131382,80.4,235689,105193,130496,80.6
03,동부,080,75~79세,2018,1105530,472463,633067,74.6,1099927,470738,629189,74.8
03,동부,080001, 75세,2018,239363,105892,133471,79.3,238139,105488,132651,79.5
03,동부,080002, 76세,2018,270989,118922,152067,78.2,269808,118531,151277,78.4
03,동부,080003, 77세,2018,215521,91972,123549,74.4,214370,91621,122749,74.6
03,동부,080004, 78세,2018,193228,79829,113399,70.4,192166,79519,112647,70.6
03,동부,080005, 79세,2018,186429,75848,110581,68.6,185444,75579,109865,68.8
03,동부,085,80~84세,2018,663565,243501,420064,58,660101,242543,417558,58.1
03,동부,085001, 80세,2018,164487,64748,99739,64.9,163544,64486,99058,65.1
03,동부,085002, 81세,2018,147458,56094,91364,61.4,146708,55879,90829,61.5
03,동부,085003, 82세,2018,130825,47417,83408,56.8,130103,47220,82883,57
03,동부,085004, 83세,2018,120755,41955,78800,53.2,120192,41789,78403,53.3
03,동부,085005, 84세,2018,100040,33287,66753,49.9,99554,33169,66385,50
03,동부,090,85~89세,2018,303323,86529,216794,39.9,302070,86229,215841,40
03,동부,090001, 85세,2018,83253,26220,57033,46,82866,26131,56735,46.1
03,동부,090002, 86세,2018,72312,21575,50737,42.5,72034,21503,50531,42.6
03,동부,090003, 87세,2018,55339,15254,40085,38.1,55116,15205,39911,38.1
03,동부,090004, 88세,2018,50436,12618,37818,33.4,50233,12576,37657,33.4
03,동부,090005, 89세,2018,41983,10862,31121,34.9,41821,10814,31007,34.9
03,동부,095,90~94세,2018,101015,22223,78792,28.2,100693,22150,78543,28.2
03,동부,095001, 90세,2018,33593,7861,25732,30.5,33494,7834,25660,30.5
03,동부,095002, 91세,2018,26066,5797,20269,28.6,25976,5778,20198,28.6
03,동부,095003, 92세,2018,17325,3638,13687,26.6,17266,3622,13644,26.5
03,동부,095004, 93세,2018,14200,2801,11399,24.6,14155,2794,11361,24.6
03,동부,095005, 94세,2018,9831,2126,7705,27.6,9802,2122,7680,27.6
03,동부,100,95~99세,2018,24072,5011,19061,26.3,24006,4992,19014,26.3
03,동부,100001, 95세,2018,9345,2021,7324,27.6,9320,2014,7306,27.6
03,동부,100002, 96세,2018,6369,1297,5072,25.6,6355,1294,5061,25.6
03,동부,100003, 97세,2018,3969,775,3194,24.3,3960,770,3190,24.1
03,동부,100004, 98세,2018,2744,549,2195,25,2731,546,2185,25
03,동부,100005, 99세,2018,1645,369,1276,28.9,1640,368,1272,28.9
03,동부,101,100세이상,2018,2816,412,2404,17.1,2799,403,2396,16.8
03,동부,102,15세미만,2018,5443679,2799548,2644131,105.9,5389705,2772120,2617585,105.9
03,동부,103,15~64세,2018,31100481,15746153,15354328,102.6,30018680,15167380,14851300,102.1
03,동부,104,65세이상,2018,5371039,2319996,3051043,76,5317964,2297600,3020364,76.1
03,동부,086,85세이상,2018,431226,114175,317051,36,429568,113774,315794,36
03,동부,126,평균연령,2018,41,39.9,42,,41,40,42.1,
03,동부,127,중위연령,2018,41.7,40.5,43,,41.9,40.7,43.1,
11,서울특별시,000,합계,2018,9673936,4718972,4954964,95.2,9299511,4536552,4762959,95.2
11,서울특별시,005,0~4세,2018,328817,168527,160290,105.1,320267,164216,156051,105.2
11,서울특별시,005001, 0세,2018,58730,30444,28286,107.6,57121,29622,27499,107.7
11,서울특별시,005002, 1세,2018,62137,31716,30421,104.3,60208,30754,29454,104.4
11,서울특별시,005003, 2세,2018,68739,35160,33579,104.7,66779,34141,32638,104.6
11,서울특별시,005004, 3세,2018,70434,36012,34422,104.6,68843,35222,33621,104.8
11,서울특별시,005005, 4세,2018,68777,35195,33582,104.8,67316,34477,32839,105
11,서울특별시,010,5~9세,2018,351631,180429,171202,105.4,346346,177716,168630,105.4
11,서울특별시,010001, 5세,2018,68618,35205,33413,105.4,67319,34540,32779,105.4
11,서울특별시,010002, 6세,2018,73676,37802,35874,105.4,72482,37195,35287,105.4
11,서울특별시,010003, 7세,2018,71763,36756,35007,105,70752,36221,34531,104.9
11,서울특별시,010004, 8세,2018,69899,35973,33926,106,68984,35488,33496,105.9
11,서울특별시,010005, 9세,2018,67675,34693,32982,105.2,66809,34272,32537,105.3
11,서울특별시,015,10~14세,2018,363181,187466,175715,106.7,359678,185675,174003,106.7
11,서울특별시,015001, 10세,2018,72570,37287,35283,105.7,71717,36862,34855,105.8
11,서울특별시,015002, 11세,2018,74824,38555,36269,106.3,74054,38173,35881,106.4
11,서울특별시,015003, 12세,2018,69821,36130,33691,107.2,69187,35809,33378,107.3
11,서울특별시,015004, 13세,2018,69221,35937,33284,108,68628,35610,33018,107.9
11,서울특별시,015005, 14세,2018,76745,39557,37188,106.4,76092,39221,36871,106.4
11,서울특별시,020,15~19세,2018,465785,235494,230291,102.3,455469,231225,224244,103.1
11,서울특별시,020001, 15세,2018,77490,39939,37551,106.4,76974,39676,37298,106.4
11,서울특별시,020002, 16세,2018,79650,40973,38677,105.9,79037,40656,38381,105.9
11,서울특별시,020003, 17세,2018,90975,47009,43966,106.9,90144,46612,43532,107.1
11,서울특별시,020004, 18세,2018,105064,53067,51997,102.1,102562,52104,50458,103.3
11,서울특별시,020005, 19세,2018,112606,54506,58100,93.8,106752,52177,54575,95.6
11,서울특별시,025,20~24세,2018,691954,330203,361751,91.3,645569,312686,332883,93.9
11,서울특별시,025001, 20세,2018,123355,58614,64741,90.5,114160,55238,58922,93.7
11,서울특별시,025002, 21세,2018,128985,60989,67996,89.7,119896,57702,62194,92.8
11,서울특별시,025003, 22세,2018,137821,65879,71942,91.6,128511,62411,66100,94.4
11,서울특별시,025004, 23세,2018,146873,70175,76698,91.5,137128,66426,70702,94
11,서울특별시,025005, 24세,2018,154920,74546,80374,92.7,145874,70909,74965,94.6
11,서울특별시,030,25~29세,2018,799023,395630,403393,98.1,755906,375910,379996,98.9
11,서울특별시,030001, 25세,2018,161804,79338,82466,96.2,153087,75636,77451,97.7
11,서울특별시,030002, 26세,2018,167740,82817,84923,97.5,159379,79110,80269,98.6
11,서울특별시,030003, 27세,2018,162003,80298,81705,98.3,153793,76486,77307,98.9
11,서울특별시,030004, 28세,2018,155912,77623,78289,99.1,146911,73332,73579,99.7
11,서울특별시,030005, 29세,2018,151564,75554,76010,99.4,142736,71346,71390,99.9
11,서울특별시,035,30~34세,2018,738359,369944,368415,100.4,696267,348197,348070,100
11,서울특별시,035001, 30세,2018,148674,73906,74768,98.8,139716,69525,70191,99.1
11,서울특별시,035002, 31세,2018,147213,73000,74213,98.4,137984,68323,69661,98.1
11,서울특별시,035003, 32세,2018,147474,74104,73370,101,138769,69499,69270,100.3
11,서울특별시,035004, 33세,2018,145960,73422,72538,101.2,138243,69378,68865,100.7
11,서울특별시,035005, 34세,2018,149038,75512,73526,102.7,141555,71472,70083,102
11,서울특별시,040,35~39세,2018,804461,407004,397457,102.4,772520,389408,383112,101.6
11,서울특별시,040001, 35세,2018,158289,80156,78133,102.6,151238,76376,74862,102
11,서울특별시,040002, 36세,2018,166482,83977,82505,101.8,159384,80098,79286,101
11,서울특별시,040003, 37세,2018,163309,83433,79876,104.5,157393,80199,77194,103.9
11,서울특별시,040004, 38세,2018,162599,81961,80638,101.6,156846,78762,78084,100.9
11,서울특별시,040005, 39세,2018,153782,77477,76305,101.5,147659,73973,73686,100.4
11,서울특별시,045,40~44세,2018,720732,360945,359787,100.3,694455,345987,348468,99.3
11,서울특별시,045001, 40세,2018,137178,68956,68222,101.1,131551,65731,65820,99.9
11,서울특별시,045002, 41세,2018,141758,70650,71108,99.4,136678,67743,68935,98.3
11,서울특별시,045003, 42세,2018,139411,70227,69184,101.5,134261,67314,66947,100.5
11,서울특별시,045004, 43세,2018,144926,72302,72624,99.6,139941,69487,70454,98.6
11,서울특별시,045005, 44세,2018,157459,78810,78649,100.2,152024,75712,76312,99.2
11,서울특별시,050,45~49세,2018,835977,414897,421080,98.5,801944,396529,405415,97.8
11,서울특별시,050001, 45세,2018,161007,79688,81319,98,154953,76221,78732,96.8
11,서울특별시,050002, 46세,2018,164572,82614,81958,100.8,158068,79043,79025,100
11,서울특별시,050003, 47세,2018,174832,86983,87849,99,167772,83184,84588,98.3
11,서울특별시,050004, 48세,2018,167943,83004,84939,97.7,160628,79147,81481,97.1
11,서울특별시,050005, 49세,2018,167623,82608,85015,97.2,160523,78934,81589,96.7
11,서울특별시,055,50~54세,2018,757187,370282,386905,95.7,720312,351708,368604,95.4
11,서울특별시,055001, 50세,2018,163811,79662,84149,94.7,156575,75935,80640,94.2
11,서울특별시,055002, 51세,2018,149572,72316,77256,93.6,143430,69211,74219,93.3
11,서울특별시,055003, 52세,2018,145056,72543,72513,100,137931,68923,69008,99.9
11,서울특별시,055004, 53세,2018,152116,73865,78251,94.4,144072,69896,74176,94.2
11,서울특별시,055005, 54세,2018,146632,71896,74736,96.2,138304,67743,70561,96
11,서울특별시,060,55~59세,2018,786431,378116,408315,92.6,750422,360520,389902,92.5
11,서울특별시,060001, 55세,2018,154060,75421,78639,95.9,144019,70497,73522,95.9
11,서울특별시,060002, 56세,2018,154365,75833,78532,96.6,146576,72026,74550,96.6
11,서울특별시,060003, 57세,2018,161464,76845,84619,90.8,156572,74525,82047,90.8
11,서울특별시,060004, 58세,2018,165973,78215,87758,89.1,158517,74541,83976,88.8
11,서울특별시,060005, 59세,2018,150569,71802,78767,91.2,144738,68931,75807,90.9
11,서울특별시,065,60~64세,2018,673923,320123,353800,90.5,644797,305781,339016,90.2
11,서울특별시,065001, 60세,2018,145406,69887,75519,92.5,138756,66681,72075,92.5
11,서울특별시,065002, 61세,2018,143418,68397,75021,91.2,136578,64939,71639,90.6
11,서울특별시,065003, 62세,2018,132531,62927,69604,90.4,126933,60197,66736,90.2
11,서울특별시,065004, 63세,2018,137258,64132,73126,87.7,131849,61441,70408,87.3
11,서울특별시,065005, 64세,2018,115310,54780,60530,90.5,110681,52523,58158,90.3
11,서울특별시,070,65~69세,2018,463507,218200,245307,88.9,450779,212039,238740,88.8
11,서울특별시,070001, 65세,2018,101997,48159,53838,89.5,98359,46344,52015,89.1
11,서울특별시,070002, 66세,2018,108167,51162,57005,89.8,105117,49670,55447,89.6
11,서울특별시,070003, 67세,2018,78524,37042,41482,89.3,76130,35908,40222,89.3
11,서울특별시,070004, 68세,2018,87250,41124,46126,89.2,85296,40202,45094,89.2
11,서울특별시,070005, 69세,2018,87569,40713,46856,86.9,85877,39915,45962,86.8
11,서울특별시,075,70~74세,2018,360011,166087,193924,85.6,356109,164528,191581,85.9
11,서울특별시,075001, 70세,2018,84713,39726,44987,88.3,83587,39252,44335,88.5
11,서울특별시,075002, 71세,2018,85018,38990,46028,84.7,84059,38604,45455,84.9
11,서울특별시,075003, 72세,2018,65930,30294,35636,85,65159,29973,35186,85.2
11,서울특별시,075004, 73세,2018,62780,28996,33784,85.8,62247,28802,33445,86.1
11,서울특별시,075005, 74세,2018,61570,28081,33489,83.9,61057,27897,33160,84.1
11,서울특별시,080,75~79세,2018,278840,125514,153326,81.9,276612,124859,151753,82.3
11,서울특별시,080001, 75세,2018,61363,28198,33165,85,60868,28027,32841,85.3
11,서울특별시,080002, 76세,2018,69191,31802,37389,85.1,68728,31665,37063,85.4
11,서울특별시,080003, 77세,2018,54570,24686,29884,82.6,54134,24560,29574,83
11,서울특별시,080004, 78세,2018,48044,21067,26977,78.1,47605,20947,26658,78.6
11,서울특별시,080005, 79세,2018,45672,19761,25911,76.3,45277,19660,25617,76.7
11,서울특별시,085,80~84세,2018,156237,61459,94778,64.8,154865,61090,93775,65.1
11,서울특별시,085001, 80세,2018,39716,16669,23047,72.3,39362,16575,22787,72.7
11,서울특별시,085002, 81세,2018,35236,14227,21009,67.7,34921,14146,20775,68.1
11,서울특별시,085003, 82세,2018,30604,11958,18646,64.1,30313,11877,18436,64.4
11,서울특별시,085004, 83세,2018,28038,10498,17540,59.9,27805,10422,17383,60
11,서울특별시,085005, 84세,2018,22643,8107,14536,55.8,22464,8070,14394,56.1
11,서울특별시,090,85~89세,2018,68170,21507,46663,46.1,67670,21385,46285,46.2
11,서울특별시,090001, 85세,2018,18694,6426,12268,52.4,18532,6388,12144,52.6
11,서울특별시,090002, 86세,2018,16241,5367,10874,49.4,16137,5341,10796,49.5
11,서울특별시,090003, 87세,2018,12387,3743,8644,43.3,12295,3719,8576,43.4
11,서울특별시,090004, 88세,2018,11313,3197,8116,39.4,11229,3182,8047,39.5
11,서울특별시,090005, 89세,2018,9535,2774,6761,41,9477,2755,6722,41
11,서울특별시,095,90~94세,2018,23407,5654,17753,31.8,23263,5619,17644,31.8
11,서울특별시,095001, 90세,2018,7762,1994,5768,34.6,7719,1980,5739,34.5
11,서울특별시,095002, 91세,2018,5951,1437,4514,31.8,5909,1427,4482,31.8
11,서울특별시,095003, 92세,2018,4059,919,3140,29.3,4036,913,3123,29.2
11,서울특별시,095004, 93세,2018,3199,697,2502,27.9,3178,694,2484,27.9
11,서울특별시,095005, 94세,2018,2436,607,1829,33.2,2421,605,1816,33.3
11,서울특별시,100,95~99세,2018,5626,1363,4263,32,5594,1351,4243,31.8
11,서울특별시,100001, 95세,2018,2199,558,1641,34,2186,552,1634,33.8
11,서울특별시,100002, 96세,2018,1449,326,1123,29,1445,325,1120,29
11,서울특별시,100003, 97세,2018,921,227,694,32.7,915,224,691,32.4
11,서울특별시,100004, 98세,2018,667,160,507,31.6,662,159,503,31.6
11,서울특별시,100005, 99세,2018,390,92,298,30.9,386,91,295,30.8
11,서울특별시,101,100세이상,2018,677,128,549,23.3,667,123,544,22.6
11,서울특별시,102,15세미만,2018,1043629,536422,507207,105.8,1026291,527607,498684,105.8
11,서울특별시,103,15~64세,2018,7273832,3582638,3691194,97.1,6937661,3417951,3519710,97.1
11,서울특별시,104,65세이상,2018,1356475,599912,756563,79.3,1335559,590994,744565,79.4
11,서울특별시,086,85세이상,2018,97880,28652,69228,41.4,97194,28478,68716,41.4
11,서울특별시,126,평균연령,2018,41.9,41.1,42.7,,42,41.1,42.8,
11,서울특별시,127,중위연령,2018,42.1,41.2,43,,42.2,41.3,43.2,
11010, 종로구,000,합계,2018,157967,77147,80820,95.5,145911,71611,74300,96.4
11010, 종로구,005,0~4세,2018,3870,1957,1913,102.3,3734,1889,1845,102.4
11010, 종로구,005001, 0세,2018,639,337,302,111.6,619,327,292,112
11010, 종로구,005002, 1세,2018,704,335,369,90.8,675,319,356,89.6
11010, 종로구,005003, 2세,2018,814,407,407,100,778,387,391,99
11010, 종로구,005004, 3세,2018,868,449,419,107.2,842,439,403,108.9
11010, 종로구,005005, 4세,2018,845,429,416,103.1,820,417,403,103.5
11010, 종로구,010,5~9세,2018,4468,2286,2182,104.8,4353,2233,2120,105.3
11010, 종로구,010001, 5세,2018,824,422,402,105,795,408,387,105.4
11010, 종로구,010002, 6세,2018,964,496,468,106,937,482,455,105.9
11010, 종로구,010003, 7세,2018,898,467,431,108.4,875,457,418,109.3
11010, 종로구,010004, 8세,2018,879,436,443,98.4,864,431,433,99.5
11010, 종로구,010005, 9세,2018,903,465,438,106.2,882,455,427,106.6
11010, 종로구,015,10~14세,2018,4863,2509,2354,106.6,4784,2460,2324,105.9
11010, 종로구,015001, 10세,2018,932,495,437,113.3,912,483,429,112.6
11010, 종로구,015002, 11세,2018,1030,532,498,106.8,1014,521,493,105.7
11010, 종로구,015003, 12세,2018,989,504,485,103.9,974,497,477,104.2
11010, 종로구,015004, 13세,2018,919,473,446,106.1,902,460,442,104.1
11010, 종로구,015005, 14세,2018,993,505,488,103.5,982,499,483,103.3
11010, 종로구,020,15~19세,2018,9887,5129,4758,107.8,9022,4816,4206,114.5
11010, 종로구,020001, 15세,2018,1225,657,568,115.7,1209,648,561,115.5
11010, 종로구,020002, 16세,2018,1453,789,664,118.8,1437,778,659,118.1
11010, 종로구,020003, 17세,2018,1710,1012,698,145,1667,990,677,146.2
11010, 종로구,020004, 18세,2018,2552,1410,1142,123.5,2354,1339,1015,131.9
11010, 종로구,020005, 19세,2018,2947,1261,1686,74.8,2355,1061,1294,82
11010, 종로구,025,20~24세,2018,15995,7391,8604,85.9,12709,6160,6549,94.1
11010, 종로구,025001, 20세,2018,3181,1316,1865,70.6,2368,1027,1341,76.6
11010, 종로구,025002, 21세,2018,3017,1280,1737,73.7,2298,1031,1267,81.4
11010, 종로구,025003, 22세,2018,3252,1517,1735,87.4,2575,1267,1308,96.9
11010, 종로구,025004, 23세,2018,3363,1674,1689,99.1,2733,1417,1316,107.7
11010, 종로구,025005, 24세,2018,3182,1604,1578,101.6,2735,1418,1317,107.7
11010, 종로구,030,25~29세,2018,14177,7388,6789,108.8,12650,6669,5981,111.5
11010, 종로구,030001, 25세,2018,3229,1658,1571,105.5,2828,1480,1348,109.8
11010, 종로구,030002, 26세,2018,2988,1598,1390,115,2650,1448,1202,120.5
11010, 종로구,030003, 27세,2018,2896,1534,1362,112.6,2621,1400,1221,114.7
11010, 종로구,030004, 28세,2018,2642,1345,1297,103.7,2368,1210,1158,104.5
11010, 종로구,030005, 29세,2018,2422,1253,1169,107.2,2183,1131,1052,107.5
11010, 종로구,035,30~34세,2018,11013,5656,5357,105.6,9810,5017,4793,104.7
11010, 종로구,035001, 30세,2018,2401,1301,1100,118.3,2133,1150,983,117
11010, 종로구,035002, 31세,2018,2328,1123,1205,93.2,2071,994,1077,92.3
11010, 종로구,035003, 32세,2018,2132,1096,1036,105.8,1865,944,921,102.5
11010, 종로구,035004, 33세,2018,2091,1076,1015,106,1894,990,904,109.5
11010, 종로구,035005, 34세,2018,2061,1060,1001,105.9,1847,939,908,103.4
11010, 종로구,040,35~39세,2018,10832,5365,5467,98.1,9908,4873,5035,96.8
11010, 종로구,040001, 35세,2018,2120,1061,1059,100.2,1933,970,963,100.7
11010, 종로구,040002, 36세,2018,2180,1080,1100,98.2,1975,967,1008,95.9
11010, 종로구,040003, 37세,2018,2259,1129,1130,99.9,2079,1031,1048,98.4
11010, 종로구,040004, 38세,2018,2185,1066,1119,95.3,2006,968,1038,93.3
11010, 종로구,040005, 39세,2018,2088,1029,1059,97.2,1915,937,978,95.8
11010, 종로구,045,40~44세,2018,10267,5048,5219,96.7,9512,4599,4913,93.6
11010, 종로구,045001, 40세,2018,1890,957,933,102.6,1722,852,870,97.9
11010, 종로구,045002, 41세,2018,1954,922,1032,89.3,1808,839,969,86.6
11010, 종로구,045003, 42세,2018,2036,1032,1004,102.8,1873,931,942,98.8
11010, 종로구,045004, 43세,2018,2087,1017,1070,95,1945,930,1015,91.6
11010, 종로구,045005, 44세,2018,2300,1120,1180,94.9,2164,1047,1117,93.7
11010, 종로구,050,45~49세,2018,13107,6468,6639,97.4,12287,6030,6257,96.4
11010, 종로구,050001, 45세,2018,2465,1171,1294,90.5,2292,1076,1216,88.5
11010, 종로구,050002, 46세,2018,2585,1306,1279,102.1,2417,1218,1199,101.6
11010, 종로구,050003, 47세,2018,2761,1434,1327,108.1,2603,1347,1256,107.2
11010, 종로구,050004, 48세,2018,2672,1304,1368,95.3,2505,1213,1292,93.9
11010, 종로구,050005, 49세,2018,2624,1253,1371,91.4,2470,1176,1294,90.9
11010, 종로구,055,50~54세,2018,12329,5988,6341,94.4,11543,5610,5933,94.6
11010, 종로구,055001, 50세,2018,2553,1197,1356,88.3,2396,1124,1272,88.4
11010, 종로구,055002, 51세,2018,2392,1166,1226,95.1,2266,1097,1169,93.8
11010, 종로구,055003, 52세,2018,2406,1156,1250,92.5,2251,1081,1170,92.4
11010, 종로구,055004, 53세,2018,2480,1222,1258,97.1,2295,1139,1156,98.5
11010, 종로구,055005, 54세,2018,2498,1247,1251,99.7,2335,1169,1166,100.3
11010, 종로구,060,55~59세,2018,12701,6313,6388,98.8,12032,6008,6024,99.7
11010, 종로구,060001, 55세,2018,2504,1270,1234,102.9,2341,1193,1148,103.9
11010, 종로구,060002, 56세,2018,2517,1307,1210,108,2365,1230,1135,108.4
11010, 종로구,060003, 57세,2018,2627,1274,1353,94.2,2536,1235,1301,94.9
11010, 종로구,060004, 58세,2018,2656,1237,1419,87.2,2516,1170,1346,86.9
11010, 종로구,060005, 59세,2018,2397,1225,1172,104.5,2274,1180,1094,107.9
11010, 종로구,065,60~64세,2018,10411,5177,5234,98.9,9906,4939,4967,99.4
11010, 종로구,065001, 60세,2018,2259,1151,1108,103.9,2123,1092,1031,105.9
11010, 종로구,065002, 61세,2018,2157,1075,1082,99.4,2051,1025,1026,99.9
11010, 종로구,065003, 62세,2018,2076,1035,1041,99.4,1984,990,994,99.6
11010, 종로구,065004, 63세,2018,2098,1011,1087,93,2006,961,1045,92
11010, 종로구,065005, 64세,2018,1821,905,916,98.8,1742,871,871,100
11010, 종로구,070,65~69세,2018,7143,3374,3769,89.5,6905,3266,3639,89.7
11010, 종로구,070001, 65세,2018,1602,774,828,93.5,1532,746,786,94.9
11010, 종로구,070002, 66세,2018,1661,823,838,98.2,1609,793,816,97.2
11010, 종로구,070003, 67세,2018,1189,545,644,84.6,1133,522,611,85.4
11010, 종로구,070004, 68세,2018,1351,615,736,83.6,1317,604,713,84.7
11010, 종로구,070005, 69세,2018,1340,617,723,85.3,1314,601,713,84.3
11010, 종로구,075,70~74세,2018,6066,2658,3408,78,6001,2635,3366,78.3
11010, 종로구,075001, 70세,2018,1384,631,753,83.8,1367,624,743,84
11010, 종로구,075002, 71세,2018,1388,621,767,81,1371,613,758,80.9
11010, 종로구,075003, 72세,2018,1105,484,621,77.9,1096,482,614,78.5
11010, 종로구,075004, 73세,2018,1092,475,617,77,1078,472,606,77.9
11010, 종로구,075005, 74세,2018,1097,447,650,68.8,1089,444,645,68.8
11010, 종로구,080,75~79세,2018,5463,2422,3041,79.6,5422,2408,3014,79.9
11010, 종로구,080001, 75세,2018,1150,525,625,84,1143,523,620,84.4
11010, 종로구,080002, 76세,2018,1312,588,724,81.2,1301,584,717,81.5
11010, 종로구,080003, 77세,2018,1084,482,602,80.1,1076,478,598,79.9
11010, 종로구,080004, 78세,2018,959,427,532,80.3,952,426,526,81
11010, 종로구,080005, 79세,2018,958,400,558,71.7,950,397,553,71.8
11010, 종로구,085,80~84세,2018,3209,1307,1902,68.7,3186,1296,1890,68.6
11010, 종로구,085001, 80세,2018,794,318,476,66.8,789,317,472,67.2
11010, 종로구,085002, 81세,2018,700,298,402,74.1,695,295,400,73.8
11010, 종로구,085003, 82세,2018,630,264,366,72.1,628,264,364,72.5
11010, 종로구,085004, 83세,2018,602,241,361,66.8,594,235,359,65.5
11010, 종로구,085005, 84세,2018,483,186,297,62.6,480,185,295,62.7
11010, 종로구,090,85~89세,2018,1468,508,960,52.9,1457,504,953,52.9
11010, 종로구,090001, 85세,2018,378,133,245,54.3,378,133,245,54.3
11010, 종로구,090002, 86세,2018,337,123,214,57.5,335,123,212,58
11010, 종로구,090003, 87세,2018,301,98,203,48.3,296,97,199,48.7
11010, 종로구,090004, 88세,2018,245,76,169,45,243,75,168,44.6
11010, 종로구,090005, 89세,2018,207,78,129,60.5,205,76,129,58.9
11010, 종로구,095,90~94세,2018,540,157,383,41,536,156,380,41.1
11010, 종로구,095001, 90세,2018,166,45,121,37.2,164,45,119,37.8
11010, 종로구,095002, 91세,2018,136,43,93,46.2,134,42,92,45.7
11010, 종로구,095003, 92세,2018,102,30,72,41.7,102,30,72,41.7
11010, 종로구,095004, 93세,2018,77,22,55,40,77,22,55,40
11010, 종로구,095005, 94세,2018,59,17,42,40.5,59,17,42,40.5
11010, 종로구,100,95~99세,2018,136,42,94,44.7,133,40,93,43
11010, 종로구,100001, 95세,2018,44,16,28,57.1,43,15,28,53.6
11010, 종로구,100002, 96세,2018,43,13,30,43.3,43,13,30,43.3
11010, 종로구,100003, 97세,2018,22,6,16,37.5,21,5,16,31.3
11010, 종로구,100004, 98세,2018,17,X,14,21.4,16,X,13,23.1
11010, 종로구,100005, 99세,2018,10,X,6,66.7,10,X,6,66.7
11010, 종로구,101,100세이상,2018,22,X,18,22.2,21,X,18,16.7
11010, 종로구,102,15세미만,2018,13201,6752,6449,104.7,12871,6582,6289,104.7
11010, 종로구,103,15~64세,2018,120719,59923,60796,98.6,109379,54721,54658,100.1
11010, 종로구,104,65세이상,2018,24047,10472,13575,77.1,23661,10308,13353,77.2
11010, 종로구,086,85세이상,2018,2166,711,1455,48.9,2147,703,1444,48.7
11010, 종로구,126,평균연령,2018,42.3,41.5,43.1,,42.9,41.9,43.9,
11010, 종로구,127,중위연령,2018,42,40.9,43,,43.3,42,44.4,
11020, 중구,000,합계,2018,129797,62975,66822,94.2,117809,57240,60569,94.5
11020, 중구,005,0~4세,2018,4111,2059,2052,100.3,3824,1912,1912,100
11020, 중구,005001, 0세,2018,756,371,385,96.4,708,347,361,96.1
11020, 중구,005002, 1세,2018,787,384,403,95.3,722,355,367,96.7
11020, 중구,005003, 2세,2018,907,485,422,114.9,826,439,387,113.4
11020, 중구,005004, 3세,2018,847,409,438,93.4,794,383,411,93.2
11020, 중구,005005, 4세,2018,814,410,404,101.5,774,388,386,100.5
11020, 중구,010,5~9세,2018,3617,1853,1764,105,3423,1732,1691,102.4
11020, 중구,010001, 5세,2018,776,410,366,112,725,373,352,106
11020, 중구,010002, 6세,2018,809,420,389,108,766,403,363,111
11020, 중구,010003, 7세,2018,741,356,385,92.5,702,333,369,90.2
11020, 중구,010004, 8세,2018,676,357,319,111.9,650,337,313,107.7
11020, 중구,010005, 9세,2018,615,310,305,101.6,580,286,294,97.3
11020, 중구,015,10~14세,2018,3148,1574,1574,100,2995,1493,1502,99.4
11020, 중구,015001, 10세,2018,716,337,379,88.9,682,322,360,89.4
11020, 중구,015002, 11세,2018,679,345,334,103.3,646,325,321,101.2
11020, 중구,015003, 12세,2018,530,275,255,107.8,508,262,246,106.5
11020, 중구,015004, 13세,2018,563,293,270,108.5,538,280,258,108.5
11020, 중구,015005, 14세,2018,660,324,336,96.4,621,304,317,95.9
11020, 중구,020,15~19세,2018,5634,2532,3102,81.6,5115,2296,2819,81.4
11020, 중구,020001, 15세,2018,628,314,314,100,611,305,306,99.7
11020, 중구,020002, 16세,2018,740,350,390,89.7,705,331,374,88.5
11020, 중구,020003, 17세,2018,1072,428,644,66.5,1044,418,626,66.8
11020, 중구,020004, 18세,2018,1309,584,725,80.6,1195,537,658,81.6
11020, 중구,020005, 19세,2018,1885,856,1029,83.2,1560,705,855,82.5
11020, 중구,025,20~24세,2018,10679,4895,5784,84.6,8604,4030,4574,88.1
11020, 중구,025001, 20세,2018,1957,802,1155,69.4,1517,616,901,68.4
11020, 중구,025002, 21세,2018,2027,839,1188,70.6,1620,690,930,74.2
11020, 중구,025003, 22세,2018,2126,988,1138,86.8,1713,822,891,92.3
11020, 중구,025004, 23세,2018,2222,1078,1144,94.2,1783,880,903,97.5
11020, 중구,025005, 24세,2018,2347,1188,1159,102.5,1971,1022,949,107.7
11020, 중구,030,25~29세,2018,11534,5784,5750,100.6,10032,5080,4952,102.6
11020, 중구,030001, 25세,2018,2407,1178,1229,95.9,2043,1023,1020,100.3
11020, 중구,030002, 26세,2018,2484,1249,1235,101.1,2178,1104,1074,102.8
11020, 중구,030003, 27세,2018,2336,1166,1170,99.7,2074,1049,1025,102.3
11020, 중구,030004, 28세,2018,2162,1089,1073,101.5,1872,946,926,102.2
11020, 중구,030005, 29세,2018,2145,1102,1043,105.7,1865,958,907,105.6
11020, 중구,035,30~34세,2018,10846,5444,5402,100.8,9524,4741,4783,99.1
11020, 중구,035001, 30세,2018,2220,1091,1129,96.6,1930,949,981,96.7
11020, 중구,035002, 31세,2018,2183,1125,1058,106.3,1905,983,922,106.6
11020, 중구,035003, 32세,2018,2169,1064,1105,96.3,1895,914,981,93.2
11020, 중구,035004, 33세,2018,2052,1027,1025,100.2,1808,900,908,99.1
11020, 중구,035005, 34세,2018,2222,1137,1085,104.8,1986,995,991,100.4
11020, 중구,040,35~39세,2018,10882,5592,5290,105.7,9866,5020,4846,103.6
11020, 중구,040001, 35세,2018,2266,1154,1112,103.8,2066,1046,1020,102.5
11020, 중구,040002, 36세,2018,2255,1140,1115,102.2,2026,1012,1014,99.8
11020, 중구,040003, 37세,2018,2173,1124,1049,107.1,1980,1018,962,105.8
11020, 중구,040004, 38세,2018,2223,1151,1072,107.4,2013,1032,981,105.2
11020, 중구,040005, 39세,2018,1965,1023,942,108.6,1781,912,869,104.9
11020, 중구,045,40~44세,2018,8872,4627,4245,109,7977,4147,3830,108.3
11020, 중구,045001, 40세,2018,1763,953,810,117.7,1565,838,727,115.3
11020, 중구,045002, 41세,2018,1750,919,831,110.6,1588,828,760,108.9
11020, 중구,045003, 42세,2018,1720,898,822,109.2,1533,794,739,107.4
11020, 중구,045004, 43세,2018,1752,884,868,101.8,1593,807,786,102.7
11020, 중구,045005, 44세,2018,1887,973,914,106.5,1698,880,818,107.6
11020, 중구,050,45~49세,2018,10126,5128,4998,102.6,9209,4666,4543,102.7
11020, 중구,050001, 45세,2018,1858,917,941,97.4,1675,828,847,97.8
11020, 중구,050002, 46세,2018,1986,1023,963,106.2,1807,919,888,103.5
11020, 중구,050003, 47세,2018,2124,1073,1051,102.1,1945,982,963,102
11020, 중구,050004, 48세,2018,2042,1006,1036,97.1,1853,920,933,98.6
11020, 중구,050005, 49세,2018,2116,1109,1007,110.1,1929,1017,912,111.5
11020, 중구,055,50~54세,2018,10154,4977,5177,96.1,9228,4539,4689,96.8
11020, 중구,055001, 50세,2018,2224,1076,1148,93.7,2011,962,1049,91.7
11020, 중구,055002, 51세,2018,1966,974,992,98.2,1804,906,898,100.9
11020, 중구,055003, 52세,2018,1854,943,911,103.5,1696,863,833,103.6
11020, 중구,055004, 53세,2018,2035,968,1067,90.7,1850,879,971,90.5
11020, 중구,055005, 54세,2018,2075,1016,1059,95.9,1867,929,938,99
11020, 중구,060,55~59세,2018,10915,5369,5546,96.8,10015,4981,5034,98.9
11020, 중구,060001, 55세,2018,2167,1075,1092,98.4,1924,970,954,101.7
11020, 중구,060002, 56세,2018,2180,1096,1084,101.1,1987,1018,969,105.1
11020, 중구,060003, 57세,2018,2240,1086,1154,94.1,2108,1030,1078,95.5
11020, 중구,060004, 58세,2018,2258,1086,1172,92.7,2086,1004,1082,92.8
11020, 중구,060005, 59세,2018,2070,1026,1044,98.3,1910,959,951,100.8
11020, 중구,065,60~64세,2018,9525,4659,4866,95.7,8781,4345,4436,97.9
11020, 중구,065001, 60세,2018,2029,974,1055,92.3,1842,899,943,95.3
11020, 중구,065002, 61세,2018,2046,1025,1021,100.4,1880,954,926,103
11020, 중구,065003, 62세,2018,1958,959,999,96,1827,905,922,98.2
11020, 중구,065004, 63세,2018,1898,905,993,91.1,1760,847,913,92.8
11020, 중구,065005, 64세,2018,1594,796,798,99.7,1472,740,732,101.1
11020, 중구,070,65~69세,2018,6294,3005,3289,91.4,5966,2855,3111,91.8
11020, 중구,070001, 65세,2018,1380,674,706,95.5,1291,630,661,95.3
11020, 중구,070002, 66세,2018,1439,665,774,85.9,1361,631,730,86.4
11020, 중구,070003, 67세,2018,1057,514,543,94.7,997,486,511,95.1
11020, 중구,070004, 68세,2018,1242,605,637,95,1184,580,604,96
11020, 중구,070005, 69세,2018,1176,547,629,87,1133,528,605,87.3
11020, 중구,075,70~74세,2018,5054,2267,2787,81.3,4955,2227,2728,81.6
11020, 중구,075001, 70세,2018,1169,550,619,88.9,1151,546,605,90.2
11020, 중구,075002, 71세,2018,1194,529,665,79.5,1156,513,643,79.8
11020, 중구,075003, 72세,2018,864,357,507,70.4,849,351,498,70.5
11020, 중구,075004, 73세,2018,922,423,499,84.8,911,420,491,85.5
11020, 중구,075005, 74세,2018,905,408,497,82.1,888,397,491,80.9
11020, 중구,080,75~79세,2018,4249,1798,2451,73.4,4187,1780,2407,74
11020, 중구,080001, 75세,2018,893,387,506,76.5,880,383,497,77.1
11020, 중구,080002, 76세,2018,1049,444,605,73.4,1034,442,592,74.7
11020, 중구,080003, 77세,2018,873,365,508,71.9,858,361,497,72.6
11020, 중구,080004, 78세,2018,713,288,425,67.8,705,283,422,67.1
11020, 중구,080005, 79세,2018,721,314,407,77.1,710,311,399,77.9
11020, 중구,085,80~84세,2018,2465,905,1560,58,2430,895,1535,58.3
11020, 중구,085001, 80세,2018,601,235,366,64.2,596,231,365,63.3
11020, 중구,085002, 81세,2018,545,201,344,58.4,536,199,337,59.1
11020, 중구,085003, 82세,2018,503,191,312,61.2,498,191,307,62.2
11020, 중구,085004, 83세,2018,436,162,274,59.1,429,160,269,59.5
11020, 중구,085005, 84세,2018,380,116,264,43.9,371,114,257,44.4
11020, 중구,090,85~89세,2018,1161,366,795,46,1153,362,791,45.8
11020, 중구,090001, 85세,2018,320,100,220,45.5,317,98,219,44.7
11020, 중구,090002, 86세,2018,260,77,183,42.1,258,77,181,42.5
11020, 중구,090003, 87세,2018,211,67,144,46.5,211,67,144,46.5
11020, 중구,090004, 88세,2018,205,64,141,45.4,203,63,140,45
11020, 중구,090005, 89세,2018,165,58,107,54.2,164,57,107,53.3
11020, 중구,095,90~94세,2018,429,115,314,36.6,425,114,311,36.7
11020, 중구,095001, 90세,2018,149,40,109,36.7,148,40,108,37
11020, 중구,095002, 91세,2018,114,32,82,39,112,31,81,38.3
11020, 중구,095003, 92세,2018,67,14,53,26.4,67,14,53,26.4
11020, 중구,095004, 93세,2018,49,11,38,28.9,49,11,38,28.9
11020, 중구,095005, 94세,2018,50,18,32,56.3,49,18,31,58.1
11020, 중구,100,95~99세,2018,79,20,59,33.9,78,19,59,32.2
11020, 중구,100001, 95세,2018,26,5,21,23.8,25,X,21,19
11020, 중구,100002, 96세,2018,29,8,21,38.1,29,8,21,38.1
11020, 중구,100003, 97세,2018,12,X,9,33.3,12,X,9,33.3
11020, 중구,100004, 98세,2018,9,X,6,50,9,X,6,50
11020, 중구,100005, 99세,2018,X,X,X,50,X,X,X,50
11020, 중구,101,100세이상,2018,23,6,17,35.3,22,6,16,37.5
11020, 중구,102,15세미만,2018,10876,5486,5390,101.8,10242,5137,5105,100.6
11020, 중구,103,15~64세,2018,99167,49007,50160,97.7,88351,43845,44506,98.5
11020, 중구,104,65세이상,2018,19754,8482,11272,75.2,19216,8258,10958,75.4
11020, 중구,086,85세이상,2018,1692,507,1185,42.8,1678,501,1177,42.6
11020, 중구,126,평균연령,2018,43,42.3,43.6,,43.6,42.9,44.2,
11020, 중구,127,중위연령,2018,42.5,41.9,43.3,,43.5,42.8,44.2,
11030, 용산구,000,합계,2018,226938,110685,116253,95.2,207812,99806,108006,92.4
11030, 용산구,005,0~4세,2018,7932,4097,3835,106.8,6926,3581,3345,107.1
11030, 용산구,005001, 0세,2018,1500,794,706,112.5,1325,691,634,109
11030, 용산구,005002, 1세,2018,1532,752,780,96.4,1282,629,653,96.3
11030, 용산구,005003, 2세,2018,1657,855,802,106.6,1456,756,700,108
11030, 용산구,005004, 3세,2018,1676,884,792,111.6,1478,789,689,114.5
11030, 용산구,005005, 4세,2018,1567,812,755,107.5,1385,716,669,107
11030, 용산구,010,5~9세,2018,7633,3908,3725,104.9,6845,3522,3323,106
11030, 용산구,010001, 5세,2018,1581,813,768,105.9,1404,724,680,106.5
11030, 용산구,010002, 6세,2018,1600,827,773,107,1441,755,686,110.1
11030, 용산구,010003, 7세,2018,1537,811,726,111.7,1364,723,641,112.8
11030, 용산구,010004, 8세,2018,1468,760,708,107.3,1332,695,637,109.1
11030, 용산구,010005, 9세,2018,1447,697,750,92.9,1304,625,679,92
11030, 용산구,015,10~14세,2018,7246,3691,3555,103.8,6679,3411,3268,104.4
11030, 용산구,015001, 10세,2018,1488,724,764,94.8,1357,666,691,96.4
11030, 용산구,015002, 11세,2018,1533,785,748,104.9,1409,727,682,106.6
11030, 용산구,015003, 12세,2018,1373,695,678,102.5,1262,639,623,102.6
11030, 용산구,015004, 13세,2018,1367,708,659,107.4,1264,651,613,106.2
11030, 용산구,015005, 14세,2018,1485,779,706,110.3,1387,728,659,110.5
11030, 용산구,020,15~19세,2018,9272,4584,4688,97.8,8642,4212,4430,95.1
11030, 용산구,020001, 15세,2018,1454,742,712,104.2,1374,699,675,103.6
11030, 용산구,020002, 16세,2018,1565,822,743,110.6,1495,784,711,110.3
11030, 용산구,020003, 17세,2018,1771,939,832,112.9,1694,893,801,111.5
11030, 용산구,020004, 18세,2018,2023,1003,1020,98.3,1912,938,974,96.3
11030, 용산구,020005, 19세,2018,2459,1078,1381,78.1,2167,898,1269,70.8
11030, 용산구,025,20~24세,2018,15432,6978,8454,82.5,13282,5737,7545,76
11030, 용산구,025001, 20세,2018,2760,1219,1541,79.1,2315,999,1316,75.9
11030, 용산구,025002, 21세,2018,2868,1314,1554,84.6,2474,1098,1376,79.8
11030, 용산구,025003, 22세,2018,2919,1346,1573,85.6,2526,1104,1422,77.6
11030, 용산구,025004, 23세,2018,3341,1447,1894,76.4,2915,1193,1722,69.3
11030, 용산구,025005, 24세,2018,3544,1652,1892,87.3,3052,1343,1709,78.6
11030, 용산구,030,25~29세,2018,19802,9932,9870,100.6,17283,8371,8912,93.9
11030, 용산구,030001, 25세,2018,3708,1772,1936,91.5,3220,1453,1767,82.2
11030, 용산구,030002, 26세,2018,3982,1959,2023,96.8,3478,1669,1809,92.3
11030, 용산구,030003, 27세,2018,4080,2053,2027,101.3,3570,1746,1824,95.7
11030, 용산구,030004, 28세,2018,4029,2089,1940,107.7,3529,1766,1763,100.2
11030, 용산구,030005, 29세,2018,4003,2059,1944,105.9,3486,1737,1749,99.3
11030, 용산구,035,30~34세,2018,19887,10317,9570,107.8,17242,8655,8587,100.8
11030, 용산구,035001, 30세,2018,4007,2081,1926,108,3468,1752,1716,102.1
11030, 용산구,035002, 31세,2018,3892,1963,1929,101.8,3388,1652,1736,95.2
11030, 용산구,035003, 32세,2018,4056,2122,1934,109.7,3531,1784,1747,102.1
11030, 용산구,035004, 33세,2018,3889,2020,1869,108.1,3361,1686,1675,100.7
11030, 용산구,035005, 34세,2018,4043,2131,1912,111.5,3494,1781,1713,104
11030, 용산구,040,35~39세,2018,20348,10441,9907,105.4,18105,9091,9014,100.9
11030, 용산구,040001, 35세,2018,4150,2155,1995,108,3676,1863,1813,102.8
11030, 용산구,040002, 36세,2018,4229,2154,2075,103.8,3796,1883,1913,98.4
11030, 용산구,040003, 37세,2018,4163,2153,2010,107.1,3738,1916,1822,105.2
11030, 용산구,040004, 38세,2018,4125,2118,2007,105.5,3644,1825,1819,100.3
11030, 용산구,040005, 39세,2018,3681,1861,1820,102.3,3251,1604,1647,97.4
11030, 용산구,045,40~44세,2018,17140,8647,8493,101.8,15388,7610,7778,97.8
11030, 용산구,045001, 40세,2018,3386,1741,1645,105.8,2981,1495,1486,100.6
11030, 용산구,045002, 41세,2018,3330,1626,1704,95.4,2972,1412,1560,90.5
11030, 용산구,045003, 42세,2018,3279,1661,1618,102.7,2924,1451,1473,98.5
11030, 용산구,045004, 43세,2018,3437,1738,1699,102.3,3108,1556,1552,100.3
11030, 용산구,045005, 44세,2018,3708,1881,1827,103,3403,1696,1707,99.4
11030, 용산구,050,45~49세,2018,19574,9761,9813,99.5,18108,8918,9190,97
11030, 용산구,050001, 45세,2018,3665,1861,1804,103.2,3374,1685,1689,99.8
11030, 용산구,050002, 46세,2018,3992,2011,1981,101.5,3671,1838,1833,100.3
11030, 용산구,050003, 47세,2018,4080,2019,2061,98,3794,1853,1941,95.5
11030, 용산구,050004, 48세,2018,3914,1925,1989,96.8,3629,1766,1863,94.8
11030, 용산구,050005, 49세,2018,3923,1945,1978,98.3,3640,1776,1864,95.3
11030, 용산구,055,50~54세,2018,17170,8511,8659,98.3,16013,7929,8084,98.1
11030, 용산구,055001, 50세,2018,3825,1893,1932,98,3537,1726,1811,95.3
11030, 용산구,055002, 51세,2018,3349,1628,1721,94.6,3130,1512,1618,93.4
11030, 용산구,055003, 52세,2018,3264,1670,1594,104.8,3046,1565,1481,105.7
11030, 용산구,055004, 53세,2018,3436,1673,1763,94.9,3211,1580,1631,96.9
11030, 용산구,055005, 54세,2018,3296,1647,1649,99.9,3089,1546,1543,100.2
11030, 용산구,060,55~59세,2018,17553,8494,9059,93.8,16658,8057,8601,93.7
11030, 용산구,060001, 55세,2018,3545,1735,1810,95.9,3275,1603,1672,95.9
11030, 용산구,060002, 56세,2018,3530,1753,1777,98.6,3358,1667,1691,98.6
11030, 용산구,060003, 57세,2018,3520,1699,1821,93.3,3373,1628,1745,93.3
11030, 용산구,060004, 58세,2018,3608,1698,1910,88.9,3442,1617,1825,88.6
11030, 용산구,060005, 59세,2018,3350,1609,1741,92.4,3210,1542,1668,92.4
11030, 용산구,065,60~64세,2018,14977,7276,7701,94.5,14320,6972,7348,94.9
11030, 용산구,065001, 60세,2018,3211,1608,1603,100.3,3058,1535,1523,100.8
11030, 용산구,065002, 61세,2018,3183,1535,1648,93.1,3032,1468,1564,93.9
11030, 용산구,065003, 62세,2018,3023,1486,1537,96.7,2905,1434,1471,97.5
11030, 용산구,065004, 63세,2018,3010,1409,1601,88,2888,1353,1535,88.1
11030, 용산구,065005, 64세,2018,2550,1238,1312,94.4,2437,1182,1255,94.2
11030, 용산구,070,65~69세,2018,10067,4686,5381,87.1,9714,4517,5197,86.9
11030, 용산구,070001, 65세,2018,2221,1069,1152,92.8,2124,1023,1101,92.9
11030, 용산구,070002, 66세,2018,2286,1005,1281,78.5,2202,970,1232,78.7
11030, 용산구,070003, 67세,2018,1703,797,906,88,1632,766,866,88.5
11030, 용산구,070004, 68세,2018,1936,906,1030,88,1887,883,1004,87.9
11030, 용산구,070005, 69세,2018,1921,909,1012,89.8,1869,875,994,88
11030, 용산구,075,70~74세,2018,8204,3596,4608,78,8080,3533,4547,77.7
11030, 용산구,075001, 70세,2018,1913,895,1018,87.9,1883,880,1003,87.7
11030, 용산구,075002, 71세,2018,1869,789,1080,73.1,1836,778,1058,73.5
11030, 용산구,075003, 72세,2018,1489,638,851,75,1456,620,836,74.2
11030, 용산구,075004, 73세,2018,1455,661,794,83.2,1442,650,792,82.1
11030, 용산구,075005, 74세,2018,1478,613,865,70.9,1463,605,858,70.5
11030, 용산구,080,75~79세,2018,7268,3114,4154,75,7169,3068,4101,74.8
11030, 용산구,080001, 75세,2018,1517,684,833,82.1,1489,670,819,81.8
11030, 용산구,080002, 76세,2018,1794,783,1011,77.4,1775,776,999,77.7
11030, 용산구,080003, 77세,2018,1442,600,842,71.3,1424,594,830,71.6
11030, 용산구,080004, 78세,2018,1275,531,744,71.4,1255,519,736,70.5
11030, 용산구,080005, 79세,2018,1240,516,724,71.3,1226,509,717,71
11030, 용산구,085,80~84세,2018,4546,1709,2837,60.2,4499,1690,2809,60.2
11030, 용산구,085001, 80세,2018,1174,453,721,62.8,1165,451,714,63.2
11030, 용산구,085002, 81세,2018,1021,402,619,64.9,1012,399,613,65.1
11030, 용산구,085003, 82세,2018,923,327,596,54.9,910,320,590,54.2
11030, 용산구,085004, 83세,2018,775,303,472,64.2,764,298,466,63.9
11030, 용산구,085005, 84세,2018,653,224,429,52.2,648,222,426,52.1
11030, 용산구,090,85~89세,2018,2037,712,1325,53.7,2015,705,1310,53.8
11030, 용산구,090001, 85세,2018,555,203,352,57.7,548,199,349,57
11030, 용산구,090002, 86세,2018,481,175,306,57.2,478,175,303,57.8
11030, 용산구,090003, 87세,2018,369,132,237,55.7,366,131,235,55.7
11030, 용산구,090004, 88세,2018,340,125,215,58.1,335,124,211,58.8
11030, 용산구,090005, 89세,2018,292,77,215,35.8,288,76,212,35.8
11030, 용산구,095,90~94세,2018,652,175,477,36.7,647,171,476,35.9
11030, 용산구,095001, 90세,2018,224,53,171,31,221,51,170,30
11030, 용산구,095002, 91세,2018,153,33,120,27.5,152,32,120,26.7
11030, 용산구,095003, 92세,2018,115,29,86,33.7,115,29,86,33.7
11030, 용산구,095004, 93세,2018,80,29,51,56.9,79,28,51,54.9
11030, 용산구,095005, 94세,2018,80,31,49,63.3,80,31,49,63.3
11030, 용산구,100,95~99세,2018,178,51,127,40.2,177,51,126,40.5
11030, 용산구,100001, 95세,2018,65,22,43,51.2,65,22,43,51.2
11030, 용산구,100002, 96세,2018,53,10,43,23.3,53,10,43,23.3
11030, 용산구,100003, 97세,2018,29,9,20,45,29,9,20,45
11030, 용산구,100004, 98세,2018,19,6,13,46.2,19,6,13,46.2
11030, 용산구,100005, 99세,2018,12,X,8,50,11,X,7,57.1
11030, 용산구,101,100세이상,2018,20,5,15,33.3,20,5,15,33.3
11030, 용산구,102,15세미만,2018,22811,11696,11115,105.2,20450,10514,9936,105.8
11030, 용산구,103,15~64세,2018,171155,84941,86214,98.5,155041,75552,79489,95
11030, 용산구,104,65세이상,2018,32972,14048,18924,74.2,32321,13740,18581,73.9
11030, 용산구,086,85세이상,2018,2887,943,1944,48.5,2859,932,1927,48.4
11030, 용산구,126,평균연령,2018,42.3,41.4,43.2,,43,42.2,43.8,
11030, 용산구,127,중위연령,2018,41.8,40.8,42.7,,43,42.3,43.7,
11040, 성동구,000,합계,2018,306796,150623,156173,96.4,295489,145220,150269,96.6
11040, 성동구,005,0~4세,2018,12282,6247,6035,103.5,12041,6127,5914,103.6
11040, 성동구,005001, 0세,2018,2363,1202,1161,103.5,2325,1184,1141,103.8
11040, 성동구,005002, 1세,2018,2424,1252,1172,106.8,2360,1220,1140,107
11040, 성동구,005003, 2세,2018,2533,1271,1262,100.7,2481,1250,1231,101.5
11040, 성동구,005004, 3세,2018,2559,1316,1243,105.9,2510,1289,1221,105.6
11040, 성동구,005005, 4세,2018,2403,1206,1197,100.8,2365,1184,1181,100.3
11040, 성동구,010,5~9세,2018,10491,5336,5155,103.5,10350,5263,5087,103.5
11040, 성동구,010001, 5세,2018,2354,1208,1146,105.4,2320,1194,1126,106
11040, 성동구,010002, 6세,2018,2270,1152,1118,103,2233,1128,1105,102.1
11040, 성동구,010003, 7세,2018,2089,1068,1021,104.6,2067,1056,1011,104.5
11040, 성동구,010004, 8세,2018,1949,981,968,101.3,1919,969,950,102
11040, 성동구,010005, 9세,2018,1829,927,902,102.8,1811,916,895,102.3
11040, 성동구,015,10~14세,2018,9545,4871,4674,104.2,9473,4838,4635,104.4
11040, 성동구,015001, 10세,2018,2030,1041,989,105.3,2015,1034,981,105.4
11040, 성동구,015002, 11세,2018,2032,1048,984,106.5,2021,1043,978,106.6
11040, 성동구,015003, 12세,2018,1772,905,867,104.4,1760,898,862,104.2
11040, 성동구,015004, 13세,2018,1785,900,885,101.7,1768,892,876,101.8
11040, 성동구,015005, 14세,2018,1926,977,949,103,1909,971,938,103.5
11040, 성동구,020,15~19세,2018,12994,6353,6641,95.7,12622,6198,6424,96.5
11040, 성동구,020001, 15세,2018,1892,874,1018,85.9,1874,865,1009,85.7
11040, 성동구,020002, 16세,2018,2064,989,1075,92,2043,978,1065,91.8
11040, 성동구,020003, 17세,2018,2334,1209,1125,107.5,2308,1191,1117,106.6
11040, 성동구,020004, 18세,2018,2920,1447,1473,98.2,2830,1414,1416,99.9
11040, 성동구,020005, 19세,2018,3784,1834,1950,94.1,3567,1750,1817,96.3
11040, 성동구,025,20~24세,2018,24010,11722,12288,95.4,21884,10848,11036,98.3
11040, 성동구,025001, 20세,2018,4133,1949,2184,89.2,3738,1792,1946,92.1
11040, 성동구,025002, 21세,2018,4391,2080,2311,90,4015,1931,2084,92.7
11040, 성동구,025003, 22세,2018,4861,2390,2471,96.7,4402,2215,2187,101.3
11040, 성동구,025004, 23세,2018,5193,2632,2561,102.8,4705,2405,2300,104.6
11040, 성동구,025005, 24세,2018,5432,2671,2761,96.7,5024,2505,2519,99.4
11040, 성동구,030,25~29세,2018,26682,13638,13044,104.6,25210,12939,12271,105.4
11040, 성동구,030001, 25세,2018,5495,2864,2631,108.9,5167,2729,2438,111.9
11040, 성동구,030002, 26세,2018,5678,2968,2710,109.5,5391,2840,2551,111.3
11040, 성동구,030003, 27세,2018,5336,2777,2559,108.5,5054,2634,2420,108.8
11040, 성동구,030004, 28세,2018,5228,2603,2625,99.2,4923,2455,2468,99.5
11040, 성동구,030005, 29세,2018,4945,2426,2519,96.3,4675,2281,2394,95.3
11040, 성동구,035,30~34세,2018,25451,12449,13002,95.7,24176,11784,12392,95.1
11040, 성동구,035001, 30세,2018,4993,2406,2587,93,4731,2274,2457,92.6
11040, 성동구,035002, 31세,2018,4939,2398,2541,94.4,4656,2249,2407,93.4
11040, 성동구,035003, 32세,2018,5015,2503,2512,99.6,4766,2371,2395,99
11040, 성동구,035004, 33세,2018,5265,2570,2695,95.4,5015,2442,2573,94.9
11040, 성동구,035005, 34세,2018,5239,2572,2667,96.4,5008,2448,2560,95.6
11040, 성동구,040,35~39세,2018,27523,14051,13472,104.3,26550,13491,13059,103.3
11040, 성동구,040001, 35세,2018,5489,2799,2690,104.1,5280,2677,2603,102.8
11040, 성동구,040002, 36세,2018,5824,2983,2841,105,5579,2845,2734,104.1
11040, 성동구,040003, 37세,2018,5642,2894,2748,105.3,5451,2777,2674,103.9
11040, 성동구,040004, 38세,2018,5595,2861,2734,104.6,5421,2761,2660,103.8
11040, 성동구,040005, 39세,2018,4973,2514,2459,102.2,4819,2431,2388,101.8
11040, 성동구,045,40~44세,2018,22590,11577,11013,105.1,21834,11171,10663,104.8
11040, 성동구,045001, 40세,2018,4484,2326,2158,107.8,4322,2235,2087,107.1
11040, 성동구,045002, 41세,2018,4526,2310,2216,104.2,4369,2230,2139,104.3
11040, 성동구,045003, 42세,2018,4348,2269,2079,109.1,4200,2187,2013,108.6
11040, 성동구,045004, 43세,2018,4432,2224,2208,100.7,4281,2139,2142,99.9
11040, 성동구,045005, 44세,2018,4800,2448,2352,104.1,4662,2380,2282,104.3
11040, 성동구,050,45~49세,2018,25312,12628,12684,99.6,24402,12181,12221,99.7
11040, 성동구,050001, 45세,2018,4894,2497,2397,104.2,4731,2418,2313,104.5
11040, 성동구,050002, 46세,2018,4885,2449,2436,100.5,4690,2353,2337,100.7
11040, 성동구,050003, 47세,2018,5239,2589,2650,97.7,5064,2498,2566,97.3
11040, 성동구,050004, 48세,2018,5195,2610,2585,101,4997,2513,2484,101.2
11040, 성동구,050005, 49세,2018,5099,2483,2616,94.9,4920,2399,2521,95.2
11040, 성동구,055,50~54세,2018,23867,11745,12122,96.9,22912,11283,11629,97
11040, 성동구,055001, 50세,2018,5075,2481,2594,95.6,4878,2385,2493,95.7
11040, 성동구,055002, 51세,2018,4647,2254,2393,94.2,4516,2182,2334,93.5
11040, 성동구,055003, 52세,2018,4620,2289,2331,98.2,4414,2194,2220,98.8
11040, 성동구,055004, 53세,2018,4832,2369,2463,96.2,4608,2257,2351,96
11040, 성동구,055005, 54세,2018,4693,2352,2341,100.5,4496,2265,2231,101.5
11040, 성동구,060,55~59세,2018,24851,12304,12547,98.1,24011,11925,12086,98.7
11040, 성동구,060001, 55세,2018,4854,2371,2483,95.5,4638,2279,2359,96.6
11040, 성동구,060002, 56세,2018,4986,2529,2457,102.9,4794,2438,2356,103.5
11040, 성동구,060003, 57세,2018,5074,2502,2572,97.3,4947,2448,2499,98
11040, 성동구,060004, 58세,2018,5258,2584,2674,96.6,5095,2517,2578,97.6
11040, 성동구,060005, 59세,2018,4679,2318,2361,98.2,4537,2243,2294,97.8
11040, 성동구,065,60~64세,2018,20377,9939,10438,95.2,19668,9609,10059,95.5
11040, 성동구,065001, 60세,2018,4480,2265,2215,102.3,4295,2180,2115,103.1
11040, 성동구,065002, 61세,2018,4384,2153,2231,96.5,4234,2078,2156,96.4
11040, 성동구,065003, 62세,2018,4013,1952,2061,94.7,3872,1884,1988,94.8
11040, 성동구,065004, 63세,2018,4037,1896,2141,88.6,3914,1842,2072,88.9
11040, 성동구,065005, 64세,2018,3463,1673,1790,93.5,3353,1625,1728,94
11040, 성동구,070,65~69세,2018,13403,6315,7088,89.1,13090,6163,6927,89
11040, 성동구,070001, 65세,2018,2906,1421,1485,95.7,2824,1382,1442,95.8
11040, 성동구,070002, 66세,2018,3099,1468,1631,90,3017,1423,1594,89.3
11040, 성동구,070003, 67세,2018,2326,1079,1247,86.5,2262,1055,1207,87.4
11040, 성동구,070004, 68세,2018,2554,1189,1365,87.1,2506,1164,1342,86.7
11040, 성동구,070005, 69세,2018,2518,1158,1360,85.1,2481,1139,1342,84.9
11040, 성동구,075,70~74세,2018,10765,4869,5896,82.6,10687,4844,5843,82.9
11040, 성동구,075001, 70세,2018,2434,1144,1290,88.7,2410,1139,1271,89.6
11040, 성동구,075002, 71세,2018,2537,1132,1405,80.6,2523,1128,1395,80.9
11040, 성동구,075003, 72세,2018,1989,895,1094,81.8,1966,885,1081,81.9
11040, 성동구,075004, 73세,2018,1900,827,1073,77.1,1892,825,1067,77.3
11040, 성동구,075005, 74세,2018,1905,871,1034,84.2,1896,867,1029,84.3
11040, 성동구,080,75~79세,2018,8788,3852,4936,78,8749,3840,4909,78.2
11040, 성동구,080001, 75세,2018,1902,845,1057,79.9,1892,842,1050,80.2
11040, 성동구,080002, 76세,2018,2218,1007,1211,83.2,2209,1005,1204,83.5
11040, 성동구,080003, 77세,2018,1753,780,973,80.2,1749,779,970,80.3
11040, 성동구,080004, 78세,2018,1489,602,887,67.9,1480,598,882,67.8
11040, 성동구,080005, 79세,2018,1426,618,808,76.5,1419,616,803,76.7
11040, 성동구,085,80~84세,2018,4979,1900,3079,61.7,4955,1893,3062,61.8
11040, 성동구,085001, 80세,2018,1269,499,770,64.8,1266,497,769,64.6
11040, 성동구,085002, 81세,2018,1132,437,695,62.9,1127,436,691,63.1
11040, 성동구,085003, 82세,2018,982,358,624,57.4,978,358,620,57.7
11040, 성동구,085004, 83세,2018,823,306,517,59.2,815,303,512,59.2
11040, 성동구,085005, 84세,2018,773,300,473,63.4,769,299,470,63.6
11040, 성동구,090,85~89세,2018,2045,614,1431,42.9,2037,611,1426,42.8
11040, 성동구,090001, 85세,2018,558,180,378,47.6,556,180,376,47.9
11040, 성동구,090002, 86세,2018,488,155,333,46.5,486,154,332,46.4
11040, 성동구,090003, 87세,2018,381,106,275,38.5,378,104,274,38
11040, 성동구,090004, 88세,2018,342,88,254,34.6,341,88,253,34.8
11040, 성동구,090005, 89세,2018,276,85,191,44.5,276,85,191,44.5
11040, 성동구,095,90~94세,2018,653,163,490,33.3,652,163,489,33.3
11040, 성동구,095001, 90세,2018,212,57,155,36.8,212,57,155,36.8
11040, 성동구,095002, 91세,2018,163,43,120,35.8,162,43,119,36.1
11040, 성동구,095003, 92세,2018,117,28,89,31.5,117,28,89,31.5
11040, 성동구,095004, 93세,2018,87,18,69,26.1,87,18,69,26.1
11040, 성동구,095005, 94세,2018,74,17,57,29.8,74,17,57,29.8
11040, 성동구,100,95~99세,2018,169,46,123,37.4,167,45,122,36.9
11040, 성동구,100001, 95세,2018,70,21,49,42.9,68,20,48,41.7
11040, 성동구,100002, 96세,2018,37,9,28,32.1,37,9,28,32.1
11040, 성동구,100003, 97세,2018,32,8,24,33.3,32,8,24,33.3
11040, 성동구,100004, 98세,2018,20,6,14,42.9,20,6,14,42.9
11040, 성동구,100005, 99세,2018,10,X,8,25,10,X,8,25
11040, 성동구,101,100세이상,2018,19,X,15,26.7,19,X,15,26.7
11040, 성동구,102,15세미만,2018,32318,16454,15864,103.7,31864,16228,15636,103.8
11040, 성동구,103,15~64세,2018,233657,116406,117251,99.3,223269,111429,111840,99.6
11040, 성동구,104,65세이상,2018,40821,17763,23058,77,40356,17563,22793,77.1
11040, 성동구,086,85세이상,2018,2886,827,2059,40.2,2875,823,2052,40.1
11040, 성동구,126,평균연령,2018,41.5,40.8,42.2,,41.7,40.9,42.4,
11040, 성동구,127,중위연령,2018,41,40.3,41.7,,41.3,40.5,42,
11050, 광진구,000,합계,2018,362304,175762,186542,94.2,342575,166730,175845,94.8
11050, 광진구,005,0~4세,2018,11239,5753,5486,104.9,10854,5558,5296,104.9
11050, 광진구,005001, 0세,2018,2137,1090,1047,104.1,2075,1063,1012,105
11050, 광진구,005002, 1세,2018,2134,1076,1058,101.7,2056,1031,1025,100.6
11050, 광진구,005003, 2세,2018,2310,1201,1109,108.3,2222,1157,1065,108.6
11050, 광진구,005004, 3세,2018,2408,1217,1191,102.2,2342,1181,1161,101.7
11050, 광진구,005005, 4세,2018,2250,1169,1081,108.1,2159,1126,1033,109
11050, 광진구,010,5~9세,2018,11552,5953,5599,106.3,11330,5833,5497,106.1
11050, 광진구,010001, 5세,2018,2273,1160,1113,104.2,2227,1134,1093,103.8
11050, 광진구,010002, 6세,2018,2392,1231,1161,106,2340,1200,1140,105.3
11050, 광진구,010003, 7세,2018,2352,1188,1164,102.1,2306,1161,1145,101.4
11050, 광진구,010004, 8세,2018,2347,1247,1100,113.4,2305,1224,1081,113.2
11050, 광진구,010005, 9세,2018,2188,1127,1061,106.2,2152,1114,1038,107.3
11050, 광진구,015,10~14세,2018,12225,6246,5979,104.5,12098,6176,5922,104.3
11050, 광진구,015001, 10세,2018,2387,1234,1153,107,2360,1220,1140,107
11050, 광진구,015002, 11세,2018,2539,1266,1273,99.5,2502,1246,1256,99.2
11050, 광진구,015003, 12세,2018,2369,1208,1161,104,2347,1195,1152,103.7
11050, 광진구,015004, 13세,2018,2376,1217,1159,105,2364,1208,1156,104.5
11050, 광진구,015005, 14세,2018,2554,1321,1233,107.1,2525,1307,1218,107.3
11050, 광진구,020,15~19세,2018,17094,8595,8499,101.1,16343,8325,8018,103.8
11050, 광진구,020001, 15세,2018,2576,1328,1248,106.4,2560,1319,1241,106.3
11050, 광진구,020002, 16세,2018,2639,1330,1309,101.6,2603,1319,1284,102.7
11050, 광진구,020003, 17세,2018,3040,1600,1440,111.1,2976,1575,1401,112.4
11050, 광진구,020004, 18세,2018,3971,1968,2003,98.3,3757,1886,1871,100.8
11050, 광진구,020005, 19세,2018,4868,2369,2499,94.8,4447,2226,2221,100.2
11050, 광진구,025,20~24세,2018,31468,14403,17065,84.4,28038,13132,14906,88.1
11050, 광진구,025001, 20세,2018,5486,2501,2985,83.8,4864,2275,2589,87.9
11050, 광진구,025002, 21세,2018,5714,2574,3140,82,4988,2312,2676,86.4
11050, 광진구,025003, 22세,2018,6338,2864,3474,82.4,5608,2616,2992,87.4
11050, 광진구,025004, 23세,2018,6771,3160,3611,87.5,6046,2874,3172,90.6
11050, 광진구,025005, 24세,2018,7159,3304,3855,85.7,6532,3055,3477,87.9
11050, 광진구,030,25~29세,2018,36283,17770,18513,96,33847,16701,17146,97.4
11050, 광진구,030001, 25세,2018,7618,3729,3889,95.9,7036,3488,3548,98.3
11050, 광진구,030002, 26세,2018,7603,3711,3892,95.3,7164,3533,3631,97.3
11050, 광진구,030003, 27세,2018,7290,3647,3643,100.1,6858,3439,3419,100.6
11050, 광진구,030004, 28세,2018,7019,3445,3574,96.4,6496,3215,3281,98
11050, 광진구,030005, 29세,2018,6753,3238,3515,92.1,6293,3026,3267,92.6
11050, 광진구,035,30~34세,2018,31022,15429,15593,98.9,29006,14403,14603,98.6
11050, 광진구,035001, 30세,2018,6577,3203,3374,94.9,6125,2981,3144,94.8
11050, 광진구,035002, 31세,2018,6380,3130,3250,96.3,5910,2893,3017,95.9
11050, 광진구,035003, 32세,2018,6191,3107,3084,100.7,5789,2892,2897,99.8
11050, 광진구,035004, 33세,2018,5947,2980,2967,100.4,5577,2802,2775,101
11050, 광진구,035005, 34세,2018,5927,3009,2918,103.1,5605,2835,2770,102.3
11050, 광진구,040,35~39세,2018,30108,15065,15043,100.1,28742,14369,14373,100
11050, 광진구,040001, 35세,2018,6308,3170,3138,101,5970,3014,2956,102
11050, 광진구,040002, 36세,2018,6387,3172,3215,98.7,6087,3017,3070,98.3
11050, 광진구,040003, 37세,2018,6022,3020,3002,100.6,5762,2881,2881,100
11050, 광진구,040004, 38세,2018,5881,2952,2929,100.8,5637,2825,2812,100.5
11050, 광진구,040005, 39세,2018,5510,2751,2759,99.7,5286,2632,2654,99.2
11050, 광진구,045,40~44세,2018,25673,12962,12711,102,24527,12324,12203,101
11050, 광진구,045001, 40세,2018,4873,2511,2362,106.3,4628,2371,2257,105.1
11050, 광진구,045002, 41세,2018,5206,2597,2609,99.5,4971,2459,2512,97.9
11050, 광진구,045003, 42세,2018,4955,2530,2425,104.3,4741,2411,2330,103.5
11050, 광진구,045004, 43세,2018,5151,2572,2579,99.7,4945,2460,2485,99
11050, 광진구,045005, 44세,2018,5488,2752,2736,100.6,5242,2623,2619,100.2
11050, 광진구,050,45~49세,2018,30109,14646,15463,94.7,28495,13831,14664,94.3
11050, 광진구,050001, 45세,2018,5697,2747,2950,93.1,5422,2600,2822,92.1
11050, 광진구,050002, 46세,2018,5900,2977,2923,101.8,5605,2832,2773,102.1
11050, 광진구,050003, 47세,2018,6309,3090,3219,96,5954,2896,3058,94.7
11050, 광진구,050004, 48세,2018,6163,2946,3217,91.6,5825,2785,3040,91.6
11050, 광진구,050005, 49세,2018,6040,2886,3154,91.5,5689,2718,2971,91.5
11050, 광진구,055,50~54세,2018,28396,13764,14632,94.1,26500,12877,13623,94.5
11050, 광진구,055001, 50세,2018,6219,2984,3235,92.2,5859,2823,3036,93
11050, 광진구,055002, 51세,2018,5545,2681,2864,93.6,5235,2539,2696,94.2
11050, 광진구,055003, 52세,2018,5494,2637,2857,92.3,5122,2455,2667,92.1
11050, 광진구,055004, 53세,2018,5738,2805,2933,95.6,5322,2615,2707,96.6
11050, 광진구,055005, 54세,2018,5400,2657,2743,96.9,4962,2445,2517,97.1
11050, 광진구,060,55~59세,2018,29158,13981,15177,92.1,27187,13088,14099,92.8
11050, 광진구,060001, 55세,2018,5837,2891,2946,98.1,5256,2627,2629,99.9
11050, 광진구,060002, 56세,2018,5797,2831,2966,95.4,5382,2653,2729,97.2
11050, 광진구,060003, 57세,2018,5912,2747,3165,86.8,5655,2641,3014,87.6
11050, 광진구,060004, 58세,2018,6149,2943,3206,91.8,5745,2750,2995,91.8
11050, 광진구,060005, 59세,2018,5463,2569,2894,88.8,5149,2417,2732,88.5
11050, 광진구,065,60~64세,2018,23857,11490,12367,92.9,22428,10799,11629,92.9
11050, 광진구,065001, 60세,2018,5323,2565,2758,93,4981,2404,2577,93.3
11050, 광진구,065002, 61세,2018,5173,2517,2656,94.8,4819,2338,2481,94.2
11050, 광진구,065003, 62세,2018,4660,2223,2437,91.2,4412,2103,2309,91.1
11050, 광진구,065004, 63세,2018,4760,2265,2495,90.8,4502,2144,2358,90.9
11050, 광진구,065005, 64세,2018,3941,1920,2021,95,3714,1810,1904,95.1
11050, 광진구,070,65~69세,2018,15301,7232,8069,89.6,14714,6973,7741,90.1
11050, 광진구,070001, 65세,2018,3468,1649,1819,90.7,3286,1563,1723,90.7
11050, 광진구,070002, 66세,2018,3707,1769,1938,91.3,3567,1708,1859,91.9
11050, 광진구,070003, 67세,2018,2578,1190,1388,85.7,2473,1151,1322,87.1
11050, 광진구,070004, 68세,2018,2728,1287,1441,89.3,2645,1248,1397,89.3
11050, 광진구,070005, 69세,2018,2820,1337,1483,90.2,2743,1303,1440,90.5
11050, 광진구,075,70~74세,2018,11773,5484,6289,87.2,11598,5405,6193,87.3
11050, 광진구,075001, 70세,2018,2796,1314,1482,88.7,2742,1287,1455,88.5
11050, 광진구,075002, 71세,2018,2704,1227,1477,83.1,2664,1211,1453,83.3
11050, 광진구,075003, 72세,2018,2162,1024,1138,90,2125,1006,1119,89.9
11050, 광진구,075004, 73세,2018,2023,974,1049,92.9,2001,967,1034,93.5
11050, 광진구,075005, 74세,2018,2088,945,1143,82.7,2066,934,1132,82.5
11050, 광진구,080,75~79세,2018,8966,4131,4835,85.4,8881,4099,4782,85.7
11050, 광진구,080001, 75세,2018,1974,913,1061,86.1,1952,906,1046,86.6
11050, 광진구,080002, 76세,2018,2239,1042,1197,87.1,2210,1028,1182,87
11050, 광진구,080003, 77세,2018,1738,792,946,83.7,1727,786,941,83.5
11050, 광진구,080004, 78세,2018,1553,722,831,86.9,1542,718,824,87.1
11050, 광진구,080005, 79세,2018,1462,662,800,82.8,1450,661,789,83.8
11050, 광진구,085,80~84세,2018,4995,1962,3033,64.7,4926,1945,2981,65.2
11050, 광진구,085001, 80세,2018,1345,573,772,74.2,1320,568,752,75.5
11050, 광진구,085002, 81세,2018,1113,462,651,71,1099,459,640,71.7
11050, 광진구,085003, 82세,2018,932,338,594,56.9,918,335,583,57.5
11050, 광진구,085004, 83세,2018,884,319,565,56.5,878,318,560,56.8
11050, 광진구,085005, 84세,2018,721,270,451,59.9,711,265,446,59.4
11050, 광진구,090,85~89세,2018,2164,671,1493,44.9,2145,668,1477,45.2
11050, 광진구,090001, 85세,2018,592,198,394,50.3,584,197,387,50.9
11050, 광진구,090002, 86세,2018,545,174,371,46.9,542,174,368,47.3
11050, 광진구,090003, 87세,2018,384,116,268,43.3,382,116,266,43.6
11050, 광진구,090004, 88세,2018,343,94,249,37.8,339,93,246,37.8
11050, 광진구,090005, 89세,2018,300,89,211,42.2,298,88,210,41.9
11050, 광진구,095,90~94세,2018,711,187,524,35.7,707,186,521,35.7
11050, 광진구,095001, 90세,2018,238,63,175,36,238,63,175,36
11050, 광진구,095002, 91세,2018,183,50,133,37.6,180,49,131,37.4
11050, 광진구,095003, 92세,2018,112,23,89,25.8,112,23,89,25.8
11050, 광진구,095004, 93세,2018,97,28,69,40.6,96,28,68,41.2
11050, 광진구,095005, 94세,2018,81,23,58,39.7,81,23,58,39.7
11050, 광진구,100,95~99세,2018,183,36,147,24.5,182,36,146,24.7
11050, 광진구,100001, 95세,2018,58,10,48,20.8,57,10,47,21.3
11050, 광진구,100002, 96세,2018,50,9,41,22,50,9,41,22
11050, 광진구,100003, 97세,2018,39,8,31,25.8,39,8,31,25.8
11050, 광진구,100004, 98세,2018,20,X,16,25,20,X,16,25
11050, 광진구,100005, 99세,2018,16,5,11,45.5,16,5,11,45.5
11050, 광진구,101,100세이상,2018,27,X,25,8,27,X,25,8
11050, 광진구,102,15세미만,2018,35016,17952,17064,105.2,34282,17567,16715,105.1
11050, 광진구,103,15~64세,2018,283168,138105,145063,95.2,265113,129849,135264,96
11050, 광진구,104,65세이상,2018,44120,19705,24415,80.7,43180,19314,23866,80.9
11050, 광진구,086,85세이상,2018,3085,896,2189,40.9,3061,892,2169,41.1
11050, 광진구,126,평균연령,2018,41,40.4,41.5,,41.1,40.4,41.7,
11050, 광진구,127,중위연령,2018,40,39.5,40.6,,40.2,39.6,41,
11060, 동대문구,000,합계,2018,358141,176323,181818,97,338293,167999,170294,98.7
11060, 동대문구,005,0~4세,2018,11274,5802,5472,106,11046,5698,5348,106.5
11060, 동대문구,005001, 0세,2018,1957,1032,925,111.6,1916,1011,905,111.7
11060, 동대문구,005002, 1세,2018,2154,1113,1041,106.9,2114,1093,1021,107.1
11060, 동대문구,005003, 2세,2018,2398,1230,1168,105.3,2339,1205,1134,106.3
11060, 동대문구,005004, 3세,2018,2443,1228,1215,101.1,2386,1206,1180,102.2
11060, 동대문구,005005, 4세,2018,2322,1199,1123,106.8,2291,1183,1108,106.8
11060, 동대문구,010,5~9세,2018,11456,5901,5555,106.2,11329,5824,5505,105.8
11060, 동대문구,010001, 5세,2018,2346,1227,1119,109.7,2311,1208,1103,109.5
11060, 동대문구,010002, 6세,2018,2371,1208,1163,103.9,2350,1196,1154,103.6
11060, 동대문구,010003, 7세,2018,2333,1177,1156,101.8,2307,1157,1150,100.6
11060, 동대문구,010004, 8세,2018,2235,1166,1069,109.1,2216,1155,1061,108.9
11060, 동대문구,010005, 9세,2018,2171,1123,1048,107.2,2145,1108,1037,106.8
11060, 동대문구,015,10~14세,2018,11169,5740,5429,105.7,11071,5692,5379,105.8
11060, 동대문구,015001, 10세,2018,2338,1176,1162,101.2,2318,1165,1153,101
11060, 동대문구,015002, 11세,2018,2325,1220,1105,110.4,2298,1204,1094,110.1
11060, 동대문구,015003, 12세,2018,2205,1146,1059,108.2,2181,1137,1044,108.9
11060, 동대문구,015004, 13세,2018,2037,1042,995,104.7,2021,1037,984,105.4
11060, 동대문구,015005, 14세,2018,2264,1156,1108,104.3,2253,1149,1104,104.1
11060, 동대문구,020,15~19세,2018,16903,8066,8837,91.3,15614,7604,8010,94.9
11060, 동대문구,020001, 15세,2018,2313,1175,1138,103.3,2303,1169,1134,103.1
11060, 동대문구,020002, 16세,2018,2272,1144,1128,101.4,2253,1139,1114,102.2
11060, 동대문구,020003, 17세,2018,2748,1384,1364,101.5,2700,1367,1333,102.6
11060, 동대문구,020004, 18세,2018,3850,1842,2008,91.7,3513,1717,1796,95.6
11060, 동대문구,020005, 19세,2018,5720,2521,3199,78.8,4845,2212,2633,84
11060, 동대문구,025,20~24세,2018,35535,16232,19303,84.1,28989,13987,15002,93.2
11060, 동대문구,025001, 20세,2018,6674,2836,3838,73.9,5213,2311,2902,79.6
11060, 동대문구,025002, 21세,2018,6589,2768,3821,72.4,5196,2325,2871,81
11060, 동대문구,025003, 22세,2018,7367,3301,4066,81.2,5950,2824,3126,90.3
11060, 동대문구,025004, 23세,2018,7408,3520,3888,90.5,6181,3095,3086,100.3
11060, 동대문구,025005, 24세,2018,7497,3807,3690,103.2,6449,3432,3017,113.8
11060, 동대문구,030,25~29세,2018,31871,16924,14947,113.2,28790,15669,13121,119.4
11060, 동대문구,030001, 25세,2018,7261,3806,3455,110.2,6416,3497,2919,119.8
11060, 동대문구,030002, 26세,2018,7015,3767,3248,116,6335,3495,2840,123.1
11060, 동대문구,030003, 27세,2018,6241,3353,2888,116.1,5712,3136,2576,121.7
11060, 동대문구,030004, 28세,2018,5870,3106,2764,112.4,5348,2853,2495,114.3
11060, 동대문구,030005, 29세,2018,5484,2892,2592,111.6,4979,2688,2291,117.3
11060, 동대문구,035,30~34세,2018,25495,13214,12281,107.6,23657,12345,11312,109.1
11060, 동대문구,035001, 30세,2018,5186,2640,2546,103.7,4766,2478,2288,108.3
11060, 동대문구,035002, 31세,2018,5049,2646,2403,110.1,4617,2439,2178,112
11060, 동대문구,035003, 32세,2018,5167,2728,2439,111.8,4788,2527,2261,111.8
11060, 동대문구,035004, 33세,2018,4985,2561,2424,105.7,4668,2410,2258,106.7
11060, 동대문구,035005, 34세,2018,5108,2639,2469,106.9,4818,2491,2327,107
11060, 동대문구,040,35~39세,2018,28161,14580,13581,107.4,26897,13933,12964,107.5
11060, 동대문구,040001, 35세,2018,5561,2878,2683,107.3,5273,2741,2532,108.3
11060, 동대문구,040002, 36세,2018,5851,2992,2859,104.7,5565,2842,2723,104.4
11060, 동대문구,040003, 37세,2018,5725,2964,2761,107.4,5506,2851,2655,107.4
11060, 동대문구,040004, 38세,2018,5672,2970,2702,109.9,5441,2850,2591,110
11060, 동대문구,040005, 39세,2018,5352,2776,2576,107.8,5112,2649,2463,107.6
11060, 동대문구,045,40~44세,2018,24714,12841,11873,108.2,23692,12299,11393,108
11060, 동대문구,045001, 40세,2018,4803,2503,2300,108.8,4578,2373,2205,107.6
11060, 동대문구,045002, 41세,2018,4880,2491,2389,104.3,4683,2395,2288,104.7
11060, 동대문구,045003, 42세,2018,4815,2527,2288,110.4,4602,2421,2181,111
11060, 동대문구,045004, 43세,2018,4983,2598,2385,108.9,4807,2497,2310,108.1
11060, 동대문구,045005, 44세,2018,5233,2722,2511,108.4,5022,2613,2409,108.5
11060, 동대문구,050,45~49세,2018,27862,14176,13686,103.6,26729,13591,13138,103.4
11060, 동대문구,050001, 45세,2018,5305,2707,2598,104.2,5102,2605,2497,104.3
11060, 동대문구,050002, 46세,2018,5556,2913,2643,110.2,5325,2780,2545,109.2
11060, 동대문구,050003, 47세,2018,5831,3012,2819,106.8,5606,2903,2703,107.4
11060, 동대문구,050004, 48세,2018,5586,2794,2792,100.1,5351,2662,2689,99
11060, 동대문구,050005, 49세,2018,5584,2750,2834,97,5345,2641,2704,97.7
11060, 동대문구,055,50~54세,2018,26127,13037,13090,99.6,25093,12564,12529,100.3
11060, 동대문구,055001, 50세,2018,5518,2743,2775,98.8,5319,2650,2669,99.3
11060, 동대문구,055002, 51세,2018,5093,2459,2634,93.4,4921,2390,2531,94.4
11060, 동대문구,055003, 52세,2018,5107,2663,2444,109,4894,2567,2327,110.3
11060, 동대문구,055004, 53세,2018,5342,2660,2682,99.2,5108,2546,2562,99.4
11060, 동대문구,055005, 54세,2018,5067,2512,2555,98.3,4851,2411,2440,98.8
11060, 동대문구,060,55~59세,2018,28042,13583,14459,93.9,27141,13146,13995,93.9
11060, 동대문구,060001, 55세,2018,5323,2652,2671,99.3,5063,2517,2546,98.9
11060, 동대문구,060002, 56세,2018,5457,2659,2798,95,5246,2572,2674,96.2
11060, 동대문구,060003, 57세,2018,5812,2821,2991,94.3,5692,2758,2934,94
11060, 동대문구,060004, 58세,2018,5956,2822,3134,90,5775,2737,3038,90.1
11060, 동대문구,060005, 59세,2018,5494,2629,2865,91.8,5365,2562,2803,91.4
11060, 동대문구,065,60~64세,2018,24931,12094,12837,94.2,24211,11766,12445,94.5
11060, 동대문구,065001, 60세,2018,5378,2639,2739,96.3,5215,2576,2639,97.6
11060, 동대문구,065002, 61세,2018,5188,2498,2690,92.9,5008,2407,2601,92.5
11060, 동대문구,065003, 62세,2018,4906,2403,2503,96,4774,2340,2434,96.1
11060, 동대문구,065004, 63세,2018,5078,2445,2633,92.9,4938,2384,2554,93.3
11060, 동대문구,065005, 64세,2018,4381,2109,2272,92.8,4276,2059,2217,92.9
11060, 동대문구,070,65~69세,2018,17578,8353,9225,90.5,17232,8187,9045,90.5
11060, 동대문구,070001, 65세,2018,3835,1857,1978,93.9,3738,1820,1918,94.9
11060, 동대문구,070002, 66세,2018,4063,1871,2192,85.4,3983,1829,2154,84.9
11060, 동대문구,070003, 67세,2018,3050,1456,1594,91.3,2984,1421,1563,90.9
11060, 동대문구,070004, 68세,2018,3359,1641,1718,95.5,3306,1612,1694,95.2
11060, 동대문구,070005, 69세,2018,3271,1528,1743,87.7,3221,1505,1716,87.7
11060, 동대문구,075,70~74세,2018,14562,6522,8040,81.1,14450,6474,7976,81.2
11060, 동대문구,075001, 70세,2018,3313,1484,1829,81.1,3277,1468,1809,81.1
11060, 동대문구,075002, 71세,2018,3383,1517,1866,81.3,3354,1502,1852,81.1
11060, 동대문구,075003, 72세,2018,2683,1245,1438,86.6,2662,1234,1428,86.4
11060, 동대문구,075004, 73세,2018,2602,1163,1439,80.8,2590,1162,1428,81.4
11060, 동대문구,075005, 74세,2018,2581,1113,1468,75.8,2567,1108,1459,75.9
11060, 동대문구,080,75~79세,2018,11996,5372,6624,81.1,11945,5353,6592,81.2
11060, 동대문구,080001, 75세,2018,2670,1249,1421,87.9,2658,1241,1417,87.6
11060, 동대문구,080002, 76세,2018,2970,1321,1649,80.1,2962,1320,1642,80.4
11060, 동대문구,080003, 77세,2018,2335,1067,1268,84.1,2324,1061,1263,84
11060, 동대문구,080004, 78세,2018,2059,879,1180,74.5,2044,876,1168,75
11060, 동대문구,080005, 79세,2018,1962,856,1106,77.4,1957,855,1102,77.6
11060, 동대문구,085,80~84세,2018,6669,2698,3971,67.9,6629,2684,3945,68
11060, 동대문구,085001, 80세,2018,1732,735,997,73.7,1725,733,992,73.9
11060, 동대문구,085002, 81세,2018,1483,605,878,68.9,1469,601,868,69.2
11060, 동대문구,085003, 82세,2018,1294,533,761,70,1286,530,756,70.1
11060, 동대문구,085004, 83세,2018,1177,463,714,64.8,1169,461,708,65.1
11060, 동대문구,085005, 84세,2018,983,362,621,58.3,980,359,621,57.8
11060, 동대문구,090,85~89세,2018,2711,900,1811,49.7,2694,896,1798,49.8
11060, 동대문구,090001, 85세,2018,767,257,510,50.4,760,256,504,50.8
11060, 동대문구,090002, 86세,2018,689,252,437,57.7,684,250,434,57.6
11060, 동대문구,090003, 87세,2018,470,153,317,48.3,469,153,316,48.4
11060, 동대문구,090004, 88세,2018,425,131,294,44.6,422,130,292,44.5
11060, 동대문구,090005, 89세,2018,360,107,253,42.3,359,107,252,42.5
11060, 동대문구,095,90~94세,2018,849,223,626,35.6,848,222,626,35.5
11060, 동대문구,095001, 90세,2018,282,89,193,46.1,282,89,193,46.1
11060, 동대문구,095002, 91세,2018,238,63,175,36,238,63,175,36
11060, 동대문구,095003, 92세,2018,140,26,114,22.8,139,25,114,21.9
11060, 동대문구,095004, 93세,2018,109,28,81,34.6,109,28,81,34.6
11060, 동대문구,095005, 94세,2018,80,17,63,27,80,17,63,27
11060, 동대문구,100,95~99세,2018,211,60,151,39.7,211,60,151,39.7
11060, 동대문구,100001, 95세,2018,88,27,61,44.3,88,27,61,44.3
11060, 동대문구,100002, 96세,2018,51,10,41,24.4,51,10,41,24.4
11060, 동대문구,100003, 97세,2018,31,7,24,29.2,31,7,24,29.2
11060, 동대문구,100004, 98세,2018,29,10,19,52.6,29,10,19,52.6
11060, 동대문구,100005, 99세,2018,12,6,6,100,12,6,6,100
11060, 동대문구,101,100세이상,2018,25,5,20,25,25,5,20,25
11060, 동대문구,102,15세미만,2018,33899,17443,16456,106,33446,17214,16232,106
11060, 동대문구,103,15~64세,2018,269641,134747,134894,99.9,250813,126904,123909,102.4
11060, 동대문구,104,65세이상,2018,54601,24133,30468,79.2,54034,23881,30153,79.2
11060, 동대문구,086,85세이상,2018,3796,1188,2608,45.6,3778,1183,2595,45.6
11060, 동대문구,126,평균연령,2018,42.1,41.4,42.8,,42.7,41.7,43.6,
11060, 동대문구,127,중위연령,2018,41.5,40.7,42.4,,42.5,41.4,43.8,
11070, 중랑구,000,합계,2018,391668,193599,198069,97.7,385082,190871,194211,98.3
11070, 중랑구,005,0~4세,2018,12974,6685,6289,106.3,12811,6598,6213,106.2
11070, 중랑구,005001, 0세,2018,2396,1258,1138,110.5,2364,1244,1120,111.1
11070, 중랑구,005002, 1세,2018,2483,1247,1236,100.9,2444,1230,1214,101.3
11070, 중랑구,005003, 2세,2018,2683,1378,1305,105.6,2650,1356,1294,104.8
11070, 중랑구,005004, 3세,2018,2766,1458,1308,111.5,2740,1444,1296,111.4
11070, 중랑구,005005, 4세,2018,2646,1344,1302,103.2,2613,1324,1289,102.7
11070, 중랑구,010,5~9세,2018,13069,6673,6396,104.3,12953,6624,6329,104.7
11070, 중랑구,010001, 5세,2018,2658,1356,1302,104.1,2636,1345,1291,104.2
11070, 중랑구,010002, 6세,2018,2798,1437,1361,105.6,2768,1425,1343,106.1
11070, 중랑구,010003, 7세,2018,2678,1376,1302,105.7,2659,1366,1293,105.6
11070, 중랑구,010004, 8세,2018,2530,1285,1245,103.2,2508,1275,1233,103.4
11070, 중랑구,010005, 9세,2018,2405,1219,1186,102.8,2382,1213,1169,103.8
11070, 중랑구,015,10~14세,2018,12685,6536,6149,106.3,12612,6498,6114,106.3
11070, 중랑구,015001, 10세,2018,2583,1294,1289,100.4,2560,1281,1279,100.2
11070, 중랑구,015002, 11세,2018,2589,1336,1253,106.6,2575,1328,1247,106.5
11070, 중랑구,015003, 12세,2018,2447,1320,1127,117.1,2437,1315,1122,117.2
11070, 중랑구,015004, 13세,2018,2406,1255,1151,109,2395,1249,1146,109
11070, 중랑구,015005, 14세,2018,2660,1331,1329,100.2,2645,1325,1320,100.4
11070, 중랑구,020,15~19세,2018,16662,8528,8134,104.8,16518,8467,8051,105.2
11070, 중랑구,020001, 15세,2018,2815,1413,1402,100.8,2800,1405,1395,100.7
11070, 중랑구,020002, 16세,2018,2882,1507,1375,109.6,2867,1496,1371,109.1
11070, 중랑구,020003, 17세,2018,3393,1793,1600,112.1,3370,1784,1586,112.5
11070, 중랑구,020004, 18세,2018,3881,1933,1948,99.2,3836,1917,1919,99.9
11070, 중랑구,020005, 19세,2018,3691,1882,1809,104,3645,1865,1780,104.8
11070, 중랑구,025,20~24세,2018,25056,12769,12287,103.9,24579,12568,12011,104.6
11070, 중랑구,025001, 20세,2018,4145,2226,1919,116,4064,2198,1866,117.8
11070, 중랑구,025002, 21세,2018,4693,2449,2244,109.1,4600,2402,2198,109.3
11070, 중랑구,025003, 22세,2018,5023,2571,2452,104.9,4944,2534,2410,105.1
11070, 중랑구,025004, 23세,2018,5403,2702,2701,100,5290,2659,2631,101.1
11070, 중랑구,025005, 24세,2018,5792,2821,2971,95,5681,2775,2906,95.5
11070, 중랑구,030,25~29세,2018,30637,15120,15517,97.4,29778,14787,14991,98.6
11070, 중랑구,030001, 25세,2018,6101,3056,3045,100.4,5957,3000,2957,101.5
11070, 중랑구,030002, 26세,2018,6550,3235,3315,97.6,6387,3160,3227,97.9
11070, 중랑구,030003, 27세,2018,6136,2976,3160,94.2,5972,2913,3059,95.2
11070, 중랑구,030004, 28세,2018,6019,2957,3062,96.6,5841,2891,2950,98
11070, 중랑구,030005, 29세,2018,5831,2896,2935,98.7,5621,2823,2798,100.9
11070, 중랑구,035,30~34세,2018,29173,14878,14295,104.1,28306,14503,13803,105.1
11070, 중랑구,035001, 30세,2018,5804,2908,2896,100.4,5626,2837,2789,101.7
11070, 중랑구,035002, 31세,2018,5794,2933,2861,102.5,5596,2841,2755,103.1
11070, 중랑구,035003, 32세,2018,5903,3043,2860,106.4,5732,2976,2756,108
11070, 중랑구,035004, 33세,2018,5784,2942,2842,103.5,5619,2864,2755,104
11070, 중랑구,035005, 34세,2018,5888,3052,2836,107.6,5733,2985,2748,108.6
11070, 중랑구,040,35~39세,2018,32088,16898,15190,111.2,31436,16631,14805,112.3
11070, 중랑구,040001, 35세,2018,6267,3297,2970,111,6121,3238,2883,112.3
11070, 중랑구,040002, 36세,2018,6607,3472,3135,110.7,6483,3421,3062,111.7
11070, 중랑구,040003, 37세,2018,6599,3501,3098,113,6471,3456,3015,114.6
11070, 중랑구,040004, 38세,2018,6583,3446,3137,109.9,6465,3391,3074,110.3
11070, 중랑구,040005, 39세,2018,6032,3182,2850,111.6,5896,3125,2771,112.8
11070, 중랑구,045,40~44세,2018,26894,13994,12900,108.5,26378,13782,12596,109.4
11070, 중랑구,045001, 40세,2018,5197,2780,2417,115,5091,2731,2360,115.7
11070, 중랑구,045002, 41세,2018,5420,2838,2582,109.9,5321,2801,2520,111.2
11070, 중랑구,045003, 42세,2018,5157,2693,2464,109.3,5042,2648,2394,110.6
11070, 중랑구,045004, 43세,2018,5296,2704,2592,104.3,5198,2662,2536,105
11070, 중랑구,045005, 44세,2018,5824,2979,2845,104.7,5726,2940,2786,105.5
11070, 중랑구,050,45~49세,2018,32495,16231,16264,99.8,31845,15966,15879,100.5
11070, 중랑구,050001, 45세,2018,6011,3018,2993,100.8,5903,2971,2932,101.3
11070, 중랑구,050002, 46세,2018,6143,3072,3071,100,6007,3020,2987,101.1
11070, 중랑구,050003, 47세,2018,6823,3485,3338,104.4,6694,3431,3263,105.1
11070, 중랑구,050004, 48세,2018,6581,3260,3321,98.2,6433,3201,3232,99
11070, 중랑구,050005, 49세,2018,6937,3396,3541,95.9,6808,3343,3465,96.5
11070, 중랑구,055,50~54세,2018,33261,16069,17192,93.5,32629,15803,16826,93.9
11070, 중랑구,055001, 50세,2018,6946,3286,3660,89.8,6829,3235,3594,90
11070, 중랑구,055002, 51세,2018,6500,3099,3401,91.1,6398,3060,3338,91.7
11070, 중랑구,055003, 52세,2018,6423,3159,3264,96.8,6285,3093,3192,96.9
11070, 중랑구,055004, 53세,2018,6784,3267,3517,92.9,6646,3226,3420,94.3
11070, 중랑구,055005, 54세,2018,6608,3258,3350,97.3,6471,3189,3282,97.2
11070, 중랑구,060,55~59세,2018,36505,17780,18725,95,35921,17552,18369,95.6
11070, 중랑구,060001, 55세,2018,6848,3324,3524,94.3,6692,3264,3428,95.2
11070, 중랑구,060002, 56세,2018,7259,3640,3619,100.6,7123,3582,3541,101.2
11070, 중랑구,060003, 57세,2018,7786,3715,4071,91.3,7708,3684,4024,91.6
11070, 중랑구,060004, 58세,2018,7744,3752,3992,94,7627,3705,3922,94.5
11070, 중랑구,060005, 59세,2018,6868,3349,3519,95.2,6771,3317,3454,96
11070, 중랑구,065,60~64세,2018,30603,14861,15742,94.4,30148,14669,15479,94.8
11070, 중랑구,065001, 60세,2018,6683,3284,3399,96.6,6576,3241,3335,97.2
11070, 중랑구,065002, 61세,2018,6457,3128,3329,94,6346,3083,3263,94.5
11070, 중랑구,065003, 62세,2018,6004,2936,3068,95.7,5931,2903,3028,95.9
11070, 중랑구,065004, 63세,2018,6218,2938,3280,89.6,6135,2902,3233,89.8
11070, 중랑구,065005, 64세,2018,5241,2575,2666,96.6,5160,2540,2620,96.9
11070, 중랑구,070,65~69세,2018,20753,9947,10806,92.1,20516,9842,10674,92.2
11070, 중랑구,070001, 65세,2018,4555,2181,2374,91.9,4487,2150,2337,92
11070, 중랑구,070002, 66세,2018,4901,2364,2537,93.2,4845,2340,2505,93.4
11070, 중랑구,070003, 67세,2018,3545,1663,1882,88.4,3502,1646,1856,88.7
11070, 중랑구,070004, 68세,2018,3846,1876,1970,95.2,3815,1865,1950,95.6
11070, 중랑구,070005, 69세,2018,3906,1863,2043,91.2,3867,1841,2026,90.9
11070, 중랑구,075,70~74세,2018,16096,7423,8673,85.6,16003,7392,8611,85.8
11070, 중랑구,075001, 70세,2018,3778,1776,2002,88.7,3752,1766,1986,88.9
11070, 중랑구,075002, 71세,2018,3836,1771,2065,85.8,3812,1761,2051,85.9
11070, 중랑구,075003, 72세,2018,2943,1373,1570,87.5,2925,1369,1556,88
11070, 중랑구,075004, 73세,2018,2764,1256,1508,83.3,2751,1252,1499,83.5
11070, 중랑구,075005, 74세,2018,2775,1247,1528,81.6,2763,1244,1519,81.9
11070, 중랑구,080,75~79세,2018,12388,5588,6800,82.2,12354,5575,6779,82.2
11070, 중랑구,080001, 75세,2018,2712,1231,1481,83.1,2702,1227,1475,83.2
11070, 중랑구,080002, 76세,2018,3143,1413,1730,81.7,3138,1411,1727,81.7
11070, 중랑구,080003, 77세,2018,2444,1135,1309,86.7,2441,1134,1307,86.8
11070, 중랑구,080004, 78세,2018,2124,931,1193,78,2113,927,1186,78.2
11070, 중랑구,080005, 79세,2018,1965,878,1087,80.8,1960,876,1084,80.8
11070, 중랑구,085,80~84세,2018,6519,2597,3922,66.2,6500,2595,3905,66.5
11070, 중랑구,085001, 80세,2018,1680,701,979,71.6,1675,701,974,72
11070, 중랑구,085002, 81세,2018,1476,623,853,73,1470,622,848,73.3
11070, 중랑구,085003, 82세,2018,1296,527,769,68.5,1293,527,766,68.8
11070, 중랑구,085004, 83세,2018,1127,409,718,57,1124,408,716,57
11070, 중랑구,085005, 84세,2018,940,337,603,55.9,938,337,601,56.1
11070, 중랑구,090,85~89세,2018,2664,771,1893,40.7,2653,768,1885,40.7
11070, 중랑구,090001, 85세,2018,751,248,503,49.3,749,248,501,49.5
11070, 중랑구,090002, 86세,2018,615,212,403,52.6,611,210,401,52.4
11070, 중랑구,090003, 87세,2018,512,135,377,35.8,509,134,375,35.7
11070, 중랑구,090004, 88세,2018,434,94,340,27.6,432,94,338,27.8
11070, 중랑구,090005, 89세,2018,352,82,270,30.4,352,82,270,30.4
11070, 중랑구,095,90~94세,2018,892,201,691,29.1,888,201,687,29.3
11070, 중랑구,095001, 90세,2018,320,70,250,28,320,70,250,28
11070, 중랑구,095002, 91세,2018,215,57,158,36.1,213,57,156,36.5
11070, 중랑구,095003, 92세,2018,150,34,116,29.3,149,34,115,29.6
11070, 중랑구,095004, 93세,2018,113,21,92,22.8,113,21,92,22.8
11070, 중랑구,095005, 94세,2018,94,19,75,25.3,93,19,74,25.7
11070, 중랑구,100,95~99세,2018,228,48,180,26.7,228,48,180,26.7
11070, 중랑구,100001, 95세,2018,90,23,67,34.3,90,23,67,34.3
11070, 중랑구,100002, 96세,2018,57,8,49,16.3,57,8,49,16.3
11070, 중랑구,100003, 97세,2018,40,13,27,48.1,40,13,27,48.1
11070, 중랑구,100004, 98세,2018,21,X,18,16.7,21,X,18,16.7
11070, 중랑구,100005, 99세,2018,20,X,19,5.3,20,X,19,5.3
11070, 중랑구,101,100세이상,2018,26,X,24,8.3,26,X,24,8.3
11070, 중랑구,102,15세미만,2018,38728,19894,18834,105.6,38376,19720,18656,105.7
11070, 중랑구,103,15~64세,2018,293374,147128,146246,100.6,287538,144728,142810,101.3
11070, 중랑구,104,65세이상,2018,59566,26577,32989,80.6,59168,26423,32745,80.7
11070, 중랑구,086,85세이상,2018,3810,1022,2788,36.7,3795,1019,2776,36.7
11070, 중랑구,126,평균연령,2018,43.4,42.5,44.2,,43.4,42.5,44.3,
11070, 중랑구,127,중위연령,2018,44.4,43.1,45.6,,44.5,43.2,45.7,
11080, 성북구,000,합계,2018,438734,211204,227530,92.8,424211,205031,219180,93.5
11080, 성북구,005,0~4세,2018,14176,7295,6881,106,13949,7182,6767,106.1
11080, 성북구,005001, 0세,2018,2271,1183,1088,108.7,2234,1164,1070,108.8
11080, 성북구,005002, 1세,2018,2665,1363,1302,104.7,2603,1336,1267,105.4
11080, 성북구,005003, 2세,2018,2981,1516,1465,103.5,2925,1487,1438,103.4
11080, 성북구,005004, 3세,2018,3153,1638,1515,108.1,3114,1616,1498,107.9
11080, 성북구,005005, 4세,2018,3106,1595,1511,105.6,3073,1579,1494,105.7
11080, 성북구,010,5~9세,2018,16649,8539,8110,105.3,16519,8478,8041,105.4
11080, 성북구,010001, 5세,2018,3131,1576,1555,101.4,3091,1555,1536,101.2
11080, 성북구,010002, 6세,2018,3494,1842,1652,111.5,3474,1831,1643,111.4
11080, 성북구,010003, 7세,2018,3470,1775,1695,104.7,3447,1769,1678,105.4
11080, 성북구,010004, 8세,2018,3381,1705,1676,101.7,3354,1694,1660,102
11080, 성북구,010005, 9세,2018,3173,1641,1532,107.1,3153,1629,1524,106.9
11080, 성북구,015,10~14세,2018,17371,8999,8372,107.5,17274,8947,8327,107.4
11080, 성북구,015001, 10세,2018,3458,1801,1657,108.7,3440,1790,1650,108.5
11080, 성북구,015002, 11세,2018,3666,1908,1758,108.5,3642,1896,1746,108.6
11080, 성북구,015003, 12세,2018,3276,1659,1617,102.6,3257,1651,1606,102.8
11080, 성북구,015004, 13세,2018,3284,1735,1549,112,3271,1728,1543,112
11080, 성북구,015005, 14세,2018,3687,1896,1791,105.9,3664,1882,1782,105.6
11080, 성북구,020,15~19세,2018,24511,11677,12834,91,23528,11353,12175,93.2
11080, 성북구,020001, 15세,2018,3588,1856,1732,107.2,3572,1845,1727,106.8
11080, 성북구,020002, 16세,2018,3646,1836,1810,101.4,3628,1826,1802,101.3
11080, 성북구,020003, 17세,2018,4173,2076,2097,99,4108,2051,2057,99.7
11080, 성북구,020004, 18세,2018,5388,2540,2848,89.2,5105,2449,2656,92.2
11080, 성북구,020005, 19세,2018,7716,3369,4347,77.5,7115,3182,3933,80.9
11080, 성북구,025,20~24세,2018,40660,18033,22627,79.7,35882,16334,19548,83.6
11080, 성북구,025001, 20세,2018,8184,3373,4811,70.1,7060,3014,4046,74.5
11080, 성북구,025002, 21세,2018,7914,3182,4732,67.2,6834,2820,4014,70.3
11080, 성북구,025003, 22세,2018,8103,3551,4552,78,7136,3196,3940,81.1
11080, 성북구,025004, 23세,2018,8326,3850,4476,86,7391,3499,3892,89.9
11080, 성북구,025005, 24세,2018,8133,4077,4056,100.5,7461,3805,3656,104.1
11080, 성북구,030,25~29세,2018,34569,17685,16884,104.7,32381,16734,15647,106.9
11080, 성북구,030001, 25세,2018,7862,4059,3803,106.7,7322,3818,3504,109
11080, 성북구,030002, 26세,2018,7618,3904,3714,105.1,7130,3692,3438,107.4
11080, 성북구,030003, 27세,2018,6956,3622,3334,108.6,6568,3464,3104,111.6
11080, 성북구,030004, 28세,2018,6321,3144,3177,99,5923,2986,2937,101.7
11080, 성북구,030005, 29세,2018,5812,2956,2856,103.5,5438,2774,2664,104.1
11080, 성북구,035,30~34세,2018,28462,14220,14242,99.8,26929,13471,13458,100.1
11080, 성북구,035001, 30세,2018,5737,2895,2842,101.9,5375,2726,2649,102.9
11080, 성북구,035002, 31세,2018,5604,2803,2801,100.1,5288,2643,2645,99.9
11080, 성북구,035003, 32세,2018,5698,2869,2829,101.4,5395,2704,2691,100.5
11080, 성북구,035004, 33세,2018,5621,2752,2869,95.9,5335,2619,2716,96.4
11080, 성북구,035005, 34세,2018,5802,2901,2901,100,5536,2779,2757,100.8
11080, 성북구,040,35~39세,2018,33213,16570,16643,99.6,32153,16044,16109,99.6
11080, 성북구,040001, 35세,2018,6274,3145,3129,100.5,6025,3025,3000,100.8
11080, 성북구,040002, 36세,2018,6734,3339,3395,98.4,6506,3226,3280,98.4
11080, 성북구,040003, 37세,2018,6866,3494,3372,103.6,6657,3391,3266,103.8
11080, 성북구,040004, 38세,2018,6668,3266,3402,96,6483,3177,3306,96.1
11080, 성북구,040005, 39세,2018,6671,3326,3345,99.4,6482,3225,3257,99
11080, 성북구,045,40~44세,2018,32184,15965,16219,98.4,31380,15553,15827,98.3
11080, 성북구,045001, 40세,2018,5862,2924,2938,99.5,5657,2823,2834,99.6
11080, 성북구,045002, 41세,2018,6103,3005,3098,97,5949,2926,3023,96.8
11080, 성북구,045003, 42세,2018,6234,3089,3145,98.2,6083,3009,3074,97.9
11080, 성북구,045004, 43세,2018,6669,3293,3376,97.5,6518,3222,3296,97.8
11080, 성북구,045005, 44세,2018,7316,3654,3662,99.8,7173,3573,3600,99.3
11080, 성북구,050,45~49세,2018,38300,19095,19205,99.4,37459,18672,18787,99.4
11080, 성북구,050001, 45세,2018,7478,3700,3778,97.9,7310,3601,3709,97.1
11080, 성북구,050002, 46세,2018,7631,3859,3772,102.3,7457,3778,3679,102.7
11080, 성북구,050003, 47세,2018,7964,3958,4006,98.8,7788,3869,3919,98.7
11080, 성북구,050004, 48세,2018,7679,3797,3882,97.8,7514,3717,3797,97.9
11080, 성북구,050005, 49세,2018,7548,3781,3767,100.4,7390,3707,3683,100.7
11080, 성북구,055,50~54세,2018,32645,16048,16597,96.7,31968,15731,16237,96.9
11080, 성북구,055001, 50세,2018,7247,3620,3627,99.8,7085,3547,3538,100.3
11080, 성북구,055002, 51세,2018,6545,3211,3334,96.3,6409,3148,3261,96.5
11080, 성북구,055003, 52세,2018,6200,3080,3120,98.7,6074,3017,3057,98.7
11080, 성북구,055004, 53세,2018,6393,3124,3269,95.6,6264,3070,3194,96.1
11080, 성북구,055005, 54세,2018,6260,3013,3247,92.8,6136,2949,3187,92.5
11080, 성북구,060,55~59세,2018,32881,15748,17133,91.9,32383,15524,16859,92.1
11080, 성북구,060001, 55세,2018,6373,3067,3306,92.8,6240,3003,3237,92.8
11080, 성북구,060002, 56세,2018,6430,3109,3321,93.6,6318,3064,3254,94.2
11080, 성북구,060003, 57세,2018,6771,3258,3513,92.7,6688,3223,3465,93
11080, 성북구,060004, 58세,2018,6962,3233,3729,86.7,6863,3184,3679,86.5
11080, 성북구,060005, 59세,2018,6345,3081,3264,94.4,6274,3050,3224,94.6
11080, 성북구,065,60~64세,2018,28680,13558,15122,89.7,28313,13395,14918,89.8
11080, 성북구,065001, 60세,2018,6156,2967,3189,93,6088,2937,3151,93.2
11080, 성북구,065002, 61세,2018,6083,2851,3232,88.2,5996,2808,3188,88.1
11080, 성북구,065003, 62세,2018,5733,2706,3027,89.4,5645,2664,2981,89.4
11080, 성북구,065004, 63세,2018,5806,2677,3129,85.6,5735,2652,3083,86
11080, 성북구,065005, 64세,2018,4902,2357,2545,92.6,4849,2334,2515,92.8
11080, 성북구,070,65~69세,2018,20314,9380,10934,85.8,20124,9284,10840,85.6
11080, 성북구,070001, 65세,2018,4355,2022,2333,86.7,4302,1992,2310,86.2
11080, 성북구,070002, 66세,2018,4735,2223,2512,88.5,4687,2198,2489,88.3
11080, 성북구,070003, 67세,2018,3332,1547,1785,86.7,3300,1530,1770,86.4
11080, 성북구,070004, 68세,2018,3906,1804,2102,85.8,3876,1790,2086,85.8
11080, 성북구,070005, 69세,2018,3986,1784,2202,81,3959,1774,2185,81.2
11080, 성북구,075,70~74세,2018,16902,7426,9476,78.4,16838,7395,9443,78.3
11080, 성북구,075001, 70세,2018,3749,1631,2118,77,3733,1624,2109,77
11080, 성북구,075002, 71세,2018,3981,1776,2205,80.5,3965,1767,2198,80.4
11080, 성북구,075003, 72세,2018,3116,1354,1762,76.8,3106,1348,1758,76.7
11080, 성북구,075004, 73세,2018,2999,1331,1668,79.8,2993,1329,1664,79.9
11080, 성북구,075005, 74세,2018,3057,1334,1723,77.4,3041,1327,1714,77.4
11080, 성북구,080,75~79세,2018,14382,6301,8081,78,14340,6284,8056,78
11080, 성북구,080001, 75세,2018,3116,1406,1710,82.2,3107,1402,1705,82.2
11080, 성북구,080002, 76세,2018,3550,1590,1960,81.1,3543,1587,1956,81.1
11080, 성북구,080003, 77세,2018,2817,1251,1566,79.9,2811,1249,1562,80
11080, 성북구,080004, 78세,2018,2491,1040,1451,71.7,2483,1037,1446,71.7
11080, 성북구,080005, 79세,2018,2408,1014,1394,72.7,2396,1009,1387,72.7
11080, 성북구,085,80~84세,2018,8056,3202,4854,66,8031,3193,4838,66
11080, 성북구,085001, 80세,2018,2064,872,1192,73.2,2059,870,1189,73.2
11080, 성북구,085002, 81세,2018,1811,724,1087,66.6,1808,723,1085,66.6
11080, 성북구,085003, 82세,2018,1573,610,963,63.3,1563,608,955,63.7
11080, 성북구,085004, 83세,2018,1475,563,912,61.7,1473,562,911,61.7
11080, 성북구,085005, 84세,2018,1133,433,700,61.9,1128,430,698,61.6
11080, 성북구,090,85~89세,2018,3368,1104,2264,48.8,3353,1100,2253,48.8
11080, 성북구,090001, 85세,2018,940,353,587,60.1,933,352,581,60.6
11080, 성북구,090002, 86세,2018,771,253,518,48.8,767,252,515,48.9
11080, 성북구,090003, 87세,2018,643,206,437,47.1,642,205,437,46.9
11080, 성북구,090004, 88세,2018,552,165,387,42.6,551,165,386,42.7
11080, 성북구,090005, 89세,2018,462,127,335,37.9,460,126,334,37.7
11080, 성북구,095,90~94세,2018,1137,279,858,32.5,1134,278,856,32.5
11080, 성북구,095001, 90세,2018,391,102,289,35.3,391,102,289,35.3
11080, 성북구,095002, 91세,2018,305,77,228,33.8,305,77,228,33.8
11080, 성북구,095003, 92세,2018,207,50,157,31.8,204,49,155,31.6
11080, 성북구,095004, 93세,2018,138,26,112,23.2,138,26,112,23.2
11080, 성북구,095005, 94세,2018,96,24,72,33.3,96,24,72,33.3
11080, 성북구,100,95~99세,2018,254,71,183,38.8,254,71,183,38.8
11080, 성북구,100001, 95세,2018,88,23,65,35.4,88,23,65,35.4
11080, 성북구,100002, 96세,2018,70,24,46,52.2,70,24,46,52.2
11080, 성북구,100003, 97세,2018,42,11,31,35.5,42,11,31,35.5
11080, 성북구,100004, 98세,2018,30,5,25,20,30,5,25,20
11080, 성북구,100005, 99세,2018,24,8,16,50,24,8,16,50
11080, 성북구,101,100세이상,2018,20,9,11,81.8,19,8,11,72.7
11080, 성북구,102,15세미만,2018,48196,24833,23363,106.3,47742,24607,23135,106.4
11080, 성북구,103,15~64세,2018,326105,158599,167506,94.7,312376,152811,159565,95.8
11080, 성북구,104,65세이상,2018,64433,27772,36661,75.8,64093,27613,36480,75.7
11080, 성북구,086,85세이상,2018,4779,1463,3316,44.1,4760,1457,3303,44.1
11080, 성북구,126,평균연령,2018,41.5,40.8,42.3,,41.9,41,42.7,
11080, 성북구,127,중위연령,2018,41.6,40.9,42.4,,42.3,41.4,43.2,
11090, 강북구,000,합계,2018,309138,150028,159110,94.3,304191,148057,156134,94.8
11090, 강북구,005,0~4세,2018,8662,4394,4268,103,8591,4360,4231,103
11090, 강북구,005001, 0세,2018,1421,736,685,107.4,1395,721,674,107
11090, 강북구,005002, 1세,2018,1673,834,839,99.4,1657,829,828,100.1
11090, 강북구,005003, 2세,2018,1830,921,909,101.3,1820,914,906,100.9
11090, 강북구,005004, 3세,2018,1868,958,910,105.3,1858,956,902,106
11090, 강북구,005005, 4세,2018,1870,945,925,102.2,1861,940,921,102.1
11090, 강북구,010,5~9세,2018,10021,5185,4836,107.2,9987,5172,4815,107.4
11090, 강북구,010001, 5세,2018,1957,1037,920,112.7,1949,1032,917,112.5
11090, 강북구,010002, 6세,2018,2026,1057,969,109.1,2014,1051,963,109.1
11090, 강북구,010003, 7세,2018,2049,1040,1009,103.1,2046,1040,1006,103.4
11090, 강북구,010004, 8세,2018,2008,1041,967,107.7,2000,1039,961,108.1
11090, 강북구,010005, 9세,2018,1981,1010,971,104,1978,1010,968,104.3
11090, 강북구,015,10~14세,2018,10310,5267,5043,104.4,10288,5259,5029,104.6
11090, 강북구,015001, 10세,2018,2022,1011,1011,100,2015,1008,1007,100.1
11090, 강북구,015002, 11세,2018,2078,1088,990,109.9,2073,1087,986,110.2
11090, 강북구,015003, 12세,2018,2022,1051,971,108.2,2020,1050,970,108.2
11090, 강북구,015004, 13세,2018,2002,1025,977,104.9,1999,1024,975,105
11090, 강북구,015005, 14세,2018,2186,1092,1094,99.8,2181,1090,1091,99.9
11090, 강북구,020,15~19세,2018,13789,7028,6761,103.9,13644,6970,6674,104.4
11090, 강북구,020001, 15세,2018,2365,1240,1125,110.2,2358,1237,1121,110.3
11090, 강북구,020002, 16세,2018,2375,1245,1130,110.2,2367,1241,1126,110.2
11090, 강북구,020003, 17세,2018,2773,1440,1333,108,2764,1437,1327,108.3
11090, 강북구,020004, 18세,2018,3117,1627,1490,109.2,3085,1615,1470,109.9
11090, 강북구,020005, 19세,2018,3159,1476,1683,87.7,3070,1440,1630,88.3
11090, 강북구,025,20~24세,2018,20968,9964,11004,90.5,20345,9746,10599,92
11090, 강북구,025001, 20세,2018,3671,1719,1952,88.1,3566,1676,1890,88.7
11090, 강북구,025002, 21세,2018,4024,1902,2122,89.6,3913,1861,2052,90.7
11090, 강북구,025003, 22세,2018,4218,2010,2208,91,4112,1979,2133,92.8
11090, 강북구,025004, 23세,2018,4372,2086,2286,91.3,4212,2030,2182,93
11090, 강북구,025005, 24세,2018,4683,2247,2436,92.2,4542,2200,2342,93.9
11090, 강북구,030,25~29세,2018,22283,11125,11158,99.7,21548,10874,10674,101.9
11090, 강북구,030001, 25세,2018,4630,2304,2326,99.1,4506,2255,2251,100.2
11090, 강북구,030002, 26세,2018,4905,2394,2511,95.3,4740,2340,2400,97.5
11090, 강북구,030003, 27세,2018,4558,2229,2329,95.7,4420,2181,2239,97.4
11090, 강북구,030004, 28세,2018,4118,2112,2006,105.3,3958,2059,1899,108.4
11090, 강북구,030005, 29세,2018,4072,2086,1986,105,3924,2039,1885,108.2
11090, 강북구,035,30~34세,2018,19541,10212,9329,109.5,18917,9975,8942,111.6
11090, 강북구,035001, 30세,2018,3872,1981,1891,104.8,3728,1926,1802,106.9
11090, 강북구,035002, 31세,2018,3771,1985,1786,111.1,3648,1940,1708,113.6
11090, 강북구,035003, 32세,2018,3926,2065,1861,111,3785,2012,1773,113.5
11090, 강북구,035004, 33세,2018,3883,2004,1879,106.7,3775,1967,1808,108.8
11090, 강북구,035005, 34세,2018,4089,2177,1912,113.9,3981,2130,1851,115.1
11090, 강북구,040,35~39세,2018,23054,12092,10962,110.3,22598,11890,10708,111
11090, 강북구,040001, 35세,2018,4329,2251,2078,108.3,4227,2208,2019,109.4
11090, 강북구,040002, 36세,2018,4731,2435,2296,106.1,4614,2381,2233,106.6
11090, 강북구,040003, 37세,2018,4639,2502,2137,117.1,4552,2462,2090,117.8
11090, 강북구,040004, 38세,2018,4793,2518,2275,110.7,4708,2480,2228,111.3
11090, 강북구,040005, 39세,2018,4562,2386,2176,109.7,4497,2359,2138,110.3
11090, 강북구,045,40~44세,2018,21840,11178,10662,104.8,21488,11034,10454,105.5
11090, 강북구,045001, 40세,2018,4019,2040,1979,103.1,3943,2010,1933,104
11090, 강북구,045002, 41세,2018,4269,2203,2066,106.6,4199,2171,2028,107.1
11090, 강북구,045003, 42세,2018,4165,2166,1999,108.4,4103,2141,1962,109.1
11090, 강북구,045004, 43세,2018,4438,2271,2167,104.8,4365,2243,2122,105.7
11090, 강북구,045005, 44세,2018,4949,2498,2451,101.9,4878,2469,2409,102.5
11090, 강북구,050,45~49세,2018,26698,13331,13367,99.7,26298,13147,13151,100
11090, 강북구,050001, 45세,2018,5109,2551,2558,99.7,5028,2517,2511,100.2
11090, 강북구,050002, 46세,2018,5223,2715,2508,108.3,5154,2689,2465,109.1
11090, 강북구,050003, 47세,2018,5541,2774,2767,100.3,5451,2728,2723,100.2
11090, 강북구,050004, 48세,2018,5388,2687,2701,99.5,5307,2652,2655,99.9
11090, 강북구,050005, 49세,2018,5437,2604,2833,91.9,5358,2561,2797,91.6
11090, 강북구,055,50~54세,2018,25031,12072,12959,93.2,24620,11908,12712,93.7
11090, 강북구,055001, 50세,2018,5414,2602,2812,92.5,5339,2569,2770,92.7
11090, 강북구,055002, 51세,2018,4942,2369,2573,92.1,4870,2340,2530,92.5
11090, 강북구,055003, 52세,2018,4758,2322,2436,95.3,4680,2291,2389,95.9
11090, 강북구,055004, 53세,2018,5068,2404,2664,90.2,4974,2365,2609,90.6
11090, 강북구,055005, 54세,2018,4849,2375,2474,96,4757,2343,2414,97.1
11090, 강북구,060,55~59세,2018,27243,12991,14252,91.2,26803,12801,14002,91.4
11090, 강북구,060001, 55세,2018,5242,2615,2627,99.5,5128,2561,2567,99.8
11090, 강북구,060002, 56세,2018,5159,2523,2636,95.7,5068,2493,2575,96.8
11090, 강북구,060003, 57세,2018,5746,2682,3064,87.5,5686,2655,3031,87.6
11090, 강북구,060004, 58세,2018,5857,2683,3174,84.5,5751,2632,3119,84.4
11090, 강북구,060005, 59세,2018,5239,2488,2751,90.4,5170,2460,2710,90.8
11090, 강북구,065,60~64세,2018,23944,11255,12689,88.7,23614,11112,12502,88.9
11090, 강북구,065001, 60세,2018,5135,2432,2703,90,5065,2401,2664,90.1
11090, 강북구,065002, 61세,2018,4938,2404,2534,94.9,4862,2368,2494,94.9
11090, 강북구,065003, 62세,2018,4683,2194,2489,88.1,4637,2176,2461,88.4
11090, 강북구,065004, 63세,2018,4965,2292,2673,85.7,4893,2264,2629,86.1
11090, 강북구,065005, 64세,2018,4223,1933,2290,84.4,4157,1903,2254,84.4
11090, 강북구,070,65~69세,2018,17701,7926,9775,81.1,17522,7846,9676,81.1
11090, 강북구,070001, 65세,2018,3645,1662,1983,83.8,3595,1640,1955,83.9
11090, 강북구,070002, 66세,2018,4062,1849,2213,83.6,4018,1830,2188,83.6
11090, 강북구,070003, 67세,2018,3083,1395,1688,82.6,3051,1379,1672,82.5
11090, 강북구,070004, 68세,2018,3338,1437,1901,75.6,3305,1425,1880,75.8
11090, 강북구,070005, 69세,2018,3573,1583,1990,79.5,3553,1572,1981,79.4
11090, 강북구,075,70~74세,2018,15193,6644,8549,77.7,15130,6619,8511,77.8
11090, 강북구,075001, 70세,2018,3503,1546,1957,79,3487,1538,1949,78.9
11090, 강북구,075002, 71세,2018,3539,1546,1993,77.6,3527,1542,1985,77.7
11090, 강북구,075003, 72세,2018,2720,1166,1554,75,2707,1161,1546,75.1
11090, 강북구,075004, 73세,2018,2742,1151,1591,72.3,2728,1148,1580,72.7
11090, 강북구,075005, 74세,2018,2689,1235,1454,84.9,2681,1230,1451,84.8
11090, 강북구,080,75~79세,2018,12664,5587,7077,78.9,12634,5575,7059,79
11090, 강북구,080001, 75세,2018,2795,1211,1584,76.5,2789,1208,1581,76.4
11090, 강북구,080002, 76세,2018,3236,1476,1760,83.9,3232,1474,1758,83.8
11090, 강북구,080003, 77세,2018,2534,1148,1386,82.8,2527,1145,1382,82.9
11090, 강북구,080004, 78세,2018,2090,925,1165,79.4,2085,924,1161,79.6
11090, 강북구,080005, 79세,2018,2009,827,1182,70,2001,824,1177,70
11090, 강북구,085,80~84세,2018,6587,2695,3892,69.2,6571,2692,3879,69.4
11090, 강북구,085001, 80세,2018,1741,725,1016,71.4,1735,724,1011,71.6
11090, 강북구,085002, 81세,2018,1469,631,838,75.3,1466,631,835,75.6
11090, 강북구,085003, 82세,2018,1372,558,814,68.6,1368,557,811,68.7
11090, 강북구,085004, 83세,2018,1125,453,672,67.4,1123,452,671,67.4
11090, 강북구,085005, 84세,2018,880,328,552,59.4,879,328,551,59.5
11090, 강북구,090,85~89세,2018,2529,811,1718,47.2,2520,808,1712,47.2
11090, 강북구,090001, 85세,2018,693,253,440,57.5,691,253,438,57.8
11090, 강북구,090002, 86세,2018,617,214,403,53.1,617,214,403,53.1
11090, 강북구,090003, 87세,2018,435,127,308,41.2,433,126,307,41
11090, 강북구,090004, 88세,2018,411,107,304,35.2,409,107,302,35.4
11090, 강북구,090005, 89세,2018,373,110,263,41.8,370,108,262,41.2
11090, 강북구,095,90~94세,2018,839,209,630,33.2,832,207,625,33.1
11090, 강북구,095001, 90세,2018,279,81,198,40.9,277,81,196,41.3
11090, 강북구,095002, 91세,2018,196,46,150,30.7,196,46,150,30.7
11090, 강북구,095003, 92세,2018,151,38,113,33.6,149,37,112,33
11090, 강북구,095004, 93세,2018,120,26,94,27.7,117,25,92,27.2
11090, 강북구,095005, 94세,2018,93,18,75,24,93,18,75,24
11090, 강북구,100,95~99세,2018,214,54,160,33.8,214,54,160,33.8
11090, 강북구,100001, 95세,2018,73,23,50,46,73,23,50,46
11090, 강북구,100002, 96세,2018,61,15,46,32.6,61,15,46,32.6
11090, 강북구,100003, 97세,2018,41,10,31,32.3,41,10,31,32.3
11090, 강북구,100004, 98세,2018,24,5,19,26.3,24,5,19,26.3
11090, 강북구,100005, 99세,2018,15,X,14,7.1,15,X,14,7.1
11090, 강북구,101,100세이상,2018,27,8,19,42.1,27,8,19,42.1
11090, 강북구,102,15세미만,2018,28993,14846,14147,104.9,28866,14791,14075,105.1
11090, 강북구,103,15~64세,2018,224391,111248,113143,98.3,219875,109457,110418,99.1
11090, 강북구,104,65세이상,2018,55754,23934,31820,75.2,55450,23809,31641,75.2
11090, 강북구,086,85세이상,2018,3609,1082,2527,42.8,3593,1077,2516,42.8
11090, 강북구,126,평균연령,2018,44.5,43.4,45.6,,44.6,43.4,45.7,
11090, 강북구,127,중위연령,2018,45.8,44.4,47.2,,45.9,44.5,47.4,
11100, 도봉구,000,합계,2018,328243,159569,168674,94.6,325292,158370,166922,94.9
11100, 도봉구,005,0~4세,2018,10236,5258,4978,105.6,10172,5227,4945,105.7
11100, 도봉구,005001, 0세,2018,1708,902,806,111.9,1691,896,795,112.7
11100, 도봉구,005002, 1세,2018,1874,964,910,105.9,1861,959,902,106.3
11100, 도봉구,005003, 2세,2018,2154,1090,1064,102.4,2140,1085,1055,102.8
11100, 도봉구,005004, 3세,2018,2250,1151,1099,104.7,2238,1143,1095,104.4
11100, 도봉구,005005, 4세,2018,2250,1151,1099,104.7,2242,1144,1098,104.2
11100, 도봉구,010,5~9세,2018,11549,5989,5560,107.7,11521,5972,5549,107.6
11100, 도봉구,010001, 5세,2018,2155,1135,1020,111.3,2147,1131,1016,111.3
11100, 도봉구,010002, 6세,2018,2428,1265,1163,108.8,2423,1263,1160,108.9
11100, 도봉구,010003, 7세,2018,2379,1216,1163,104.6,2374,1213,1161,104.5
11100, 도봉구,010004, 8세,2018,2345,1209,1136,106.4,2340,1205,1135,106.2
11100, 도봉구,010005, 9세,2018,2242,1164,1078,108,2237,1160,1077,107.7
11100, 도봉구,015,10~14세,2018,12250,6323,5927,106.7,12231,6314,5917,106.7
11100, 도봉구,015001, 10세,2018,2307,1206,1101,109.5,2304,1206,1098,109.8
11100, 도봉구,015002, 11세,2018,2630,1366,1264,108.1,2626,1363,1263,107.9
11100, 도봉구,015003, 12세,2018,2311,1197,1114,107.5,2308,1196,1112,107.6
11100, 도봉구,015004, 13세,2018,2269,1138,1131,100.6,2263,1135,1128,100.6
11100, 도봉구,015005, 14세,2018,2733,1416,1317,107.5,2730,1414,1316,107.4
11100, 도봉구,020,15~19세,2018,16096,8147,7949,102.5,16013,8113,7900,102.7
11100, 도봉구,020001, 15세,2018,2636,1344,1292,104,2629,1340,1289,104
11100, 도봉구,020002, 16세,2018,2853,1466,1387,105.7,2849,1464,1385,105.7
11100, 도봉구,020003, 17세,2018,3283,1748,1535,113.9,3277,1744,1533,113.8
11100, 도봉구,020004, 18세,2018,3688,1843,1845,99.9,3671,1837,1834,100.2
11100, 도봉구,020005, 19세,2018,3636,1746,1890,92.4,3587,1728,1859,93
11100, 도봉구,025,20~24세,2018,21818,10767,11051,97.4,21449,10632,10817,98.3
11100, 도봉구,025001, 20세,2018,3929,1868,2061,90.6,3845,1843,2002,92.1
11100, 도봉구,025002, 21세,2018,4401,2217,2184,101.5,4334,2194,2140,102.5
11100, 도봉구,025003, 22세,2018,4417,2195,2222,98.8,4347,2168,2179,99.5
11100, 도봉구,025004, 23세,2018,4549,2239,2310,96.9,4473,2206,2267,97.3
11100, 도봉구,025005, 24세,2018,4522,2248,2274,98.9,4450,2221,2229,99.6
11100, 도봉구,030,25~29세,2018,22565,11387,11178,101.9,22129,11225,10904,102.9
11100, 도봉구,030001, 25세,2018,4850,2499,2351,106.3,4762,2458,2304,106.7
11100, 도봉구,030002, 26세,2018,4812,2390,2422,98.7,4718,2359,2359,100
11100, 도봉구,030003, 27세,2018,4535,2281,2254,101.2,4466,2261,2205,102.5
11100, 도봉구,030004, 28세,2018,4203,2097,2106,99.6,4114,2062,2052,100.5
11100, 도봉구,030005, 29세,2018,4165,2120,2045,103.7,4069,2085,1984,105.1
11100, 도봉구,035,30~34세,2018,20165,10348,9817,105.4,19764,10182,9582,106.3
11100, 도봉구,035001, 30세,2018,4018,2052,1966,104.4,3932,2016,1916,105.2
11100, 도봉구,035002, 31세,2018,3871,1982,1889,104.9,3790,1954,1836,106.4
11100, 도봉구,035003, 32세,2018,4005,2061,1944,106,3929,2021,1908,105.9
11100, 도봉구,035004, 33세,2018,4121,2091,2030,103,4041,2061,1980,104.1
11100, 도봉구,035005, 34세,2018,4150,2162,1988,108.8,4072,2130,1942,109.7
11100, 도봉구,040,35~39세,2018,23924,12175,11749,103.6,23616,12044,11572,104.1
11100, 도봉구,040001, 35세,2018,4586,2396,2190,109.4,4516,2369,2147,110.3
11100, 도봉구,040002, 36세,2018,4911,2468,2443,101,4842,2434,2408,101.1
11100, 도봉구,040003, 37세,2018,4887,2482,2405,103.2,4828,2459,2369,103.8
11100, 도봉구,040004, 38세,2018,4873,2466,2407,102.5,4823,2447,2376,103
11100, 도봉구,040005, 39세,2018,4667,2363,2304,102.6,4607,2335,2272,102.8
11100, 도봉구,045,40~44세,2018,22591,11281,11310,99.7,22357,11190,11167,100.2
11100, 도봉구,045001, 40세,2018,4161,2081,2080,100,4100,2056,2044,100.6
11100, 도봉구,045002, 41세,2018,4363,2214,2149,103,4322,2197,2125,103.4
11100, 도봉구,045003, 42세,2018,4361,2196,2165,101.4,4313,2182,2131,102.4
11100, 도봉구,045004, 43세,2018,4633,2237,2396,93.4,4596,2225,2371,93.8
11100, 도봉구,045005, 44세,2018,5073,2553,2520,101.3,5026,2530,2496,101.4
11100, 도봉구,050,45~49세,2018,28487,13758,14729,93.4,28235,13640,14595,93.5
11100, 도봉구,050001, 45세,2018,5400,2577,2823,91.3,5353,2555,2798,91.3
11100, 도봉구,050002, 46세,2018,5444,2739,2705,101.3,5391,2710,2681,101.1
11100, 도봉구,050003, 47세,2018,5959,2864,3095,92.5,5897,2832,3065,92.4
11100, 도봉구,050004, 48세,2018,5853,2810,3043,92.3,5805,2793,3012,92.7
11100, 도봉구,050005, 49세,2018,5831,2768,3063,90.4,5789,2750,3039,90.5
11100, 도봉구,055,50~54세,2018,27557,13058,14499,90.1,27333,12967,14366,90.3
11100, 도봉구,055001, 50세,2018,5974,2809,3165,88.8,5925,2790,3135,89
11100, 도봉구,055002, 51세,2018,5440,2540,2900,87.6,5395,2518,2877,87.5
11100, 도봉구,055003, 52세,2018,5355,2610,2745,95.1,5308,2599,2709,95.9
11100, 도봉구,055004, 53세,2018,5529,2595,2934,88.4,5483,2572,2911,88.4
11100, 도봉구,055005, 54세,2018,5259,2504,2755,90.9,5222,2488,2734,91
11100, 도봉구,060,55~59세,2018,30145,14217,15928,89.3,29953,14143,15810,89.5
11100, 도봉구,060001, 55세,2018,5641,2784,2857,97.4,5594,2764,2830,97.7
11100, 도봉구,060002, 56세,2018,5830,2757,3073,89.7,5787,2744,3043,90.2
11100, 도봉구,060003, 57세,2018,6280,2904,3376,86,6245,2892,3353,86.3
11100, 도봉구,060004, 58세,2018,6506,3032,3474,87.3,6469,3013,3456,87.2
11100, 도봉구,060005, 59세,2018,5888,2740,3148,87,5858,2730,3128,87.3
11100, 도봉구,065,60~64세,2018,26469,12721,13748,92.5,26299,12650,13649,92.7
11100, 도봉구,065001, 60세,2018,5694,2682,3012,89,5660,2667,2993,89.1
11100, 도봉구,065002, 61세,2018,5748,2809,2939,95.6,5707,2790,2917,95.6
11100, 도봉구,065003, 62세,2018,5208,2476,2732,90.6,5165,2457,2708,90.7
11100, 도봉구,065004, 63세,2018,5417,2575,2842,90.6,5390,2565,2825,90.8
11100, 도봉구,065005, 64세,2018,4402,2179,2223,98,4377,2171,2206,98.4
11100, 도봉구,070,65~69세,2018,17603,8513,9090,93.7,17515,8475,9040,93.8
11100, 도봉구,070001, 65세,2018,3836,1907,1929,98.9,3818,1898,1920,98.9
11100, 도봉구,070002, 66세,2018,4189,2023,2166,93.4,4159,2009,2150,93.4
11100, 도봉구,070003, 67세,2018,3036,1450,1586,91.4,3020,1446,1574,91.9
11100, 도봉구,070004, 68세,2018,3312,1590,1722,92.3,3299,1585,1714,92.5
11100, 도봉구,070005, 69세,2018,3230,1543,1687,91.5,3219,1537,1682,91.4
11100, 도봉구,075,70~74세,2018,14061,6537,7524,86.9,14025,6520,7505,86.9
11100, 도봉구,075001, 70세,2018,3316,1603,1713,93.6,3306,1598,1708,93.6
11100, 도봉구,075002, 71세,2018,3271,1504,1767,85.1,3264,1501,1763,85.1
11100, 도봉구,075003, 72세,2018,2532,1184,1348,87.8,2527,1182,1345,87.9
11100, 도봉구,075004, 73세,2018,2495,1153,1342,85.9,2487,1149,1338,85.9
11100, 도봉구,075005, 74세,2018,2447,1093,1354,80.7,2441,1090,1351,80.7
11100, 도봉구,080,75~79세,2018,11747,5257,6490,81,11724,5250,6474,81.1
11100, 도봉구,080001, 75세,2018,2541,1139,1402,81.2,2537,1138,1399,81.3
11100, 도봉구,080002, 76세,2018,2886,1348,1538,87.6,2881,1348,1533,87.9
11100, 도봉구,080003, 77세,2018,2335,1074,1261,85.2,2330,1071,1259,85.1
11100, 도봉구,080004, 78세,2018,2001,865,1136,76.1,1997,864,1133,76.3
11100, 도봉구,080005, 79세,2018,1984,831,1153,72.1,1979,829,1150,72.1
11100, 도봉구,085,80~84세,2018,6573,2548,4025,63.3,6559,2545,4014,63.4
11100, 도봉구,085001, 80세,2018,1667,697,970,71.9,1663,695,968,71.8
11100, 도봉구,085002, 81세,2018,1492,596,896,66.5,1489,596,893,66.7
11100, 도봉구,085003, 82세,2018,1298,490,808,60.6,1295,489,806,60.7
11100, 도봉구,085004, 83세,2018,1163,439,724,60.6,1160,439,721,60.9
11100, 도봉구,085005, 84세,2018,953,326,627,52,952,326,626,52.1
11100, 도봉구,090,85~89세,2018,3075,955,2120,45,3071,955,2116,45.1
11100, 도봉구,090001, 85세,2018,844,291,553,52.6,844,291,553,52.6
11100, 도봉구,090002, 86세,2018,734,216,518,41.7,734,216,518,41.7
11100, 도봉구,090003, 87세,2018,567,175,392,44.6,565,175,390,44.9
11100, 도봉구,090004, 88세,2018,485,140,345,40.6,484,140,344,40.7
11100, 도봉구,090005, 89세,2018,445,133,312,42.6,444,133,311,42.8
11100, 도봉구,095,90~94세,2018,1046,266,780,34.1,1043,265,778,34.1
11100, 도봉구,095001, 90세,2018,348,96,252,38.1,347,95,252,37.7
11100, 도봉구,095002, 91세,2018,268,77,191,40.3,268,77,191,40.3
11100, 도봉구,095003, 92세,2018,183,48,135,35.6,182,48,134,35.8
11100, 도봉구,095004, 93세,2018,150,28,122,23,149,28,121,23.1
11100, 도봉구,095005, 94세,2018,97,17,80,21.3,97,17,80,21.3
11100, 도봉구,100,95~99세,2018,254,57,197,28.9,253,56,197,28.4
11100, 도봉구,100001, 95세,2018,115,28,87,32.2,114,27,87,31
11100, 도봉구,100002, 96세,2018,58,14,44,31.8,58,14,44,31.8
11100, 도봉구,100003, 97세,2018,41,8,33,24.2,41,8,33,24.2
11100, 도봉구,100004, 98세,2018,25,X,24,4.2,25,X,24,4.2
11100, 도봉구,100005, 99세,2018,15,6,9,66.7,15,6,9,66.7
11100, 도봉구,101,100세이상,2018,32,7,25,28,30,5,25,20
11100, 도봉구,102,15세미만,2018,34035,17570,16465,106.7,33924,17513,16411,106.7
11100, 도봉구,103,15~64세,2018,239817,117859,121958,96.6,237148,116786,120362,97
11100, 도봉구,104,65세이상,2018,54391,24140,30251,79.8,54220,24071,30149,79.8
11100, 도봉구,086,85세이상,2018,4407,1285,3122,41.2,4397,1281,3116,41.1
11100, 도봉구,126,평균연령,2018,43.9,42.8,44.9,,43.9,42.9,45,
11100, 도봉구,127,중위연령,2018,45.5,44.3,46.7,,45.6,44.3,46.9,
11110, 노원구,000,합계,2018,534096,258737,275359,94,528268,256124,272144,94.1
11110, 노원구,005,0~4세,2018,17276,8904,8372,106.4,17198,8864,8334,106.4
11110, 노원구,005001, 0세,2018,2893,1506,1387,108.6,2875,1499,1376,108.9
11110, 노원구,005002, 1세,2018,3264,1646,1618,101.7,3242,1630,1612,101.1
11110, 노원구,005003, 2세,2018,3569,1846,1723,107.1,3561,1840,1721,106.9
11110, 노원구,005004, 3세,2018,3816,1993,1823,109.3,3804,1989,1815,109.6
11110, 노원구,005005, 4세,2018,3734,1913,1821,105.1,3716,1906,1810,105.3
11110, 노원구,010,5~9세,2018,20384,10441,9943,105,20333,10416,9917,105
11110, 노원구,010001, 5세,2018,3696,1892,1804,104.9,3683,1886,1797,105
11110, 노원구,010002, 6세,2018,4159,2142,2017,106.2,4148,2138,2010,106.4
11110, 노원구,010003, 7세,2018,4155,2114,2041,103.6,4146,2110,2036,103.6
11110, 노원구,010004, 8세,2018,4200,2149,2051,104.8,4190,2143,2047,104.7
11110, 노원구,010005, 9세,2018,4174,2144,2030,105.6,4166,2139,2027,105.5
11110, 노원구,015,10~14세,2018,25257,13096,12161,107.7,25229,13082,12147,107.7
11110, 노원구,015001, 10세,2018,4741,2434,2307,105.5,4735,2431,2304,105.5
11110, 노원구,015002, 11세,2018,4977,2560,2417,105.9,4971,2555,2416,105.8
11110, 노원구,015003, 12세,2018,4854,2562,2292,111.8,4850,2560,2290,111.8
11110, 노원구,015004, 13세,2018,5048,2619,2429,107.8,5042,2616,2426,107.8
11110, 노원구,015005, 14세,2018,5637,2921,2716,107.5,5631,2920,2711,107.7
11110, 노원구,020,15~19세,2018,34359,17751,16608,106.9,33932,17564,16368,107.3
11110, 노원구,020001, 15세,2018,5760,3033,2727,111.2,5754,3030,2724,111.2
11110, 노원구,020002, 16세,2018,5886,3050,2836,107.5,5876,3045,2831,107.6
11110, 노원구,020003, 17세,2018,6767,3572,3195,111.8,6741,3559,3182,111.8
11110, 노원구,020004, 18세,2018,7787,4066,3721,109.3,7708,4025,3683,109.3
11110, 노원구,020005, 19세,2018,8159,4030,4129,97.6,7853,3905,3948,98.9
11110, 노원구,025,20~24세,2018,42934,21683,21251,102,41554,21037,20517,102.5
11110, 노원구,025001, 20세,2018,8590,4131,4459,92.6,8232,3987,4245,93.9
11110, 노원구,025002, 21세,2018,8460,4103,4357,94.2,8173,3953,4220,93.7
11110, 노원구,025003, 22세,2018,8642,4388,4254,103.1,8404,4263,4141,102.9
11110, 노원구,025004, 23세,2018,8814,4569,4245,107.6,8554,4450,4104,108.4
11110, 노원구,025005, 24세,2018,8428,4492,3936,114.1,8191,4384,3807,115.2
11110, 노원구,030,25~29세,2018,35102,18300,16802,108.9,34236,17889,16347,109.4
11110, 노원구,030001, 25세,2018,8066,4391,3675,119.5,7859,4278,3581,119.5
11110, 노원구,030002, 26세,2018,7601,4052,3549,114.2,7428,3977,3451,115.2
11110, 노원구,030003, 27세,2018,6882,3510,3372,104.1,6722,3436,3286,104.6
11110, 노원구,030004, 28세,2018,6408,3278,3130,104.7,6235,3199,3036,105.4
11110, 노원구,030005, 29세,2018,6145,3069,3076,99.8,5992,2999,2993,100.2
11110, 노원구,035,30~34세,2018,31004,15406,15598,98.8,30322,15114,15208,99.4
11110, 노원구,035001, 30세,2018,5908,2932,2976,98.5,5757,2869,2888,99.3
11110, 노원구,035002, 31세,2018,6014,3006,3008,99.9,5863,2943,2920,100.8
11110, 노원구,035003, 32세,2018,6317,3114,3203,97.2,6180,3056,3124,97.8
11110, 노원구,035004, 33세,2018,6320,3172,3148,100.8,6188,3120,3068,101.7
11110, 노원구,035005, 34세,2018,6445,3182,3263,97.5,6334,3126,3208,97.4
11110, 노원구,040,35~39세,2018,38653,19198,19455,98.7,38135,18977,19158,99.1
11110, 노원구,040001, 35세,2018,7247,3616,3631,99.6,7130,3569,3561,100.2
11110, 노원구,040002, 36세,2018,7776,3864,3912,98.8,7668,3820,3848,99.3
11110, 노원구,040003, 37세,2018,7772,3946,3826,103.1,7658,3895,3763,103.5
11110, 노원구,040004, 38세,2018,8065,3913,4152,94.2,7983,3882,4101,94.7
11110, 노원구,040005, 39세,2018,7793,3859,3934,98.1,7696,3811,3885,98.1
11110, 노원구,045,40~44세,2018,39914,19011,20903,90.9,39514,18820,20694,90.9
11110, 노원구,045001, 40세,2018,7135,3474,3661,94.9,7042,3430,3612,95
11110, 노원구,045002, 41세,2018,7672,3625,4047,89.6,7589,3586,4003,89.6
11110, 노원구,045003, 42세,2018,7500,3632,3868,93.9,7432,3598,3834,93.8
11110, 노원구,045004, 43세,2018,8358,3894,4464,87.2,8277,3854,4423,87.1
11110, 노원구,045005, 44세,2018,9249,4386,4863,90.2,9174,4352,4822,90.3
11110, 노원구,050,45~49세,2018,51235,24533,26702,91.9,50824,24335,26489,91.9
11110, 노원구,050001, 45세,2018,9742,4625,5117,90.4,9674,4595,5079,90.5
11110, 노원구,050002, 46세,2018,9927,4699,5228,89.9,9850,4659,5191,89.8
11110, 노원구,050003, 47세,2018,10910,5217,5693,91.6,10825,5169,5656,91.4
11110, 노원구,050004, 48세,2018,10383,4985,5398,92.3,10296,4947,5349,92.5
11110, 노원구,050005, 49세,2018,10273,5007,5266,95.1,10179,4965,5214,95.2
11110, 노원구,055,50~54세,2018,44072,21555,22517,95.7,43699,21395,22304,95.9
11110, 노원구,055001, 50세,2018,9939,4799,5140,93.4,9862,4765,5097,93.5
11110, 노원구,055002, 51세,2018,9016,4390,4626,94.9,8941,4358,4583,95.1
11110, 노원구,055003, 52세,2018,8491,4260,4231,100.7,8422,4224,4198,100.6
11110, 노원구,055004, 53세,2018,8574,4124,4450,92.7,8503,4095,4408,92.9
11110, 노원구,055005, 54세,2018,8052,3982,4070,97.8,7971,3953,4018,98.4
11110, 노원구,060,55~59세,2018,43323,20655,22668,91.1,43059,20565,22494,91.4
11110, 노원구,060001, 55세,2018,8470,4045,4425,91.4,8393,4023,4370,92.1
11110, 노원구,060002, 56세,2018,8571,4195,4376,95.9,8520,4175,4345,96.1
11110, 노원구,060003, 57세,2018,9047,4358,4689,92.9,9001,4344,4657,93.3
11110, 노원구,060004, 58세,2018,9082,4236,4846,87.4,9030,4217,4813,87.6
11110, 노원구,060005, 59세,2018,8153,3821,4332,88.2,8115,3806,4309,88.3
11110, 노원구,065,60~64세,2018,36264,17043,19221,88.7,36083,16971,19112,88.8
11110, 노원구,065001, 60세,2018,7888,3746,4142,90.4,7848,3729,4119,90.5
11110, 노원구,065002, 61세,2018,7745,3633,4112,88.4,7704,3610,4094,88.2
11110, 노원구,065003, 62세,2018,7133,3346,3787,88.4,7103,3338,3765,88.7
11110, 노원구,065004, 63세,2018,7308,3354,3954,84.8,7272,3344,3928,85.1
11110, 노원구,065005, 64세,2018,6190,2964,3226,91.9,6156,2950,3206,92
11110, 노원구,070,65~69세,2018,24421,11471,12950,88.6,24340,11438,12902,88.7
11110, 노원구,070001, 65세,2018,5295,2556,2739,93.3,5280,2549,2731,93.3
11110, 노원구,070002, 66세,2018,5860,2776,3084,90,5836,2767,3069,90.2
11110, 노원구,070003, 67세,2018,4123,1927,2196,87.8,4109,1924,2185,88.1
11110, 노원구,070004, 68세,2018,4558,2124,2434,87.3,4546,2119,2427,87.3
11110, 노원구,070005, 69세,2018,4585,2088,2497,83.6,4569,2079,2490,83.5
11110, 노원구,075,70~74세,2018,18673,8226,10447,78.7,18631,8207,10424,78.7
11110, 노원구,075001, 70세,2018,4371,2016,2355,85.6,4364,2015,2349,85.8
11110, 노원구,075002, 71세,2018,4404,1928,2476,77.9,4394,1923,2471,77.8
11110, 노원구,075003, 72세,2018,3440,1476,1964,75.2,3429,1470,1959,75
11110, 노원구,075004, 73세,2018,3229,1449,1780,81.4,3225,1448,1777,81.5
11110, 노원구,075005, 74세,2018,3229,1357,1872,72.5,3219,1351,1868,72.3
11110, 노원구,080,75~79세,2018,15601,6464,9137,70.7,15577,6457,9120,70.8
11110, 노원구,080001, 75세,2018,3347,1448,1899,76.3,3339,1446,1893,76.4
11110, 노원구,080002, 76세,2018,3813,1617,2196,73.6,3809,1615,2194,73.6
11110, 노원구,080003, 77세,2018,3048,1212,1836,66,3045,1212,1833,66.1
11110, 노원구,080004, 78세,2018,2773,1155,1618,71.4,2769,1153,1616,71.3
11110, 노원구,080005, 79세,2018,2620,1032,1588,65,2615,1031,1584,65.1
11110, 노원구,085,80~84세,2018,9451,3284,6167,53.3,9439,3279,6160,53.2
11110, 노원구,085001, 80세,2018,2370,867,1503,57.7,2366,865,1501,57.6
11110, 노원구,085002, 81세,2018,2122,778,1344,57.9,2122,778,1344,57.9
11110, 노원구,085003, 82세,2018,1815,634,1181,53.7,1813,634,1179,53.8
11110, 노원구,085004, 83세,2018,1725,543,1182,45.9,1723,542,1181,45.9
11110, 노원구,085005, 84세,2018,1419,462,957,48.3,1415,460,955,48.2
11110, 노원구,090,85~89세,2018,4327,1306,3021,43.2,4320,1304,3016,43.2
11110, 노원구,090001, 85세,2018,1148,363,785,46.2,1147,363,784,46.3
11110, 노원구,090002, 86세,2018,1050,323,727,44.4,1048,323,725,44.6
11110, 노원구,090003, 87세,2018,791,220,571,38.5,789,220,569,38.7
11110, 노원구,090004, 88세,2018,748,224,524,42.7,748,224,524,42.7
11110, 노원구,090005, 89세,2018,590,176,414,42.5,588,174,414,42
11110, 노원구,095,90~94세,2018,1461,326,1135,28.7,1460,326,1134,28.7
11110, 노원구,095001, 90세,2018,490,121,369,32.8,489,121,368,32.9
11110, 노원구,095002, 91세,2018,365,78,287,27.2,365,78,287,27.2
11110, 노원구,095003, 92세,2018,260,52,208,25,260,52,208,25
11110, 노원구,095004, 93세,2018,185,38,147,25.9,185,38,147,25.9
11110, 노원구,095005, 94세,2018,161,37,124,29.8,161,37,124,29.8
11110, 노원구,100,95~99세,2018,346,82,264,31.1,346,82,264,31.1
11110, 노원구,100001, 95세,2018,127,29,98,29.6,127,29,98,29.6
11110, 노원구,100002, 96세,2018,81,20,61,32.8,81,20,61,32.8
11110, 노원구,100003, 97세,2018,66,14,52,26.9,66,14,52,26.9
11110, 노원구,100004, 98세,2018,45,14,31,45.2,45,14,31,45.2
11110, 노원구,100005, 99세,2018,27,5,22,22.7,27,5,22,22.7
11110, 노원구,101,100세이상,2018,39,X,37,5.4,37,X,35,5.7
11110, 노원구,102,15세미만,2018,62917,32441,30476,106.4,62760,32362,30398,106.5
11110, 노원구,103,15~64세,2018,396860,195135,201725,96.7,391358,192667,198691,97
11110, 노원구,104,65세이상,2018,74319,31161,43158,72.2,74150,31095,43055,72.2
11110, 노원구,086,85세이상,2018,6173,1716,4457,38.5,6163,1714,4449,38.5
11110, 노원구,126,평균연령,2018,41.6,40.3,42.9,,41.7,40.4,43,
11110, 노원구,127,중위연령,2018,43,41.3,44.3,,43.1,41.5,44.5,
11120, 은평구,000,합계,2018,462552,223452,239100,93.5,456582,220818,235764,93.7
11120, 은평구,005,0~4세,2018,15485,7912,7573,104.5,15362,7848,7514,104.4
11120, 은평구,005001, 0세,2018,2732,1382,1350,102.4,2705,1370,1335,102.6
11120, 은평구,005002, 1세,2018,2854,1464,1390,105.3,2824,1447,1377,105.1
11120, 은평구,005003, 2세,2018,3224,1647,1577,104.4,3201,1632,1569,104
11120, 은평구,005004, 3세,2018,3411,1725,1686,102.3,3387,1711,1676,102.1
11120, 은평구,005005, 4세,2018,3264,1694,1570,107.9,3245,1688,1557,108.4
11120, 은평구,010,5~9세,2018,17336,8959,8377,106.9,17262,8913,8349,106.8
11120, 은평구,010001, 5세,2018,3260,1715,1545,111,3243,1707,1536,111.1
11120, 은평구,010002, 6세,2018,3658,1895,1763,107.5,3631,1875,1756,106.8
11120, 은평구,010003, 7세,2018,3513,1797,1716,104.7,3505,1793,1712,104.7
11120, 은평구,010004, 8세,2018,3461,1783,1678,106.3,3449,1774,1675,105.9
11120, 은평구,010005, 9세,2018,3444,1769,1675,105.6,3434,1764,1670,105.6
11120, 은평구,015,10~14세,2018,18027,9363,8664,108.1,17961,9330,8631,108.1
11120, 은평구,015001, 10세,2018,3564,1836,1728,106.3,3551,1829,1722,106.2
11120, 은평구,015002, 11세,2018,3762,1994,1768,112.8,3753,1989,1764,112.8
11120, 은평구,015003, 12세,2018,3504,1800,1704,105.6,3497,1798,1699,105.8
11120, 은평구,015004, 13세,2018,3324,1764,1560,113.1,3312,1756,1556,112.9
11120, 은평구,015005, 14세,2018,3873,1969,1904,103.4,3848,1958,1890,103.6
11120, 은평구,020,15~19세,2018,22894,11622,11272,103.1,22689,11518,11171,103.1
11120, 은평구,020001, 15세,2018,4049,2112,1937,109,4026,2101,1925,109.1
11120, 은평구,020002, 16세,2018,4257,2155,2102,102.5,4222,2137,2085,102.5
11120, 은평구,020003, 17세,2018,4622,2315,2307,100.3,4587,2303,2284,100.8
11120, 은평구,020004, 18세,2018,5305,2700,2605,103.6,5252,2666,2586,103.1
11120, 은평구,020005, 19세,2018,4661,2340,2321,100.8,4602,2311,2291,100.9
11120, 은평구,025,20~24세,2018,28347,14144,14203,99.6,27883,13957,13926,100.2
11120, 은평구,025001, 20세,2018,4984,2548,2436,104.6,4919,2515,2404,104.6
11120, 은평구,025002, 21세,2018,5447,2774,2673,103.8,5384,2758,2626,105
11120, 은평구,025003, 22세,2018,5664,2823,2841,99.4,5579,2793,2786,100.3
11120, 은평구,025004, 23세,2018,5998,2982,3016,98.9,5883,2938,2945,99.8
11120, 은평구,025005, 24세,2018,6254,3017,3237,93.2,6118,2953,3165,93.3
11120, 은평구,030,25~29세,2018,33045,15939,17106,93.2,32284,15637,16647,93.9
11120, 은평구,030001, 25세,2018,6689,3216,3473,92.6,6540,3155,3385,93.2
11120, 은평구,030002, 26세,2018,6878,3324,3554,93.5,6742,3262,3480,93.7
11120, 은평구,030003, 27세,2018,6766,3293,3473,94.8,6609,3236,3373,95.9
11120, 은평구,030004, 28세,2018,6494,3108,3386,91.8,6329,3046,3283,92.8
11120, 은평구,030005, 29세,2018,6218,2998,3220,93.1,6064,2938,3126,94
11120, 은평구,035,30~34세,2018,31402,15397,16005,96.2,30565,15032,15533,96.8
11120, 은평구,035001, 30세,2018,6134,2973,3161,94.1,5953,2898,3055,94.9
11120, 은평구,035002, 31세,2018,6152,2999,3153,95.1,5962,2913,3049,95.5
11120, 은평구,035003, 32세,2018,6203,3015,3188,94.6,6024,2936,3088,95.1
11120, 은평구,035004, 33세,2018,6361,3172,3189,99.5,6216,3113,3103,100.3
11120, 은평구,035005, 34세,2018,6552,3238,3314,97.7,6410,3172,3238,98
11120, 은평구,040,35~39세,2018,38139,19323,18816,102.7,37465,19032,18433,103.2
11120, 은평구,040001, 35세,2018,7209,3604,3605,100,7069,3546,3523,100.7
11120, 은평구,040002, 36세,2018,7793,3994,3799,105.1,7635,3924,3711,105.7
11120, 은평구,040003, 37세,2018,7840,3973,3867,102.7,7712,3913,3799,103
11120, 은평구,040004, 38세,2018,7961,4052,3909,103.7,7830,3997,3833,104.3
11120, 은평구,040005, 39세,2018,7336,3700,3636,101.8,7219,3652,3567,102.4
11120, 은평구,045,40~44세,2018,35233,17529,17704,99,34754,17302,17452,99.1
11120, 은평구,045001, 40세,2018,6440,3167,3273,96.8,6346,3122,3224,96.8
11120, 은평구,045002, 41세,2018,6949,3485,3464,100.6,6852,3432,3420,100.4
11120, 은평구,045003, 42세,2018,6825,3433,3392,101.2,6723,3387,3336,101.5
11120, 은평구,045004, 43세,2018,7142,3541,3601,98.3,7043,3495,3548,98.5
11120, 은평구,045005, 44세,2018,7877,3903,3974,98.2,7790,3866,3924,98.5
11120, 은평구,050,45~49세,2018,41125,20261,20864,97.1,40645,20023,20622,97.1
11120, 은평구,050001, 45세,2018,8097,4043,4054,99.7,8020,4002,4018,99.6
11120, 은평구,050002, 46세,2018,8148,4051,4097,98.9,8053,4001,4052,98.7
11120, 은평구,050003, 47세,2018,8616,4256,4360,97.6,8515,4211,4304,97.8
11120, 은평구,050004, 48세,2018,8057,3876,4181,92.7,7949,3827,4122,92.8
11120, 은평구,050005, 49세,2018,8207,4035,4172,96.7,8108,3982,4126,96.5
11120, 은평구,055,50~54세,2018,36322,17421,18901,92.2,35826,17205,18621,92.4
11120, 은평구,055001, 50세,2018,7935,3802,4133,92,7821,3760,4061,92.6
11120, 은평구,055002, 51세,2018,7322,3498,3824,91.5,7236,3455,3781,91.4
11120, 은평구,055003, 52세,2018,6964,3395,3569,95.1,6888,3358,3530,95.1
11120, 은평구,055004, 53세,2018,7138,3353,3785,88.6,7030,3311,3719,89
11120, 은평구,055005, 54세,2018,6963,3373,3590,94,6851,3321,3530,94.1
11120, 은평구,060,55~59세,2018,38339,18103,20236,89.5,37834,17874,19960,89.5
11120, 은평구,060001, 55세,2018,7288,3478,3810,91.3,7146,3420,3726,91.8
11120, 은평구,060002, 56세,2018,7443,3613,3830,94.3,7343,3565,3778,94.4
11120, 은평구,060003, 57세,2018,7924,3731,4193,89,7851,3699,4152,89.1
11120, 은평구,060004, 58세,2018,8156,3721,4435,83.9,8065,3678,4387,83.8
11120, 은평구,060005, 59세,2018,7528,3560,3968,89.7,7429,3512,3917,89.7
11120, 은평구,065,60~64세,2018,33231,15478,17753,87.2,32801,15307,17494,87.5
11120, 은평구,065001, 60세,2018,7117,3332,3785,88,7030,3302,3728,88.6
11120, 은평구,065002, 61세,2018,6996,3268,3728,87.7,6891,3230,3661,88.2
11120, 은평구,065003, 62세,2018,6597,3108,3489,89.1,6518,3072,3446,89.1
11120, 은평구,065004, 63세,2018,6739,3144,3595,87.5,6653,3107,3546,87.6
11120, 은평구,065005, 64세,2018,5782,2626,3156,83.2,5709,2596,3113,83.4
11120, 은평구,070,65~69세,2018,23603,10800,12803,84.4,23400,10700,12700,84.3
11120, 은평구,070001, 65세,2018,5169,2339,2830,82.7,5109,2306,2803,82.3
11120, 은평구,070002, 66세,2018,5335,2531,2804,90.3,5284,2508,2776,90.3
11120, 은평구,070003, 67세,2018,4021,1811,2210,81.9,3988,1793,2195,81.7
11120, 은평구,070004, 68세,2018,4480,2062,2418,85.3,4451,2050,2401,85.4
11120, 은평구,070005, 69세,2018,4598,2057,2541,81,4568,2043,2525,80.9
11120, 은평구,075,70~74세,2018,19678,8769,10909,80.4,19596,8736,10860,80.4
11120, 은평구,075001, 70세,2018,4585,2070,2515,82.3,4557,2057,2500,82.3
11120, 은평구,075002, 71세,2018,4593,2056,2537,81,4580,2049,2531,81
11120, 은평구,075003, 72세,2018,3607,1618,1989,81.3,3593,1611,1982,81.3
11120, 은평구,075004, 73세,2018,3459,1526,1933,78.9,3449,1522,1927,79
11120, 은평구,075005, 74세,2018,3434,1499,1935,77.5,3417,1497,1920,78
11120, 은평구,080,75~79세,2018,16212,7228,8984,80.5,16167,7213,8954,80.6
11120, 은평구,080001, 75세,2018,3552,1534,2018,76,3543,1530,2013,76
11120, 은평구,080002, 76세,2018,4032,1818,2214,82.1,4018,1813,2205,82.2
11120, 은평구,080003, 77세,2018,3145,1445,1700,85,3137,1441,1696,85
11120, 은평구,080004, 78세,2018,2827,1303,1524,85.5,2819,1301,1518,85.7
11120, 은평구,080005, 79세,2018,2656,1128,1528,73.8,2650,1128,1522,74.1
11120, 은평구,085,80~84세,2018,8991,3660,5331,68.7,8959,3651,5308,68.8
11120, 은평구,085001, 80세,2018,2280,966,1314,73.5,2269,962,1307,73.6
11120, 은평구,085002, 81세,2018,2099,886,1213,73,2088,884,1204,73.4
11120, 은평구,085003, 82세,2018,1776,692,1084,63.8,1773,692,1081,64
11120, 은평구,085004, 83세,2018,1592,634,958,66.2,1589,632,957,66
11120, 은평구,085005, 84세,2018,1244,482,762,63.3,1240,481,759,63.4
11120, 은평구,090,85~89세,2018,3609,1179,2430,48.5,3600,1175,2425,48.5
11120, 은평구,090001, 85세,2018,988,347,641,54.1,986,347,639,54.3
11120, 은평구,090002, 86세,2018,878,309,569,54.3,875,306,569,53.8
11120, 은평구,090003, 87세,2018,668,199,469,42.4,666,199,467,42.6
11120, 은평구,090004, 88세,2018,559,159,400,39.8,558,158,400,39.5
11120, 은평구,090005, 89세,2018,516,165,351,47,515,165,350,47.1
11120, 은평구,095,90~94세,2018,1248,300,948,31.6,1244,300,944,31.8
11120, 은평구,095001, 90세,2018,409,116,293,39.6,408,116,292,39.7
11120, 은평구,095002, 91세,2018,326,63,263,24,323,63,260,24.2
11120, 은평구,095003, 92세,2018,208,55,153,35.9,208,55,153,35.9
11120, 은평구,095004, 93세,2018,167,30,137,21.9,167,30,137,21.9
11120, 은평구,095005, 94세,2018,138,36,102,35.3,138,36,102,35.3
11120, 은평구,100,95~99세,2018,260,62,198,31.3,259,62,197,31.5
11120, 은평구,100001, 95세,2018,112,31,81,38.3,111,31,80,38.8
11120, 은평구,100002, 96세,2018,61,13,48,27.1,61,13,48,27.1
11120, 은평구,100003, 97세,2018,40,8,32,25,40,8,32,25
11120, 은평구,100004, 98세,2018,30,7,23,30.4,30,7,23,30.4
11120, 은평구,100005, 99세,2018,17,X,14,21.4,17,X,14,21.4
11120, 은평구,101,100세이상,2018,26,X,23,13,26,X,23,13
11120, 은평구,102,15세미만,2018,50848,26234,24614,106.6,50585,26091,24494,106.5
11120, 은평구,103,15~64세,2018,338077,165217,172860,95.6,332746,162887,169859,95.9
11120, 은평구,104,65세이상,2018,73627,32001,41626,76.9,73251,31840,41411,76.9
11120, 은평구,086,85세이상,2018,5143,1544,3599,42.9,5129,1540,3589,42.9
11120, 은평구,126,평균연령,2018,43,42,44,,43.1,42,44.1,
11120, 은평구,127,중위연령,2018,43.9,42.7,45,,44,42.8,45.1,
11130, 서대문구,000,합계,2018,318874,149438,169436,88.2,304508,144208,160300,90
11130, 서대문구,005,0~4세,2018,10148,5164,4984,103.6,9896,5050,4846,104.2
11130, 서대문구,005001, 0세,2018,1808,952,856,111.2,1774,940,834,112.7
11130, 서대문구,005002, 1세,2018,1898,1015,883,114.9,1846,984,862,114.2
11130, 서대문구,005003, 2세,2018,2127,1076,1051,102.4,2055,1048,1007,104.1
11130, 서대문구,005004, 3세,2018,2148,1062,1086,97.8,2093,1038,1055,98.4
11130, 서대문구,005005, 4세,2018,2167,1059,1108,95.6,2128,1040,1088,95.6
11130, 서대문구,010,5~9세,2018,10413,5274,5139,102.6,10227,5172,5055,102.3
11130, 서대문구,010001, 5세,2018,2039,1047,992,105.5,1999,1023,976,104.8
11130, 서대문구,010002, 6세,2018,2172,1110,1062,104.5,2134,1092,1042,104.8
11130, 서대문구,010003, 7세,2018,2067,1013,1054,96.1,2028,990,1038,95.4
11130, 서대문구,010004, 8세,2018,2046,1062,984,107.9,2005,1037,968,107.1
11130, 서대문구,010005, 9세,2018,2089,1042,1047,99.5,2061,1030,1031,99.9
11130, 서대문구,015,10~14세,2018,10573,5340,5233,102,10384,5246,5138,102.1
11130, 서대문구,015001, 10세,2018,2036,1025,1011,101.4,1990,1003,987,101.6
11130, 서대문구,015002, 11세,2018,2115,1064,1051,101.2,2078,1046,1032,101.4
11130, 서대문구,015003, 12세,2018,2106,1074,1032,104.1,2067,1053,1014,103.8
11130, 서대문구,015004, 13세,2018,2036,1023,1013,101,2008,1008,1000,100.8
11130, 서대문구,015005, 14세,2018,2280,1154,1126,102.5,2241,1136,1105,102.8
11130, 서대문구,020,15~19세,2018,16526,7559,8967,84.3,15745,7325,8420,87
11130, 서대문구,020001, 15세,2018,2433,1222,1211,100.9,2394,1203,1191,101
11130, 서대문구,020002, 16세,2018,2430,1238,1192,103.9,2394,1217,1177,103.4
11130, 서대문구,020003, 17세,2018,2917,1531,1386,110.5,2848,1499,1349,111.1
11130, 서대문구,020004, 18세,2018,3699,1724,1975,87.3,3511,1679,1832,91.6
11130, 서대문구,020005, 19세,2018,5047,1844,3203,57.6,4598,1727,2871,60.2
11130, 서대문구,025,20~24세,2018,33419,12920,20499,63,29002,11875,17127,69.3
11130, 서대문구,025001, 20세,2018,6224,2180,4044,53.9,5334,1970,3364,58.6
11130, 서대문구,025002, 21세,2018,6480,2201,4279,51.4,5525,1991,3534,56.3
11130, 서대문구,025003, 22세,2018,6795,2585,4210,61.4,5904,2383,3521,67.7
11130, 서대문구,025004, 23세,2018,7173,2980,4193,71.1,6234,2746,3488,78.7
11130, 서대문구,025005, 24세,2018,6747,2974,3773,78.8,6005,2785,3220,86.5
11130, 서대문구,030,25~29세,2018,29146,14360,14786,97.1,26647,13563,13084,103.7
11130, 서대문구,030001, 25세,2018,6797,3266,3531,92.5,6097,3073,3024,101.6
11130, 서대문구,030002, 26세,2018,6352,3142,3210,97.9,5807,2984,2823,105.7
11130, 서대문구,030003, 27세,2018,5904,2918,2986,97.7,5465,2761,2704,102.1
11130, 서대문구,030004, 28세,2018,5258,2594,2664,97.4,4838,2445,2393,102.2
11130, 서대문구,030005, 29세,2018,4835,2440,2395,101.9,4440,2300,2140,107.5
11130, 서대문구,035,30~34세,2018,21831,10726,11105,96.6,20453,10131,10322,98.1
11130, 서대문구,035001, 30세,2018,4485,2201,2284,96.4,4178,2069,2109,98.1
11130, 서대문구,035002, 31세,2018,4414,2177,2237,97.3,4099,2063,2036,101.3
11130, 서대문구,035003, 32세,2018,4292,2142,2150,99.6,4019,2017,2002,100.7
11130, 서대문구,035004, 33세,2018,4318,2097,2221,94.4,4050,1971,2079,94.8
11130, 서대문구,035005, 34세,2018,4322,2109,2213,95.3,4107,2011,2096,95.9
11130, 서대문구,040,35~39세,2018,23697,11798,11899,99.2,22691,11332,11359,99.8
11130, 서대문구,040001, 35세,2018,4622,2342,2280,102.7,4403,2241,2162,103.7
11130, 서대문구,040002, 36세,2018,4922,2396,2526,94.9,4696,2293,2403,95.4
11130, 서대문구,040003, 37세,2018,4915,2481,2434,101.9,4710,2384,2326,102.5
11130, 서대문구,040004, 38세,2018,4835,2402,2433,98.7,4650,2313,2337,99
11130, 서대문구,040005, 39세,2018,4403,2177,2226,97.8,4232,2101,2131,98.6
11130, 서대문구,045,40~44세,2018,21796,10900,10896,100,21042,10510,10532,99.8
11130, 서대문구,045001, 40세,2018,4095,2038,2057,99.1,3924,1961,1963,99.9
11130, 서대문구,045002, 41세,2018,4310,2159,2151,100.4,4148,2065,2083,99.1
11130, 서대문구,045003, 42세,2018,4218,2117,2101,100.8,4086,2054,2032,101.1
11130, 서대문구,045004, 43세,2018,4357,2212,2145,103.1,4224,2139,2085,102.6
11130, 서대문구,045005, 44세,2018,4816,2374,2442,97.2,4660,2291,2369,96.7
11130, 서대문구,050,45~49세,2018,25863,12700,13163,96.5,25100,12305,12795,96.2
11130, 서대문구,050001, 45세,2018,4805,2316,2489,93,4656,2242,2414,92.9
11130, 서대문구,050002, 46세,2018,5137,2597,2540,102.2,4970,2511,2459,102.1
11130, 서대문구,050003, 47세,2018,5533,2791,2742,101.8,5362,2704,2658,101.7
11130, 서대문구,050004, 48세,2018,5219,2537,2682,94.6,5089,2462,2627,93.7
11130, 서대문구,050005, 49세,2018,5169,2459,2710,90.7,5023,2386,2637,90.5
11130, 서대문구,055,50~54세,2018,23534,11355,12179,93.2,22915,11044,11871,93
11130, 서대문구,055001, 50세,2018,5135,2460,2675,92,4997,2395,2602,92
11130, 서대문구,055002, 51세,2018,4689,2191,2498,87.7,4592,2143,2449,87.5
11130, 서대문구,055003, 52세,2018,4482,2324,2158,107.7,4359,2270,2089,108.7
11130, 서대문구,055004, 53세,2018,4703,2209,2494,88.6,4566,2133,2433,87.7
11130, 서대문구,055005, 54세,2018,4525,2171,2354,92.2,4401,2103,2298,91.5
11130, 서대문구,060,55~59세,2018,24150,11548,12602,91.6,23543,11272,12271,91.9
11130, 서대문구,060001, 55세,2018,4727,2323,2404,96.6,4561,2241,2320,96.6
11130, 서대문구,060002, 56세,2018,4754,2308,2446,94.4,4627,2253,2374,94.9
11130, 서대문구,060003, 57세,2018,5043,2389,2654,90,4923,2339,2584,90.5
11130, 서대문구,060004, 58세,2018,4993,2326,2667,87.2,4891,2279,2612,87.3
11130, 서대문구,060005, 59세,2018,4633,2202,2431,90.6,4541,2160,2381,90.7
11130, 서대문구,065,60~64세,2018,20300,9668,10632,90.9,19836,9454,10382,91.1
11130, 서대문구,065001, 60세,2018,4483,2194,2289,95.8,4365,2139,2226,96.1
11130, 서대문구,065002, 61세,2018,4283,2045,2238,91.4,4191,1997,2194,91
11130, 서대문구,065003, 62세,2018,3955,1861,2094,88.9,3867,1826,2041,89.5
11130, 서대문구,065004, 63세,2018,4130,1946,2184,89.1,4037,1900,2137,88.9
11130, 서대문구,065005, 64세,2018,3449,1622,1827,88.8,3376,1592,1784,89.2
11130, 서대문구,070,65~69세,2018,14253,6416,7837,81.9,14029,6308,7721,81.7
11130, 서대문구,070001, 65세,2018,3104,1450,1654,87.7,3029,1412,1617,87.3
11130, 서대문구,070002, 66세,2018,3209,1466,1743,84.1,3164,1449,1715,84.5
11130, 서대문구,070003, 67세,2018,2421,1136,1285,88.4,2387,1117,1270,88
11130, 서대문구,070004, 68세,2018,2748,1174,1574,74.6,2711,1156,1555,74.3
11130, 서대문구,070005, 69세,2018,2771,1190,1581,75.3,2738,1174,1564,75.1
11130, 서대문구,075,70~74세,2018,12308,5381,6927,77.7,12203,5334,6869,77.7
11130, 서대문구,075001, 70세,2018,2661,1169,1492,78.4,2631,1156,1475,78.4
11130, 서대문구,075002, 71세,2018,2943,1302,1641,79.3,2918,1290,1628,79.2
11130, 서대문구,075003, 72세,2018,2272,1008,1264,79.7,2252,999,1253,79.7
11130, 서대문구,075004, 73세,2018,2241,969,1272,76.2,2224,959,1265,75.8
11130, 서대문구,075005, 74세,2018,2191,933,1258,74.2,2178,930,1248,74.5
11130, 서대문구,080,75~79세,2018,10848,4654,6194,75.1,10794,4635,6159,75.3
11130, 서대문구,080001, 75세,2018,2256,956,1300,73.5,2244,949,1295,73.3
11130, 서대문구,080002, 76세,2018,2643,1172,1471,79.7,2635,1169,1466,79.7
11130, 서대문구,080003, 77세,2018,2074,909,1165,78,2056,905,1151,78.6
11130, 서대문구,080004, 78세,2018,1945,823,1122,73.4,1937,820,1117,73.4
11130, 서대문구,080005, 79세,2018,1930,794,1136,69.9,1922,792,1130,70.1
11130, 서대문구,085,80~84세,2018,6418,2564,3854,66.5,6375,2547,3828,66.5
11130, 서대문구,085001, 80세,2018,1621,678,943,71.9,1615,675,940,71.8
11130, 서대문구,085002, 81세,2018,1450,590,860,68.6,1437,587,850,69.1
11130, 서대문구,085003, 82세,2018,1261,509,752,67.7,1247,502,745,67.4
11130, 서대문구,085004, 83세,2018,1171,451,720,62.6,1169,449,720,62.4
11130, 서대문구,085005, 84세,2018,915,336,579,58,907,334,573,58.3
11130, 서대문구,090,85~89세,2018,2581,857,1724,49.7,2564,852,1712,49.8
11130, 서대문구,090001, 85세,2018,732,258,474,54.4,728,256,472,54.2
11130, 서대문구,090002, 86세,2018,592,204,388,52.6,592,204,388,52.6
11130, 서대문구,090003, 87세,2018,438,138,300,46,432,137,295,46.4
11130, 서대문구,090004, 88세,2018,451,138,313,44.1,449,138,311,44.4
11130, 서대문구,090005, 89세,2018,368,119,249,47.8,363,117,246,47.6
11130, 서대문구,095,90~94세,2018,864,214,650,32.9,858,214,644,33.2
11130, 서대문구,095001, 90세,2018,277,80,197,40.6,276,80,196,40.8
11130, 서대문구,095002, 91세,2018,229,50,179,27.9,228,50,178,28.1
11130, 서대문구,095003, 92세,2018,144,39,105,37.1,144,39,105,37.1
11130, 서대문구,095004, 93세,2018,121,25,96,26,118,25,93,26.9
11130, 서대문구,095005, 94세,2018,93,20,73,27.4,92,20,72,27.8
11130, 서대문구,100,95~99세,2018,182,33,149,22.1,181,33,148,22.3
11130, 서대문구,100001, 95세,2018,65,13,52,25,65,13,52,25
11130, 서대문구,100002, 96세,2018,61,11,50,22,60,11,49,22.4
11130, 서대문구,100003, 97세,2018,26,X,22,18.2,26,X,22,18.2
11130, 서대문구,100004, 98세,2018,15,X,12,25,15,X,12,25
11130, 서대문구,100005, 99세,2018,15,X,13,15.4,15,X,13,15.4
11130, 서대문구,101,100세이상,2018,24,7,17,41.2,23,6,17,35.3
11130, 서대문구,102,15세미만,2018,31134,15778,15356,102.7,30507,15468,15039,102.9
11130, 서대문구,103,15~64세,2018,240262,113534,126728,89.6,226974,108811,118163,92.1
11130, 서대문구,104,65세이상,2018,47478,20126,27352,73.6,47027,19929,27098,73.5
11130, 서대문구,086,85세이상,2018,3651,1111,2540,43.7,3626,1105,2521,43.8
11130, 서대문구,126,평균연령,2018,41.6,41.2,42,,42.1,41.4,42.7,
11130, 서대문구,127,중위연령,2018,40.9,40.8,41,,41.8,41.2,42.4,
11140, 마포구,000,합계,2018,368181,174194,193987,89.8,355405,168819,186586,90.5
11140, 마포구,005,0~4세,2018,13679,6979,6700,104.2,13443,6858,6585,104.1
11140, 마포구,005001, 0세,2018,2662,1365,1297,105.2,2614,1338,1276,104.9
11140, 마포구,005002, 1세,2018,2645,1381,1264,109.3,2593,1361,1232,110.5
11140, 마포구,005003, 2세,2018,2889,1477,1412,104.6,2845,1452,1393,104.2
11140, 마포구,005004, 3세,2018,2783,1400,1383,101.2,2732,1374,1358,101.2
11140, 마포구,005005, 4세,2018,2700,1356,1344,100.9,2659,1333,1326,100.5
11140, 마포구,010,5~9세,2018,13336,6748,6588,102.4,13184,6673,6511,102.5
11140, 마포구,010001, 5세,2018,2638,1302,1336,97.5,2596,1282,1314,97.6
11140, 마포구,010002, 6세,2018,2767,1399,1368,102.3,2733,1381,1352,102.1
11140, 마포구,010003, 7세,2018,2699,1367,1332,102.6,2677,1356,1321,102.6
11140, 마포구,010004, 8세,2018,2623,1327,1296,102.4,2598,1315,1283,102.5
11140, 마포구,010005, 9세,2018,2609,1353,1256,107.7,2580,1339,1241,107.9
11140, 마포구,015,10~14세,2018,13483,6806,6677,101.9,13356,6739,6617,101.8
11140, 마포구,015001, 10세,2018,2791,1419,1372,103.4,2760,1405,1355,103.7
11140, 마포구,015002, 11세,2018,2824,1434,1390,103.2,2807,1424,1383,103
11140, 마포구,015003, 12세,2018,2527,1259,1268,99.3,2498,1241,1257,98.7
11140, 마포구,015004, 13세,2018,2579,1322,1257,105.2,2557,1309,1248,104.9
11140, 마포구,015005, 14세,2018,2762,1372,1390,98.7,2734,1360,1374,99
11140, 마포구,020,15~19세,2018,15939,7908,8031,98.5,15456,7746,7710,100.5
11140, 마포구,020001, 15세,2018,2716,1440,1276,112.9,2700,1434,1266,113.3
11140, 마포구,020002, 16세,2018,2631,1318,1313,100.4,2614,1309,1305,100.3
11140, 마포구,020003, 17세,2018,2968,1540,1428,107.8,2941,1528,1413,108.1
11140, 마포구,020004, 18세,2018,3497,1685,1812,93,3381,1656,1725,96
11140, 마포구,020005, 19세,2018,4127,1925,2202,87.4,3820,1819,2001,90.9
11140, 마포구,025,20~24세,2018,28582,12587,15995,78.7,25752,11780,13972,84.3
11140, 마포구,025001, 20세,2018,4776,2103,2673,78.7,4240,1945,2295,84.7
11140, 마포구,025002, 21세,2018,5169,2229,2940,75.8,4621,2069,2552,81.1
11140, 마포구,025003, 22세,2018,5705,2477,3228,76.7,5122,2317,2805,82.6
11140, 마포구,025004, 23세,2018,6193,2720,3473,78.3,5628,2574,3054,84.3
11140, 마포구,025005, 24세,2018,6739,3058,3681,83.1,6141,2875,3266,88
11140, 마포구,030,25~29세,2018,34885,16165,18720,86.4,32743,15370,17373,88.5
11140, 마포구,030001, 25세,2018,7107,3338,3769,88.6,6595,3159,3436,91.9
11140, 마포구,030002, 26세,2018,7342,3399,3943,86.2,6910,3256,3654,89.1
11140, 마포구,030003, 27세,2018,7048,3304,3744,88.2,6645,3154,3491,90.3
11140, 마포구,030004, 28세,2018,6855,3108,3747,82.9,6411,2932,3479,84.3
11140, 마포구,030005, 29세,2018,6533,3016,3517,85.8,6182,2869,3313,86.6
11140, 마포구,035,30~34세,2018,32791,15308,17483,87.6,31183,14560,16623,87.6
11140, 마포구,035001, 30세,2018,6420,2977,3443,86.5,6061,2821,3240,87.1
11140, 마포구,035002, 31세,2018,6478,2880,3598,80,6132,2737,3395,80.6
11140, 마포구,035003, 32세,2018,6595,3043,3552,85.7,6281,2893,3388,85.4
11140, 마포구,035004, 33세,2018,6565,3110,3455,90,6276,2973,3303,90
11140, 마포구,035005, 34세,2018,6733,3298,3435,96,6433,3136,3297,95.1
11140, 마포구,040,35~39세,2018,33687,16546,17141,96.5,32494,15923,16571,96.1
11140, 마포구,040001, 35세,2018,6842,3313,3529,93.9,6569,3170,3399,93.3
11140, 마포구,040002, 36세,2018,7185,3530,3655,96.6,6933,3400,3533,96.2
11140, 마포구,040003, 37세,2018,6861,3404,3457,98.5,6631,3287,3344,98.3
11140, 마포구,040004, 38세,2018,6546,3211,3335,96.3,6341,3104,3237,95.9
11140, 마포구,040005, 39세,2018,6253,3088,3165,97.6,6020,2962,3058,96.9
11140, 마포구,045,40~44세,2018,29479,14471,15008,96.4,28615,13994,14621,95.7
11140, 마포구,045001, 40세,2018,5622,2759,2863,96.4,5426,2649,2777,95.4
11140, 마포구,045002, 41세,2018,5864,2824,3040,92.9,5676,2723,2953,92.2
11140, 마포구,045003, 42세,2018,5835,2812,3023,93,5676,2726,2950,92.4
11140, 마포구,045004, 43세,2018,5944,2967,2977,99.7,5770,2871,2899,99
11140, 마포구,045005, 44세,2018,6214,3109,3105,100.1,6067,3025,3042,99.4
11140, 마포구,050,45~49세,2018,31729,15694,16035,97.9,30917,15264,15653,97.5
11140, 마포구,050001, 45세,2018,6359,3053,3306,92.3,6183,2956,3227,91.6
11140, 마포구,050002, 46세,2018,6461,3253,3208,101.4,6309,3173,3136,101.2
11140, 마포구,050003, 47세,2018,6626,3246,3380,96,6468,3156,3312,95.3
11140, 마포구,050004, 48세,2018,6188,3079,3109,99,6013,2999,3014,99.5
11140, 마포구,050005, 49세,2018,6095,3063,3032,101,5944,2980,2964,100.5
11140, 마포구,055,50~54세,2018,26115,12675,13440,94.3,25365,12317,13048,94.4
11140, 마포구,055001, 50세,2018,5799,2776,3023,91.8,5631,2694,2937,91.7
11140, 마포구,055002, 51세,2018,5225,2489,2736,91,5061,2402,2659,90.3
11140, 마포구,055003, 52세,2018,4894,2467,2427,101.6,4776,2412,2364,102
11140, 마포구,055004, 53세,2018,5317,2571,2746,93.6,5171,2510,2661,94.3
11140, 마포구,055005, 54세,2018,4880,2372,2508,94.6,4726,2299,2427,94.7
11140, 마포구,060,55~59세,2018,25830,12431,13399,92.8,25200,12141,13059,93
11140, 마포구,060001, 55세,2018,5097,2472,2625,94.2,4935,2402,2533,94.8
11140, 마포구,060002, 56세,2018,5039,2447,2592,94.4,4893,2377,2516,94.5
11140, 마포구,060003, 57세,2018,5331,2586,2745,94.2,5233,2542,2691,94.5
11140, 마포구,060004, 58세,2018,5446,2586,2860,90.4,5323,2528,2795,90.4
11140, 마포구,060005, 59세,2018,4917,2340,2577,90.8,4816,2292,2524,90.8
11140, 마포구,065,60~64세,2018,21067,9805,11262,87.1,20561,9577,10984,87.2
11140, 마포구,065001, 60세,2018,4521,2114,2407,87.8,4395,2068,2327,88.9
11140, 마포구,065002, 61세,2018,4551,2126,2425,87.7,4441,2063,2378,86.8
11140, 마포구,065003, 62세,2018,4145,1926,2219,86.8,4057,1888,2169,87
11140, 마포구,065004, 63세,2018,4308,2012,2296,87.6,4207,1970,2237,88.1
11140, 마포구,065005, 64세,2018,3542,1627,1915,85,3461,1588,1873,84.8
11140, 마포구,070,65~69세,2018,14582,6499,8083,80.4,14347,6379,7968,80.1
11140, 마포구,070001, 65세,2018,3093,1408,1685,83.6,3031,1377,1654,83.3
11140, 마포구,070002, 66세,2018,3411,1571,1840,85.4,3351,1540,1811,85
11140, 마포구,070003, 67세,2018,2405,1068,1337,79.9,2363,1049,1314,79.8
11140, 마포구,070004, 68세,2018,2792,1223,1569,77.9,2752,1203,1549,77.7
11140, 마포구,070005, 69세,2018,2881,1229,1652,74.4,2850,1210,1640,73.8
11140, 마포구,075,70~74세,2018,12480,5280,7200,73.3,12373,5238,7135,73.4
11140, 마포구,075001, 70세,2018,2863,1221,1642,74.4,2836,1212,1624,74.6
11140, 마포구,075002, 71세,2018,2868,1216,1652,73.6,2839,1206,1633,73.9
11140, 마포구,075003, 72세,2018,2207,922,1285,71.8,2190,916,1274,71.9
11140, 마포구,075004, 73세,2018,2288,968,1320,73.3,2274,961,1313,73.2
11140, 마포구,075005, 74세,2018,2254,953,1301,73.3,2234,943,1291,73
11140, 마포구,080,75~79세,2018,10575,4622,5953,77.6,10529,4608,5921,77.8
11140, 마포구,080001, 75세,2018,2242,1006,1236,81.4,2231,1001,1230,81.4
11140, 마포구,080002, 76세,2018,2628,1152,1476,78,2621,1152,1469,78.4
11140, 마포구,080003, 77세,2018,2044,895,1149,77.9,2033,891,1142,78
11140, 마포구,080004, 78세,2018,1906,808,1098,73.6,1895,804,1091,73.7
11140, 마포구,080005, 79세,2018,1755,761,994,76.6,1749,760,989,76.8
11140, 마포구,085,80~84세,2018,6215,2431,3784,64.2,6188,2423,3765,64.4
11140, 마포구,085001, 80세,2018,1506,635,871,72.9,1500,635,865,73.4
11140, 마포구,085002, 81세,2018,1457,588,869,67.7,1450,586,864,67.8
11140, 마포구,085003, 82세,2018,1253,494,759,65.1,1243,490,753,65.1
11140, 마포구,085004, 83세,2018,1137,421,716,58.8,1133,419,714,58.7
11140, 마포구,085005, 84세,2018,862,293,569,51.5,862,293,569,51.5
11140, 마포구,090,85~89세,2018,2690,950,1740,54.6,2671,943,1728,54.6
11140, 마포구,090001, 85세,2018,765,309,456,67.8,761,307,454,67.6
11140, 마포구,090002, 86세,2018,646,226,420,53.8,641,224,417,53.7
11140, 마포구,090003, 87세,2018,474,156,318,49.1,473,156,317,49.2
11140, 마포구,090004, 88세,2018,445,139,306,45.4,438,137,301,45.5
11140, 마포구,090005, 89세,2018,360,120,240,50,358,119,239,49.8
11140, 마포구,095,90~94세,2018,802,230,572,40.2,796,228,568,40.1
11140, 마포구,095001, 90세,2018,279,86,193,44.6,278,86,192,44.8
11140, 마포구,095002, 91세,2018,204,55,149,36.9,201,54,147,36.7
11140, 마포구,095003, 92세,2018,134,40,94,42.6,133,39,94,41.5
11140, 마포구,095004, 93세,2018,105,28,77,36.4,104,28,76,36.8
11140, 마포구,095005, 94세,2018,80,21,59,35.6,80,21,59,35.6
11140, 마포구,100,95~99세,2018,199,52,147,35.4,196,51,145,35.2
11140, 마포구,100001, 95세,2018,78,21,57,36.8,77,21,56,37.5
11140, 마포구,100002, 96세,2018,53,10,43,23.3,53,10,43,23.3
11140, 마포구,100003, 97세,2018,33,12,21,57.1,31,11,20,55
11140, 마포구,100004, 98세,2018,23,5,18,27.8,23,5,18,27.8
11140, 마포구,100005, 99세,2018,12,X,8,50,12,X,8,50
11140, 마포구,101,100세이상,2018,36,7,29,24.1,36,7,29,24.1
11140, 마포구,102,15세미만,2018,40498,20533,19965,102.8,39983,20270,19713,102.8
11140, 마포구,103,15~64세,2018,280104,133590,146514,91.2,268286,128672,139614,92.2
11140, 마포구,104,65세이상,2018,47579,20071,27508,73,47136,19877,27259,72.9
11140, 마포구,086,85세이상,2018,3727,1239,2488,49.8,3699,1229,2470,49.8
11140, 마포구,126,평균연령,2018,40.7,40.1,41.3,,40.9,40.2,41.6,
11140, 마포구,127,중위연령,2018,39.6,39.4,39.9,,40,39.6,40.5,
11150, 양천구,000,합계,2018,445591,218975,226616,96.6,439910,216381,223529,96.8
11150, 양천구,005,0~4세,2018,14539,7394,7145,103.5,14426,7342,7084,103.6
11150, 양천구,005001, 0세,2018,2323,1168,1155,101.1,2299,1156,1143,101.1
11150, 양천구,005002, 1세,2018,2757,1414,1343,105.3,2731,1401,1330,105.3
11150, 양천구,005003, 2세,2018,3027,1509,1518,99.4,2999,1498,1501,99.8
11150, 양천구,005004, 3세,2018,3125,1629,1496,108.9,3109,1621,1488,108.9
11150, 양천구,005005, 4세,2018,3307,1674,1633,102.5,3288,1666,1622,102.7
11150, 양천구,010,5~9세,2018,19416,10061,9355,107.5,19349,10028,9321,107.6
11150, 양천구,010001, 5세,2018,3439,1798,1641,109.6,3424,1790,1634,109.5
11150, 양천구,010002, 6세,2018,3825,1944,1881,103.3,3809,1936,1873,103.4
11150, 양천구,010003, 7세,2018,3999,2075,1924,107.8,3986,2071,1915,108.1
11150, 양천구,010004, 8세,2018,4067,2094,1973,106.1,4054,2087,1967,106.1
11150, 양천구,010005, 9세,2018,4086,2150,1936,111.1,4076,2144,1932,111
11150, 양천구,015,10~14세,2018,24014,12552,11462,109.5,23972,12525,11447,109.4
11150, 양천구,015001, 10세,2018,4572,2346,2226,105.4,4558,2339,2219,105.4
11150, 양천구,015002, 11세,2018,4835,2508,2327,107.8,4828,2503,2325,107.7
11150, 양천구,015003, 12세,2018,4591,2384,2207,108,4586,2379,2207,107.8
11150, 양천구,015004, 13세,2018,4796,2535,2261,112.1,4789,2531,2258,112.1
11150, 양천구,015005, 14세,2018,5220,2779,2441,113.8,5211,2773,2438,113.7
11150, 양천구,020,15~19세,2018,27484,14310,13174,108.6,27400,14272,13128,108.7
11150, 양천구,020001, 15세,2018,5196,2673,2523,105.9,5190,2672,2518,106.1
11150, 양천구,020002, 16세,2018,5203,2707,2496,108.5,5195,2703,2492,108.5
11150, 양천구,020003, 17세,2018,5799,3030,2769,109.4,5788,3024,2764,109.4
11150, 양천구,020004, 18세,2018,5899,3095,2804,110.4,5884,3087,2797,110.4
11150, 양천구,020005, 19세,2018,5387,2805,2582,108.6,5343,2786,2557,109
11150, 양천구,025,20~24세,2018,28227,14732,13495,109.2,27928,14614,13314,109.8
11150, 양천구,025001, 20세,2018,5288,2802,2486,112.7,5255,2787,2468,112.9
11150, 양천구,025002, 21세,2018,5607,3049,2558,119.2,5567,3027,2540,119.2
11150, 양천구,025003, 22세,2018,5690,3019,2671,113,5634,3002,2632,114.1
11150, 양천구,025004, 23세,2018,5743,2937,2806,104.7,5668,2912,2756,105.7
11150, 양천구,025005, 24세,2018,5899,2925,2974,98.4,5804,2886,2918,98.9
11150, 양천구,030,25~29세,2018,28660,14255,14405,99,28077,13999,14078,99.4
11150, 양천구,030001, 25세,2018,5935,2969,2966,100.1,5838,2929,2909,100.7
11150, 양천구,030002, 26세,2018,5964,2974,2990,99.5,5853,2931,2922,100.3
11150, 양천구,030003, 27세,2018,5893,2903,2990,97.1,5784,2857,2927,97.6
11150, 양천구,030004, 28세,2018,5483,2810,2673,105.1,5362,2750,2612,105.3
11150, 양천구,030005, 29세,2018,5385,2599,2786,93.3,5240,2532,2708,93.5
11150, 양천구,035,30~34세,2018,27097,13486,13611,99.1,26359,13152,13207,99.6
11150, 양천구,035001, 30세,2018,5298,2633,2665,98.8,5149,2573,2576,99.9
11150, 양천구,035002, 31세,2018,5223,2540,2683,94.7,5066,2460,2606,94.4
11150, 양천구,035003, 32세,2018,5369,2683,2686,99.9,5210,2613,2597,100.6
11150, 양천구,035004, 33세,2018,5401,2690,2711,99.2,5280,2631,2649,99.3
11150, 양천구,035005, 34세,2018,5806,2940,2866,102.6,5654,2875,2779,103.5
11150, 양천구,040,35~39세,2018,33683,16551,17132,96.6,33133,16276,16857,96.6
11150, 양천구,040001, 35세,2018,6294,3163,3131,101,6177,3104,3073,101
11150, 양천구,040002, 36세,2018,6776,3341,3435,97.3,6657,3282,3375,97.2
11150, 양천구,040003, 37세,2018,6777,3347,3430,97.6,6681,3295,3386,97.3
11150, 양천구,040004, 38세,2018,6983,3431,3552,96.6,6872,3368,3504,96.1
11150, 양천구,040005, 39세,2018,6853,3269,3584,91.2,6746,3227,3519,91.7
11150, 양천구,045,40~44세,2018,35517,16770,18747,89.5,35009,16534,18475,89.5
11150, 양천구,045001, 40세,2018,6362,2970,3392,87.6,6260,2928,3332,87.9
11150, 양천구,045002, 41세,2018,6695,3133,3562,88,6596,3091,3505,88.2
11150, 양천구,045003, 42세,2018,6855,3280,3575,91.7,6752,3230,3522,91.7
11150, 양천구,045004, 43세,2018,7353,3410,3943,86.5,7265,3367,3898,86.4
11150, 양천구,045005, 44세,2018,8252,3977,4275,93,8136,3918,4218,92.9
11150, 양천구,050,45~49세,2018,44723,21627,23096,93.6,44127,21334,22793,93.6
11150, 양천구,050001, 45세,2018,8453,3966,4487,88.4,8345,3912,4433,88.2
11150, 양천구,050002, 46세,2018,8678,4117,4561,90.3,8552,4053,4499,90.1
11150, 양천구,050003, 47세,2018,9426,4613,4813,95.8,9306,4553,4753,95.8
11150, 양천구,050004, 48세,2018,9093,4411,4682,94.2,8963,4352,4611,94.4
11150, 양천구,050005, 49세,2018,9073,4520,4553,99.3,8961,4464,4497,99.3
11150, 양천구,055,50~54세,2018,39002,19356,19646,98.5,38379,19078,19301,98.8
11150, 양천구,055001, 50세,2018,8636,4277,4359,98.1,8520,4223,4297,98.3
11150, 양천구,055002, 51세,2018,7891,3866,4025,96,7775,3810,3965,96.1
11150, 양천구,055003, 52세,2018,7546,3801,3745,101.5,7429,3757,3672,102.3
11150, 양천구,055004, 53세,2018,7705,3781,3924,96.4,7564,3713,3851,96.4
11150, 양천구,055005, 54세,2018,7224,3631,3593,101.1,7091,3575,3516,101.7
11150, 양천구,060,55~59세,2018,37226,18354,18872,97.3,36659,18084,18575,97.4
11150, 양천구,060001, 55세,2018,7448,3741,3707,100.9,7292,3677,3615,101.7
11150, 양천구,060002, 56세,2018,7410,3748,3662,102.3,7296,3684,3612,102
11150, 양천구,060003, 57세,2018,7705,3754,3951,95,7629,3718,3911,95.1
11150, 양천구,060004, 58세,2018,7702,3746,3956,94.7,7575,3688,3887,94.9
11150, 양천구,060005, 59세,2018,6961,3365,3596,93.6,6867,3317,3550,93.4
11150, 양천구,065,60~64세,2018,30358,14610,15748,92.8,29872,14387,15485,92.9
11150, 양천구,065001, 60세,2018,6618,3179,3439,92.4,6510,3129,3381,92.5
11150, 양천구,065002, 61세,2018,6416,3094,3322,93.1,6317,3056,3261,93.7
11150, 양천구,065003, 62세,2018,5936,2819,3117,90.4,5839,2774,3065,90.5
11150, 양천구,065004, 63세,2018,6273,3007,3266,92.1,6181,2961,3220,92
11150, 양천구,065005, 64세,2018,5115,2511,2604,96.4,5025,2467,2558,96.4
11150, 양천구,070,65~69세,2018,20467,9985,10482,95.3,20225,9884,10341,95.6
11150, 양천구,070001, 65세,2018,4547,2195,2352,93.3,4493,2173,2320,93.7
11150, 양천구,070002, 66세,2018,4862,2358,2504,94.2,4800,2330,2470,94.3
11150, 양천구,070003, 67세,2018,3468,1701,1767,96.3,3422,1684,1738,96.9
11150, 양천구,070004, 68세,2018,3870,1933,1937,99.8,3829,1913,1916,99.8
11150, 양천구,070005, 69세,2018,3720,1798,1922,93.5,3681,1784,1897,94
11150, 양천구,075,70~74세,2018,14496,6944,7552,91.9,14408,6909,7499,92.1
11150, 양천구,075001, 70세,2018,3573,1745,1828,95.5,3548,1737,1811,95.9
11150, 양천구,075002, 71세,2018,3462,1676,1786,93.8,3439,1665,1774,93.9
11150, 양천구,075003, 72세,2018,2632,1262,1370,92.1,2613,1253,1360,92.1
11150, 양천구,075004, 73세,2018,2416,1141,1275,89.5,2406,1138,1268,89.7
11150, 양천구,075005, 74세,2018,2413,1120,1293,86.6,2402,1116,1286,86.8
11150, 양천구,080,75~79세,2018,10468,4663,5805,80.3,10423,4651,5772,80.6
11150, 양천구,080001, 75세,2018,2357,1125,1232,91.3,2345,1122,1223,91.7
11150, 양천구,080002, 76세,2018,2555,1144,1411,81.1,2547,1143,1404,81.4
11150, 양천구,080003, 77세,2018,2068,951,1117,85.1,2060,949,1111,85.4
11150, 양천구,080004, 78세,2018,1774,734,1040,70.6,1766,732,1034,70.8
11150, 양천구,080005, 79세,2018,1714,709,1005,70.5,1705,705,1000,70.5
11150, 양천구,085,80~84세,2018,6123,2209,3914,56.4,6086,2200,3886,56.6
11150, 양천구,085001, 80세,2018,1501,623,878,71,1492,620,872,71.1
11150, 양천구,085002, 81세,2018,1419,507,912,55.6,1412,505,907,55.7
11150, 양천구,085003, 82세,2018,1208,422,786,53.7,1198,419,779,53.8
11150, 양천구,085004, 83세,2018,1089,365,724,50.4,1081,364,717,50.8
11150, 양천구,085005, 84세,2018,906,292,614,47.6,903,292,611,47.8
11150, 양천구,090,85~89세,2018,2884,829,2055,40.3,2874,826,2048,40.3
11150, 양천구,090001, 85세,2018,800,257,543,47.3,797,256,541,47.3
11150, 양천구,090002, 86세,2018,681,201,480,41.9,679,201,478,42.1
11150, 양천구,090003, 87세,2018,520,137,383,35.8,517,135,382,35.3
11150, 양천구,090004, 88세,2018,488,114,374,30.5,487,114,373,30.6
11150, 양천구,090005, 89세,2018,395,120,275,43.6,394,120,274,43.8
11150, 양천구,095,90~94세,2018,935,223,712,31.3,932,222,710,31.3
11150, 양천구,095001, 90세,2018,316,89,227,39.2,314,88,226,38.9
11150, 양천구,095002, 91세,2018,220,61,159,38.4,220,61,159,38.4
11150, 양천구,095003, 92세,2018,173,29,144,20.1,172,29,143,20.3
11150, 양천구,095004, 93세,2018,150,32,118,27.1,150,32,118,27.1
11150, 양천구,095005, 94세,2018,76,12,64,18.8,76,12,64,18.8
11150, 양천구,100,95~99세,2018,248,61,187,32.6,248,61,187,32.6
11150, 양천구,100001, 95세,2018,115,30,85,35.3,115,30,85,35.3
11150, 양천구,100002, 96세,2018,62,9,53,17,62,9,53,17
11150, 양천구,100003, 97세,2018,30,9,21,42.9,30,9,21,42.9
11150, 양천구,100004, 98세,2018,23,6,17,35.3,23,6,17,35.3
11150, 양천구,100005, 99세,2018,18,7,11,63.6,18,7,11,63.6
11150, 양천구,101,100세이상,2018,24,X,21,14.3,24,X,21,14.3
11150, 양천구,102,15세미만,2018,57969,30007,27962,107.3,57747,29895,27852,107.3
11150, 양천구,103,15~64세,2018,331977,164051,167926,97.7,326943,161730,165213,97.9
11150, 양천구,104,65세이상,2018,55645,24917,30728,81.1,55220,24756,30464,81.3
11150, 양천구,086,85세이상,2018,4091,1116,2975,37.5,4078,1112,2966,37.5
11150, 양천구,126,평균연령,2018,41.2,40.3,42.1,,41.2,40.3,42,
11150, 양천구,127,중위연령,2018,43,42,43.8,,43,42,43.8,
11160, 강서구,000,합계,2018,578539,280629,297910,94.2,569360,276282,293078,94.3
11160, 강서구,005,0~4세,2018,23315,11893,11422,104.1,23078,11775,11303,104.2
11160, 강서구,005001, 0세,2018,4233,2166,2067,104.8,4188,2144,2044,104.9
11160, 강서구,005002, 1세,2018,4387,2258,2129,106.1,4331,2230,2101,106.1
11160, 강서구,005003, 2세,2018,5000,2576,2424,106.3,4946,2551,2395,106.5
11160, 강서구,005004, 3세,2018,4924,2475,2449,101.1,4881,2452,2429,100.9
11160, 강서구,005005, 4세,2018,4771,2418,2353,102.8,4732,2398,2334,102.7
11160, 강서구,010,5~9세,2018,22764,11674,11090,105.3,22650,11620,11030,105.3
11160, 강서구,010001, 5세,2018,4740,2399,2341,102.5,4712,2388,2324,102.8
11160, 강서구,010002, 6세,2018,5011,2565,2446,104.9,4987,2555,2432,105.1
11160, 강서구,010003, 7세,2018,4610,2366,2244,105.4,4590,2355,2235,105.4
11160, 강서구,010004, 8세,2018,4318,2220,2098,105.8,4298,2211,2087,105.9
11160, 강서구,010005, 9세,2018,4085,2124,1961,108.3,4063,2111,1952,108.1
11160, 강서구,015,10~14세,2018,21486,10956,10530,104,21428,10930,10498,104.1
11160, 강서구,015001, 10세,2018,4501,2272,2229,101.9,4479,2261,2218,101.9
11160, 강서구,015002, 11세,2018,4449,2278,2171,104.9,4439,2274,2165,105
11160, 강서구,015003, 12세,2018,4081,2098,1983,105.8,4069,2094,1975,106
11160, 강서구,015004, 13세,2018,4003,2034,1969,103.3,3995,2031,1964,103.4
11160, 강서구,015005, 14세,2018,4452,2274,2178,104.4,4446,2270,2176,104.3
11160, 강서구,020,15~19세,2018,25321,12791,12530,102.1,25190,12729,12461,102.2
11160, 강서구,020001, 15세,2018,4519,2296,2223,103.3,4510,2293,2217,103.4
11160, 강서구,020002, 16세,2018,4648,2366,2282,103.7,4632,2358,2274,103.7
11160, 강서구,020003, 17세,2018,5351,2677,2674,100.1,5333,2671,2662,100.3
11160, 강서구,020004, 18세,2018,5780,2868,2912,98.5,5747,2859,2888,99
11160, 강서구,020005, 19세,2018,5023,2584,2439,105.9,4968,2548,2420,105.3
11160, 강서구,025,20~24세,2018,34105,16590,17515,94.7,33659,16395,17264,95
11160, 강서구,025001, 20세,2018,5622,2945,2677,110,5565,2916,2649,110.1
11160, 강서구,025002, 21세,2018,6314,3198,3116,102.6,6262,3173,3089,102.7
11160, 강서구,025003, 22세,2018,6671,3334,3337,99.9,6583,3286,3297,99.7
11160, 강서구,025004, 23세,2018,7439,3508,3931,89.2,7324,3459,3865,89.5
11160, 강서구,025005, 24세,2018,8059,3605,4454,80.9,7925,3561,4364,81.6
11160, 강서구,030,25~29세,2018,48326,22579,25747,87.7,47225,22093,25132,87.9
11160, 강서구,030001, 25세,2018,8982,4099,4883,83.9,8784,4015,4769,84.2
11160, 강서구,030002, 26세,2018,9766,4460,5306,84.1,9597,4385,5212,84.1
11160, 강서구,030003, 27세,2018,9956,4595,5361,85.7,9736,4505,5231,86.1
11160, 강서구,030004, 28세,2018,9916,4730,5186,91.2,9646,4596,5050,91
11160, 강서구,030005, 29세,2018,9706,4695,5011,93.7,9462,4592,4870,94.3
11160, 강서구,035,30~34세,2018,50103,25012,25091,99.7,48740,24379,24361,100.1
11160, 강서구,035001, 30세,2018,9859,4771,5088,93.8,9601,4647,4954,93.8
11160, 강서구,035002, 31세,2018,9815,4835,4980,97.1,9518,4696,4822,97.4
11160, 강서구,035003, 32세,2018,10094,5022,5072,99,9813,4914,4899,100.3
11160, 강서구,035004, 33세,2018,10131,5176,4955,104.5,9857,5034,4823,104.4
11160, 강서구,035005, 34세,2018,10204,5208,4996,104.2,9951,5088,4863,104.6
11160, 강서구,040,35~39세,2018,54561,28126,26435,106.4,53571,27651,25920,106.7
11160, 강서구,040001, 35세,2018,11024,5683,5341,106.4,10801,5578,5223,106.8
11160, 강서구,040002, 36세,2018,11361,5791,5570,104,11148,5681,5467,103.9
11160, 강서구,040003, 37세,2018,11015,5811,5204,111.7,10820,5720,5100,112.2
11160, 강서구,040004, 38세,2018,10926,5558,5368,103.5,10745,5476,5269,103.9
11160, 강서구,040005, 39세,2018,10235,5283,4952,106.7,10057,5196,4861,106.9
11160, 강서구,045,40~44세,2018,44626,22495,22131,101.6,43942,22115,21827,101.3
11160, 강서구,045001, 40세,2018,8802,4496,4306,104.4,8644,4403,4241,103.8
11160, 강서구,045002, 41세,2018,8948,4520,4428,102.1,8813,4442,4371,101.6
11160, 강서구,045003, 42세,2018,8495,4291,4204,102.1,8355,4206,4149,101.4
11160, 강서구,045004, 43세,2018,8823,4445,4378,101.5,8693,4385,4308,101.8
11160, 강서구,045005, 44세,2018,9558,4743,4815,98.5,9437,4679,4758,98.3
11160, 강서구,050,45~49세,2018,46473,23186,23287,99.6,45653,22773,22880,99.5
11160, 강서구,050001, 45세,2018,9481,4835,4646,104.1,9320,4751,4569,104
11160, 강서구,050002, 46세,2018,9254,4652,4602,101.1,9093,4577,4516,101.4
11160, 강서구,050003, 47세,2018,9536,4734,4802,98.6,9374,4639,4735,98
11160, 강서구,050004, 48세,2018,9096,4465,4631,96.4,8913,4370,4543,96.2
11160, 강서구,050005, 49세,2018,9106,4500,4606,97.7,8953,4436,4517,98.2
11160, 강서구,055,50~54세,2018,42051,19982,22069,90.5,41148,19552,21596,90.5
11160, 강서구,055001, 50세,2018,8972,4324,4648,93,8814,4249,4565,93.1
11160, 강서구,055002, 51세,2018,8192,3888,4304,90.3,8050,3818,4232,90.2
11160, 강서구,055003, 52세,2018,8118,3868,4250,91,7928,3785,4143,91.4
11160, 강서구,055004, 53세,2018,8604,4083,4521,90.3,8402,3980,4422,90
11160, 강서구,055005, 54세,2018,8165,3819,4346,87.9,7954,3720,4234,87.9
11160, 강서구,060,55~59세,2018,47518,22305,25213,88.5,46587,21846,24741,88.3
11160, 강서구,060001, 55세,2018,8875,4210,4665,90.2,8632,4097,4535,90.3
11160, 강서구,060002, 56세,2018,9156,4364,4792,91.1,8936,4256,4680,90.9
11160, 강서구,060003, 57세,2018,10038,4670,5368,87,9910,4602,5308,86.7
11160, 강서구,060004, 58세,2018,10041,4619,5422,85.2,9859,4525,5334,84.8
11160, 강서구,060005, 59세,2018,9408,4442,4966,89.4,9250,4366,4884,89.4
11160, 강서구,065,60~64세,2018,41245,19025,22220,85.6,40451,18665,21786,85.7
11160, 강서구,065001, 60세,2018,8844,4119,4725,87.2,8681,4049,4632,87.4
11160, 강서구,065002, 61세,2018,8973,4191,4782,87.6,8787,4104,4683,87.6
11160, 강서구,065003, 62세,2018,8009,3696,4313,85.7,7853,3622,4231,85.6
11160, 강서구,065004, 63세,2018,8486,3810,4676,81.5,8332,3740,4592,81.4
11160, 강서구,065005, 64세,2018,6933,3209,3724,86.2,6798,3150,3648,86.3
11160, 강서구,070,65~69세,2018,28015,13364,14651,91.2,27655,13192,14463,91.2
11160, 강서구,070001, 65세,2018,6279,3006,3273,91.8,6175,2950,3225,91.5
11160, 강서구,070002, 66세,2018,6578,3127,3451,90.6,6499,3090,3409,90.6
11160, 강서구,070003, 67세,2018,4644,2226,2418,92.1,4576,2196,2380,92.3
11160, 강서구,070004, 68세,2018,5265,2506,2759,90.8,5203,2476,2727,90.8
11160, 강서구,070005, 69세,2018,5249,2499,2750,90.9,5202,2480,2722,91.1
11160, 강서구,075,70~74세,2018,20283,9852,10431,94.4,20173,9807,10366,94.6
11160, 강서구,075001, 70세,2018,4924,2397,2527,94.9,4901,2385,2516,94.8
11160, 강서구,075002, 71세,2018,4971,2401,2570,93.4,4944,2390,2554,93.6
11160, 강서구,075003, 72세,2018,3667,1788,1879,95.2,3648,1780,1868,95.3
11160, 강서구,075004, 73세,2018,3449,1675,1774,94.4,3426,1667,1759,94.8
11160, 강서구,075005, 74세,2018,3272,1591,1681,94.6,3254,1585,1669,95
11160, 강서구,080,75~79세,2018,14312,6264,8048,77.8,14242,6244,7998,78.1
11160, 강서구,080001, 75세,2018,3094,1409,1685,83.6,3081,1405,1676,83.8
11160, 강서구,080002, 76세,2018,3536,1633,1903,85.8,3521,1630,1891,86.2
11160, 강서구,080003, 77세,2018,2728,1166,1562,74.6,2721,1163,1558,74.6
11160, 강서구,080004, 78세,2018,2541,1104,1437,76.8,2524,1098,1426,77
11160, 강서구,080005, 79세,2018,2413,952,1461,65.2,2395,948,1447,65.5
11160, 강서구,085,80~84세,2018,8205,2945,5260,56,8167,2932,5235,56
11160, 강서구,085001, 80세,2018,2048,811,1237,65.6,2042,809,1233,65.6
11160, 강서구,085002, 81세,2018,1797,634,1163,54.5,1788,632,1156,54.7
11160, 강서구,085003, 82세,2018,1566,555,1011,54.9,1556,551,1005,54.8
11160, 강서구,085004, 83세,2018,1565,544,1021,53.3,1559,541,1018,53.1
11160, 강서구,085005, 84세,2018,1229,401,828,48.4,1222,399,823,48.5
11160, 강서구,090,85~89세,2018,4040,1182,2858,41.4,4014,1176,2838,41.4
11160, 강서구,090001, 85세,2018,1078,363,715,50.8,1069,361,708,51
11160, 강서구,090002, 86세,2018,919,276,643,42.9,914,276,638,43.3
11160, 강서구,090003, 87세,2018,738,204,534,38.2,730,201,529,38
11160, 강서구,090004, 88세,2018,715,190,525,36.2,712,189,523,36.1
11160, 강서구,090005, 89세,2018,590,149,441,33.8,589,149,440,33.9
11160, 강서구,095,90~94세,2018,1440,325,1115,29.1,1437,325,1112,29.2
11160, 강서구,095001, 90세,2018,470,98,372,26.3,469,98,371,26.4
11160, 강서구,095002, 91세,2018,363,86,277,31,363,86,277,31
11160, 강서구,095003, 92세,2018,241,50,191,26.2,240,50,190,26.3
11160, 강서구,095004, 93세,2018,200,45,155,29,200,45,155,29
11160, 강서구,095005, 94세,2018,166,46,120,38.3,165,46,119,38.7
11160, 강서구,100,95~99세,2018,314,76,238,31.9,314,76,238,31.9
11160, 강서구,100001, 95세,2018,113,25,88,28.4,113,25,88,28.4
11160, 강서구,100002, 96세,2018,91,21,70,30,91,21,70,30
11160, 강서구,100003, 97세,2018,50,15,35,42.9,50,15,35,42.9
11160, 강서구,100004, 98세,2018,35,11,24,45.8,35,11,24,45.8
11160, 강서구,100005, 99세,2018,25,X,21,19,25,X,21,19
11160, 강서구,101,100세이상,2018,36,7,29,24.1,36,7,29,24.1
11160, 강서구,102,15세미만,2018,67565,34523,33042,104.5,67156,34325,32831,104.6
11160, 강서구,103,15~64세,2018,434329,212091,222238,95.4,426166,208198,217968,95.5
11160, 강서구,104,65세이상,2018,76645,34015,42630,79.8,76038,33759,42279,79.8
11160, 강서구,086,85세이상,2018,5830,1590,4240,37.5,5801,1584,4217,37.6
11160, 강서구,126,평균연령,2018,41.5,40.6,42.3,,41.5,40.6,42.3,
11160, 강서구,127,중위연령,2018,41.1,40.2,42,,41.1,40.1,42,
11170, 구로구,000,합계,2018,433765,217086,216679,100.2,388079,192022,196057,97.9
11170, 구로구,005,0~4세,2018,16126,8256,7870,104.9,15006,7686,7320,105
11170, 구로구,005001, 0세,2018,2911,1498,1413,106,2691,1396,1295,107.8
11170, 구로구,005002, 1세,2018,3094,1586,1508,105.2,2827,1449,1378,105.2
11170, 구로구,005003, 2세,2018,3342,1740,1602,108.6,3093,1603,1490,107.6
11170, 구로구,005004, 3세,2018,3465,1727,1738,99.4,3261,1630,1631,99.9
11170, 구로구,005005, 4세,2018,3314,1705,1609,106,3134,1608,1526,105.4
11170, 구로구,010,5~9세,2018,16501,8336,8165,102.1,15872,8009,7863,101.9
11170, 구로구,010001, 5세,2018,3415,1727,1688,102.3,3238,1634,1604,101.9
11170, 구로구,010002, 6세,2018,3488,1752,1736,100.9,3339,1672,1667,100.3
11170, 구로구,010003, 7세,2018,3314,1672,1642,101.8,3205,1617,1588,101.8
11170, 구로구,010004, 8세,2018,3244,1662,1582,105.1,3141,1605,1536,104.5
11170, 구로구,010005, 9세,2018,3040,1523,1517,100.4,2949,1481,1468,100.9
11170, 구로구,015,10~14세,2018,14507,7485,7022,106.6,14133,7296,6837,106.7
11170, 구로구,015001, 10세,2018,3097,1560,1537,101.5,3009,1514,1495,101.3
11170, 구로구,015002, 11세,2018,3126,1563,1563,100,3019,1516,1503,100.9
11170, 구로구,015003, 12세,2018,2808,1471,1337,110,2750,1447,1303,111.1
11170, 구로구,015004, 13세,2018,2610,1407,1203,117,2550,1370,1180,116.1
11170, 구로구,015005, 14세,2018,2866,1484,1382,107.4,2805,1449,1356,106.9
11170, 구로구,020,15~19세,2018,17335,9052,8283,109.3,16965,8843,8122,108.9
11170, 구로구,020001, 15세,2018,2913,1479,1434,103.1,2867,1457,1410,103.3
11170, 구로구,020002, 16세,2018,3172,1663,1509,110.2,3126,1632,1494,109.2
11170, 구로구,020003, 17세,2018,3612,1966,1646,119.4,3552,1928,1624,118.7
11170, 구로구,020004, 18세,2018,3950,2060,1890,109,3846,2004,1842,108.8
11170, 구로구,020005, 19세,2018,3688,1884,1804,104.4,3574,1822,1752,104
11170, 구로구,025,20~24세,2018,24331,12196,12135,100.5,22920,11521,11399,101.1
11170, 구로구,025001, 20세,2018,4048,2141,1907,112.3,3845,2045,1800,113.6
11170, 구로구,025002, 21세,2018,4478,2306,2172,106.2,4231,2182,2049,106.5
11170, 구로구,025003, 22세,2018,4768,2400,2368,101.4,4529,2272,2257,100.7
11170, 구로구,025004, 23세,2018,5269,2504,2765,90.6,4947,2370,2577,92
11170, 구로구,025005, 24세,2018,5768,2845,2923,97.3,5368,2652,2716,97.6
11170, 구로구,030,25~29세,2018,32249,15887,16362,97.1,28832,14116,14716,95.9
11170, 구로구,030001, 25세,2018,6070,2926,3144,93.1,5645,2726,2919,93.4
11170, 구로구,030002, 26세,2018,6498,3172,3326,95.4,5897,2864,3033,94.4
11170, 구로구,030003, 27세,2018,6638,3259,3379,96.4,5943,2889,3054,94.6
11170, 구로구,030004, 28세,2018,6572,3266,3306,98.8,5740,2829,2911,97.2
11170, 구로구,030005, 29세,2018,6471,3264,3207,101.8,5607,2808,2799,100.3
11170, 구로구,035,30~34세,2018,33747,17165,16582,103.5,29088,14633,14455,101.2
11170, 구로구,035001, 30세,2018,6594,3279,3315,98.9,5643,2787,2856,97.6
11170, 구로구,035002, 31세,2018,6817,3396,3421,99.3,5792,2872,2920,98.4
11170, 구로구,035003, 32세,2018,6676,3419,3257,105,5674,2867,2807,102.1
11170, 구로구,035004, 33세,2018,6659,3446,3213,107.3,5827,2979,2848,104.6
11170, 구로구,035005, 34세,2018,7001,3625,3376,107.4,6152,3128,3024,103.4
11170, 구로구,040,35~39세,2018,37834,19855,17979,110.4,34130,17579,16551,106.2
11170, 구로구,040001, 35세,2018,7499,3949,3550,111.2,6664,3455,3209,107.7
11170, 구로구,040002, 36세,2018,7831,4075,3756,108.5,6982,3566,3416,104.4
11170, 구로구,040003, 37세,2018,7608,3974,3634,109.4,6979,3587,3392,105.7
11170, 구로구,040004, 38세,2018,7577,3951,3626,109,6929,3556,3373,105.4
11170, 구로구,040005, 39세,2018,7319,3906,3413,114.4,6576,3415,3161,108
11170, 구로구,045,40~44세,2018,33242,17648,15594,113.2,29886,15485,14401,107.5
11170, 구로구,045001, 40세,2018,6550,3458,3092,111.8,5859,3035,2824,107.5
11170, 구로구,045002, 41세,2018,6592,3541,3051,116.1,5959,3126,2833,110.3
11170, 구로구,045003, 42세,2018,6544,3449,3095,111.4,5888,3020,2868,105.3
11170, 구로구,045004, 43세,2018,6443,3436,3007,114.3,5792,3007,2785,108
11170, 구로구,045005, 44세,2018,7113,3764,3349,112.4,6388,3297,3091,106.7
11170, 구로구,050,45~49세,2018,37104,19372,17732,109.2,31901,16282,15619,104.2
11170, 구로구,050001, 45세,2018,7376,3943,3433,114.9,6468,3355,3113,107.8
11170, 구로구,050002, 46세,2018,7206,3855,3351,115,6274,3285,2989,109.9
11170, 구로구,050003, 47세,2018,7628,3957,3671,107.8,6555,3369,3186,105.7
11170, 구로구,050004, 48세,2018,7483,3846,3637,105.7,6310,3164,3146,100.6
11170, 구로구,050005, 49세,2018,7411,3771,3640,103.6,6294,3109,3185,97.6
11170, 구로구,055,50~54세,2018,35541,17938,17603,101.9,29271,14417,14854,97.1
11170, 구로구,055001, 50세,2018,7297,3576,3721,96.1,6146,2930,3216,91.1
11170, 구로구,055002, 51세,2018,6848,3491,3357,104,5852,2928,2924,100.1
11170, 구로구,055003, 52세,2018,6834,3511,3323,105.7,5646,2803,2843,98.6
11170, 구로구,055004, 53세,2018,7375,3741,3634,102.9,5929,2945,2984,98.7
11170, 구로구,055005, 54세,2018,7187,3619,3568,101.4,5698,2811,2887,97.4
11170, 구로구,060,55~59세,2018,38464,18799,19665,95.6,32213,15461,16752,92.3
11170, 구로구,060001, 55세,2018,7677,3799,3878,98,5924,2876,3048,94.4
11170, 구로구,060002, 56세,2018,7660,3836,3824,100.3,6293,3111,3182,97.8
11170, 구로구,060003, 57세,2018,7566,3693,3873,95.4,6768,3277,3491,93.9
11170, 구로구,060004, 58세,2018,8290,3972,4318,92,6947,3238,3709,87.3
11170, 구로구,060005, 59세,2018,7271,3499,3772,92.8,6281,2959,3322,89.1
11170, 구로구,065,60~64세,2018,34056,16367,17689,92.5,28764,13579,15185,89.4
11170, 구로구,065001, 60세,2018,7277,3569,3708,96.3,6101,2950,3151,93.6
11170, 구로구,065002, 61세,2018,7309,3531,3778,93.5,6040,2842,3198,88.9
11170, 구로구,065003, 62세,2018,6701,3150,3551,88.7,5658,2621,3037,86.3
11170, 구로구,065004, 63세,2018,6874,3325,3549,93.7,5925,2804,3121,89.8
11170, 구로구,065005, 64세,2018,5895,2792,3103,90,5040,2362,2678,88.2
11170, 구로구,070,65~69세,2018,23267,11176,12091,92.4,20975,9985,10990,90.9
11170, 구로구,070001, 65세,2018,5272,2515,2757,91.2,4604,2151,2453,87.7
11170, 구로구,070002, 66세,2018,5235,2507,2728,91.9,4702,2229,2473,90.1
11170, 구로구,070003, 67세,2018,3994,1928,2066,93.3,3576,1720,1856,92.7
11170, 구로구,070004, 68세,2018,4431,2142,2289,93.6,4057,1948,2109,92.4
11170, 구로구,070005, 69세,2018,4335,2084,2251,92.6,4036,1937,2099,92.3
11170, 구로구,075,70~74세,2018,16780,8163,8617,94.7,16131,7897,8234,95.9
11170, 구로구,075001, 70세,2018,3995,1977,2018,98,3798,1888,1910,98.8
11170, 구로구,075002, 71세,2018,4117,2037,2080,97.9,3944,1959,1985,98.7
11170, 구로구,075003, 72세,2018,3016,1436,1580,90.9,2895,1388,1507,92.1
11170, 구로구,075004, 73세,2018,2873,1375,1498,91.8,2793,1349,1444,93.4
11170, 구로구,075005, 74세,2018,2779,1338,1441,92.9,2701,1313,1388,94.6
11170, 구로구,080,75~79세,2018,12293,5644,6649,84.9,11915,5553,6362,87.3
11170, 구로구,080001, 75세,2018,2771,1309,1462,89.5,2687,1289,1398,92.2
11170, 구로구,080002, 76세,2018,3101,1460,1641,89,3021,1439,1582,91
11170, 구로구,080003, 77세,2018,2325,1092,1233,88.6,2253,1073,1180,90.9
11170, 구로구,080004, 78세,2018,2098,902,1196,75.4,2019,887,1132,78.4
11170, 구로구,080005, 79세,2018,1998,881,1117,78.9,1935,865,1070,80.8
11170, 구로구,085,80~84세,2018,6651,2661,3990,66.7,6429,2611,3818,68.4
11170, 구로구,085001, 80세,2018,1813,776,1037,74.8,1749,756,993,76.1
11170, 구로구,085002, 81세,2018,1457,609,848,71.8,1409,602,807,74.6
11170, 구로구,085003, 82세,2018,1284,523,761,68.7,1237,513,724,70.9
11170, 구로구,085004, 83세,2018,1184,436,748,58.3,1150,427,723,59.1
11170, 구로구,085005, 84세,2018,913,317,596,53.2,884,313,571,54.8
11170, 구로구,090,85~89세,2018,2661,860,1801,47.8,2592,848,1744,48.6
11170, 구로구,090001, 85세,2018,780,299,481,62.2,762,292,470,62.1
11170, 구로구,090002, 86세,2018,629,204,425,48,609,200,409,48.9
11170, 구로구,090003, 87세,2018,468,138,330,41.8,455,137,318,43.1
11170, 구로구,090004, 88세,2018,436,116,320,36.3,426,116,310,37.4
11170, 구로구,090005, 89세,2018,348,103,245,42,340,103,237,43.5
11170, 구로구,095,90~94세,2018,862,181,681,26.6,844,176,668,26.3
11170, 구로구,095001, 90세,2018,294,59,235,25.1,288,56,232,24.1
11170, 구로구,095002, 91세,2018,216,51,165,30.9,211,50,161,31.1
11170, 구로구,095003, 92세,2018,166,34,132,25.8,162,33,129,25.6
11170, 구로구,095004, 93세,2018,106,17,89,19.1,105,17,88,19.3
11170, 구로구,095005, 94세,2018,80,20,60,33.3,78,20,58,34.5
11170, 구로구,100,95~99세,2018,199,43,156,27.6,197,43,154,27.9
11170, 구로구,100001, 95세,2018,81,19,62,30.6,80,19,61,31.1
11170, 구로구,100002, 96세,2018,55,11,44,25,55,11,44,25
11170, 구로구,100003, 97세,2018,33,5,28,17.9,32,5,27,18.5
11170, 구로구,100004, 98세,2018,24,7,17,41.2,24,7,17,41.2
11170, 구로구,100005, 99세,2018,6,X,5,20,6,X,5,20
11170, 구로구,101,100세이상,2018,15,X,13,15.4,15,X,13,15.4
11170, 구로구,102,15세미만,2018,47134,24077,23057,104.4,45011,22991,22020,104.4
11170, 구로구,103,15~64세,2018,323903,164279,159624,102.9,283970,141916,142054,99.9
11170, 구로구,104,65세이상,2018,62728,28730,33998,84.5,59098,27115,31983,84.8
11170, 구로구,086,85세이상,2018,3737,1086,2651,41,3648,1069,2579,41.5
11170, 구로구,126,평균연령,2018,42.9,42.2,43.5,,42.5,41.8,43.2,
11170, 구로구,127,중위연령,2018,43.7,43,44.5,,42.9,42.1,43.8,
11180, 금천구,000,합계,2018,249344,127278,122066,104.3,221820,112288,109532,102.5
11180, 금천구,005,0~4세,2018,7877,4068,3809,106.8,7152,3687,3465,106.4
11180, 금천구,005001, 0세,2018,1450,754,696,108.3,1300,673,627,107.3
11180, 금천구,005002, 1세,2018,1537,785,752,104.4,1378,701,677,103.5
11180, 금천구,005003, 2세,2018,1651,861,790,109,1475,765,710,107.7
11180, 금천구,005004, 3세,2018,1684,859,825,104.1,1562,793,769,103.1
11180, 금천구,005005, 4세,2018,1555,809,746,108.4,1437,755,682,110.7
11180, 금천구,010,5~9세,2018,7366,3744,3622,103.4,6970,3543,3427,103.4
11180, 금천구,010001, 5세,2018,1460,742,718,103.3,1368,692,676,102.4
11180, 금천구,010002, 6세,2018,1645,828,817,101.3,1545,779,766,101.7
11180, 금천구,010003, 7세,2018,1484,736,748,98.4,1399,694,705,98.4
11180, 금천구,010004, 8세,2018,1414,746,668,111.7,1351,712,639,111.4
11180, 금천구,010005, 9세,2018,1363,692,671,103.1,1307,666,641,103.9
11180, 금천구,015,10~14세,2018,7018,3587,3431,104.5,6839,3483,3356,103.8
11180, 금천구,015001, 10세,2018,1385,730,655,111.5,1334,700,634,110.4
11180, 금천구,015002, 11세,2018,1432,720,712,101.1,1393,696,697,99.9
11180, 금천구,015003, 12세,2018,1363,682,681,100.1,1334,666,668,99.7
11180, 금천구,015004, 13세,2018,1387,721,666,108.3,1350,697,653,106.7
11180, 금천구,015005, 14세,2018,1451,734,717,102.4,1428,724,704,102.8
11180, 금천구,020,15~19세,2018,9497,4799,4698,102.1,9334,4717,4617,102.2
11180, 금천구,020001, 15세,2018,1577,796,781,101.9,1553,785,768,102.2
11180, 금천구,020002, 16세,2018,1702,884,818,108.1,1681,875,806,108.6
11180, 금천구,020003, 17세,2018,1895,932,963,96.8,1878,921,957,96.2
11180, 금천구,020004, 18세,2018,2136,1056,1080,97.8,2097,1037,1060,97.8
11180, 금천구,020005, 19세,2018,2187,1131,1056,107.1,2125,1099,1026,107.1
11180, 금천구,025,20~24세,2018,14895,7548,7347,102.7,14178,7207,6971,103.4
11180, 금천구,025001, 20세,2018,2418,1272,1146,111,2342,1236,1106,111.8
11180, 금천구,025002, 21세,2018,2639,1373,1266,108.5,2537,1315,1222,107.6
11180, 금천구,025003, 22세,2018,3012,1517,1495,101.5,2844,1432,1412,101.4
11180, 금천구,025004, 23세,2018,3132,1555,1577,98.6,2969,1489,1480,100.6
11180, 금천구,025005, 24세,2018,3694,1831,1863,98.3,3486,1735,1751,99.1
11180, 금천구,030,25~29세,2018,21268,11212,10056,111.5,19179,10131,9048,112
11180, 금천구,030001, 25세,2018,4055,2065,1990,103.8,3767,1921,1846,104.1
11180, 금천구,030002, 26세,2018,4338,2262,2076,109,3986,2078,1908,108.9
11180, 금천구,030003, 27세,2018,4400,2350,2050,114.6,3975,2123,1852,114.6
11180, 금천구,030004, 28세,2018,4329,2324,2005,115.9,3802,2045,1757,116.4
11180, 금천구,030005, 29세,2018,4146,2211,1935,114.3,3649,1964,1685,116.6
11180, 금천구,035,30~34세,2018,19884,10955,8929,122.7,17051,9419,7632,123.4
11180, 금천구,035001, 30세,2018,3974,2162,1812,119.3,3377,1871,1506,124.2
11180, 금천구,035002, 31세,2018,4150,2261,1889,119.7,3543,1936,1607,120.5
11180, 금천구,035003, 32세,2018,4027,2272,1755,129.5,3417,1921,1496,128.4
11180, 금천구,035004, 33세,2018,3797,2082,1715,121.4,3298,1799,1499,120
11180, 금천구,035005, 34세,2018,3936,2178,1758,123.9,3416,1892,1524,124.1
11180, 금천구,040,35~39세,2018,19607,10877,8730,124.6,17422,9545,7877,121.2
11180, 금천구,040001, 35세,2018,3947,2149,1798,119.5,3482,1890,1592,118.7
11180, 금천구,040002, 36세,2018,4177,2347,1830,128.3,3668,2024,1644,123.1
11180, 금천구,040003, 37세,2018,3886,2178,1708,127.5,3498,1943,1555,125
11180, 금천구,040004, 38세,2018,3916,2186,1730,126.4,3520,1941,1579,122.9
11180, 금천구,040005, 39세,2018,3681,2017,1664,121.2,3254,1747,1507,115.9
11180, 금천구,045,40~44세,2018,17160,9293,7867,118.1,15102,7997,7105,112.6
11180, 금천구,045001, 40세,2018,3313,1783,1530,116.5,2888,1520,1368,111.1
11180, 금천구,045002, 41세,2018,3263,1837,1426,128.8,2896,1605,1291,124.3
11180, 금천구,045003, 42세,2018,3288,1749,1539,113.6,2890,1496,1394,107.3
11180, 금천구,045004, 43세,2018,3485,1871,1614,115.9,3069,1612,1457,110.6
11180, 금천구,045005, 44세,2018,3811,2053,1758,116.8,3359,1764,1595,110.6
11180, 금천구,050,45~49세,2018,21571,11206,10365,108.1,18215,9276,8939,103.8
11180, 금천구,050001, 45세,2018,4049,2150,1899,113.2,3455,1780,1675,106.3
11180, 금천구,050002, 46세,2018,4090,2138,1952,109.5,3519,1812,1707,106.2
11180, 금천구,050003, 47세,2018,4468,2342,2126,110.2,3727,1910,1817,105.1
11180, 금천구,050004, 48세,2018,4464,2296,2168,105.9,3740,1878,1862,100.9
11180, 금천구,050005, 49세,2018,4500,2280,2220,102.7,3774,1896,1878,101
11180, 금천구,055,50~54세,2018,22910,11588,11322,102.3,19069,9420,9649,97.6
11180, 금천구,055001, 50세,2018,4645,2350,2295,102.4,3894,1915,1979,96.8
11180, 금천구,055002, 51세,2018,4242,2067,2175,95,3613,1723,1890,91.2
11180, 금천구,055003, 52세,2018,4514,2323,2191,106,3765,1902,1863,102.1
11180, 금천구,055004, 53세,2018,4793,2427,2366,102.6,3964,1951,2013,96.9
11180, 금천구,055005, 54세,2018,4716,2421,2295,105.5,3833,1929,1904,101.3
11180, 금천구,060,55~59세,2018,24585,12354,12231,101,20770,10327,10443,98.9
11180, 금천구,060001, 55세,2018,5070,2563,2507,102.2,3969,2008,1961,102.4
11180, 금천구,060002, 56세,2018,4926,2541,2385,106.5,4077,2065,2012,102.6
11180, 금천구,060003, 57세,2018,4872,2388,2484,96.1,4404,2141,2263,94.6
11180, 금천구,060004, 58세,2018,5131,2601,2530,102.8,4314,2166,2148,100.8
11180, 금천구,060005, 59세,2018,4586,2261,2325,97.2,4006,1947,2059,94.6
11180, 금천구,065,60~64세,2018,19969,9910,10059,98.5,16867,8279,8588,96.4
11180, 금천구,065001, 60세,2018,4393,2227,2166,102.8,3679,1868,1811,103.1
11180, 금천구,065002, 61세,2018,4176,2081,2095,99.3,3444,1702,1742,97.7
11180, 금천구,065003, 62세,2018,3968,2012,1956,102.9,3383,1701,1682,101.1
11180, 금천구,065004, 63세,2018,3933,1893,2040,92.8,3367,1590,1777,89.5
11180, 금천구,065005, 64세,2018,3499,1697,1802,94.2,2994,1418,1576,90
11180, 금천구,070,65~69세,2018,13192,6400,6792,94.2,11876,5743,6133,93.6
11180, 금천구,070001, 65세,2018,2868,1375,1493,92.1,2493,1183,1310,90.3
11180, 금천구,070002, 66세,2018,3047,1499,1548,96.8,2731,1326,1405,94.4
11180, 금천구,070003, 67세,2018,2330,1173,1157,101.4,2088,1049,1039,101
11180, 금천구,070004, 68세,2018,2561,1225,1336,91.7,2353,1139,1214,93.8
11180, 금천구,070005, 69세,2018,2386,1128,1258,89.7,2211,1046,1165,89.8
11180, 금천구,075,70~74세,2018,9420,4428,4992,88.7,9067,4296,4771,90
11180, 금천구,075001, 70세,2018,2195,1069,1126,94.9,2083,1022,1061,96.3
11180, 금천구,075002, 71세,2018,2271,1063,1208,88,2189,1034,1155,89.5
11180, 금천구,075003, 72세,2018,1683,781,902,86.6,1616,757,859,88.1
11180, 금천구,075004, 73세,2018,1689,800,889,90,1642,784,858,91.4
11180, 금천구,075005, 74세,2018,1582,715,867,82.5,1537,699,838,83.4
11180, 금천구,080,75~79세,2018,7215,3268,3947,82.8,6987,3215,3772,85.2
11180, 금천구,080001, 75세,2018,1597,768,829,92.6,1546,752,794,94.7
11180, 금천구,080002, 76세,2018,1787,823,964,85.4,1744,809,935,86.5
11180, 금천구,080003, 77세,2018,1442,643,799,80.5,1394,633,761,83.2
11180, 금천구,080004, 78세,2018,1219,532,687,77.4,1175,526,649,81
11180, 금천구,080005, 79세,2018,1170,502,668,75.1,1128,495,633,78.2
11180, 금천구,085,80~84세,2018,3682,1428,2254,63.4,3554,1397,2157,64.8
11180, 금천구,085001, 80세,2018,963,405,558,72.6,927,396,531,74.6
11180, 금천구,085002, 81세,2018,793,322,471,68.4,764,317,447,70.9
11180, 금천구,085003, 82세,2018,715,277,438,63.2,698,271,427,63.5
11180, 금천구,085004, 83세,2018,668,236,432,54.6,639,227,412,55.1
11180, 금천구,085005, 84세,2018,543,188,355,53,526,186,340,54.7
11180, 금천구,090,85~89세,2018,1543,483,1060,45.6,1513,477,1036,46
11180, 금천구,090001, 85세,2018,423,141,282,50,411,137,274,50
11180, 금천구,090002, 86세,2018,395,132,263,50.2,389,131,258,50.8
11180, 금천구,090003, 87세,2018,303,101,202,50,299,100,199,50.3
11180, 금천구,090004, 88세,2018,254,71,183,38.8,248,71,177,40.1
11180, 금천구,090005, 89세,2018,168,38,130,29.2,166,38,128,29.7
11180, 금천구,095,90~94세,2018,524,90,434,20.7,515,90,425,21.2
11180, 금천구,095001, 90세,2018,176,33,143,23.1,172,33,139,23.7
11180, 금천구,095002, 91세,2018,142,24,118,20.3,141,24,117,20.5
11180, 금천구,095003, 92세,2018,70,8,62,12.9,68,8,60,13.3
11180, 금천구,095004, 93세,2018,83,14,69,20.3,82,14,68,20.6
11180, 금천구,095005, 94세,2018,53,11,42,26.2,52,11,41,26.8
11180, 금천구,100,95~99세,2018,141,37,104,35.6,140,36,104,34.6
11180, 금천구,100001, 95세,2018,48,16,32,50,48,16,32,50
11180, 금천구,100002, 96세,2018,39,10,29,34.5,39,10,29,34.5
11180, 금천구,100003, 97세,2018,23,5,18,27.8,22,X,18,22.2
11180, 금천구,100004, 98세,2018,24,X,20,20,24,X,20,20
11180, 금천구,100005, 99세,2018,7,X,5,40,7,X,5,40
11180, 금천구,101,100세이상,2018,20,X,17,17.6,20,X,17,17.6
11180, 금천구,102,15세미만,2018,22261,11399,10862,104.9,20961,10713,10248,104.5
11180, 금천구,103,15~64세,2018,191346,99742,91604,108.9,167187,86318,80869,106.7
11180, 금천구,104,65세이상,2018,35737,16137,19600,82.3,33672,15257,18415,82.9
11180, 금천구,086,85세이상,2018,2228,613,1615,38,2188,606,1582,38.3
11180, 금천구,126,평균연령,2018,43.6,42.8,44.5,,43.4,42.5,44.3,
11180, 금천구,127,중위연령,2018,45,43.8,46.3,,44.3,42.9,45.8,
11190, 영등포구,000,합계,2018,395286,198031,197255,100.4,346135,171625,174510,98.3
11190, 영등포구,005,0~4세,2018,14808,7580,7228,104.9,13597,6984,6613,105.6
11190, 영등포구,005001, 0세,2018,2853,1433,1420,100.9,2610,1301,1309,99.4
11190, 영등포구,005002, 1세,2018,2783,1440,1343,107.2,2541,1341,1200,111.8
11190, 영등포구,005003, 2세,2018,3187,1622,1565,103.6,2889,1463,1426,102.6
11190, 영등포구,005004, 3세,2018,3133,1629,1504,108.3,2909,1510,1399,107.9
11190, 영등포구,005005, 4세,2018,2852,1456,1396,104.3,2648,1369,1279,107
11190, 영등포구,010,5~9세,2018,12614,6353,6261,101.5,11888,5991,5897,101.6
11190, 영등포구,010001, 5세,2018,2685,1386,1299,106.7,2504,1296,1208,107.3
11190, 영등포구,010002, 6세,2018,2781,1365,1416,96.4,2614,1284,1330,96.5
11190, 영등포구,010003, 7세,2018,2533,1241,1292,96.1,2394,1167,1227,95.1
11190, 영등포구,010004, 8세,2018,2371,1197,1174,102,2238,1129,1109,101.8
11190, 영등포구,010005, 9세,2018,2244,1164,1080,107.8,2138,1115,1023,109
11190, 영등포구,015,10~14세,2018,11359,6004,5355,112.1,10888,5753,5135,112
11190, 영등포구,015001, 10세,2018,2414,1257,1157,108.6,2295,1193,1102,108.3
11190, 영등포구,015002, 11세,2018,2362,1238,1124,110.1,2270,1194,1076,111
11190, 영등포구,015003, 12세,2018,2173,1160,1013,114.5,2088,1113,975,114.2
11190, 영등포구,015004, 13세,2018,2074,1102,972,113.4,1983,1058,925,114.4
11190, 영등포구,015005, 14세,2018,2336,1247,1089,114.5,2252,1195,1057,113.1
11190, 영등포구,020,15~19세,2018,13400,7050,6350,111,13047,6853,6194,110.6
11190, 영등포구,020001, 15세,2018,2291,1256,1035,121.4,2235,1223,1012,120.8
11190, 영등포구,020002, 16세,2018,2409,1288,1121,114.9,2353,1259,1094,115.1
11190, 영등포구,020003, 17세,2018,2733,1409,1324,106.4,2676,1379,1297,106.3
11190, 영등포구,020004, 18세,2018,2956,1518,1438,105.6,2872,1469,1403,104.7
11190, 영등포구,020005, 19세,2018,3011,1579,1432,110.3,2911,1523,1388,109.7
11190, 영등포구,025,20~24세,2018,21689,10329,11360,90.9,20363,9716,10647,91.3
11190, 영등포구,025001, 20세,2018,3520,1786,1734,103,3332,1693,1639,103.3
11190, 영등포구,025002, 21세,2018,3800,1927,1873,102.9,3603,1826,1777,102.8
11190, 영등포구,025003, 22세,2018,4170,1975,2195,90,3920,1864,2056,90.7
11190, 영등포구,025004, 23세,2018,4831,2172,2659,81.7,4515,2042,2473,82.6
11190, 영등포구,025005, 24세,2018,5368,2469,2899,85.2,4993,2291,2702,84.8
11190, 영등포구,030,25~29세,2018,34902,16983,17919,94.8,31270,15079,16191,93.1
11190, 영등포구,030001, 25세,2018,6261,2842,3419,83.1,5768,2603,3165,82.2
11190, 영등포구,030002, 26세,2018,7048,3377,3671,92,6408,3044,3364,90.5
11190, 영등포구,030003, 27세,2018,7176,3437,3739,91.9,6471,3065,3406,90
11190, 영등포구,030004, 28세,2018,7090,3526,3564,98.9,6205,3071,3134,98
11190, 영등포구,030005, 29세,2018,7327,3801,3526,107.8,6418,3296,3122,105.6
11190, 영등포구,035,30~34세,2018,36596,18890,17706,106.7,31636,16090,15546,103.5
11190, 영등포구,035001, 30세,2018,7418,3749,3669,102.2,6421,3213,3208,100.2
11190, 영등포구,035002, 31세,2018,7532,3769,3763,100.2,6357,3116,3241,96.1
11190, 영등포구,035003, 32세,2018,7308,3782,3526,107.3,6268,3195,3073,104
11190, 영등포구,035004, 33세,2018,7194,3791,3403,111.4,6306,3279,3027,108.3
11190, 영등포구,035005, 34세,2018,7144,3799,3345,113.6,6284,3287,2997,109.7
11190, 영등포구,040,35~39세,2018,35290,18777,16513,113.7,31339,16397,14942,109.7
11190, 영등포구,040001, 35세,2018,7279,3812,3467,110,6411,3300,3111,106.1
11190, 영등포구,040002, 36세,2018,7513,3959,3554,111.4,6660,3472,3188,108.9
11190, 영등포구,040003, 37세,2018,7105,3845,3260,117.9,6381,3413,2968,115
11190, 영등포구,040004, 38세,2018,6873,3654,3219,113.5,6203,3241,2962,109.4
11190, 영등포구,040005, 39세,2018,6520,3507,3013,116.4,5684,2971,2713,109.5
11190, 영등포구,045,40~44세,2018,28901,15366,13535,113.5,25376,13161,12215,107.7
11190, 영등포구,045001, 40세,2018,5653,3012,2641,114,4914,2543,2371,107.3
11190, 영등포구,045002, 41세,2018,5793,3045,2748,110.8,5159,2653,2506,105.9
11190, 영등포구,045003, 42세,2018,5664,2977,2687,110.8,4984,2562,2422,105.8
11190, 영등포구,045004, 43세,2018,5661,3020,2641,114.4,5001,2612,2389,109.3
11190, 영등포구,045005, 44세,2018,6130,3312,2818,117.5,5318,2791,2527,110.4
11190, 영등포구,050,45~49세,2018,33411,17422,15989,109,27680,14131,13549,104.3
11190, 영등포구,050001, 45세,2018,6375,3387,2988,113.4,5408,2777,2631,105.5
11190, 영등포구,050002, 46세,2018,6472,3449,3023,114.1,5429,2832,2597,109
11190, 영등포구,050003, 47세,2018,6958,3612,3346,107.9,5780,2937,2843,103.3
11190, 영등포구,050004, 48세,2018,6739,3547,3192,111.1,5456,2825,2631,107.4
11190, 영등포구,050005, 49세,2018,6867,3427,3440,99.6,5607,2760,2847,96.9
11190, 영등포구,055,50~54세,2018,32660,16606,16054,103.4,25795,12959,12836,101
11190, 영등포구,055001, 50세,2018,6677,3449,3228,106.8,5370,2724,2646,102.9
11190, 영등포구,055002, 51세,2018,6178,3095,3083,100.4,5106,2502,2604,96.1
11190, 영등포구,055003, 52세,2018,6318,3248,3070,105.8,4989,2537,2452,103.5
11190, 영등포구,055004, 53세,2018,6666,3358,3308,101.5,5159,2588,2571,100.7
11190, 영등포구,055005, 54세,2018,6821,3456,3365,102.7,5171,2608,2563,101.8
11190, 영등포구,060,55~59세,2018,34799,17284,17515,98.7,27737,13666,14071,97.1
11190, 영등포구,060001, 55세,2018,7272,3766,3506,107.4,5237,2683,2554,105.1
11190, 영등포구,060002, 56세,2018,6937,3523,3414,103.2,5452,2777,2675,103.8
11190, 영등포구,060003, 57세,2018,6745,3252,3493,93.1,5819,2789,3030,92
11190, 영등포구,060004, 58세,2018,7309,3517,3792,92.7,5863,2791,3072,90.9
11190, 영등포구,060005, 59세,2018,6536,3226,3310,97.5,5366,2626,2740,95.8
11190, 영등포구,065,60~64세,2018,29569,14626,14943,97.9,23933,11673,12260,95.2
11190, 영등포구,065001, 60세,2018,6458,3224,3234,99.7,5174,2553,2621,97.4
11190, 영등포구,065002, 61세,2018,6462,3213,3249,98.9,5132,2509,2623,95.7
11190, 영등포구,065003, 62세,2018,5802,2909,2893,100.6,4690,2330,2360,98.7
11190, 영등포구,065004, 63세,2018,5941,2877,3064,93.9,4885,2308,2577,89.6
11190, 영등포구,065005, 64세,2018,4906,2403,2503,96,4052,1973,2079,94.9
11190, 영등포구,070,65~69세,2018,19469,9359,10110,92.6,17107,8155,8952,91.1
11190, 영등포구,070001, 65세,2018,4272,2055,2217,92.7,3579,1694,1885,89.9
11190, 영등포구,070002, 66세,2018,4534,2210,2324,95.1,3958,1909,2049,93.2
11190, 영등포구,070003, 67세,2018,3350,1620,1730,93.6,2900,1386,1514,91.5
11190, 영등포구,070004, 68세,2018,3665,1711,1954,87.6,3327,1548,1779,87
11190, 영등포구,070005, 69세,2018,3648,1763,1885,93.5,3343,1618,1725,93.8
11190, 영등포구,075,70~74세,2018,14174,6665,7509,88.8,13565,6447,7118,90.6
11190, 영등포구,075001, 70세,2018,3385,1629,1756,92.8,3205,1551,1654,93.8
11190, 영등포구,075002, 71세,2018,3304,1541,1763,87.4,3156,1490,1666,89.4
11190, 영등포구,075003, 72세,2018,2633,1238,1395,88.7,2498,1191,1307,91.1
11190, 영등포구,075004, 73세,2018,2471,1192,1279,93.2,2390,1165,1225,95.1
11190, 영등포구,075005, 74세,2018,2381,1065,1316,80.9,2316,1050,1266,82.9
11190, 영등포구,080,75~79세,2018,11175,4919,6256,78.6,10786,4821,5965,80.8
11190, 영등포구,080001, 75세,2018,2398,1068,1330,80.3,2328,1045,1283,81.4
11190, 영등포구,080002, 76세,2018,2800,1233,1567,78.7,2725,1216,1509,80.6
11190, 영등포구,080003, 77세,2018,2131,944,1187,79.5,2051,925,1126,82.1
11190, 영등포구,080004, 78세,2018,1940,830,1110,74.8,1864,809,1055,76.7
11190, 영등포구,080005, 79세,2018,1906,844,1062,79.5,1818,826,992,83.3
11190, 영등포구,085,80~84세,2018,6617,2675,3942,67.9,6380,2621,3759,69.7
11190, 영등포구,085001, 80세,2018,1619,681,938,72.6,1559,669,890,75.2
11190, 영등포구,085002, 81세,2018,1494,612,882,69.4,1439,595,844,70.5
11190, 영등포구,085003, 82세,2018,1317,529,788,67.1,1266,518,748,69.3
11190, 영등포구,085004, 83세,2018,1222,510,712,71.6,1180,500,680,73.5
11190, 영등포구,085005, 84세,2018,965,343,622,55.1,936,339,597,56.8
11190, 영등포구,090,85~89세,2018,2721,856,1865,45.9,2640,845,1795,47.1
11190, 영등포구,090001, 85세,2018,797,261,536,48.7,765,258,507,50.9
11190, 영등포구,090002, 86세,2018,643,214,429,49.9,626,210,416,50.5
11190, 영등포구,090003, 87세,2018,506,156,350,44.6,490,154,336,45.8
11190, 영등포구,090004, 88세,2018,428,129,299,43.1,417,128,289,44.3
11190, 영등포구,090005, 89세,2018,347,96,251,38.2,342,95,247,38.5
11190, 영등포구,095,90~94세,2018,897,227,670,33.9,877,224,653,34.3
11190, 영등포구,095001, 90세,2018,293,84,209,40.2,287,83,204,40.7
11190, 영등포구,095002, 91세,2018,233,56,177,31.6,227,56,171,32.7
11190, 영등포구,095003, 92세,2018,140,29,111,26.1,137,28,109,25.7
11190, 영등포구,095004, 93세,2018,129,29,100,29,126,29,97,29.9
11190, 영등포구,095005, 94세,2018,102,29,73,39.7,100,28,72,38.9
11190, 영등포구,100,95~99세,2018,215,54,161,33.5,211,53,158,33.5
11190, 영등포구,100001, 95세,2018,93,23,70,32.9,92,22,70,31.4
11190, 영등포구,100002, 96세,2018,54,16,38,42.1,52,16,36,44.4
11190, 영등포구,100003, 97세,2018,31,7,24,29.2,31,7,24,29.2
11190, 영등포구,100004, 98세,2018,27,8,19,42.1,26,8,18,44.4
11190, 영등포구,100005, 99세,2018,10,X,10,0,10,X,10,0
11190, 영등포구,101,100세이상,2018,20,6,14,42.9,20,6,14,42.9
11190, 영등포구,102,15세미만,2018,38781,19937,18844,105.8,36373,18728,17645,106.1
11190, 영등포구,103,15~64세,2018,301217,153333,147884,103.7,258176,129725,128451,101
11190, 영등포구,104,65세이상,2018,55288,24761,30527,81.1,51586,23172,28414,81.6
11190, 영등포구,086,85세이상,2018,3853,1143,2710,42.2,3748,1128,2620,43.1
11190, 영등포구,126,평균연령,2018,42.8,42.2,43.5,,42.4,41.7,43.1,
11190, 영등포구,127,중위연령,2018,43,42.3,43.7,,41.8,41.2,42.5,
11200, 동작구,000,합계,2018,397980,193713,204267,94.8,380659,185596,195063,95.1
11200, 동작구,005,0~4세,2018,13491,6828,6663,102.5,13258,6708,6550,102.4
11200, 동작구,005001, 0세,2018,2453,1247,1206,103.4,2394,1220,1174,103.9
11200, 동작구,005002, 1세,2018,2521,1234,1287,95.9,2474,1206,1268,95.1
11200, 동작구,005003, 2세,2018,2794,1434,1360,105.4,2744,1405,1339,104.9
11200, 동작구,005004, 3세,2018,2964,1493,1471,101.5,2926,1478,1448,102.1
11200, 동작구,005005, 4세,2018,2759,1420,1339,106,2720,1399,1321,105.9
11200, 동작구,010,5~9세,2018,13678,6991,6687,104.5,13553,6931,6622,104.7
11200, 동작구,010001, 5세,2018,2750,1392,1358,102.5,2709,1376,1333,103.2
11200, 동작구,010002, 6세,2018,2879,1478,1401,105.5,2859,1466,1393,105.2
11200, 동작구,010003, 7세,2018,2780,1396,1384,100.9,2751,1381,1370,100.8
11200, 동작구,010004, 8세,2018,2679,1420,1259,112.8,2662,1410,1252,112.6
11200, 동작구,010005, 9세,2018,2590,1305,1285,101.6,2572,1298,1274,101.9
11200, 동작구,015,10~14세,2018,12918,6722,6196,108.5,12845,6688,6157,108.6
11200, 동작구,015001, 10세,2018,2626,1369,1257,108.9,2606,1359,1247,109
11200, 동작구,015002, 11세,2018,2681,1434,1247,115,2666,1429,1237,115.5
11200, 동작구,015003, 12세,2018,2499,1287,1212,106.2,2483,1277,1206,105.9
11200, 동작구,015004, 13세,2018,2452,1253,1199,104.5,2445,1250,1195,104.6
11200, 동작구,015005, 14세,2018,2660,1379,1281,107.7,2645,1373,1272,107.9
11200, 동작구,020,15~19세,2018,17517,8810,8707,101.2,16976,8612,8364,103
11200, 동작구,020001, 15세,2018,2658,1370,1288,106.4,2646,1365,1281,106.6
11200, 동작구,020002, 16세,2018,2737,1387,1350,102.7,2727,1381,1346,102.6
11200, 동작구,020003, 17세,2018,3093,1597,1496,106.8,3068,1588,1480,107.3
11200, 동작구,020004, 18세,2018,3842,1916,1926,99.5,3685,1865,1820,102.5
11200, 동작구,020005, 19세,2018,5187,2540,2647,96,4850,2413,2437,99
11200, 동작구,025,20~24세,2018,33393,15956,17437,91.5,30312,14827,15485,95.8
11200, 동작구,025001, 20세,2018,5888,2697,3191,84.5,5282,2486,2796,88.9
11200, 동작구,025002, 21세,2018,5894,2645,3249,81.4,5249,2420,2829,85.5
11200, 동작구,025003, 22세,2018,6651,3177,3474,91.5,6037,2947,3090,95.4
11200, 동작구,025004, 23세,2018,7258,3594,3664,98.1,6596,3347,3249,103
11200, 동작구,025005, 24세,2018,7702,3843,3859,99.6,7148,3627,3521,103
11200, 동작구,030,25~29세,2018,37471,18913,18558,101.9,35501,18055,17446,103.5
11200, 동작구,030001, 25세,2018,7782,3854,3928,98.1,7331,3700,3631,101.9
11200, 동작구,030002, 26세,2018,7933,4092,3841,106.5,7534,3917,3617,108.3
11200, 동작구,030003, 27세,2018,7657,3805,3852,98.8,7305,3643,3662,99.5
11200, 동작구,030004, 28세,2018,7283,3730,3553,105,6879,3533,3346,105.6
11200, 동작구,030005, 29세,2018,6816,3432,3384,101.4,6452,3262,3190,102.3
11200, 동작구,035,30~34세,2018,32254,16207,16047,101,30547,15323,15224,100.7
11200, 동작구,035001, 30세,2018,6774,3422,3352,102.1,6387,3227,3160,102.1
11200, 동작구,035002, 31세,2018,6546,3316,3230,102.7,6166,3122,3044,102.6
11200, 동작구,035003, 32세,2018,6357,3156,3201,98.6,6009,2980,3029,98.4
11200, 동작구,035004, 33세,2018,6321,3155,3166,99.7,6029,2996,3033,98.8
11200, 동작구,035005, 34세,2018,6256,3158,3098,101.9,5956,2998,2958,101.4
11200, 동작구,040,35~39세,2018,33242,17029,16213,105,32049,16348,15701,104.1
11200, 동작구,040001, 35세,2018,6782,3436,3346,102.7,6507,3288,3219,102.1
11200, 동작구,040002, 36세,2018,6835,3475,3360,103.4,6570,3325,3245,102.5
11200, 동작구,040003, 37세,2018,6588,3459,3129,110.5,6383,3343,3040,110
11200, 동작구,040004, 38세,2018,6735,3423,3312,103.4,6529,3302,3227,102.3
11200, 동작구,040005, 39세,2018,6302,3236,3066,105.5,6060,3090,2970,104
11200, 동작구,045,40~44세,2018,28761,14630,14131,103.5,27774,14059,13715,102.5
11200, 동작구,045001, 40세,2018,5643,2781,2862,97.2,5435,2660,2775,95.9
11200, 동작구,045002, 41세,2018,5630,2798,2832,98.8,5459,2698,2761,97.7
11200, 동작구,045003, 42세,2018,5600,2889,2711,106.6,5408,2777,2631,105.5
11200, 동작구,045004, 43세,2018,5728,2931,2797,104.8,5528,2811,2717,103.5
11200, 동작구,045005, 44세,2018,6160,3231,2929,110.3,5944,3113,2831,110
11200, 동작구,050,45~49세,2018,31244,15602,15642,99.7,29787,14842,14945,99.3
11200, 동작구,050001, 45세,2018,6023,3010,3013,99.9,5799,2895,2904,99.7
11200, 동작구,050002, 46세,2018,6085,3156,2929,107.8,5812,2998,2814,106.5
11200, 동작구,050003, 47세,2018,6552,3215,3337,96.3,6237,3051,3186,95.8
11200, 동작구,050004, 48세,2018,6231,3121,3110,100.4,5921,2974,2947,100.9
11200, 동작구,050005, 49세,2018,6353,3100,3253,95.3,6018,2924,3094,94.5
11200, 동작구,055,50~54세,2018,28793,13710,15083,90.9,27025,12854,14171,90.7
11200, 동작구,055001, 50세,2018,6105,2877,3228,89.1,5767,2697,3070,87.9
11200, 동작구,055002, 51세,2018,5635,2662,2973,89.5,5341,2523,2818,89.5
11200, 동작구,055003, 52세,2018,5511,2664,2847,93.6,5165,2509,2656,94.5
11200, 동작구,055004, 53세,2018,5733,2705,3028,89.3,5347,2518,2829,89
11200, 동작구,055005, 54세,2018,5809,2802,3007,93.2,5405,2607,2798,93.2
11200, 동작구,060,55~59세,2018,31104,14646,16458,89,29326,13804,15522,88.9
11200, 동작구,060001, 55세,2018,6032,2899,3133,92.5,5546,2651,2895,91.6
11200, 동작구,060002, 56세,2018,6058,2912,3146,92.6,5668,2723,2945,92.5
11200, 동작구,060003, 57세,2018,6287,2926,3361,87.1,6077,2837,3240,87.6
11200, 동작구,060004, 58세,2018,6747,3134,3613,86.7,6340,2951,3389,87.1
11200, 동작구,060005, 59세,2018,5980,2775,3205,86.6,5695,2642,3053,86.5
11200, 동작구,065,60~64세,2018,27076,12599,14477,87,25588,11849,13739,86.2
11200, 동작구,065001, 60세,2018,5804,2651,3153,84.1,5470,2487,2983,83.4
11200, 동작구,065002, 61세,2018,5829,2761,3068,90,5448,2565,2883,89
11200, 동작구,065003, 62세,2018,5259,2440,2819,86.6,4966,2286,2680,85.3
11200, 동작구,065004, 63세,2018,5554,2593,2961,87.6,5303,2472,2831,87.3
11200, 동작구,065005, 64세,2018,4630,2154,2476,87,4401,2039,2362,86.3
11200, 동작구,070,65~69세,2018,19061,8669,10392,83.4,18464,8394,10070,83.4
11200, 동작구,070001, 65세,2018,4134,1919,2215,86.6,3952,1833,2119,86.5
11200, 동작구,070002, 66세,2018,4356,2011,2345,85.8,4214,1950,2264,86.1
11200, 동작구,070003, 67세,2018,3344,1488,1856,80.2,3238,1438,1800,79.9
11200, 동작구,070004, 68세,2018,3608,1680,1928,87.1,3515,1636,1879,87.1
11200, 동작구,070005, 69세,2018,3619,1571,2048,76.7,3545,1537,2008,76.5
11200, 동작구,075,70~74세,2018,15368,6884,8484,81.1,15224,6825,8399,81.3
11200, 동작구,075001, 70세,2018,3613,1620,1993,81.3,3570,1604,1966,81.6
11200, 동작구,075002, 71세,2018,3586,1600,1986,80.6,3557,1590,1967,80.8
11200, 동작구,075003, 72세,2018,2880,1256,1624,77.3,2851,1239,1612,76.9
11200, 동작구,075004, 73세,2018,2668,1201,1467,81.9,2648,1192,1456,81.9
11200, 동작구,075005, 74세,2018,2621,1207,1414,85.4,2598,1200,1398,85.8
11200, 동작구,080,75~79세,2018,11997,5616,6381,88,11907,5593,6314,88.6
11200, 동작구,080001, 75세,2018,2585,1257,1328,94.7,2561,1247,1314,94.9
11200, 동작구,080002, 76세,2018,2994,1456,1538,94.7,2974,1452,1522,95.4
11200, 동작구,080003, 77세,2018,2334,1066,1268,84.1,2314,1062,1252,84.8
11200, 동작구,080004, 78세,2018,2122,958,1164,82.3,2107,957,1150,83.2
11200, 동작구,080005, 79세,2018,1962,879,1083,81.2,1951,875,1076,81.3
11200, 동작구,085,80~84세,2018,6649,2691,3958,68,6584,2677,3907,68.5
11200, 동작구,085001, 80세,2018,1667,729,938,77.7,1653,726,927,78.3
11200, 동작구,085002, 81세,2018,1503,603,900,67,1487,599,888,67.5
11200, 동작구,085003, 82세,2018,1316,523,793,66,1296,519,777,66.8
11200, 동작구,085004, 83세,2018,1167,448,719,62.3,1157,446,711,62.7
11200, 동작구,085005, 84세,2018,996,388,608,63.8,991,387,604,64.1
11200, 동작구,090,85~89세,2018,2768,907,1861,48.7,2752,905,1847,49
11200, 동작구,090001, 85세,2018,788,274,514,53.3,780,273,507,53.8
11200, 동작구,090002, 86세,2018,655,207,448,46.2,653,207,446,46.4
11200, 동작구,090003, 87세,2018,494,171,323,52.9,494,171,323,52.9
11200, 동작구,090004, 88세,2018,439,122,317,38.5,436,122,314,38.9
11200, 동작구,090005, 89세,2018,392,133,259,51.4,389,132,257,51.4
11200, 동작구,095,90~94세,2018,943,241,702,34.3,939,240,699,34.3
11200, 동작구,095001, 90세,2018,314,84,230,36.5,313,83,230,36.1
11200, 동작구,095002, 91세,2018,234,56,178,31.5,232,56,176,31.8
11200, 동작구,095003, 92세,2018,167,43,124,34.7,167,43,124,34.7
11200, 동작구,095004, 93세,2018,123,27,96,28.1,122,27,95,28.4
11200, 동작구,095005, 94세,2018,105,31,74,41.9,105,31,74,41.9
11200, 동작구,100,95~99세,2018,227,56,171,32.7,223,56,167,33.5
11200, 동작구,100001, 95세,2018,87,23,64,35.9,86,23,63,36.5
11200, 동작구,100002, 96세,2018,50,12,38,31.6,50,12,38,31.6
11200, 동작구,100003, 97세,2018,35,8,27,29.6,34,8,26,30.8
11200, 동작구,100004, 98세,2018,34,9,25,36,34,9,25,36
11200, 동작구,100005, 99세,2018,21,X,17,23.5,19,X,15,26.7
11200, 동작구,101,100세이상,2018,25,6,19,31.6,25,6,19,31.6
11200, 동작구,102,15세미만,2018,40087,20541,19546,105.1,39656,20327,19329,105.2
11200, 동작구,103,15~64세,2018,300855,148102,152753,97,284885,140573,144312,97.4
11200, 동작구,104,65세이상,2018,57038,25070,31968,78.4,56118,24696,31422,78.6
11200, 동작구,086,85세이상,2018,3963,1210,2753,44,3939,1207,2732,44.2
11200, 동작구,126,평균연령,2018,41.7,40.8,42.6,,41.8,40.8,42.7,
11200, 동작구,127,중위연령,2018,40.9,39.8,42,,41,39.8,42.2,
11210, 관악구,000,합계,2018,510303,255687,254616,100.4,484885,243815,241070,101.1
11210, 관악구,005,0~4세,2018,13933,7190,6743,106.6,13390,6926,6464,107.1
11210, 관악구,005001, 0세,2018,2573,1385,1188,116.6,2462,1333,1129,118.1
11210, 관악구,005002, 1세,2018,2694,1392,1302,106.9,2583,1328,1255,105.8
11210, 관악구,005003, 2세,2018,2862,1449,1413,102.5,2738,1390,1348,103.1
11210, 관악구,005004, 3세,2018,2970,1532,1438,106.5,2866,1486,1380,107.7
11210, 관악구,005005, 4세,2018,2834,1432,1402,102.1,2741,1389,1352,102.7
11210, 관악구,010,5~9세,2018,13488,6925,6563,105.5,13199,6777,6422,105.5
11210, 관악구,010001, 5세,2018,2738,1400,1338,104.6,2656,1365,1291,105.7
11210, 관악구,010002, 6세,2018,2832,1454,1378,105.5,2766,1418,1348,105.2
11210, 관악구,010003, 7세,2018,2768,1418,1350,105,2731,1396,1335,104.6
11210, 관악구,010004, 8세,2018,2643,1343,1300,103.3,2594,1314,1280,102.7
11210, 관악구,010005, 9세,2018,2507,1310,1197,109.4,2452,1284,1168,109.9
11210, 관악구,015,10~14세,2018,13309,6840,6469,105.7,13122,6757,6365,106.2
11210, 관악구,015001, 10세,2018,2679,1388,1291,107.5,2636,1366,1270,107.6
11210, 관악구,015002, 11세,2018,2744,1397,1347,103.7,2706,1381,1325,104.2
11210, 관악구,015003, 12세,2018,2555,1340,1215,110.3,2518,1325,1193,111.1
11210, 관악구,015004, 13세,2018,2547,1271,1276,99.6,2513,1254,1259,99.6
11210, 관악구,015005, 14세,2018,2784,1444,1340,107.8,2749,1431,1318,108.6
11210, 관악구,020,15~19세,2018,19137,9712,9425,103,18775,9570,9205,104
11210, 관악구,020001, 15세,2018,2831,1437,1394,103.1,2811,1427,1384,103.1
11210, 관악구,020002, 16세,2018,3102,1548,1554,99.6,3076,1537,1539,99.9
11210, 관악구,020003, 17세,2018,3452,1700,1752,97,3426,1685,1741,96.8
11210, 관악구,020004, 18세,2018,4336,2256,2080,108.5,4236,2226,2010,110.7
11210, 관악구,020005, 19세,2018,5416,2771,2645,104.8,5226,2695,2531,106.5
11210, 관악구,025,20~24세,2018,42323,19510,22813,85.5,40413,18882,21531,87.7
11210, 관악구,025001, 20세,2018,6184,3021,3163,95.5,5936,2937,2999,97.9
11210, 관악구,025002, 21세,2018,6634,2933,3701,79.2,6363,2847,3516,81
11210, 관악구,025003, 22세,2018,7987,3627,4360,83.2,7636,3518,4118,85.4
11210, 관악구,025004, 23세,2018,9627,4415,5212,84.7,9147,4261,4886,87.2
11210, 관악구,025005, 24세,2018,11891,5514,6377,86.5,11331,5319,6012,88.5
11210, 관악구,030,25~29세,2018,66369,34237,32132,106.6,63039,32895,30144,109.1
11210, 관악구,030001, 25세,2018,12941,6244,6697,93.2,12335,6026,6309,95.5
11210, 관악구,030002, 26세,2018,14335,7210,7125,101.2,13722,6985,6737,103.7
11210, 관악구,030003, 27세,2018,13719,7175,6544,109.6,13027,6902,6125,112.7
11210, 관악구,030004, 28세,2018,13002,6910,6092,113.4,12318,6602,5716,115.5
11210, 관악구,030005, 29세,2018,12372,6698,5674,118,11637,6380,5257,121.4
11210, 관악구,035,30~34세,2018,49870,27248,22622,120.4,46874,25771,21103,122.1
11210, 관악구,035001, 30세,2018,11334,6129,5205,117.8,10661,5822,4839,120.3
11210, 관악구,035002, 31세,2018,10543,5738,4805,119.4,9872,5395,4477,120.5
11210, 관악구,035003, 32세,2018,9959,5492,4467,122.9,9309,5164,4145,124.6
11210, 관악구,035004, 33세,2018,9069,5012,4057,123.5,8542,4749,3793,125.2
11210, 관악구,035005, 34세,2018,8965,4877,4088,119.3,8490,4641,3849,120.6
11210, 관악구,040,35~39세,2018,43258,23531,19727,119.3,41209,22383,18826,118.9
11210, 관악구,040001, 35세,2018,8893,4854,4039,120.2,8426,4587,3839,119.5
11210, 관악구,040002, 36세,2018,9380,5064,4316,117.3,8885,4802,4083,117.6
11210, 관악구,040003, 37세,2018,8688,4797,3891,123.3,8343,4593,3750,122.5
11210, 관악구,040004, 38세,2018,8583,4614,3969,116.3,8255,4439,3816,116.3
11210, 관악구,040005, 39세,2018,7714,4202,3512,119.6,7300,3962,3338,118.7
11210, 관악구,045,40~44세,2018,34539,18627,15912,117.1,32913,17720,15193,116.6
11210, 관악구,045001, 40세,2018,6864,3646,3218,113.3,6557,3476,3081,112.8
11210, 관악구,045002, 41세,2018,6794,3640,3154,115.4,6474,3457,3017,114.6
11210, 관악구,045003, 42세,2018,6721,3732,2989,124.9,6396,3551,2845,124.8
11210, 관악구,045004, 43세,2018,6821,3683,3138,117.4,6519,3509,3010,116.6
11210, 관악구,045005, 44세,2018,7339,3926,3413,115,6967,3727,3240,115
11210, 관악구,050,45~49세,2018,37672,19802,17870,110.8,35306,18613,16693,111.5
11210, 관악구,050001, 45세,2018,7369,4013,3356,119.6,6986,3802,3184,119.4
11210, 관악구,050002, 46세,2018,7537,4032,3505,115,7079,3792,3287,115.4
11210, 관악구,050003, 47세,2018,7910,4154,3756,110.6,7426,3924,3502,112.1
11210, 관악구,050004, 48세,2018,7490,3878,3612,107.4,6968,3619,3349,108.1
11210, 관악구,050005, 49세,2018,7366,3725,3641,102.3,6847,3476,3371,103.1
11210, 관악구,055,50~54세,2018,34930,17210,17720,97.1,32066,15870,16196,98
11210, 관악구,055001, 50세,2018,7294,3576,3718,96.2,6765,3315,3450,96.1
11210, 관악구,055002, 51세,2018,6756,3232,3524,91.7,6281,3022,3259,92.7
11210, 관악구,055003, 52세,2018,6780,3487,3293,105.9,6231,3212,3019,106.4
11210, 관악구,055004, 53세,2018,7256,3528,3728,94.6,6631,3258,3373,96.6
11210, 관악구,055005, 54세,2018,6844,3387,3457,98,6158,3063,3095,99
11210, 관악구,060,55~59세,2018,38056,18020,20036,89.9,35073,16587,18486,89.7
11210, 관악구,060001, 55세,2018,7459,3616,3843,94.1,6605,3211,3394,94.6
11210, 관악구,060002, 56세,2018,7467,3599,3868,93,6826,3300,3526,93.6
11210, 관악구,060003, 57세,2018,7638,3621,4017,90.1,7243,3426,3817,89.8
11210, 관악구,060004, 58세,2018,8141,3768,4373,86.2,7535,3482,4053,85.9
11210, 관악구,060005, 59세,2018,7351,3416,3935,86.8,6864,3168,3696,85.7
11210, 관악구,065,60~64세,2018,33145,15389,17756,86.7,30796,14244,16552,86.1
11210, 관악구,065001, 60세,2018,7038,3387,3651,92.8,6501,3114,3387,91.9
11210, 관악구,065002, 61세,2018,6795,3130,3665,85.4,6257,2866,3391,84.5
11210, 관악구,065003, 62세,2018,6649,3058,3591,85.2,6194,2855,3339,85.5
11210, 관악구,065004, 63세,2018,6822,3106,3716,83.6,6377,2886,3491,82.7
11210, 관악구,065005, 64세,2018,5841,2708,3133,86.4,5467,2523,2944,85.7
11210, 관악구,070,65~69세,2018,24639,11353,13286,85.5,23684,10919,12765,85.5
11210, 관악구,070001, 65세,2018,5153,2284,2869,79.6,4885,2159,2726,79.2
11210, 관악구,070002, 66세,2018,5665,2646,3019,87.6,5440,2547,2893,88
11210, 관악구,070003, 67세,2018,4339,1988,2351,84.6,4139,1898,2241,84.7
11210, 관악구,070004, 68세,2018,4660,2216,2444,90.7,4537,2160,2377,90.9
11210, 관악구,070005, 69세,2018,4822,2219,2603,85.2,4683,2155,2528,85.2
11210, 관악구,075,70~74세,2018,19464,8924,10540,84.7,19158,8811,10347,85.2
11210, 관악구,075001, 70세,2018,4595,2102,2493,84.3,4495,2060,2435,84.6
11210, 관악구,075002, 71세,2018,4557,2071,2486,83.3,4488,2046,2442,83.8
11210, 관악구,075003, 72세,2018,3516,1581,1935,81.7,3462,1559,1903,81.9
11210, 관악구,075004, 73세,2018,3414,1595,1819,87.7,3368,1579,1789,88.3
11210, 관악구,075005, 74세,2018,3382,1575,1807,87.2,3345,1567,1778,88.1
11210, 관악구,080,75~79세,2018,14871,6931,7940,87.3,14711,6889,7822,88.1
11210, 관악구,080001, 75세,2018,3375,1575,1800,87.5,3335,1560,1775,87.9
11210, 관악구,080002, 76세,2018,3763,1767,1996,88.5,3733,1757,1976,88.9
11210, 관악구,080003, 77세,2018,2912,1389,1523,91.2,2883,1383,1500,92.2
11210, 관악구,080004, 78세,2018,2432,1084,1348,80.4,2400,1078,1322,81.5
11210, 관악구,080005, 79세,2018,2389,1116,1273,87.7,2360,1111,1249,89
11210, 관악구,085,80~84세,2018,7270,3042,4228,71.9,7179,3017,4162,72.5
11210, 관악구,085001, 80세,2018,1992,894,1098,81.4,1965,887,1078,82.3
11210, 관악구,085002, 81세,2018,1648,694,954,72.7,1629,687,942,72.9
11210, 관악구,085003, 82세,2018,1386,582,804,72.4,1368,575,793,72.5
11210, 관악구,085004, 83세,2018,1287,495,792,62.5,1272,492,780,63.1
11210, 관악구,085005, 84세,2018,957,377,580,65,945,376,569,66.1
11210, 관악구,090,85~89세,2018,2846,928,1918,48.4,2808,918,1890,48.6
11210, 관악구,090001, 85세,2018,785,281,504,55.8,774,279,495,56.4
11210, 관악구,090002, 86세,2018,666,237,429,55.2,659,234,425,55.1
11210, 관악구,090003, 87세,2018,529,162,367,44.1,521,160,361,44.3
11210, 관악구,090004, 88세,2018,490,148,342,43.3,481,146,335,43.6
11210, 관악구,090005, 89세,2018,376,100,276,36.2,373,99,274,36.1
11210, 관악구,095,90~94세,2018,921,210,711,29.5,907,208,699,29.8
11210, 관악구,095001, 90세,2018,301,78,223,35,296,76,220,34.5
11210, 관악구,095002, 91세,2018,245,62,183,33.9,242,62,180,34.4
11210, 관악구,095003, 92세,2018,178,27,151,17.9,176,27,149,18.1
11210, 관악구,095004, 93세,2018,110,23,87,26.4,109,23,86,26.7
11210, 관악구,095005, 94세,2018,87,20,67,29.9,84,20,64,31.3
11210, 관악구,100,95~99세,2018,225,53,172,30.8,225,53,172,30.8
11210, 관악구,100001, 95세,2018,102,22,80,27.5,102,22,80,27.5
11210, 관악구,100002, 96세,2018,52,15,37,40.5,52,15,37,40.5
11210, 관악구,100003, 97세,2018,38,9,29,31,38,9,29,31
11210, 관악구,100004, 98세,2018,25,6,19,31.6,25,6,19,31.6
11210, 관악구,100005, 99세,2018,8,X,7,14.3,8,X,7,14.3
11210, 관악구,101,100세이상,2018,38,5,33,15.2,38,5,33,15.2
11210, 관악구,102,15세미만,2018,40730,20955,19775,106,39711,20460,19251,106.3
11210, 관악구,103,15~64세,2018,399299,203286,196013,103.7,376464,192535,183929,104.7
11210, 관악구,104,65세이상,2018,70274,31446,38828,81,68710,30820,37890,81.3
11210, 관악구,086,85세이상,2018,4030,1196,2834,42.2,3978,1184,2794,42.4
11210, 관악구,126,평균연령,2018,41.5,40.7,42.3,,41.5,40.6,42.3,
11210, 관악구,127,중위연령,2018,39.2,38.3,40.3,,39,38.1,40.2,
11220, 서초구,000,합계,2018,409491,196064,213427,91.9,402348,192460,209888,91.7
11220, 서초구,005,0~4세,2018,15481,7943,7538,105.4,15186,7787,7399,105.2
11220, 서초구,005001, 0세,2018,2749,1467,1282,114.4,2705,1440,1265,113.8
11220, 서초구,005002, 1세,2018,2814,1413,1401,100.9,2730,1373,1357,101.2
11220, 서초구,005003, 2세,2018,3103,1556,1547,100.6,3045,1525,1520,100.3
11220, 서초구,005004, 3세,2018,3321,1685,1636,103,3270,1655,1615,102.5
11220, 서초구,005005, 4세,2018,3494,1822,1672,109,3436,1794,1642,109.3
11220, 서초구,010,5~9세,2018,20054,10370,9684,107.1,19832,10252,9580,107
11220, 서초구,010001, 5세,2018,3724,1935,1789,108.2,3685,1920,1765,108.8
11220, 서초구,010002, 6세,2018,4083,2126,1957,108.6,4026,2090,1936,108
11220, 서초구,010003, 7세,2018,4236,2216,2020,109.7,4188,2190,1998,109.6
11220, 서초구,010004, 8세,2018,4042,2069,1973,104.9,4012,2051,1961,104.6
11220, 서초구,010005, 9세,2018,3969,2024,1945,104.1,3921,2001,1920,104.2
11220, 서초구,015,10~14세,2018,20960,10674,10286,103.8,20787,10586,10201,103.8
11220, 서초구,015001, 10세,2018,4200,2132,2068,103.1,4154,2110,2044,103.2
11220, 서초구,015002, 11세,2018,4305,2143,2162,99.1,4260,2120,2140,99.1
11220, 서초구,015003, 12세,2018,4001,2053,1948,105.4,3967,2039,1928,105.8
11220, 서초구,015004, 13세,2018,3948,2061,1887,109.2,3927,2048,1879,109
11220, 서초구,015005, 14세,2018,4506,2285,2221,102.9,4479,2269,2210,102.7
11220, 서초구,020,15~19세,2018,21730,10894,10836,100.5,21558,10796,10762,100.3
11220, 서초구,020001, 15세,2018,4167,2121,2046,103.7,4148,2112,2036,103.7
11220, 서초구,020002, 16세,2018,4048,2052,1996,102.8,4019,2034,1985,102.5
11220, 서초구,020003, 17세,2018,4355,2209,2146,102.9,4336,2203,2133,103.3
11220, 서초구,020004, 18세,2018,4691,2345,2346,100,4663,2333,2330,100.1
11220, 서초구,020005, 19세,2018,4469,2167,2302,94.1,4392,2114,2278,92.8
11220, 서초구,025,20~24세,2018,23991,11721,12270,95.5,23443,11414,12029,94.9
11220, 서초구,025001, 20세,2018,4682,2342,2340,100.1,4587,2280,2307,98.8
11220, 서초구,025002, 21세,2018,4630,2327,2303,101,4558,2289,2269,100.9
11220, 서초구,025003, 22세,2018,4771,2342,2429,96.4,4656,2283,2373,96.2
11220, 서초구,025004, 23세,2018,4774,2274,2500,91,4657,2203,2454,89.8
11220, 서초구,025005, 24세,2018,5134,2436,2698,90.3,4985,2359,2626,89.8
11220, 서초구,030,25~29세,2018,29094,13581,15513,87.5,28205,13107,15098,86.8
11220, 서초구,030001, 25세,2018,5481,2527,2954,85.5,5308,2433,2875,84.6
11220, 서초구,030002, 26세,2018,5854,2752,3102,88.7,5695,2655,3040,87.3
11220, 서초구,030003, 27세,2018,5939,2754,3185,86.5,5773,2671,3102,86.1
11220, 서초구,030004, 28세,2018,5834,2793,3041,91.8,5651,2685,2966,90.5
11220, 서초구,030005, 29세,2018,5986,2755,3231,85.3,5778,2663,3115,85.5
11220, 서초구,035,30~34세,2018,29766,13844,15922,86.9,28803,13306,15497,85.9
11220, 서초구,035001, 30세,2018,5864,2730,3134,87.1,5654,2626,3028,86.7
11220, 서초구,035002, 31세,2018,5941,2709,3232,83.8,5744,2590,3154,82.1
11220, 서초구,035003, 32세,2018,5898,2772,3126,88.7,5701,2663,3038,87.7
11220, 서초구,035004, 33세,2018,5906,2753,3153,87.3,5722,2645,3077,86
11220, 서초구,035005, 34세,2018,6157,2880,3277,87.9,5982,2782,3200,86.9
11220, 서초구,040,35~39세,2018,35650,16564,19086,86.8,34759,16065,18694,85.9
11220, 서초구,040001, 35세,2018,6743,3146,3597,87.5,6551,3035,3516,86.3
11220, 서초구,040002, 36세,2018,7147,3361,3786,88.8,6962,3258,3704,88
11220, 서초구,040003, 37세,2018,7218,3297,3921,84.1,7014,3190,3824,83.4
11220, 서초구,040004, 38세,2018,7387,3410,3977,85.7,7244,3330,3914,85.1
11220, 서초구,040005, 39세,2018,7155,3350,3805,88,6988,3252,3736,87
11220, 서초구,045,40~44세,2018,35293,16413,18880,86.9,34614,16062,18552,86.6
11220, 서초구,045001, 40세,2018,6510,3010,3500,86,6367,2945,3422,86.1
11220, 서초구,045002, 41세,2018,7045,3249,3796,85.6,6900,3165,3735,84.7
11220, 서초구,045003, 42세,2018,6933,3101,3832,80.9,6800,3038,3762,80.8
11220, 서초구,045004, 43세,2018,7054,3415,3639,93.8,6927,3350,3577,93.7
11220, 서초구,045005, 44세,2018,7751,3638,4113,88.5,7620,3564,4056,87.9
11220, 서초구,050,45~49세,2018,39893,19511,20382,95.7,39259,19196,20063,95.7
11220, 서초구,050001, 45세,2018,7937,3797,4140,91.7,7808,3723,4085,91.1
11220, 서초구,050002, 46세,2018,8044,3902,4142,94.2,7913,3835,4078,94
11220, 서초구,050003, 47세,2018,8265,4016,4249,94.5,8131,3948,4183,94.4
11220, 서초구,050004, 48세,2018,8010,3960,4050,97.8,7868,3892,3976,97.9
11220, 서초구,050005, 49세,2018,7637,3836,3801,100.9,7539,3798,3741,101.5
11220, 서초구,055,50~54세,2018,31132,15254,15878,96.1,30628,15060,15568,96.7
11220, 서초구,055001, 50세,2018,7093,3473,3620,95.9,6996,3437,3559,96.6
11220, 서초구,055002, 51세,2018,6411,3122,3289,94.9,6300,3074,3226,95.3
11220, 서초구,055003, 52세,2018,5664,2831,2833,99.9,5564,2792,2772,100.7
11220, 서초구,055004, 53세,2018,6107,2994,3113,96.2,6005,2954,3051,96.8
11220, 서초구,055005, 54세,2018,5857,2834,3023,93.7,5763,2803,2960,94.7
11220, 서초구,060,55~59세,2018,28972,13744,15228,90.3,28508,13549,14959,90.6
11220, 서초구,060001, 55세,2018,5866,2839,3027,93.8,5759,2795,2964,94.3
11220, 서초구,060002, 56세,2018,5628,2708,2920,92.7,5526,2662,2864,92.9
11220, 서초구,060003, 57세,2018,5895,2792,3103,90,5810,2756,3054,90.2
11220, 서초구,060004, 58세,2018,5951,2826,3125,90.4,5859,2790,3069,90.9
11220, 서초구,060005, 59세,2018,5632,2579,3053,84.5,5554,2546,3008,84.6
11220, 서초구,065,60~64세,2018,25746,11952,13794,86.6,25357,11797,13560,87
11220, 서초구,065001, 60세,2018,5545,2659,2886,92.1,5458,2630,2828,93
11220, 서초구,065002, 61세,2018,5453,2492,2961,84.2,5363,2458,2905,84.6
11220, 서초구,065003, 62세,2018,5004,2347,2657,88.3,4927,2314,2613,88.6
11220, 서초구,065004, 63세,2018,5331,2396,2935,81.6,5261,2365,2896,81.7
11220, 서초구,065005, 64세,2018,4413,2058,2355,87.4,4348,2030,2318,87.6
11220, 서초구,070,65~69세,2018,18376,8429,9947,84.7,18215,8365,9850,84.9
11220, 서초구,070001, 65세,2018,4189,1877,2312,81.2,4149,1864,2285,81.6
11220, 서초구,070002, 66세,2018,4211,1934,2277,84.9,4171,1921,2250,85.4
11220, 서초구,070003, 67세,2018,3036,1446,1590,90.9,3005,1431,1574,90.9
11220, 서초구,070004, 68세,2018,3434,1582,1852,85.4,3401,1569,1832,85.6
11220, 서초구,070005, 69세,2018,3506,1590,1916,83,3489,1580,1909,82.8
11220, 서초구,075,70~74세,2018,14447,6857,7590,90.3,14366,6830,7536,90.6
11220, 서초구,075001, 70세,2018,3489,1646,1843,89.3,3464,1639,1825,89.8
11220, 서초구,075002, 71세,2018,3322,1539,1783,86.3,3306,1534,1772,86.6
11220, 서초구,075003, 72세,2018,2819,1334,1485,89.8,2805,1329,1476,90
11220, 서초구,075004, 73세,2018,2480,1183,1297,91.2,2468,1180,1288,91.6
11220, 서초구,075005, 74세,2018,2337,1155,1182,97.7,2323,1148,1175,97.7
11220, 서초구,080,75~79세,2018,9669,4788,4881,98.1,9635,4777,4858,98.3
11220, 서초구,080001, 75세,2018,2284,1131,1153,98.1,2279,1130,1149,98.3
11220, 서초구,080002, 76세,2018,2318,1189,1129,105.3,2311,1186,1125,105.4
11220, 서초구,080003, 77세,2018,1914,944,970,97.3,1903,942,961,98
11220, 서초구,080004, 78세,2018,1665,807,858,94.1,1658,803,855,93.9
11220, 서초구,080005, 79세,2018,1488,717,771,93,1484,716,768,93.2
11220, 서초구,085,80~84세,2018,5438,2345,3093,75.8,5413,2338,3075,76
11220, 서초구,085001, 80세,2018,1348,635,713,89.1,1340,634,706,89.8
11220, 서초구,085002, 81세,2018,1260,532,728,73.1,1252,528,724,72.9
11220, 서초구,085003, 82세,2018,1028,461,567,81.3,1026,461,565,81.6
11220, 서초구,085004, 83세,2018,1018,425,593,71.7,1013,423,590,71.7
11220, 서초구,085005, 84세,2018,784,292,492,59.3,782,292,490,59.6
11220, 서초구,090,85~89세,2018,2490,861,1629,52.9,2481,859,1622,53
11220, 서초구,090001, 85세,2018,641,236,405,58.3,639,235,404,58.2
11220, 서초구,090002, 86세,2018,621,242,379,63.9,619,241,378,63.8
11220, 서초구,090003, 87세,2018,428,148,280,52.9,428,148,280,52.9
11220, 서초구,090004, 88세,2018,416,118,298,39.6,414,118,296,39.9
11220, 서초구,090005, 89세,2018,384,117,267,43.8,381,117,264,44.3
11220, 서초구,095,90~94세,2018,1027,252,775,32.5,1021,249,772,32.3
11220, 서초구,095001, 90세,2018,350,78,272,28.7,348,77,271,28.4
11220, 서초구,095002, 91세,2018,249,61,188,32.4,248,60,188,31.9
11220, 서초구,095003, 92세,2018,164,51,113,45.1,164,51,113,45.1
11220, 서초구,095004, 93세,2018,152,36,116,31,151,35,116,30.2
11220, 서초구,095005, 94세,2018,112,26,86,30.2,110,26,84,31
11220, 서초구,100,95~99세,2018,253,59,194,30.4,249,57,192,29.7
11220, 서초구,100001, 95세,2018,106,31,75,41.3,105,31,74,41.9
11220, 서초구,100002, 96세,2018,67,11,56,19.6,67,11,56,19.6
11220, 서초구,100003, 97세,2018,34,5,29,17.2,34,5,29,17.2
11220, 서초구,100004, 98세,2018,26,9,17,52.9,24,8,16,50
11220, 서초구,100005, 99세,2018,20,X,17,17.6,19,X,17,11.8
11220, 서초구,101,100세이상,2018,29,8,21,38.1,29,8,21,38.1
11220, 서초구,102,15세미만,2018,56495,28987,27508,105.4,55805,28625,27180,105.3
11220, 서초구,103,15~64세,2018,301267,143478,157789,90.9,295134,140352,154782,90.7
11220, 서초구,104,65세이상,2018,51729,23599,28130,83.9,51409,23483,27926,84.1
11220, 서초구,086,85세이상,2018,3799,1180,2619,45.1,3780,1173,2607,45
11220, 서초구,126,평균연령,2018,40.5,39.9,41.1,,40.6,40,41.1,
11220, 서초구,127,중위연령,2018,41.2,40.8,41.5,,41.3,41,41.6,
11230, 강남구,000,합계,2018,507810,243579,264231,92.2,498996,238956,260040,91.9
11230, 강남구,005,0~4세,2018,15849,8125,7724,105.2,15638,8008,7630,105
11230, 강남구,005001, 0세,2018,2796,1508,1288,117.1,2761,1485,1276,116.4
11230, 강남구,005002, 1세,2018,2905,1472,1433,102.7,2856,1441,1415,101.8
11230, 강남구,005003, 2세,2018,3215,1579,1636,96.5,3164,1552,1612,96.3
11230, 강남구,005004, 3세,2018,3353,1697,1656,102.5,3316,1682,1634,102.9
11230, 강남구,005005, 4세,2018,3580,1869,1711,109.2,3541,1848,1693,109.2
11230, 강남구,010,5~9세,2018,20727,10732,9995,107.4,20589,10650,9939,107.2
11230, 강남구,010001, 5세,2018,3843,1963,1880,104.4,3814,1943,1871,103.8
11230, 강남구,010002, 6세,2018,4153,2155,1998,107.9,4119,2138,1981,107.9
11230, 강남구,010003, 7세,2018,4334,2275,2059,110.5,4307,2257,2050,110.1
11230, 강남구,010004, 8세,2018,4180,2155,2025,106.4,4157,2140,2017,106.1
11230, 강남구,010005, 9세,2018,4217,2184,2033,107.4,4192,2172,2020,107.5
11230, 강남구,015,10~14세,2018,25240,13218,12022,109.9,25142,13168,11974,110
11230, 강남구,015001, 10세,2018,4793,2512,2281,110.1,4769,2499,2270,110.1
11230, 강남구,015002, 11세,2018,5013,2547,2466,103.3,4992,2540,2452,103.6
11230, 강남구,015003, 12세,2018,4914,2596,2318,112,4895,2588,2307,112.2
11230, 강남구,015004, 13세,2018,5032,2649,2383,111.2,5020,2640,2380,110.9
11230, 강남구,015005, 14세,2018,5488,2914,2574,113.2,5466,2901,2565,113.1
11230, 강남구,020,15~19세,2018,29662,15460,14202,108.9,29446,15329,14117,108.6
11230, 강남구,020001, 15세,2018,5551,2897,2654,109.2,5531,2887,2644,109.2
11230, 강남구,020002, 16세,2018,5411,2829,2582,109.6,5379,2812,2567,109.5
11230, 강남구,020003, 17세,2018,6258,3218,3040,105.9,6233,3205,3028,105.8
11230, 강남구,020004, 18세,2018,6710,3514,3196,109.9,6683,3502,3181,110.1
11230, 강남구,020005, 19세,2018,5732,3002,2730,110,5620,2923,2697,108.4
11230, 강남구,025,20~24세,2018,30354,14964,15390,97.2,29540,14548,14992,97
11230, 강남구,025001, 20세,2018,5776,3000,2776,108.1,5648,2917,2731,106.8
11230, 강남구,025002, 21세,2018,5704,2878,2826,101.8,5591,2818,2773,101.6
11230, 강남구,025003, 22세,2018,6026,3048,2978,102.4,5856,2969,2887,102.8
11230, 강남구,025004, 23세,2018,6147,2944,3203,91.9,5974,2851,3123,91.3
11230, 강남구,025005, 24세,2018,6701,3094,3607,85.8,6471,2993,3478,86.1
11230, 강남구,030,25~29세,2018,38489,18035,20454,88.2,37109,17315,19794,87.5
11230, 강남구,030001, 25세,2018,7152,3362,3790,88.7,6902,3226,3676,87.8
11230, 강남구,030002, 26세,2018,7837,3609,4228,85.4,7586,3476,4110,84.6
11230, 강남구,030003, 27세,2018,7670,3615,4055,89.1,7374,3462,3912,88.5
11230, 강남구,030004, 28세,2018,7789,3656,4133,88.5,7516,3520,3996,88.1
11230, 강남구,030005, 29세,2018,8041,3793,4248,89.3,7731,3631,4100,88.6
11230, 강남구,035,30~34세,2018,38874,18030,20844,86.5,37390,17193,20197,85.1
11230, 강남구,035001, 30세,2018,7744,3543,4201,84.3,7436,3381,4055,83.4
11230, 강남구,035002, 31세,2018,7620,3502,4118,85,7301,3342,3959,84.4
11230, 강남구,035003, 32세,2018,7734,3575,4159,86,7453,3405,4048,84.1
11230, 강남구,035004, 33세,2018,7762,3674,4088,89.9,7462,3491,3971,87.9
11230, 강남구,035005, 34세,2018,8014,3736,4278,87.3,7738,3574,4164,85.8
11230, 강남구,040,35~39세,2018,44043,20326,23717,85.7,42937,19706,23231,84.8
11230, 강남구,040001, 35세,2018,8382,3887,4495,86.5,8144,3752,4392,85.4
11230, 강남구,040002, 36세,2018,8917,4066,4851,83.8,8664,3933,4731,83.1
11230, 강남구,040003, 37세,2018,9092,4228,4864,86.9,8901,4128,4773,86.5
11230, 강남구,040004, 38세,2018,8829,4130,4699,87.9,8622,4006,4616,86.8
11230, 강남구,040005, 39세,2018,8823,4015,4808,83.5,8606,3887,4719,82.4
11230, 강남구,045,40~44세,2018,42509,19625,22884,85.8,41707,19160,22547,85
11230, 강남구,045001, 40세,2018,7989,3765,4224,89.1,7815,3650,4165,87.6
11230, 강남구,045002, 41세,2018,8319,3803,4516,84.2,8150,3711,4439,83.6
11230, 강남구,045003, 42세,2018,8163,3778,4385,86.2,8014,3699,4315,85.7
11230, 강남구,045004, 43세,2018,8696,3987,4709,84.7,8549,3904,4645,84
11230, 강남구,045005, 44세,2018,9342,4292,5050,85,9179,4196,4983,84.2
11230, 강남구,050,45~49세,2018,50800,24348,26452,92,50102,23965,26137,91.7
11230, 강남구,050001, 45세,2018,9519,4392,5127,85.7,9381,4312,5069,85.1
11230, 강남구,050002, 46세,2018,10080,4735,5345,88.6,9922,4652,5270,88.3
11230, 강남구,050003, 47세,2018,10745,5247,5498,95.4,10598,5159,5439,94.9
11230, 강남구,050004, 48세,2018,10373,4999,5374,93,10242,4930,5312,92.8
11230, 강남구,050005, 49세,2018,10083,4975,5108,97.4,9959,4912,5047,97.3
11230, 강남구,055,50~54세,2018,40644,20282,20362,99.6,40105,20034,20071,99.8
11230, 강남구,055001, 50세,2018,9264,4593,4671,98.3,9169,4544,4625,98.2
11230, 강남구,055002, 51세,2018,8401,4112,4289,95.9,8282,4055,4227,95.9
11230, 강남구,055003, 52세,2018,7545,3899,3646,106.9,7424,3845,3579,107.4
11230, 강남구,055004, 53세,2018,7993,3994,3999,99.9,7883,3945,3938,100.2
11230, 강남구,055005, 54세,2018,7441,3684,3757,98.1,7347,3645,3702,98.5
11230, 강남구,060,55~59세,2018,35867,17287,18580,93,35336,17069,18267,93.4
11230, 강남구,060001, 55세,2018,7544,3728,3816,97.7,7416,3676,3740,98.3
11230, 강남구,060002, 56세,2018,7032,3530,3502,100.8,6917,3472,3445,100.8
11230, 강남구,060003, 57세,2018,7309,3459,3850,89.8,7228,3425,3803,90.1
11230, 강남구,060004, 58세,2018,7288,3431,3857,89,7174,3387,3787,89.4
11230, 강남구,060005, 59세,2018,6694,3139,3555,88.3,6601,3109,3492,89
11230, 강남구,065,60~64세,2018,31583,14473,17110,84.6,31165,14312,16853,84.9
11230, 강남구,065001, 60세,2018,6618,3056,3562,85.8,6529,3027,3502,86.4
11230, 강남구,065002, 61세,2018,6731,3145,3586,87.7,6622,3100,3522,88
11230, 강남구,065003, 62세,2018,6201,2876,3325,86.5,6118,2841,3277,86.7
11230, 강남구,065004, 63세,2018,6488,2857,3631,78.7,6410,2822,3588,78.7
11230, 강남구,065005, 64세,2018,5545,2539,3006,84.5,5486,2522,2964,85.1
11230, 강남구,070,65~69세,2018,22725,10459,12266,85.3,22555,10396,12159,85.5
11230, 강남구,070001, 65세,2018,5127,2325,2802,83,5079,2306,2773,83.2
11230, 강남구,070002, 66세,2018,5326,2408,2918,82.5,5274,2388,2886,82.7
11230, 강남구,070003, 67세,2018,3640,1704,1936,88,3613,1695,1918,88.4
11230, 강남구,070004, 68세,2018,4273,1974,2299,85.9,4255,1965,2290,85.8
11230, 강남구,070005, 69세,2018,4359,2048,2311,88.6,4334,2042,2292,89.1
11230, 강남구,075,70~74세,2018,17687,8453,9234,91.5,17595,8402,9193,91.4
11230, 강남구,075001, 70세,2018,4281,2061,2220,92.8,4260,2051,2209,92.8
11230, 강남구,075002, 71세,2018,4150,1888,2262,83.5,4122,1873,2249,83.3
11230, 강남구,075003, 72세,2018,3404,1624,1780,91.2,3385,1613,1772,91
11230, 강남구,075004, 73세,2018,3016,1478,1538,96.1,3001,1468,1533,95.8
11230, 강남구,075005, 74세,2018,2836,1402,1434,97.8,2827,1397,1430,97.7
11230, 강남구,080,75~79세,2018,11615,5662,5953,95.1,11562,5633,5929,95
11230, 강남구,080001, 75세,2018,2687,1307,1380,94.7,2677,1304,1373,95
11230, 강남구,080002, 76세,2018,2808,1428,1380,103.5,2794,1419,1375,103.2
11230, 강남구,080003, 77세,2018,2352,1127,1225,92,2338,1120,1218,92
11230, 강남구,080004, 78세,2018,2014,951,1063,89.5,2008,948,1060,89.4
11230, 강남구,080005, 79세,2018,1754,849,905,93.8,1745,842,903,93.2
11230, 강남구,085,80~84세,2018,6458,2746,3712,74,6421,2728,3693,73.9
11230, 강남구,085001, 80세,2018,1634,740,894,82.8,1625,736,889,82.8
11230, 강남구,085002, 81세,2018,1467,658,809,81.3,1459,654,805,81.2
11230, 강남구,085003, 82세,2018,1233,543,690,78.7,1227,540,687,78.6
11230, 강남구,085004, 83세,2018,1148,446,702,63.5,1141,440,701,62.8
11230, 강남구,085005, 84세,2018,976,359,617,58.2,969,358,611,58.6
11230, 강남구,090,85~89세,2018,3110,970,2140,45.3,3094,962,2132,45.1
11230, 강남구,090001, 85세,2018,798,267,531,50.3,793,267,526,50.8
11230, 강남구,090002, 86세,2018,758,271,487,55.6,756,269,487,55.2
11230, 강남구,090003, 87세,2018,562,156,406,38.4,560,154,406,37.9
11230, 강남구,090004, 88세,2018,525,142,383,37.1,521,139,382,36.4
11230, 강남구,090005, 89세,2018,467,134,333,40.2,464,133,331,40.2
11230, 강남구,095,90~94세,2018,1227,304,923,32.9,1219,299,920,32.5
11230, 강남구,095001, 90세,2018,368,89,279,31.9,365,87,278,31.3
11230, 강남구,095002, 91세,2018,307,76,231,32.9,304,74,230,32.2
11230, 강남구,095003, 92세,2018,215,50,165,30.3,215,50,165,30.3
11230, 강남구,095004, 93세,2018,197,57,140,40.7,196,57,139,41
11230, 강남구,095005, 94세,2018,140,32,108,29.6,139,31,108,28.7
11230, 강남구,100,95~99세,2018,312,72,240,30,311,71,240,29.6
11230, 강남구,100001, 95세,2018,112,23,89,25.8,112,23,89,25.8
11230, 강남구,100002, 96세,2018,76,17,59,28.8,75,16,59,27.1
11230, 강남구,100003, 97세,2018,56,18,38,47.4,56,18,38,47.4
11230, 강남구,100004, 98세,2018,49,10,39,25.6,49,10,39,25.6
11230, 강남구,100005, 99세,2018,19,X,15,26.7,19,X,15,26.7
11230, 강남구,101,100세이상,2018,35,8,27,29.6,33,8,25,32
11230, 강남구,102,15세미만,2018,61816,32075,29741,107.8,61369,31826,29543,107.7
11230, 강남구,103,15~64세,2018,382825,182830,199995,91.4,374837,178631,196206,91
11230, 강남구,104,65세이상,2018,63169,28674,34495,83.1,62790,28499,34291,83.1
11230, 강남구,086,85세이상,2018,4684,1354,3330,40.7,4657,1340,3317,40.4
11230, 강남구,126,평균연령,2018,40.8,40.1,41.5,,40.9,40.2,41.5,
11230, 강남구,127,중위연령,2018,41.3,40.8,41.8,,41.5,41,41.9,
11240, 송파구,000,합계,2018,638167,309442,328725,94.1,628044,304505,323539,94.1
11240, 송파구,005,0~4세,2018,25091,13060,12031,108.6,24852,12936,11916,108.6
11240, 송파구,005001, 0세,2018,4532,2371,2161,109.7,4496,2349,2147,109.4
11240, 송파구,005002, 1세,2018,4780,2479,2301,107.7,4732,2456,2276,107.9
11240, 송파구,005003, 2세,2018,5382,2826,2556,110.6,5315,2786,2529,110.2
11240, 송파구,005004, 3세,2018,5310,2761,2549,108.3,5262,2737,2525,108.4
11240, 송파구,005005, 4세,2018,5087,2623,2464,106.5,5047,2608,2439,106.9
11240, 송파구,010,5~9세,2018,26769,13731,13038,105.3,26618,13656,12962,105.4
11240, 송파구,010001, 5세,2018,5118,2622,2496,105,5079,2602,2477,105
11240, 송파구,010002, 6세,2018,5630,2851,2779,102.6,5600,2839,2761,102.8
11240, 송파구,010003, 7세,2018,5439,2854,2585,110.4,5404,2834,2570,110.3
11240, 송파구,010004, 8세,2018,5428,2781,2647,105.1,5402,2767,2635,105
11240, 송파구,010005, 9세,2018,5154,2623,2531,103.6,5133,2614,2519,103.8
11240, 송파구,015,10~14세,2018,27312,14072,13240,106.3,27227,14030,13197,106.3
11240, 송파구,015001, 10세,2018,5430,2814,2616,107.6,5409,2809,2600,108
11240, 송파구,015002, 11세,2018,5608,2901,2707,107.2,5588,2891,2697,107.2
11240, 송파구,015003, 12세,2018,5313,2696,2617,103,5297,2684,2613,102.7
11240, 송파구,015004, 13세,2018,5268,2731,2537,107.6,5254,2723,2531,107.6
11240, 송파구,015005, 14세,2018,5693,2930,2763,106,5679,2923,2756,106.1
11240, 송파구,020,15~19세,2018,31890,16411,15479,106,31719,16307,15412,105.8
11240, 송파구,020001, 15세,2018,5698,2949,2749,107.3,5687,2943,2744,107.3
11240, 송파구,020002, 16세,2018,5787,2996,2791,107.3,5771,2989,2782,107.4
11240, 송파구,020003, 17세,2018,6608,3401,3207,106,6592,3391,3201,105.9
11240, 송파구,020004, 18세,2018,7186,3667,3519,104.2,7162,3652,3510,104
11240, 송파구,020005, 19세,2018,6611,3398,3213,105.8,6507,3332,3175,104.9
11240, 송파구,025,20~24세,2018,38997,19433,19564,99.3,38431,19157,19274,99.4
11240, 송파구,025001, 20세,2018,6855,3561,3294,108.1,6754,3515,3239,108.5
11240, 송파구,025002, 21세,2018,7384,3894,3490,111.6,7304,3846,3458,111.2
11240, 송파구,025003, 22세,2018,7680,3861,3819,101.1,7587,3815,3772,101.1
11240, 송파구,025004, 23세,2018,8202,3910,4292,91.1,8075,3851,4224,91.2
11240, 송파구,025005, 24세,2018,8876,4207,4669,90.1,8711,4130,4581,90.2
11240, 송파구,030,25~29세,2018,49515,23337,26178,89.1,48442,22822,25620,89.1
11240, 송파구,030001, 25세,2018,9385,4371,5014,87.2,9230,4306,4924,87.4
11240, 송파구,030002, 26세,2018,10075,4666,5409,86.3,9876,4565,5311,86
11240, 송파구,030003, 27세,2018,9919,4704,5215,90.2,9704,4586,5118,89.6
11240, 송파구,030004, 28세,2018,10011,4761,5250,90.7,9765,4652,5113,91
11240, 송파구,030005, 29세,2018,10125,4835,5290,91.4,9867,4713,5154,91.4
11240, 송파구,035,30~34세,2018,51955,24959,26996,92.5,50560,24266,26294,92.3
11240, 송파구,035001, 30세,2018,10104,4839,5265,91.9,9826,4701,5125,91.7
11240, 송파구,035002, 31세,2018,10326,4903,5423,90.4,10026,4750,5276,90
11240, 송파구,035003, 32세,2018,10494,5030,5464,92.1,10216,4892,5324,91.9
11240, 송파구,035004, 33세,2018,10456,5010,5446,92,10175,4870,5305,91.8
11240, 송파구,035005, 34세,2018,10575,5177,5398,95.9,10317,5053,5264,96
11240, 송파구,040,35~39세,2018,57567,27811,29756,93.5,56526,27247,29279,93.1
11240, 송파구,040001, 35세,2018,11503,5537,5966,92.8,11262,5406,5856,92.3
11240, 송파구,040002, 36세,2018,11918,5845,6073,96.2,11686,5721,5965,95.9
11240, 송파구,040003, 37세,2018,11664,5722,5942,96.3,11463,5610,5853,95.8
11240, 송파구,040004, 38세,2018,11556,5521,6035,91.5,11380,5427,5953,91.2
11240, 송파구,040005, 39세,2018,10926,5186,5740,90.3,10735,5083,5652,89.9
11240, 송파구,045,40~44세,2018,49710,24289,25421,95.5,48902,23869,25033,95.4
11240, 송파구,045001, 40세,2018,9566,4659,4907,94.9,9406,4571,4835,94.5
11240, 송파구,045002, 41세,2018,9855,4754,5101,93.2,9706,4676,5030,93
11240, 송파구,045003, 42세,2018,9652,4802,4850,99,9502,4723,4779,98.8
11240, 송파구,045004, 43세,2018,10016,4898,5118,95.7,9845,4815,5030,95.7
11240, 송파구,045005, 44세,2018,10621,5176,5445,95.1,10443,5084,5359,94.9
11240, 송파구,050,45~49세,2018,55709,26931,28778,93.6,54698,26407,28291,93.3
11240, 송파구,050001, 45세,2018,10662,5042,5620,89.7,10501,4952,5549,89.2
11240, 송파구,050002, 46세,2018,11078,5387,5691,94.7,10866,5266,5600,94
11240, 송파구,050003, 47세,2018,11747,5615,6132,91.6,11550,5516,6034,91.4
11240, 송파구,050004, 48세,2018,10979,5420,5559,97.5,10762,5311,5451,97.4
11240, 송파구,050005, 49세,2018,11243,5467,5776,94.7,11019,5362,5657,94.8
11240, 송파구,055,50~54세,2018,49760,24004,25756,93.2,48656,23505,25151,93.5
11240, 송파구,055001, 50세,2018,10815,5107,5708,89.5,10565,5004,5561,90
11240, 송파구,055002, 51세,2018,9864,4755,5109,93.1,9682,4669,5013,93.1
11240, 송파구,055003, 52세,2018,9562,4739,4823,98.3,9355,4647,4708,98.7
11240, 송파구,055004, 53세,2018,9959,4796,5163,92.9,9736,4689,5047,92.9
11240, 송파구,055005, 54세,2018,9560,4607,4953,93,9318,4496,4822,93.2
11240, 송파구,060,55~59세,2018,51488,24336,27152,89.6,50509,23913,26596,89.9
11240, 송파구,060001, 55세,2018,10089,4845,5244,92.4,9833,4725,5108,92.5
11240, 송파구,060002, 56세,2018,9917,4773,5144,92.8,9716,4684,5032,93.1
11240, 송파구,060003, 57세,2018,10630,4947,5683,87,10481,4887,5594,87.4
11240, 송파구,060004, 58세,2018,10897,5008,5889,85,10687,4920,5767,85.3
11240, 송파구,060005, 59세,2018,9955,4763,5192,91.7,9792,4697,5095,92.2
11240, 송파구,065,60~64세,2018,44615,21009,23606,89,43770,20607,23163,89
11240, 송파구,065001, 60세,2018,9635,4588,5047,90.9,9450,4498,4952,90.8
11240, 송파구,065002, 61세,2018,9525,4431,5094,87,9331,4333,4998,86.7
11240, 송파구,065003, 62세,2018,8617,4062,4555,89.2,8455,3990,4465,89.4
11240, 송파구,065004, 63세,2018,9292,4366,4926,88.6,9111,4282,4829,88.7
11240, 송파구,065005, 64세,2018,7546,3562,3984,89.4,7423,3504,3919,89.4
11240, 송파구,070,65~69세,2018,29867,14658,15209,96.4,29476,14475,15001,96.5
11240, 송파구,070001, 65세,2018,6868,3299,3569,92.4,6769,3248,3521,92.2
11240, 송파구,070002, 66세,2018,7225,3570,3655,97.7,7139,3524,3615,97.5
11240, 송파구,070003, 67세,2018,4980,2454,2526,97.1,4898,2421,2477,97.7
11240, 송파구,070004, 68세,2018,5437,2704,2733,98.9,5370,2670,2700,98.9
11240, 송파구,070005, 69세,2018,5357,2631,2726,96.5,5300,2612,2688,97.2
11240, 송파구,075,70~74세,2018,20791,10281,10510,97.8,20655,10226,10429,98.1
11240, 송파구,075001, 70세,2018,4991,2481,2510,98.8,4958,2470,2488,99.3
11240, 송파구,075002, 71세,2018,5143,2549,2594,98.3,5109,2534,2575,98.4
11240, 송파구,075003, 72세,2018,3815,1872,1943,96.3,3783,1859,1924,96.6
11240, 송파구,075004, 73세,2018,3505,1729,1776,97.4,3479,1717,1762,97.4
11240, 송파구,075005, 74세,2018,3337,1650,1687,97.8,3326,1646,1680,98
11240, 송파구,080,75~79세,2018,13771,6492,7279,89.2,13708,6472,7236,89.4
11240, 송파구,080001, 75세,2018,3169,1556,1613,96.5,3158,1551,1607,96.5
11240, 송파구,080002, 76세,2018,3451,1661,1790,92.8,3434,1656,1778,93.1
11240, 송파구,080003, 77세,2018,2653,1227,1426,86,2639,1223,1416,86.4
11240, 송파구,080004, 78세,2018,2333,1074,1259,85.3,2317,1069,1248,85.7
11240, 송파구,080005, 79세,2018,2165,974,1191,81.8,2160,973,1187,82
11240, 송파구,085,80~84세,2018,7743,3096,4647,66.6,7700,3085,4615,66.8
11240, 송파구,085001, 80세,2018,1874,810,1064,76.1,1863,808,1055,76.6
11240, 송파구,085002, 81세,2018,1757,737,1020,72.3,1748,735,1013,72.6
11240, 송파구,085003, 82세,2018,1533,589,944,62.4,1519,584,935,62.5
11240, 송파구,085004, 83세,2018,1420,538,882,61,1417,536,881,60.8
11240, 송파구,085005, 84세,2018,1159,422,737,57.3,1153,422,731,57.7
11240, 송파구,090,85~89세,2018,3847,1112,2735,40.7,3830,1106,2724,40.6
11240, 송파구,090001, 85세,2018,1060,318,742,42.9,1053,316,737,42.9
11240, 송파구,090002, 86세,2018,925,284,641,44.3,923,284,639,44.4
11240, 송파구,090003, 87세,2018,691,206,485,42.5,688,204,484,42.1
11240, 송파구,090004, 88세,2018,612,163,449,36.3,610,163,447,36.5
11240, 송파구,090005, 89세,2018,559,141,418,33.7,556,139,417,33.3
11240, 송파구,095,90~94세,2018,1405,336,1069,31.4,1401,335,1066,31.4
11240, 송파구,095001, 90세,2018,452,126,326,38.7,452,126,326,38.7
11240, 송파구,095002, 91세,2018,372,85,287,29.6,369,84,285,29.5
11240, 송파구,095003, 92세,2018,250,50,200,25,250,50,200,25
11240, 송파구,095004, 93세,2018,193,39,154,25.3,192,39,153,25.5
11240, 송파구,095005, 94세,2018,138,36,102,35.3,138,36,102,35.3
11240, 송파구,100,95~99세,2018,329,79,250,31.6,328,79,249,31.7
11240, 송파구,100001, 95세,2018,133,30,103,29.1,133,30,103,29.1
11240, 송파구,100002, 96세,2018,75,16,59,27.1,75,16,59,27.1
11240, 송파구,100003, 97세,2018,57,15,42,35.7,57,15,42,35.7
11240, 송파구,100004, 98세,2018,39,9,30,30,38,9,29,31
11240, 송파구,100005, 99세,2018,25,9,16,56.3,25,9,16,56.3
11240, 송파구,101,100세이상,2018,36,5,31,16.1,36,5,31,16.1
11240, 송파구,102,15세미만,2018,79172,40863,38309,106.7,78697,40622,38075,106.7
11240, 송파구,103,15~64세,2018,481206,232520,248686,93.5,472213,228100,244113,93.4
11240, 송파구,104,65세이상,2018,77789,36059,41730,86.4,77134,35783,41351,86.5
11240, 송파구,086,85세이상,2018,5617,1532,4085,37.5,5595,1525,4070,37.5
11240, 송파구,126,평균연령,2018,40.9,40.2,41.5,,40.9,40.2,41.5,
11240, 송파구,127,중위연령,2018,41,40.4,41.6,,41,40.4,41.6,
11250, 강동구,000,합계,2018,414231,204752,209479,97.7,407847,201718,206129,97.9
11250, 강동구,005,0~4세,2018,14963,7684,7279,105.6,14837,7625,7212,105.7
11250, 강동구,005001, 0세,2018,2614,1337,1277,104.7,2595,1330,1265,105.1
11250, 강동구,005002, 1세,2018,2774,1417,1357,104.4,2746,1405,1341,104.8
11250, 강동구,005003, 2세,2018,3100,1608,1492,107.8,3072,1595,1477,108
11250, 강동구,005004, 3세,2018,3189,1637,1552,105.5,3163,1620,1543,105
11250, 강동구,005005, 4세,2018,3286,1685,1601,105.2,3261,1675,1586,105.6
11250, 강동구,010,5~9세,2018,16280,8467,7813,108.4,16210,8432,7778,108.4
11250, 강동구,010001, 5세,2018,3018,1541,1477,104.3,3004,1532,1472,104.1
11250, 강동구,010002, 6세,2018,3441,1803,1638,110.1,3426,1798,1628,110.4
11250, 강동구,010003, 7세,2018,3306,1742,1564,111.4,3294,1735,1559,111.3
11250, 강동구,010004, 8세,2018,3365,1778,1587,112,3345,1769,1576,112.2
11250, 강동구,010005, 9세,2018,3150,1603,1547,103.6,3141,1598,1543,103.6
11250, 강동구,015,10~14세,2018,16906,8995,7911,113.7,16860,8974,7886,113.8
11250, 강동구,015001, 10세,2018,3480,1874,1606,116.7,3469,1869,1600,116.8
11250, 강동구,015002, 11세,2018,3490,1880,1610,116.8,3478,1875,1603,117
11250, 강동구,015003, 12세,2018,3238,1708,1530,111.6,3234,1705,1529,111.5
11250, 강동구,015004, 13세,2018,3109,1659,1450,114.4,3098,1655,1443,114.7
11250, 강동구,015005, 14세,2018,3589,1874,1715,109.3,3581,1870,1711,109.3
11250, 강동구,020,15~19세,2018,20252,10726,9526,112.6,20176,10690,9486,112.7
11250, 강동구,020001, 15세,2018,3639,1915,1724,111.1,3632,1912,1720,111.2
11250, 강동구,020002, 16세,2018,3738,2014,1724,116.8,3725,2012,1713,117.5
11250, 강동구,020003, 17세,2018,4248,2283,1965,116.2,4237,2278,1959,116.3
11250, 강동구,020004, 18세,2018,4591,2400,2191,109.5,4577,2395,2182,109.8
11250, 강동구,020005, 19세,2018,4036,2114,1922,110,4005,2093,1912,109.5
11250, 강동구,025,20~24세,2018,24746,12736,12010,106,24430,12582,11848,106.2
11250, 강동구,025001, 20세,2018,4380,2276,2104,108.2,4339,2258,2081,108.5
11250, 강동구,025002, 21세,2018,4707,2547,2160,117.9,4656,2524,2132,118.4
11250, 강동구,025003, 22세,2018,4965,2573,2392,107.6,4907,2542,2365,107.5
11250, 강동구,025004, 23세,2018,5325,2723,2602,104.7,5228,2675,2553,104.8
11250, 강동구,025005, 24세,2018,5369,2617,2752,95.1,5300,2583,2717,95.1
11250, 강동구,030,25~29세,2018,30099,15094,15005,100.6,29469,14790,14679,100.8
11250, 강동구,030001, 25세,2018,5940,2943,2997,98.2,5831,2885,2946,97.9
11250, 강동구,030002, 26세,2018,6284,3151,3133,100.6,6167,3091,3076,100.5
11250, 강동구,030003, 27세,2018,6072,3038,3034,100.1,5945,2973,2972,100
11250, 강동구,030004, 28세,2018,5977,3042,2935,103.6,5842,2984,2858,104.4
11250, 강동구,030005, 29세,2018,5826,2920,2906,100.5,5684,2857,2827,101.1
11250, 강동구,035,30~34세,2018,30130,15144,14986,101.1,29365,14752,14613,101
11250, 강동구,035001, 30세,2018,5949,3008,2941,102.3,5798,2931,2867,102.2
11250, 강동구,035002, 31세,2018,5831,2881,2950,97.7,5674,2800,2874,97.4
11250, 강동구,035003, 32세,2018,5889,2929,2960,99,5720,2838,2882,98.5
11250, 강동구,035004, 33세,2018,6062,3059,3003,101.9,5922,2987,2935,101.8
11250, 강동구,035005, 34세,2018,6399,3267,3132,104.3,6251,3196,3055,104.6
11250, 강동구,040,35~39세,2018,35417,17863,17554,101.8,34789,17561,17228,101.9
11250, 강동구,040001, 35세,2018,6673,3359,3314,101.4,6555,3304,3251,101.6
11250, 강동구,040002, 36세,2018,7242,3634,3608,100.7,7097,3569,3528,101.2
11250, 강동구,040003, 37세,2018,7305,3708,3597,103.1,7195,3656,3539,103.3
11250, 강동구,040004, 38세,2018,7229,3691,3538,104.3,7102,3624,3478,104.2
11250, 강동구,040005, 39세,2018,6968,3471,3497,99.3,6840,3408,3432,99.3
11250, 강동구,045,40~44세,2018,31287,15758,15529,101.5,30772,15490,15282,101.4
11250, 강동구,045001, 40세,2018,6196,3122,3074,101.6,6081,3054,3027,100.9
11250, 강동구,045002, 41세,2018,6228,3112,3116,99.9,6119,3055,3064,99.7
11250, 강동구,045003, 42세,2018,6048,3124,2924,106.8,5941,3072,2869,107.1
11250, 강동구,045004, 43세,2018,6167,3054,3113,98.1,6083,3015,3068,98.3
11250, 강동구,045005, 44세,2018,6648,3346,3302,101.3,6548,3294,3254,101.2
11250, 강동구,050,45~49세,2018,35355,17480,17875,97.8,34663,17141,17522,97.8
11250, 강동구,050001, 45세,2018,6878,3370,3508,96.1,6759,3311,3448,96
11250, 강동구,050002, 46세,2018,7030,3527,3503,100.7,6903,3460,3443,100.5
11250, 강동구,050003, 47세,2018,7281,3670,3611,101.6,7122,3599,3523,102.2
11250, 강동구,050004, 48세,2018,7065,3445,3620,95.2,6919,3375,3544,95.2
11250, 강동구,050005, 49세,2018,7101,3468,3633,95.5,6960,3396,3564,95.3
11250, 강동구,055,50~54세,2018,33184,16077,17107,94,32526,15787,16739,94.3
11250, 강동구,055001, 50세,2018,7210,3532,3678,96,7080,3472,3608,96.2
11250, 강동구,055002, 51세,2018,6483,3077,3406,90.3,6374,3037,3337,91
11250, 강동구,055003, 52세,2018,6352,3197,3155,101.3,6220,3145,3075,102.3
11250, 강동구,055004, 53세,2018,6556,3114,3442,90.5,6421,3057,3364,90.9
11250, 강동구,055005, 54세,2018,6583,3157,3426,92.1,6431,3076,3355,91.7
11250, 강동구,060,55~59세,2018,36716,17470,19246,90.8,35964,17137,18827,91
11250, 강동구,060001, 55세,2018,6812,3313,3499,94.7,6620,3231,3389,95.3
11250, 강동구,060002, 56세,2018,7222,3532,3690,95.7,7058,3461,3597,96.2
11250, 강동구,060003, 57세,2018,7666,3591,4075,88.1,7557,3549,4008,88.5
11250, 강동구,060004, 58세,2018,7845,3654,4191,87.2,7686,3572,4114,86.8
11250, 강동구,060005, 59세,2018,7171,3380,3791,89.2,7043,3324,3719,89.4
11250, 강동구,065,60~64세,2018,31925,15139,16786,90.2,31265,14824,16441,90.2
11250, 강동구,065001, 60세,2018,6819,3275,3544,92.4,6662,3206,3456,92.8
11250, 강동구,065002, 61세,2018,6817,3261,3556,91.7,6675,3185,3490,91.3
11250, 강동구,065003, 62세,2018,6291,2947,3344,88.1,6153,2883,3270,88.2
11250, 강동구,065004, 63세,2018,6492,3033,3459,87.7,6367,2976,3391,87.8
11250, 강동구,065005, 64세,2018,5506,2623,2883,91,5408,2574,2834,90.8
11250, 강동구,070,65~69세,2018,21413,10431,10982,95,21133,10298,10835,95
11250, 강동구,070001, 65세,2018,4824,2340,2484,94.2,4735,2295,2440,94.1
11250, 강동구,070002, 66세,2018,5171,2488,2683,92.7,5106,2461,2645,93
11250, 강동구,070003, 67세,2018,3530,1736,1794,96.8,3474,1705,1769,96.4
11250, 강동구,070004, 68세,2018,3896,1918,1978,97,3849,1894,1955,96.9
11250, 강동구,070005, 69세,2018,3992,1949,2043,95.4,3969,1943,2026,95.9
11250, 강동구,075,70~74세,2018,15286,7554,7732,97.7,15197,7519,7678,97.9
11250, 강동구,075001, 70세,2018,3837,1949,1888,103.2,3809,1935,1874,103.3
11250, 강동구,075002, 71세,2018,3625,1711,1914,89.4,3602,1705,1897,89.9
11250, 강동구,075003, 72세,2018,2736,1378,1358,101.5,2720,1371,1349,101.6
11250, 강동구,075004, 73세,2018,2588,1301,1287,101.1,2581,1299,1282,101.3
11250, 강동구,075005, 74세,2018,2500,1215,1285,94.6,2485,1209,1276,94.7
11250, 강동구,080,75~79세,2018,10307,4877,5430,89.8,10264,4866,5398,90.1
11250, 강동구,080001, 75세,2018,2379,1159,1220,95,2365,1156,1209,95.6
11250, 강동구,080002, 76세,2018,2565,1237,1328,93.1,2556,1234,1322,93.3
11250, 강동구,080003, 77세,2018,2045,982,1063,92.4,2040,980,1060,92.5
11250, 강동구,080004, 78세,2018,1701,792,909,87.1,1691,790,901,87.7
11250, 강동구,080005, 79세,2018,1617,707,910,77.7,1612,706,906,77.9
11250, 강동구,085,80~84세,2018,5728,2159,3569,60.5,5705,2156,3549,60.7
11250, 강동구,085001, 80세,2018,1413,611,802,76.2,1404,610,794,76.8
11250, 강동구,085002, 81세,2018,1271,498,773,64.4,1266,496,770,64.4
11250, 강동구,085003, 82세,2018,1110,429,681,63,1109,429,680,63.1
11250, 강동구,085004, 83세,2018,1058,348,710,49,1053,348,705,49.4
11250, 강동구,085005, 84세,2018,876,273,603,45.3,873,273,600,45.5
11250, 강동구,090,85~89세,2018,2831,815,2016,40.4,2819,812,2007,40.5
11250, 강동구,090001, 85세,2018,713,236,477,49.5,707,234,473,49.5
11250, 강동구,090002, 86세,2018,646,186,460,40.4,642,186,456,40.8
11250, 강동구,090003, 87세,2018,504,136,368,37,502,135,367,36.8
11250, 강동구,090004, 88세,2018,525,140,385,36.4,525,140,385,36.4
11250, 강동구,090005, 89세,2018,443,117,326,35.9,443,117,326,35.9
11250, 강동구,095,90~94세,2018,1103,220,883,24.9,1101,220,881,25
11250, 강동구,095001, 90세,2018,364,77,287,26.8,364,77,287,26.8
11250, 강동구,095002, 91세,2018,275,52,223,23.3,275,52,223,23.3
11250, 강동구,095003, 92세,2018,205,42,163,25.8,204,42,162,25.9
11250, 강동구,095004, 93세,2018,158,20,138,14.5,157,20,137,14.6
11250, 강동구,095005, 94세,2018,101,29,72,40.3,101,29,72,40.3
11250, 강동구,100,95~99세,2018,270,59,211,28,269,58,211,27.5
11250, 강동구,100001, 95세,2018,110,24,86,27.9,109,23,86,26.7
11250, 강동구,100002, 96세,2018,63,14,49,28.6,63,14,49,28.6
11250, 강동구,100003, 97세,2018,40,10,30,33.3,40,10,30,33.3
11250, 강동구,100004, 98세,2018,34,6,28,21.4,34,6,28,21.4
11250, 강동구,100005, 99세,2018,23,5,18,27.8,23,5,18,27.8
11250, 강동구,101,100세이상,2018,33,X,29,13.8,33,X,29,13.8
11250, 강동구,102,15세미만,2018,48149,25146,23003,109.3,47907,25031,22876,109.4
11250, 강동구,103,15~64세,2018,309111,153487,155624,98.6,303419,150754,152665,98.7
11250, 강동구,104,65세이상,2018,56971,26119,30852,84.7,56521,25933,30588,84.8
11250, 강동구,086,85세이상,2018,4237,1098,3139,35,4222,1094,3128,35
11250, 강동구,126,평균연령,2018,42.2,41.2,43.1,,42.2,41.2,43.1,
11250, 강동구,127,중위연령,2018,43,41.8,44.1,,42.9,41.8,44.1,
21,부산광역시,000,합계,2018,3395278,1668984,1726294,96.7,3339772,1637363,1702409,96.2
21,부산광역시,005,0~4세,2018,117270,60290,56980,105.8,116669,59985,56684,105.8
21,부산광역시,005001, 0세,2018,19509,10099,9410,107.3,19391,10029,9362,107.1
21,부산광역시,005002, 1세,2018,21578,11094,10484,105.8,21430,11011,10419,105.7
21,부산광역시,005003, 2세,2018,24669,12548,12121,103.5,24535,12479,12056,103.5
21,부산광역시,005004, 3세,2018,25949,13335,12614,105.7,25852,13295,12557,105.9
21,부산광역시,005005, 4세,2018,25565,13214,12351,107,25461,13171,12290,107.2
21,부산광역시,010,5~9세,2018,130641,67067,63574,105.5,130248,66874,63374,105.5
21,부산광역시,010001, 5세,2018,25591,13097,12494,104.8,25493,13052,12441,104.9
21,부산광역시,010002, 6세,2018,27648,14239,13409,106.2,27553,14194,13359,106.3
21,부산광역시,010003, 7세,2018,27202,13841,13361,103.6,27148,13814,13334,103.6
21,부산광역시,010004, 8세,2018,25698,13275,12423,106.9,25619,13236,12383,106.9
21,부산광역시,010005, 9세,2018,24502,12615,11887,106.1,24435,12578,11857,106.1
21,부산광역시,015,10~14세,2018,127020,65535,61485,106.6,126712,65384,61328,106.6
21,부산광역시,015001, 10세,2018,25634,13171,12463,105.7,25576,13137,12439,105.6
21,부산광역시,015002, 11세,2018,26282,13468,12814,105.1,26215,13443,12772,105.3
21,부산광역시,015003, 12세,2018,24135,12528,11607,107.9,24080,12504,11576,108
21,부산광역시,015004, 13세,2018,24279,12544,11735,106.9,24224,12523,11701,107
21,부산광역시,015005, 14세,2018,26690,13824,12866,107.4,26617,13777,12840,107.3
21,부산광역시,020,15~19세,2018,170236,88659,81577,108.7,167691,87409,80282,108.9
21,부산광역시,020001, 15세,2018,27543,14388,13155,109.4,27469,14353,13116,109.4
21,부산광역시,020002, 16세,2018,28271,14657,13614,107.7,28166,14612,13554,107.8
21,부산광역시,020003, 17세,2018,33468,17700,15768,112.3,33283,17598,15685,112.2
21,부산광역시,020004, 18세,2018,38970,20404,18566,109.9,38420,20159,18261,110.4
21,부산광역시,020005, 19세,2018,41984,21510,20474,105.1,40353,20687,19666,105.2
21,부산광역시,025,20~24세,2018,234572,123137,111435,110.5,223664,117664,106000,111
21,부산광역시,025001, 20세,2018,43778,21944,21834,100.5,41428,20881,20547,101.6
21,부산광역시,025002, 21세,2018,44989,23074,21915,105.3,42889,22045,20844,105.8
21,부산광역시,025003, 22세,2018,48392,25762,22630,113.8,46248,24665,21583,114.3
21,부산광역시,025004, 23세,2018,48447,25987,22460,115.7,46285,24855,21430,116
21,부산광역시,025005, 24세,2018,48966,26370,22596,116.7,46814,25218,21596,116.8
21,부산광역시,030,25~29세,2018,223464,118685,104779,113.3,213372,112650,100722,111.8
21,부산광역시,030001, 25세,2018,48507,26309,22198,118.5,46406,25101,21305,117.8
21,부산광역시,030002, 26세,2018,48202,25758,22444,114.8,46207,24565,21642,113.5
21,부산광역시,030003, 27세,2018,44312,23449,20863,112.4,42291,22200,20091,110.5
21,부산광역시,030004, 28세,2018,41795,21979,19816,110.9,39770,20767,19003,109.3
21,부산광역시,030005, 29세,2018,40648,21190,19458,108.9,38698,20017,18681,107.2
21,부산광역시,035,30~34세,2018,197580,102511,95069,107.8,188522,96711,91811,105.3
21,부산광역시,035001, 30세,2018,38737,20100,18637,107.8,36800,18916,17884,105.8
21,부산광역시,035002, 31세,2018,38613,19948,18665,106.9,36689,18731,17958,104.3
21,부산광역시,035003, 32세,2018,38859,20333,18526,109.8,37010,19171,17839,107.5
21,부산광역시,035004, 33세,2018,39564,20535,19029,107.9,37863,19387,18476,104.9
21,부산광역시,035005, 34세,2018,41807,21595,20212,106.8,40160,20506,19654,104.3
21,부산광역시,040,35~39세,2018,253798,130059,123739,105.1,247250,125812,121438,103.6
21,부산광역시,040001, 35세,2018,46335,23718,22617,104.9,44875,22777,22098,103.1
21,부산광역시,040002, 36세,2018,50977,26206,24771,105.8,49460,25225,24235,104.1
21,부산광역시,040003, 37세,2018,52328,26929,25399,106,51086,26119,24967,104.6
21,부산광역시,040004, 38세,2018,53751,27601,26150,105.5,52557,26822,25735,104.2
21,부산광역시,040005, 39세,2018,50407,25605,24802,103.2,49272,24869,24403,101.9
21,부산광역시,045,40~44세,2018,236317,120333,115984,103.7,231875,117597,114278,102.9
21,부산광역시,045001, 40세,2018,45803,23653,22150,106.8,44804,23012,21792,105.6
21,부산광역시,045002, 41세,2018,45780,23382,22398,104.4,44848,22806,22042,103.5
21,부산광역시,045003, 42세,2018,44525,22763,21762,104.6,43648,22244,21404,103.9
21,부산광역시,045004, 43세,2018,48127,24234,23893,101.4,47295,23720,23575,100.6
21,부산광역시,045005, 44세,2018,52082,26301,25781,102,51280,25815,25465,101.4
21,부산광역시,050,45~49세,2018,276778,137022,139756,98,273156,134967,138189,97.7
21,부산광역시,050001, 45세,2018,53234,26522,26712,99.3,52431,26059,26372,98.8
21,부산광역시,050002, 46세,2018,53822,27138,26684,101.7,53104,26707,26397,101.2
21,부산광역시,050003, 47세,2018,56897,28090,28807,97.5,56173,27671,28502,97.1
21,부산광역시,050004, 48세,2018,56257,27725,28532,97.2,55534,27340,28194,97
21,부산광역시,050005, 49세,2018,56568,27547,29021,94.9,55914,27190,28724,94.7
21,부산광역시,055,50~54세,2018,269069,129854,139215,93.3,266478,128547,137931,93.2
21,부산광역시,055001, 50세,2018,57312,27708,29604,93.6,56749,27434,29315,93.6
21,부산광역시,055002, 51세,2018,54180,25766,28414,90.7,53637,25475,28162,90.5
21,부산광역시,055003, 52세,2018,52852,26023,26829,97,52328,25757,26571,96.9
21,부산광역시,055004, 53세,2018,53397,25407,27990,90.8,52912,25164,27748,90.7
21,부산광역시,055005, 54세,2018,51328,24950,26378,94.6,50852,24717,26135,94.6
21,부산광역시,060,55~59세,2018,308391,146553,161838,90.6,306445,145628,160817,90.6
21,부산광역시,060001, 55세,2018,56551,27334,29217,93.6,56025,27085,28940,93.6
21,부산광역시,060002, 56세,2018,60243,29031,31212,93,59793,28823,30970,93.1
21,부산광역시,060003, 57세,2018,65473,30688,34785,88.2,65157,30538,34619,88.2
21,부산광역시,060004, 58세,2018,66098,31000,35098,88.3,65713,30816,34897,88.3
21,부산광역시,060005, 59세,2018,60026,28500,31526,90.4,59757,28366,31391,90.4
21,부산광역시,065,60~64세,2018,276347,131953,144394,91.4,275048,131314,143734,91.4
21,부산광역시,065001, 60세,2018,58239,28042,30197,92.9,57932,27885,30047,92.8
21,부산광역시,065002, 61세,2018,58481,27816,30665,90.7,58195,27673,30522,90.7
21,부산광역시,065003, 62세,2018,54742,26093,28649,91.1,54494,25973,28521,91.1
21,부산광역시,065004, 63세,2018,56977,26596,30381,87.5,56747,26486,30261,87.5
21,부산광역시,065005, 64세,2018,47908,23406,24502,95.5,47680,23297,24383,95.5
21,부산광역시,070,65~69세,2018,198815,93440,105375,88.7,198202,93153,105049,88.7
21,부산광역시,070001, 65세,2018,42604,19882,22722,87.5,42431,19809,22622,87.6
21,부산광역시,070002, 66세,2018,45341,21446,23895,89.8,45194,21372,23822,89.7
21,부산광역시,070003, 67세,2018,36507,17223,19284,89.3,36398,17172,19226,89.3
21,부산광역시,070004, 68세,2018,36727,17362,19365,89.7,36619,17314,19305,89.7
21,부산광역시,070005, 69세,2018,37636,17527,20109,87.2,37560,17486,20074,87.1
21,부산광역시,075,70~74세,2018,146932,67877,79055,85.9,146684,67757,78927,85.8
21,부산광역시,075001, 70세,2018,36283,16901,19382,87.2,36213,16868,19345,87.2
21,부산광역시,075002, 71세,2018,34227,15764,18463,85.4,34172,15736,18436,85.4
21,부산광역시,075003, 72세,2018,25440,11975,13465,88.9,25393,11950,13443,88.9
21,부산광역시,075004, 73세,2018,24981,11487,13494,85.1,24944,11470,13474,85.1
21,부산광역시,075005, 74세,2018,26001,11750,14251,82.5,25962,11733,14229,82.5
21,부산광역시,080,75~79세,2018,119267,51114,68153,75,119119,51060,68059,75
21,부산광역시,080001, 75세,2018,26550,11921,14629,81.5,26521,11911,14610,81.5
21,부산광역시,080002, 76세,2018,28289,12546,15743,79.7,28257,12529,15728,79.7
21,부산광역시,080003, 77세,2018,23446,9913,13533,73.3,23417,9903,13514,73.3
21,부산광역시,080004, 78세,2018,21076,8720,12356,70.6,21047,8715,12332,70.7
21,부산광역시,080005, 79세,2018,19906,8014,11892,67.4,19877,8002,11875,67.4
21,부산광역시,085,80~84세,2018,67136,24403,42733,57.1,67051,24380,42671,57.1
21,부산광역시,085001, 80세,2018,16594,6531,10063,64.9,16564,6525,10039,65
21,부산광역시,085002, 81세,2018,15313,5801,9512,61,15294,5796,9498,61
21,부산광역시,085003, 82세,2018,13137,4744,8393,56.5,13119,4738,8381,56.5
21,부산광역시,085004, 83세,2018,12074,4070,8004,50.8,12066,4067,7999,50.8
21,부산광역시,085005, 84세,2018,10018,3257,6761,48.2,10008,3254,6754,48.2
21,부산광역시,090,85~89세,2018,29656,8195,21461,38.2,29619,8182,21437,38.2
21,부산광역시,090001, 85세,2018,8213,2571,5642,45.6,8196,2567,5629,45.6
21,부산광역시,090002, 86세,2018,7174,2048,5126,40,7163,2044,5119,39.9
21,부산광역시,090003, 87세,2018,5520,1449,4071,35.6,5518,1448,4070,35.6
21,부산광역시,090004, 88세,2018,4649,1118,3531,31.7,4647,1116,3531,31.6
21,부산광역시,090005, 89세,2018,4100,1009,3091,32.6,4095,1007,3088,32.6
21,부산광역시,095,90~94세,2018,9707,1898,7809,24.3,9691,1893,7798,24.3
21,부산광역시,095001, 90세,2018,3320,680,2640,25.8,3314,679,2635,25.8
21,부산광역시,095002, 91세,2018,2565,511,2054,24.9,2562,511,2051,24.9
21,부산광역시,095003, 92세,2018,1598,311,1287,24.2,1594,309,1285,24
21,부산광역시,095004, 93세,2018,1346,235,1111,21.2,1343,233,1110,21
21,부산광역시,095005, 94세,2018,878,161,717,22.5,878,161,717,22.5
21,부산광역시,100,95~99세,2018,2063,375,1688,22.2,2057,372,1685,22.1
21,부산광역시,100001, 95세,2018,809,144,665,21.7,808,144,664,21.7
21,부산광역시,100002, 96세,2018,528,102,426,23.9,527,101,426,23.7
21,부산광역시,100003, 97세,2018,335,51,284,18,333,50,283,17.7
21,부산광역시,100004, 98세,2018,236,41,195,21,235,40,195,20.5
21,부산광역시,100005, 99세,2018,155,37,118,31.4,154,37,117,31.6
21,부산광역시,101,100세이상,2018,219,24,195,12.3,219,24,195,12.3
21,부산광역시,102,15세미만,2018,374931,192892,182039,106,373629,192243,181386,106
21,부산광역시,103,15~64세,2018,2446552,1228766,1217786,100.9,2393501,1198299,1195202,100.3
21,부산광역시,104,65세이상,2018,573795,247326,326469,75.8,572642,246821,325821,75.8
21,부산광역시,086,85세이상,2018,41645,10492,31153,33.7,41586,10471,31115,33.7
21,부산광역시,126,평균연령,2018,43.6,42.2,44.9,,43.8,42.4,45.1,
21,부산광역시,127,중위연령,2018,45.1,43.4,46.8,,45.5,43.8,47.1,
21004, 읍부,000,합계,2018,143925,71111,72814,97.7,141619,69474,72145,96.3
21004, 읍부,005,0~4세,2018,8916,4500,4416,101.9,8897,4488,4409,101.8
21004, 읍부,005001, 0세,2018,1376,685,691,99.1,1372,682,690,98.8
21004, 읍부,005002, 1세,2018,1608,829,779,106.4,1606,828,778,106.4
21004, 읍부,005003, 2세,2018,1876,906,970,93.4,1874,905,969,93.4
21004, 읍부,005004, 3세,2018,2018,1021,997,102.4,2012,1017,995,102.2
21004, 읍부,005005, 4세,2018,2038,1059,979,108.2,2033,1056,977,108.1
21004, 읍부,010,5~9세,2018,9779,4981,4798,103.8,9771,4979,4792,103.9
21004, 읍부,010001, 5세,2018,2048,1054,994,106,2045,1053,992,106.1
21004, 읍부,010002, 6세,2018,2110,1091,1019,107.1,2107,1091,1016,107.4
21004, 읍부,010003, 7세,2018,2085,1062,1023,103.8,2083,1061,1022,103.8
21004, 읍부,010004, 8세,2018,1834,918,916,100.2,1834,918,916,100.2
21004, 읍부,010005, 9세,2018,1702,856,846,101.2,1702,856,846,101.2
21004, 읍부,015,10~14세,2018,7925,4187,3738,112,7917,4182,3735,112
21004, 읍부,015001, 10세,2018,1731,919,812,113.2,1729,918,811,113.2
21004, 읍부,015002, 11세,2018,1730,905,825,109.7,1730,905,825,109.7
21004, 읍부,015003, 12세,2018,1453,764,689,110.9,1451,762,689,110.6
21004, 읍부,015004, 13세,2018,1470,785,685,114.6,1469,785,684,114.8
21004, 읍부,015005, 14세,2018,1541,814,727,112,1538,812,726,111.8
21004, 읍부,020,15~19세,2018,7114,3667,3447,106.4,7083,3645,3438,106
21004, 읍부,020001, 15세,2018,1462,755,707,106.8,1459,754,705,107
21004, 읍부,020002, 16세,2018,1432,737,695,106,1429,736,693,106.2
21004, 읍부,020003, 17세,2018,1550,808,742,108.9,1541,799,742,107.7
21004, 읍부,020004, 18세,2018,1580,792,788,100.5,1574,787,787,100
21004, 읍부,020005, 19세,2018,1090,575,515,111.7,1080,569,511,111.4
21004, 읍부,025,20~24세,2018,6312,3502,2810,124.6,6057,3314,2743,120.8
21004, 읍부,025001, 20세,2018,1182,664,518,128.2,1169,653,516,126.6
21004, 읍부,025002, 21세,2018,1225,724,501,144.5,1199,709,490,144.7
21004, 읍부,025003, 22세,2018,1279,703,576,122,1228,668,560,119.3
21004, 읍부,025004, 23세,2018,1307,713,594,120,1229,653,576,113.4
21004, 읍부,025005, 24세,2018,1319,698,621,112.4,1232,631,601,105
21004, 읍부,030,25~29세,2018,7017,3673,3344,109.8,6559,3327,3232,102.9
21004, 읍부,030001, 25세,2018,1363,703,660,106.5,1285,647,638,101.4
21004, 읍부,030002, 26세,2018,1361,734,627,117.1,1275,664,611,108.7
21004, 읍부,030003, 27세,2018,1457,765,692,110.5,1356,689,667,103.3
21004, 읍부,030004, 28세,2018,1373,729,644,113.2,1268,655,613,106.9
21004, 읍부,030005, 29세,2018,1463,742,721,102.9,1375,672,703,95.6
21004, 읍부,035,30~34세,2018,9335,4628,4707,98.3,8794,4211,4583,91.9
21004, 읍부,035001, 30세,2018,1627,830,797,104.1,1503,732,771,94.9
21004, 읍부,035002, 31세,2018,1673,812,861,94.3,1559,732,827,88.5
21004, 읍부,035003, 32세,2018,1808,882,926,95.2,1708,800,908,88.1
21004, 읍부,035004, 33세,2018,1931,978,953,102.6,1836,904,932,97
21004, 읍부,035005, 34세,2018,2296,1126,1170,96.2,2188,1043,1145,91.1
21004, 읍부,040,35~39세,2018,15568,7748,7820,99.1,15215,7487,7728,96.9
21004, 읍부,040001, 35세,2018,2612,1246,1366,91.2,2529,1187,1342,88.5
21004, 읍부,040002, 36세,2018,3089,1540,1549,99.4,3002,1475,1527,96.6
21004, 읍부,040003, 37세,2018,3239,1642,1597,102.8,3166,1586,1580,100.4
21004, 읍부,040004, 38세,2018,3432,1708,1724,99.1,3374,1664,1710,97.3
21004, 읍부,040005, 39세,2018,3196,1612,1584,101.8,3144,1575,1569,100.4
21004, 읍부,045,40~44세,2018,13948,7087,6861,103.3,13737,6944,6793,102.2
21004, 읍부,045001, 40세,2018,2890,1439,1451,99.2,2843,1404,1439,97.6
21004, 읍부,045002, 41세,2018,2814,1466,1348,108.8,2768,1435,1333,107.7
21004, 읍부,045003, 42세,2018,2676,1365,1311,104.1,2640,1338,1302,102.8
21004, 읍부,045004, 43세,2018,2764,1389,1375,101,2727,1366,1361,100.4
21004, 읍부,045005, 44세,2018,2804,1428,1376,103.8,2759,1401,1358,103.2
21004, 읍부,050,45~49세,2018,12461,6518,5943,109.7,12285,6411,5874,109.1
21004, 읍부,050001, 45세,2018,2684,1358,1326,102.4,2638,1329,1309,101.5
21004, 읍부,050002, 46세,2018,2619,1384,1235,112.1,2585,1361,1224,111.2
21004, 읍부,050003, 47세,2018,2555,1376,1179,116.7,2517,1348,1169,115.3
21004, 읍부,050004, 48세,2018,2353,1261,1092,115.5,2321,1245,1076,115.7
21004, 읍부,050005, 49세,2018,2250,1139,1111,102.5,2224,1128,1096,102.9
21004, 읍부,055,50~54세,2018,9134,4653,4481,103.8,9041,4597,4444,103.4
21004, 읍부,055001, 50세,2018,2067,1042,1025,101.7,2043,1027,1016,101.1
21004, 읍부,055002, 51세,2018,1908,968,940,103,1891,956,935,102.2
21004, 읍부,055003, 52세,2018,1816,970,846,114.7,1790,958,832,115.1
21004, 읍부,055004, 53세,2018,1733,834,899,92.8,1714,822,892,92.2
21004, 읍부,055005, 54세,2018,1610,839,771,108.8,1603,834,769,108.5
21004, 읍부,060,55~59세,2018,9232,4392,4840,90.7,9173,4362,4811,90.7
21004, 읍부,060001, 55세,2018,1751,859,892,96.3,1730,850,880,96.6
21004, 읍부,060002, 56세,2018,1815,868,947,91.7,1805,863,942,91.6
21004, 읍부,060003, 57세,2018,1848,889,959,92.7,1839,881,958,92
21004, 읍부,060004, 58세,2018,1948,894,1054,84.8,1937,888,1049,84.7
21004, 읍부,060005, 59세,2018,1870,882,988,89.3,1862,880,982,89.6
21004, 읍부,065,60~64세,2018,8266,3749,4517,83,8220,3725,4495,82.9
21004, 읍부,065001, 60세,2018,1667,773,894,86.5,1658,766,892,85.9
21004, 읍부,065002, 61세,2018,1773,782,991,78.9,1764,779,985,79.1
21004, 읍부,065003, 62세,2018,1659,736,923,79.7,1647,732,915,80
21004, 읍부,065004, 63세,2018,1722,786,936,84,1718,783,935,83.7
21004, 읍부,065005, 64세,2018,1445,672,773,86.9,1433,665,768,86.6
21004, 읍부,070,65~69세,2018,6289,2857,3432,83.2,6262,2847,3415,83.4
21004, 읍부,070001, 65세,2018,1368,594,774,76.7,1362,593,769,77.1
21004, 읍부,070002, 66세,2018,1432,654,778,84.1,1426,652,774,84.2
21004, 읍부,070003, 67세,2018,1172,553,619,89.3,1168,552,616,89.6
21004, 읍부,070004, 68세,2018,1147,515,632,81.5,1141,512,629,81.4
21004, 읍부,070005, 69세,2018,1170,541,629,86,1165,538,627,85.8
21004, 읍부,075,70~74세,2018,4814,2197,2617,84,4799,2188,2611,83.8
21004, 읍부,075001, 70세,2018,1156,539,617,87.4,1154,538,616,87.3
21004, 읍부,075002, 71세,2018,1102,529,573,92.3,1099,528,571,92.5
21004, 읍부,075003, 72세,2018,838,374,464,80.6,833,370,463,79.9
21004, 읍부,075004, 73세,2018,829,367,462,79.4,827,365,462,79
21004, 읍부,075005, 74세,2018,889,388,501,77.4,886,387,499,77.6
21004, 읍부,080,75~79세,2018,3827,1606,2221,72.3,3825,1604,2221,72.2
21004, 읍부,080001, 75세,2018,849,387,462,83.8,848,386,462,83.5
21004, 읍부,080002, 76세,2018,881,388,493,78.7,881,388,493,78.7
21004, 읍부,080003, 77세,2018,720,298,422,70.6,720,298,422,70.6
21004, 읍부,080004, 78세,2018,677,263,414,63.5,677,263,414,63.5
21004, 읍부,080005, 79세,2018,700,270,430,62.8,699,269,430,62.6
21004, 읍부,085,80~84세,2018,2302,784,1518,51.6,2301,784,1517,51.7
21004, 읍부,085001, 80세,2018,550,190,360,52.8,550,190,360,52.8
21004, 읍부,085002, 81세,2018,508,178,330,53.9,508,178,330,53.9
21004, 읍부,085003, 82세,2018,447,148,299,49.5,446,148,298,49.7
21004, 읍부,085004, 83세,2018,428,156,272,57.4,428,156,272,57.4
21004, 읍부,085005, 84세,2018,369,112,257,43.6,369,112,257,43.6
21004, 읍부,090,85~89세,2018,1181,314,867,36.2,1180,313,867,36.1
21004, 읍부,090001, 85세,2018,325,86,239,36,325,86,239,36
21004, 읍부,090002, 86세,2018,296,91,205,44.4,295,90,205,43.9
21004, 읍부,090003, 87세,2018,236,64,172,37.2,236,64,172,37.2
21004, 읍부,090004, 88세,2018,182,42,140,30,182,42,140,30
21004, 읍부,090005, 89세,2018,142,31,111,27.9,142,31,111,27.9
21004, 읍부,095,90~94세,2018,390,54,336,16.1,390,54,336,16.1
21004, 읍부,095001, 90세,2018,116,22,94,23.4,116,22,94,23.4
21004, 읍부,095002, 91세,2018,108,13,95,13.7,108,13,95,13.7
21004, 읍부,095003, 92세,2018,63,12,51,23.5,63,12,51,23.5
21004, 읍부,095004, 93세,2018,68,X,64,6.3,68,X,64,6.3
21004, 읍부,095005, 94세,2018,35,X,32,9.4,35,X,32,9.4
21004, 읍부,100,95~99세,2018,106,14,92,15.2,104,12,92,13
21004, 읍부,100001, 95세,2018,38,X,34,11.8,38,X,34,11.8
21004, 읍부,100002, 96세,2018,30,7,23,30.4,29,6,23,26.1
21004, 읍부,100003, 97세,2018,18,X,17,5.9,18,X,17,5.9
21004, 읍부,100004, 98세,2018,14,X,12,16.7,13,X,12,8.3
21004, 읍부,100005, 99세,2018,6,X,6,0,6,X,6,0
21004, 읍부,101,100세이상,2018,9,X,9,0,9,X,9,0
21004, 읍부,102,15세미만,2018,26620,13668,12952,105.5,26585,13649,12936,105.5
21004, 읍부,103,15~64세,2018,98387,49617,48770,101.7,96164,48023,48141,99.8
21004, 읍부,104,65세이상,2018,18918,7826,11092,70.6,18870,7802,11068,70.5
21004, 읍부,086,85세이상,2018,1686,382,1304,29.3,1683,379,1304,29.1
21004, 읍부,126,평균연령,2018,39.3,38,40.6,,39.4,38.1,40.7,
21004, 읍부,127,중위연령,2018,40,39.2,40.9,,40.2,39.4,41,
21005, 면부,000,합계,2018,16410,8251,8159,101.1,16134,8069,8065,100
21005, 면부,005,0~4세,2018,499,270,229,117.9,498,269,229,117.5
21005, 면부,005001, 0세,2018,74,34,40,85,74,34,40,85
21005, 면부,005002, 1세,2018,85,43,42,102.4,84,42,42,100
21005, 면부,005003, 2세,2018,116,56,60,93.3,116,56,60,93.3
21005, 면부,005004, 3세,2018,106,68,38,178.9,106,68,38,178.9
21005, 면부,005005, 4세,2018,118,69,49,140.8,118,69,49,140.8
21005, 면부,010,5~9세,2018,466,241,225,107.1,466,241,225,107.1
21005, 면부,010001, 5세,2018,100,50,50,100,100,50,50,100
21005, 면부,010002, 6세,2018,96,54,42,128.6,96,54,42,128.6
21005, 면부,010003, 7세,2018,96,46,50,92,96,46,50,92
21005, 면부,010004, 8세,2018,102,55,47,117,102,55,47,117
21005, 면부,010005, 9세,2018,72,36,36,100,72,36,36,100
21005, 면부,015,10~14세,2018,399,205,194,105.7,398,204,194,105.2
21005, 면부,015001, 10세,2018,79,30,49,61.2,79,30,49,61.2
21005, 면부,015002, 11세,2018,76,37,39,94.9,76,37,39,94.9
21005, 면부,015003, 12세,2018,89,49,40,122.5,89,49,40,122.5
21005, 면부,015004, 13세,2018,73,37,36,102.8,73,37,36,102.8
21005, 면부,015005, 14세,2018,82,52,30,173.3,81,51,30,170
21005, 면부,020,15~19세,2018,465,284,181,156.9,460,280,180,155.6
21005, 면부,020001, 15세,2018,72,36,36,100,71,36,35,102.9
21005, 면부,020002, 16세,2018,80,50,30,166.7,80,50,30,166.7
21005, 면부,020003, 17세,2018,91,62,29,213.8,91,62,29,213.8
21005, 면부,020004, 18세,2018,98,64,34,188.2,97,63,34,185.3
21005, 면부,020005, 19세,2018,124,72,52,138.5,121,69,52,132.7
21005, 면부,025,20~24세,2018,804,470,334,140.7,786,457,329,138.9
21005, 면부,025001, 20세,2018,148,94,54,174.1,146,92,54,170.4
21005, 면부,025002, 21세,2018,138,79,59,133.9,137,78,59,132.2
21005, 면부,025003, 22세,2018,169,95,74,128.4,162,90,72,125
21005, 면부,025004, 23세,2018,157,89,68,130.9,153,86,67,128.4
21005, 면부,025005, 24세,2018,192,113,79,143,188,111,77,144.2
21005, 면부,030,25~29세,2018,900,526,374,140.6,843,490,353,138.8
21005, 면부,030001, 25세,2018,200,127,73,174,188,119,69,172.5
21005, 면부,030002, 26세,2018,199,119,80,148.8,184,112,72,155.6
21005, 면부,030003, 27세,2018,175,103,72,143.1,162,92,70,131.4
21005, 면부,030004, 28세,2018,171,89,82,108.5,164,85,79,107.6
21005, 면부,030005, 29세,2018,155,88,67,131.3,145,82,63,130.2
21005, 면부,035,30~34세,2018,836,445,391,113.8,784,409,375,109.1
21005, 면부,035001, 30세,2018,172,100,72,138.9,163,93,70,132.9
21005, 면부,035002, 31세,2018,153,78,75,104,142,70,72,97.2
21005, 면부,035003, 32세,2018,172,84,88,95.5,154,73,81,90.1
21005, 면부,035004, 33세,2018,172,87,85,102.4,164,81,83,97.6
21005, 면부,035005, 34세,2018,167,96,71,135.2,161,92,69,133.3
21005, 면부,040,35~39세,2018,1027,572,455,125.7,967,529,438,120.8
21005, 면부,040001, 35세,2018,200,118,82,143.9,193,114,79,144.3
21005, 면부,040002, 36세,2018,190,111,79,140.5,180,103,77,133.8
21005, 면부,040003, 37세,2018,221,124,97,127.8,203,109,94,116
21005, 면부,040004, 38세,2018,212,115,97,118.6,197,105,92,114.1
21005, 면부,040005, 39세,2018,204,104,100,104,194,98,96,102.1
21005, 면부,045,40~44세,2018,912,537,375,143.2,886,517,369,140.1
21005, 면부,045001, 40세,2018,164,88,76,115.8,155,82,73,112.3
21005, 면부,045002, 41세,2018,172,99,73,135.6,165,92,73,126
21005, 면부,045003, 42세,2018,186,118,68,173.5,183,116,67,173.1
21005, 면부,045004, 43세,2018,185,114,71,160.6,181,112,69,162.3
21005, 면부,045005, 44세,2018,205,118,87,135.6,202,115,87,132.2
21005, 면부,050,45~49세,2018,1078,576,502,114.7,1059,564,495,113.9
21005, 면부,050001, 45세,2018,194,113,81,139.5,191,112,79,141.8
21005, 면부,050002, 46세,2018,214,111,103,107.8,214,111,103,107.8
21005, 면부,050003, 47세,2018,226,122,104,117.3,218,118,100,118
21005, 면부,050004, 48세,2018,221,108,113,95.6,218,105,113,92.9
21005, 면부,050005, 49세,2018,223,122,101,120.8,218,118,100,118
21005, 면부,055,50~54세,2018,1265,617,648,95.2,1252,611,641,95.3
21005, 면부,055001, 50세,2018,245,133,112,118.8,245,133,112,118.8
21005, 면부,055002, 51세,2018,263,119,144,82.6,261,118,143,82.5
21005, 면부,055003, 52세,2018,255,124,131,94.7,252,123,129,95.3
21005, 면부,055004, 53세,2018,247,117,130,90,243,114,129,88.4
21005, 면부,055005, 54세,2018,255,124,131,94.7,251,123,128,96.1
21005, 면부,060,55~59세,2018,1698,806,892,90.4,1686,801,885,90.5
21005, 면부,060001, 55세,2018,301,137,164,83.5,298,137,161,85.1
21005, 면부,060002, 56세,2018,323,164,159,103.1,322,163,159,102.5
21005, 면부,060003, 57세,2018,363,169,194,87.1,361,167,194,86.1
21005, 면부,060004, 58세,2018,368,186,182,102.2,364,185,179,103.4
21005, 면부,060005, 59세,2018,343,150,193,77.7,341,149,192,77.6
21005, 면부,065,60~64세,2018,1776,856,920,93,1770,853,917,93
21005, 면부,065001, 60세,2018,365,175,190,92.1,362,173,189,91.5
21005, 면부,065002, 61세,2018,371,176,195,90.3,370,176,194,90.7
21005, 면부,065003, 62세,2018,351,168,183,91.8,351,168,183,91.8
21005, 면부,065004, 63세,2018,364,192,172,111.6,363,192,171,112.3
21005, 면부,065005, 64세,2018,325,145,180,80.6,324,144,180,80
21005, 면부,070,65~69세,2018,1373,662,711,93.1,1371,662,709,93.4
21005, 면부,070001, 65세,2018,260,125,135,92.6,260,125,135,92.6
21005, 면부,070002, 66세,2018,309,140,169,82.8,309,140,169,82.8
21005, 면부,070003, 67세,2018,284,133,151,88.1,282,133,149,89.3
21005, 면부,070004, 68세,2018,249,124,125,99.2,249,124,125,99.2
21005, 면부,070005, 69세,2018,271,140,131,106.9,271,140,131,106.9
21005, 면부,075,70~74세,2018,1108,532,576,92.4,1105,531,574,92.5
21005, 면부,075001, 70세,2018,265,119,146,81.5,265,119,146,81.5
21005, 면부,075002, 71세,2018,272,129,143,90.2,271,128,143,89.5
21005, 면부,075003, 72세,2018,189,91,98,92.9,189,91,98,92.9
21005, 면부,075004, 73세,2018,190,95,95,100,189,95,94,101.1
21005, 면부,075005, 74세,2018,192,98,94,104.3,191,98,93,105.4
21005, 면부,080,75~79세,2018,896,363,533,68.1,895,362,533,67.9
21005, 면부,080001, 75세,2018,200,94,106,88.7,200,94,106,88.7
21005, 면부,080002, 76세,2018,210,78,132,59.1,210,78,132,59.1
21005, 면부,080003, 77세,2018,154,68,86,79.1,153,67,86,77.9
21005, 면부,080004, 78세,2018,174,62,112,55.4,174,62,112,55.4
21005, 면부,080005, 79세,2018,158,61,97,62.9,158,61,97,62.9
21005, 면부,085,80~84세,2018,551,197,354,55.6,551,197,354,55.6
21005, 면부,085001, 80세,2018,139,59,80,73.8,139,59,80,73.8
21005, 면부,085002, 81세,2018,131,54,77,70.1,131,54,77,70.1
21005, 면부,085003, 82세,2018,95,41,54,75.9,95,41,54,75.9
21005, 면부,085004, 83세,2018,94,28,66,42.4,94,28,66,42.4
21005, 면부,085005, 84세,2018,92,15,77,19.5,92,15,77,19.5
21005, 면부,090,85~89세,2018,249,68,181,37.6,249,68,181,37.6
21005, 면부,090001, 85세,2018,66,18,48,37.5,66,18,48,37.5
21005, 면부,090002, 86세,2018,64,22,42,52.4,64,22,42,52.4
21005, 면부,090003, 87세,2018,51,15,36,41.7,51,15,36,41.7
21005, 면부,090004, 88세,2018,45,9,36,25,45,9,36,25
21005, 면부,090005, 89세,2018,23,X,19,21.1,23,X,19,21.1
21005, 면부,095,90~94세,2018,82,21,61,34.4,82,21,61,34.4
21005, 면부,095001, 90세,2018,36,13,23,56.5,36,13,23,56.5
21005, 면부,095002, 91세,2018,15,X,11,36.4,15,X,11,36.4
21005, 면부,095003, 92세,2018,6,X,5,20,6,X,5,20
21005, 면부,095004, 93세,2018,11,X,10,10,11,X,10,10
21005, 면부,095005, 94세,2018,14,X,12,16.7,14,X,12,16.7
21005, 면부,100,95~99세,2018,22,X,19,15.8,22,X,19,15.8
21005, 면부,100001, 95세,2018,9,X,7,28.6,9,X,7,28.6
21005, 면부,100002, 96세,2018,6,X,6,0,6,X,6,0
21005, 면부,100003, 97세,2018,X,X,X,33.3,X,X,X,33.3
21005, 면부,100004, 98세,2018,X,X,X,0,X,X,X,0
21005, 면부,100005, 99세,2018,X,X,X,0,X,X,X,0
21005, 면부,101,100세이상,2018,X,X,X,0,X,X,X,0
21005, 면부,102,15세미만,2018,1364,716,648,110.5,1362,714,648,110.2
21005, 면부,103,15~64세,2018,10761,5689,5072,112.2,10493,5511,4982,110.6
21005, 면부,104,65세이상,2018,4285,1846,2439,75.7,4279,1844,2435,75.7
21005, 면부,086,85세이상,2018,357,92,265,34.7,357,92,265,34.7
21005, 면부,126,평균연령,2018,49.4,47.1,51.7,,49.6,47.4,51.8,
21005, 면부,127,중위연령,2018,53.2,50,56,,53.7,50.6,56.3,
21003, 동부,000,합계,2018,3234943,1589622,1645321,96.6,3182019,1559820,1622199,96.2
21003, 동부,005,0~4세,2018,107855,55520,52335,106.1,107274,55228,52046,106.1
21003, 동부,005001, 0세,2018,18059,9380,8679,108.1,17945,9313,8632,107.9
21003, 동부,005002, 1세,2018,19885,10222,9663,105.8,19740,10141,9599,105.6
21003, 동부,005003, 2세,2018,22677,11586,11091,104.5,22545,11518,11027,104.5
21003, 동부,005004, 3세,2018,23825,12246,11579,105.8,23734,12210,11524,106
21003, 동부,005005, 4세,2018,23409,12086,11323,106.7,23310,12046,11264,106.9
21003, 동부,010,5~9세,2018,120396,61845,58551,105.6,120011,61654,58357,105.6
21003, 동부,010001, 5세,2018,23443,11993,11450,104.7,23348,11949,11399,104.8
21003, 동부,010002, 6세,2018,25442,13094,12348,106,25350,13049,12301,106.1
21003, 동부,010003, 7세,2018,25021,12733,12288,103.6,24969,12707,12262,103.6
21003, 동부,010004, 8세,2018,23762,12302,11460,107.3,23683,12263,11420,107.4
21003, 동부,010005, 9세,2018,22728,11723,11005,106.5,22661,11686,10975,106.5
21003, 동부,015,10~14세,2018,118696,61143,57553,106.2,118397,60998,57399,106.3
21003, 동부,015001, 10세,2018,23824,12222,11602,105.3,23768,12189,11579,105.3
21003, 동부,015002, 11세,2018,24476,12526,11950,104.8,24409,12501,11908,105
21003, 동부,015003, 12세,2018,22593,11715,10878,107.7,22540,11693,10847,107.8
21003, 동부,015004, 13세,2018,22736,11722,11014,106.4,22682,11701,10981,106.6
21003, 동부,015005, 14세,2018,25067,12958,12109,107,24998,12914,12084,106.9
21003, 동부,020,15~19세,2018,162657,84708,77949,108.7,160148,83484,76664,108.9
21003, 동부,020001, 15세,2018,26009,13597,12412,109.5,25939,13563,12376,109.6
21003, 동부,020002, 16세,2018,26759,13870,12889,107.6,26657,13826,12831,107.8
21003, 동부,020003, 17세,2018,31827,16830,14997,112.2,31651,16737,14914,112.2
21003, 동부,020004, 18세,2018,37292,19548,17744,110.2,36749,19309,17440,110.7
21003, 동부,020005, 19세,2018,40770,20863,19907,104.8,39152,20049,19103,105
21003, 동부,025,20~24세,2018,227456,119165,108291,110,216821,113893,102928,110.7
21003, 동부,025001, 20세,2018,42448,21186,21262,99.6,40113,20136,19977,100.8
21003, 동부,025002, 21세,2018,43626,22271,21355,104.3,41553,21258,20295,104.7
21003, 동부,025003, 22세,2018,46944,24964,21980,113.6,44858,23907,20951,114.1
21003, 동부,025004, 23세,2018,46983,25185,21798,115.5,44903,24116,20787,116
21003, 동부,025005, 24세,2018,47455,25559,21896,116.7,45394,24476,20918,117
21003, 동부,030,25~29세,2018,215547,114486,101061,113.3,205970,108833,97137,112
21003, 동부,030001, 25세,2018,46944,25479,21465,118.7,44933,24335,20598,118.1
21003, 동부,030002, 26세,2018,46642,24905,21737,114.6,44748,23789,20959,113.5
21003, 동부,030003, 27세,2018,42680,22581,20099,112.3,40773,21419,19354,110.7
21003, 동부,030004, 28세,2018,40251,21161,19090,110.8,38338,20027,18311,109.4
21003, 동부,030005, 29세,2018,39030,20360,18670,109.1,37178,19263,17915,107.5
21003, 동부,035,30~34세,2018,187409,97438,89971,108.3,178944,92091,86853,106
21003, 동부,035001, 30세,2018,36938,19170,17768,107.9,35134,18091,17043,106.1
21003, 동부,035002, 31세,2018,36787,19058,17729,107.5,34988,17929,17059,105.1
21003, 동부,035003, 32세,2018,36879,19367,17512,110.6,35148,18298,16850,108.6
21003, 동부,035004, 33세,2018,37461,19470,17991,108.2,35863,18402,17461,105.4
21003, 동부,035005, 34세,2018,39344,20373,18971,107.4,37811,19371,18440,105
21003, 동부,040,35~39세,2018,237203,121739,115464,105.4,231068,117796,113272,104
21003, 동부,040001, 35세,2018,43523,22354,21169,105.6,42153,21476,20677,103.9
21003, 동부,040002, 36세,2018,47698,24555,23143,106.1,46278,23647,22631,104.5
21003, 동부,040003, 37세,2018,48868,25163,23705,106.2,47717,24424,23293,104.9
21003, 동부,040004, 38세,2018,50107,25778,24329,106,48986,25053,23933,104.7
21003, 동부,040005, 39세,2018,47007,23889,23118,103.3,45934,23196,22738,102
21003, 동부,045,40~44세,2018,221457,112709,108748,103.6,217252,110136,107116,102.8
21003, 동부,045001, 40세,2018,42749,22126,20623,107.3,41806,21526,20280,106.1
21003, 동부,045002, 41세,2018,42794,21817,20977,104,41915,21279,20636,103.1
21003, 동부,045003, 42세,2018,41663,21280,20383,104.4,40825,20790,20035,103.8
21003, 동부,045004, 43세,2018,45178,22731,22447,101.3,44387,22242,22145,100.4
21003, 동부,045005, 44세,2018,49073,24755,24318,101.8,48319,24299,24020,101.2
21003, 동부,050,45~49세,2018,263239,129928,133311,97.5,259812,127992,131820,97.1
21003, 동부,050001, 45세,2018,50356,25051,25305,99,49602,24618,24984,98.5
21003, 동부,050002, 46세,2018,50989,25643,25346,101.2,50305,25235,25070,100.7
21003, 동부,050003, 47세,2018,54116,26592,27524,96.6,53438,26205,27233,96.2
21003, 동부,050004, 48세,2018,53683,26356,27327,96.4,52995,25990,27005,96.2
21003, 동부,050005, 49세,2018,54095,26286,27809,94.5,53472,25944,27528,94.2
21003, 동부,055,50~54세,2018,258670,124584,134086,92.9,256185,123339,132846,92.8
21003, 동부,055001, 50세,2018,55000,26533,28467,93.2,54461,26274,28187,93.2
21003, 동부,055002, 51세,2018,52009,24679,27330,90.3,51485,24401,27084,90.1
21003, 동부,055003, 52세,2018,50781,24929,25852,96.4,50286,24676,25610,96.4
21003, 동부,055004, 53세,2018,51417,24456,26961,90.7,50955,24228,26727,90.6
21003, 동부,055005, 54세,2018,49463,23987,25476,94.2,48998,23760,25238,94.1
21003, 동부,060,55~59세,2018,297461,141355,156106,90.6,295586,140465,155121,90.6
21003, 동부,060001, 55세,2018,54499,26338,28161,93.5,53997,26098,27899,93.5
21003, 동부,060002, 56세,2018,58105,27999,30106,93,57666,27797,29869,93.1
21003, 동부,060003, 57세,2018,63262,29630,33632,88.1,62957,29490,33467,88.1
21003, 동부,060004, 58세,2018,63782,29920,33862,88.4,63412,29743,33669,88.3
21003, 동부,060005, 59세,2018,57813,27468,30345,90.5,57554,27337,30217,90.5
21003, 동부,065,60~64세,2018,266305,127348,138957,91.6,265058,126736,138322,91.6
21003, 동부,065001, 60세,2018,56207,27094,29113,93.1,55912,26946,28966,93
21003, 동부,065002, 61세,2018,56337,26858,29479,91.1,56061,26718,29343,91.1
21003, 동부,065003, 62세,2018,52732,25189,27543,91.5,52496,25073,27423,91.4
21003, 동부,065004, 63세,2018,54891,25618,29273,87.5,54666,25511,29155,87.5
21003, 동부,065005, 64세,2018,46138,22589,23549,95.9,45923,22488,23435,96
21003, 동부,070,65~69세,2018,191153,89921,101232,88.8,190569,89644,100925,88.8
21003, 동부,070001, 65세,2018,40976,19163,21813,87.9,40809,19091,21718,87.9
21003, 동부,070002, 66세,2018,43600,20652,22948,90,43459,20580,22879,90
21003, 동부,070003, 67세,2018,35051,16537,18514,89.3,34948,16487,18461,89.3
21003, 동부,070004, 68세,2018,35331,16723,18608,89.9,35229,16678,18551,89.9
21003, 동부,070005, 69세,2018,36195,16846,19349,87.1,36124,16808,19316,87
21003, 동부,075,70~74세,2018,141010,65148,75862,85.9,140780,65038,75742,85.9
21003, 동부,075001, 70세,2018,34862,16243,18619,87.2,34794,16211,18583,87.2
21003, 동부,075002, 71세,2018,32853,15106,17747,85.1,32802,15080,17722,85.1
21003, 동부,075003, 72세,2018,24413,11510,12903,89.2,24371,11489,12882,89.2
21003, 동부,075004, 73세,2018,23962,11025,12937,85.2,23928,11010,12918,85.2
21003, 동부,075005, 74세,2018,24920,11264,13656,82.5,24885,11248,13637,82.5
21003, 동부,080,75~79세,2018,114544,49145,65399,75.1,114399,49094,65305,75.2
21003, 동부,080001, 75세,2018,25501,11440,14061,81.4,25473,11431,14042,81.4
21003, 동부,080002, 76세,2018,27198,12080,15118,79.9,27166,12063,15103,79.9
21003, 동부,080003, 77세,2018,22572,9547,13025,73.3,22544,9538,13006,73.3
21003, 동부,080004, 78세,2018,20225,8395,11830,71,20196,8390,11806,71.1
21003, 동부,080005, 79세,2018,19048,7683,11365,67.6,19020,7672,11348,67.6
21003, 동부,085,80~84세,2018,64283,23422,40861,57.3,64199,23399,40800,57.4
21003, 동부,085001, 80세,2018,15905,6282,9623,65.3,15875,6276,9599,65.4
21003, 동부,085002, 81세,2018,14674,5569,9105,61.2,14655,5564,9091,61.2
21003, 동부,085003, 82세,2018,12595,4555,8040,56.7,12578,4549,8029,56.7
21003, 동부,085004, 83세,2018,11552,3886,7666,50.7,11544,3883,7661,50.7
21003, 동부,085005, 84세,2018,9557,3130,6427,48.7,9547,3127,6420,48.7
21003, 동부,090,85~89세,2018,28226,7813,20413,38.3,28190,7801,20389,38.3
21003, 동부,090001, 85세,2018,7822,2467,5355,46.1,7805,2463,5342,46.1
21003, 동부,090002, 86세,2018,6814,1935,4879,39.7,6804,1932,4872,39.7
21003, 동부,090003, 87세,2018,5233,1370,3863,35.5,5231,1369,3862,35.4
21003, 동부,090004, 88세,2018,4422,1067,3355,31.8,4420,1065,3355,31.7
21003, 동부,090005, 89세,2018,3935,974,2961,32.9,3930,972,2958,32.9
21003, 동부,095,90~94세,2018,9235,1823,7412,24.6,9219,1818,7401,24.6
21003, 동부,095001, 90세,2018,3168,645,2523,25.6,3162,644,2518,25.6
21003, 동부,095002, 91세,2018,2442,494,1948,25.4,2439,494,1945,25.4
21003, 동부,095003, 92세,2018,1529,298,1231,24.2,1525,296,1229,24.1
21003, 동부,095004, 93세,2018,1267,230,1037,22.2,1264,228,1036,22
21003, 동부,095005, 94세,2018,829,156,673,23.2,829,156,673,23.2
21003, 동부,100,95~99세,2018,1935,358,1577,22.7,1931,357,1574,22.7
21003, 동부,100001, 95세,2018,762,138,624,22.1,761,138,623,22.2
21003, 동부,100002, 96세,2018,492,95,397,23.9,492,95,397,23.9
21003, 동부,100003, 97세,2018,313,49,264,18.6,311,48,263,18.3
21003, 동부,100004, 98세,2018,220,39,181,21.5,220,39,181,21.5
21003, 동부,100005, 99세,2018,148,37,111,33.3,147,37,110,33.6
21003, 동부,101,100세이상,2018,206,24,182,13.2,206,24,182,13.2
21003, 동부,102,15세미만,2018,346947,178508,168439,106,345682,177880,167802,106
21003, 동부,103,15~64세,2018,2337404,1173460,1163944,100.8,2286844,1144765,1142079,100.2
21003, 동부,104,65세이상,2018,550592,237654,312938,75.9,549493,237175,312318,75.9
21003, 동부,086,85세이상,2018,39602,10018,29584,33.9,39546,10000,29546,33.8
21003, 동부,126,평균연령,2018,43.8,42.4,45.1,,43.9,42.6,45.2,
21003, 동부,127,중위연령,2018,45.4,43.6,47.1,,45.7,44,47.3,
21010, 중구,000,합계,2018,42766,21194,21572,98.2,40674,19846,20828,95.3
21010, 중구,005,0~4세,2018,791,445,346,128.6,780,439,341,128.7
21010, 중구,005001, 0세,2018,151,81,70,115.7,150,81,69,117.4
21010, 중구,005002, 1세,2018,153,86,67,128.4,151,84,67,125.4
21010, 중구,005003, 2세,2018,131,77,54,142.6,124,74,50,148
21010, 중구,005004, 3세,2018,183,109,74,147.3,182,108,74,145.9
21010, 중구,005005, 4세,2018,173,92,81,113.6,173,92,81,113.6
21010, 중구,010,5~9세,2018,894,464,430,107.9,885,461,424,108.7
21010, 중구,010001, 5세,2018,173,85,88,96.6,171,84,87,96.6
21010, 중구,010002, 6세,2018,177,97,80,121.3,176,97,79,122.8
21010, 중구,010003, 7세,2018,192,101,91,111,189,100,89,112.4
21010, 중구,010004, 8세,2018,189,90,99,90.9,187,89,98,90.8
21010, 중구,010005, 9세,2018,163,91,72,126.4,162,91,71,128.2
21010, 중구,015,10~14세,2018,927,439,488,90,913,431,482,89.4
21010, 중구,015001, 10세,2018,186,101,85,118.8,183,98,85,115.3
21010, 중구,015002, 11세,2018,176,70,106,66,175,69,106,65.1
21010, 중구,015003, 12세,2018,175,82,93,88.2,172,81,91,89
21010, 중구,015004, 13세,2018,187,94,93,101.1,182,92,90,102.2
21010, 중구,015005, 14세,2018,203,92,111,82.9,201,91,110,82.7
21010, 중구,020,15~19세,2018,1492,740,752,98.4,1377,694,683,101.6
21010, 중구,020001, 15세,2018,212,105,107,98.1,208,103,105,98.1
21010, 중구,020002, 16세,2018,246,131,115,113.9,241,128,113,113.3
21010, 중구,020003, 17세,2018,282,157,125,125.6,277,154,123,125.2
21010, 중구,020004, 18세,2018,358,161,197,81.7,327,149,178,83.7
21010, 중구,020005, 19세,2018,394,186,208,89.4,324,160,164,97.6
21010, 중구,025,20~24세,2018,2652,1338,1314,101.8,2342,1201,1141,105.3
21010, 중구,025001, 20세,2018,410,207,203,102,371,191,180,106.1
21010, 중구,025002, 21세,2018,484,260,224,116.1,424,228,196,116.3
21010, 중구,025003, 22세,2018,529,252,277,91,466,226,240,94.2
21010, 중구,025004, 23세,2018,589,310,279,111.1,521,280,241,116.2
21010, 중구,025005, 24세,2018,640,309,331,93.4,560,276,284,97.2
21010, 중구,030,25~29세,2018,3155,1705,1450,117.6,2805,1467,1338,109.6
21010, 중구,030001, 25세,2018,661,323,338,95.6,584,281,303,92.7
21010, 중구,030002, 26세,2018,719,389,330,117.9,647,336,311,108
21010, 중구,030003, 27세,2018,652,365,287,127.2,579,313,266,117.7
21010, 중구,030004, 28세,2018,573,324,249,130.1,511,278,233,119.3
21010, 중구,030005, 29세,2018,550,304,246,123.6,484,259,225,115.1
21010, 중구,035,30~34세,2018,2525,1473,1052,140,2194,1212,982,123.4
21010, 중구,035001, 30세,2018,526,306,220,139.1,464,261,203,128.6
21010, 중구,035002, 31세,2018,504,288,216,133.3,444,241,203,118.7
21010, 중구,035003, 32세,2018,504,289,215,134.4,441,239,202,118.3
21010, 중구,035004, 33세,2018,512,305,207,147.3,438,241,197,122.3
21010, 중구,035005, 34세,2018,479,285,194,146.9,407,230,177,129.9
21010, 중구,040,35~39세,2018,2744,1555,1189,130.8,2460,1333,1127,118.3
21010, 중구,040001, 35세,2018,547,320,227,141,472,258,214,120.6
21010, 중구,040002, 36세,2018,548,311,237,131.2,491,272,219,124.2
21010, 중구,040003, 37세,2018,572,327,245,133.5,516,286,230,124.3
21010, 중구,040004, 38세,2018,572,322,250,128.8,524,281,243,115.6
21010, 중구,040005, 39세,2018,505,275,230,119.6,457,236,221,106.8
21010, 중구,045,40~44세,2018,2668,1508,1160,130,2431,1319,1112,118.6
21010, 중구,045001, 40세,2018,496,282,214,131.8,443,242,201,120.4
21010, 중구,045002, 41세,2018,470,269,201,133.8,432,240,192,125
21010, 중구,045003, 42세,2018,504,301,203,148.3,448,253,195,129.7
21010, 중구,045004, 43세,2018,611,340,271,125.5,568,304,264,115.2
21010, 중구,045005, 44세,2018,587,316,271,116.6,540,280,260,107.7
21010, 중구,050,45~49세,2018,3436,1847,1589,116.2,3269,1739,1530,113.7
21010, 중구,050001, 45세,2018,638,357,281,127,600,333,267,124.7
21010, 중구,050002, 46세,2018,675,395,280,141.1,639,365,274,133.2
21010, 중구,050003, 47세,2018,698,348,350,99.4,662,324,338,95.9
21010, 중구,050004, 48세,2018,685,344,341,100.9,652,326,326,100
21010, 중구,050005, 49세,2018,740,403,337,119.6,716,391,325,120.3
21010, 중구,055,50~54세,2018,3267,1635,1632,100.2,3169,1582,1587,99.7
21010, 중구,055001, 50세,2018,694,347,347,100,668,335,333,100.6
21010, 중구,055002, 51세,2018,634,331,303,109.2,615,317,298,106.4
21010, 중구,055003, 52세,2018,654,344,310,111,633,330,303,108.9
21010, 중구,055004, 53세,2018,664,308,356,86.5,651,303,348,87.1
21010, 중구,055005, 54세,2018,621,305,316,96.5,602,297,305,97.4
21010, 중구,060,55~59세,2018,4069,1930,2139,90.2,4002,1905,2097,90.8
21010, 중구,060001, 55세,2018,736,350,386,90.7,716,345,371,93
21010, 중구,060002, 56세,2018,797,393,404,97.3,782,385,397,97
21010, 중구,060003, 57세,2018,833,372,461,80.7,823,370,453,81.7
21010, 중구,060004, 58세,2018,886,425,461,92.2,876,421,455,92.5
21010, 중구,060005, 59세,2018,817,390,427,91.3,805,384,421,91.2
21010, 중구,065,60~64세,2018,4171,1991,2180,91.3,4121,1965,2156,91.1
21010, 중구,065001, 60세,2018,879,411,468,87.8,864,406,458,88.6
21010, 중구,065002, 61세,2018,890,412,478,86.2,885,409,476,85.9
21010, 중구,065003, 62세,2018,783,374,409,91.4,775,370,405,91.4
21010, 중구,065004, 63세,2018,884,424,460,92.2,877,419,458,91.5
21010, 중구,065005, 64세,2018,735,370,365,101.4,720,361,359,100.6
21010, 중구,070,65~69세,2018,3192,1442,1750,82.4,3161,1423,1738,81.9
21010, 중구,070001, 65세,2018,685,301,384,78.4,676,297,379,78.4
21010, 중구,070002, 66세,2018,703,326,377,86.5,694,320,374,85.6
21010, 중구,070003, 67세,2018,573,264,309,85.4,568,260,308,84.4
21010, 중구,070004, 68세,2018,617,282,335,84.2,612,279,333,83.8
21010, 중구,070005, 69세,2018,614,269,345,78,611,267,344,77.6
21010, 중구,075,70~74세,2018,2521,1102,1419,77.7,2515,1100,1415,77.7
21010, 중구,075001, 70세,2018,604,256,348,73.6,601,256,345,74.2
21010, 중구,075002, 71세,2018,540,237,303,78.2,539,236,303,77.9
21010, 중구,075003, 72세,2018,468,209,259,80.7,468,209,259,80.7
21010, 중구,075004, 73세,2018,442,189,253,74.7,441,188,253,74.3
21010, 중구,075005, 74세,2018,467,211,256,82.4,466,211,255,82.7
21010, 중구,080,75~79세,2018,2197,943,1254,75.2,2191,939,1252,75
21010, 중구,080001, 75세,2018,493,227,266,85.3,492,226,266,85
21010, 중구,080002, 76세,2018,519,219,300,73,518,218,300,72.7
21010, 중구,080003, 77세,2018,437,184,253,72.7,437,184,253,72.7
21010, 중구,080004, 78세,2018,374,159,215,74,372,159,213,74.6
21010, 중구,080005, 79세,2018,374,154,220,70,372,152,220,69.1
21010, 중구,085,80~84세,2018,1196,427,769,55.5,1194,427,767,55.7
21010, 중구,085001, 80세,2018,304,122,182,67,303,122,181,67.4
21010, 중구,085002, 81세,2018,264,89,175,50.9,263,89,174,51.1
21010, 중구,085003, 82세,2018,230,89,141,63.1,230,89,141,63.1
21010, 중구,085004, 83세,2018,216,69,147,46.9,216,69,147,46.9
21010, 중구,085005, 84세,2018,182,58,124,46.8,182,58,124,46.8
21010, 중구,090,85~89세,2018,580,152,428,35.5,578,151,427,35.4
21010, 중구,090001, 85세,2018,143,40,103,38.8,142,40,102,39.2
21010, 중구,090002, 86세,2018,150,40,110,36.4,150,40,110,36.4
21010, 중구,090003, 87세,2018,91,30,61,49.2,91,30,61,49.2
21010, 중구,090004, 88세,2018,104,22,82,26.8,104,22,82,26.8
21010, 중구,090005, 89세,2018,92,20,72,27.8,91,19,72,26.4
21010, 중구,095,90~94세,2018,231,46,185,24.9,229,46,183,25.1
21010, 중구,095001, 90세,2018,75,12,63,19,75,12,63,19
21010, 중구,095002, 91세,2018,61,11,50,22,60,11,49,22.4
21010, 중구,095003, 92세,2018,46,7,39,17.9,45,7,38,18.4
21010, 중구,095004, 93세,2018,30,7,23,30.4,30,7,23,30.4
21010, 중구,095005, 94세,2018,19,9,10,90,19,9,10,90
21010, 중구,100,95~99세,2018,54,12,42,28.6,54,12,42,28.6
21010, 중구,100001, 95세,2018,21,X,19,10.5,21,X,19,10.5
21010, 중구,100002, 96세,2018,15,X,13,15.4,15,X,13,15.4
21010, 중구,100003, 97세,2018,X,X,X,33.3,X,X,X,33.3
21010, 중구,100004, 98세,2018,8,X,5,60,8,X,5,60
21010, 중구,100005, 99세,2018,6,X,X,200,6,X,X,200
21010, 중구,101,100세이상,2018,X,X,X,0,X,X,X,0
21010, 중구,102,15세미만,2018,2612,1348,1264,106.6,2578,1331,1247,106.7
21010, 중구,103,15~64세,2018,30179,15722,14457,108.8,28170,14417,13753,104.8
21010, 중구,104,65세이상,2018,9975,4124,5851,70.5,9926,4098,5828,70.3
21010, 중구,086,85세이상,2018,869,210,659,31.9,865,209,656,31.9
21010, 중구,126,평균연령,2018,48.3,46.4,50.1,,48.9,47.1,50.7,
21010, 중구,127,중위연령,2018,50.1,47.5,53.2,,51.3,49,53.9,
21020, 서구,000,합계,2018,107028,52462,54566,96.1,104885,51019,53866,94.7
21020, 서구,005,0~4세,2018,2702,1411,1291,109.3,2688,1404,1284,109.3
21020, 서구,005001, 0세,2018,430,208,222,93.7,428,207,221,93.7
21020, 서구,005002, 1세,2018,491,267,224,119.2,486,263,223,117.9
21020, 서구,005003, 2세,2018,575,302,273,110.6,574,302,272,111
21020, 서구,005004, 3세,2018,614,336,278,120.9,610,335,275,121.8
21020, 서구,005005, 4세,2018,592,298,294,101.4,590,297,293,101.4
21020, 서구,010,5~9세,2018,3203,1664,1539,108.1,3193,1660,1533,108.3
21020, 서구,010001, 5세,2018,594,340,254,133.9,593,340,253,134.4
21020, 서구,010002, 6세,2018,669,337,332,101.5,666,336,330,101.8
21020, 서구,010003, 7세,2018,677,351,326,107.7,674,349,325,107.4
21020, 서구,010004, 8세,2018,655,315,340,92.6,654,315,339,92.9
21020, 서구,010005, 9세,2018,608,321,287,111.8,606,320,286,111.9
21020, 서구,015,10~14세,2018,3302,1649,1653,99.8,3289,1643,1646,99.8
21020, 서구,015001, 10세,2018,620,292,328,89,618,291,327,89
21020, 서구,015002, 11세,2018,681,360,321,112.1,679,358,321,111.5
21020, 서구,015003, 12세,2018,612,310,302,102.6,610,309,301,102.7
21020, 서구,015004, 13세,2018,634,313,321,97.5,630,312,318,98.1
21020, 서구,015005, 14세,2018,755,374,381,98.2,752,373,379,98.4
21020, 서구,020,15~19세,2018,4611,2380,2231,106.7,4562,2358,2204,107
21020, 서구,020001, 15세,2018,743,402,341,117.9,741,402,339,118.6
21020, 서구,020002, 16세,2018,720,377,343,109.9,715,374,341,109.7
21020, 서구,020003, 17세,2018,927,470,457,102.8,924,468,456,102.6
21020, 서구,020004, 18세,2018,1039,524,515,101.7,1030,523,507,103.2
21020, 서구,020005, 19세,2018,1182,607,575,105.6,1152,591,561,105.3
21020, 서구,025,20~24세,2018,7016,3564,3452,103.2,6737,3396,3341,101.6
21020, 서구,025001, 20세,2018,1227,589,638,92.3,1188,568,620,91.6
21020, 서구,025002, 21세,2018,1278,659,619,106.5,1241,637,604,105.5
21020, 서구,025003, 22세,2018,1460,743,717,103.6,1391,708,683,103.7
21020, 서구,025004, 23세,2018,1510,770,740,104.1,1450,730,720,101.4
21020, 서구,025005, 24세,2018,1541,803,738,108.8,1467,753,714,105.5
21020, 서구,030,25~29세,2018,6953,3647,3306,110.3,6559,3377,3182,106.1
21020, 서구,030001, 25세,2018,1586,815,771,105.7,1506,760,746,101.9
21020, 서구,030002, 26세,2018,1511,779,732,106.4,1432,728,704,103.4
21020, 서구,030003, 27세,2018,1362,715,647,110.5,1277,659,618,106.6
21020, 서구,030004, 28세,2018,1287,691,596,115.9,1210,634,576,110.1
21020, 서구,030005, 29세,2018,1207,647,560,115.5,1134,596,538,110.8
21020, 서구,035,30~34세,2018,5566,3001,2565,117,5155,2710,2445,110.8
21020, 서구,035001, 30세,2018,1235,685,550,124.5,1153,625,528,118.4
21020, 서구,035002, 31세,2018,1069,575,494,116.4,993,523,470,111.3
21020, 서구,035003, 32세,2018,1080,614,466,131.8,987,548,439,124.8
21020, 서구,035004, 33세,2018,1075,569,506,112.5,992,509,483,105.4
21020, 서구,035005, 34세,2018,1107,558,549,101.6,1030,505,525,96.2
21020, 서구,040,35~39세,2018,6983,3731,3252,114.7,6685,3494,3191,109.5
21020, 서구,040001, 35세,2018,1279,666,613,108.6,1225,624,601,103.8
21020, 서구,040002, 36세,2018,1396,730,666,109.6,1334,681,653,104.3
21020, 서구,040003, 37세,2018,1440,749,691,108.4,1388,710,678,104.7
21020, 서구,040004, 38세,2018,1489,822,667,123.2,1427,775,652,118.9
21020, 서구,040005, 39세,2018,1379,764,615,124.2,1311,704,607,116
21020, 서구,045,40~44세,2018,6591,3500,3091,113.2,6350,3310,3040,108.9
21020, 서구,045001, 40세,2018,1265,676,589,114.8,1204,622,582,106.9
21020, 서구,045002, 41세,2018,1233,655,578,113.3,1187,616,571,107.9
21020, 서구,045003, 42세,2018,1240,672,568,118.3,1197,641,556,115.3
21020, 서구,045004, 43세,2018,1323,693,630,110,1273,657,616,106.7
21020, 서구,045005, 44세,2018,1530,804,726,110.7,1489,774,715,108.3
21020, 서구,050,45~49세,2018,8238,4329,3909,110.7,8065,4200,3865,108.7
21020, 서구,050001, 45세,2018,1637,863,774,111.5,1594,832,762,109.2
21020, 서구,050002, 46세,2018,1584,846,738,114.6,1551,819,732,111.9
21020, 서구,050003, 47세,2018,1659,856,803,106.6,1627,832,795,104.7
21020, 서구,050004, 48세,2018,1685,902,783,115.2,1656,878,778,112.9
21020, 서구,050005, 49세,2018,1673,862,811,106.3,1637,839,798,105.1
21020, 서구,055,50~54세,2018,8117,4102,4015,102.2,8022,4052,3970,102.1
21020, 서구,055001, 50세,2018,1669,862,807,106.8,1648,850,798,106.5
21020, 서구,055002, 51세,2018,1639,871,768,113.4,1612,854,758,112.7
21020, 서구,055003, 52세,2018,1577,777,800,97.1,1557,769,788,97.6
21020, 서구,055004, 53세,2018,1624,786,838,93.8,1613,779,834,93.4
21020, 서구,055005, 54세,2018,1608,806,802,100.5,1592,800,792,101
21020, 서구,060,55~59세,2018,10191,4897,5294,92.5,10118,4865,5253,92.6
21020, 서구,060001, 55세,2018,1812,913,899,101.6,1790,904,886,102
21020, 서구,060002, 56세,2018,1881,949,932,101.8,1868,940,928,101.3
21020, 서구,060003, 57세,2018,2162,1006,1156,87,2151,1004,1147,87.5
21020, 서구,060004, 58세,2018,2290,1087,1203,90.4,2273,1081,1192,90.7
21020, 서구,060005, 59세,2018,2046,942,1104,85.3,2036,936,1100,85.1
21020, 서구,065,60~64세,2018,9709,4578,5131,89.2,9665,4562,5103,89.4
21020, 서구,065001, 60세,2018,2012,971,1041,93.3,2001,965,1036,93.1
21020, 서구,065002, 61세,2018,2011,942,1069,88.1,2005,941,1064,88.4
21020, 서구,065003, 62세,2018,1879,912,967,94.3,1872,910,962,94.6
21020, 서구,065004, 63세,2018,1993,889,1104,80.5,1983,887,1096,80.9
21020, 서구,065005, 64세,2018,1814,864,950,90.9,1804,859,945,90.9
21020, 서구,070,65~69세,2018,7567,3490,4077,85.6,7544,3479,4065,85.6
21020, 서구,070001, 65세,2018,1498,692,806,85.9,1490,686,804,85.3
21020, 서구,070002, 66세,2018,1716,789,927,85.1,1712,789,923,85.5
21020, 서구,070003, 67세,2018,1396,637,759,83.9,1391,635,756,84
21020, 서구,070004, 68세,2018,1470,692,778,88.9,1466,689,777,88.7
21020, 서구,070005, 69세,2018,1487,680,807,84.3,1485,680,805,84.5
21020, 서구,075,70~74세,2018,6025,2718,3307,82.2,6015,2713,3302,82.2
21020, 서구,075001, 70세,2018,1404,644,760,84.7,1404,644,760,84.7
21020, 서구,075002, 71세,2018,1443,651,792,82.2,1439,650,789,82.4
21020, 서구,075003, 72세,2018,1050,480,570,84.2,1048,479,569,84.2
21020, 서구,075004, 73세,2018,1015,447,568,78.7,1013,445,568,78.3
21020, 서구,075005, 74세,2018,1113,496,617,80.4,1111,495,616,80.4
21020, 서구,080,75~79세,2018,5366,2177,3189,68.3,5358,2175,3183,68.3
21020, 서구,080001, 75세,2018,1176,474,702,67.5,1174,474,700,67.7
21020, 서구,080002, 76세,2018,1256,562,694,81,1254,561,693,81
21020, 서구,080003, 77세,2018,1063,427,636,67.1,1062,427,635,67.2
21020, 서구,080004, 78세,2018,938,358,580,61.7,937,358,579,61.8
21020, 서구,080005, 79세,2018,933,356,577,61.7,931,355,576,61.6
21020, 서구,085,80~84세,2018,3048,1153,1895,60.8,3042,1151,1891,60.9
21020, 서구,085001, 80세,2018,760,291,469,62,755,289,466,62
21020, 서구,085002, 81세,2018,673,268,405,66.2,672,268,404,66.3
21020, 서구,085003, 82세,2018,629,249,380,65.5,629,249,380,65.5
21020, 서구,085004, 83세,2018,540,183,357,51.3,540,183,357,51.3
21020, 서구,085005, 84세,2018,446,162,284,57,446,162,284,57
21020, 서구,090,85~89세,2018,1284,350,934,37.5,1283,350,933,37.5
21020, 서구,090001, 85세,2018,377,110,267,41.2,377,110,267,41.2
21020, 서구,090002, 86세,2018,319,98,221,44.3,318,98,220,44.5
21020, 서구,090003, 87세,2018,227,52,175,29.7,227,52,175,29.7
21020, 서구,090004, 88세,2018,181,44,137,32.1,181,44,137,32.1
21020, 서구,090005, 89세,2018,180,46,134,34.3,180,46,134,34.3
21020, 서구,095,90~94세,2018,442,88,354,24.9,442,88,354,24.9
21020, 서구,095001, 90세,2018,156,27,129,20.9,156,27,129,20.9
21020, 서구,095002, 91세,2018,123,24,99,24.2,123,24,99,24.2
21020, 서구,095003, 92세,2018,58,13,45,28.9,58,13,45,28.9
21020, 서구,095004, 93세,2018,60,15,45,33.3,60,15,45,33.3
21020, 서구,095005, 94세,2018,45,9,36,25,45,9,36,25
21020, 서구,100,95~99세,2018,104,31,73,42.5,103,30,73,41.1
21020, 서구,100001, 95세,2018,39,11,28,39.3,39,11,28,39.3
21020, 서구,100002, 96세,2018,31,10,21,47.6,31,10,21,47.6
21020, 서구,100003, 97세,2018,15,X,11,36.4,14,X,11,27.3
21020, 서구,100004, 98세,2018,14,5,9,55.6,14,5,9,55.6
21020, 서구,100005, 99세,2018,5,X,X,25,5,X,X,25
21020, 서구,101,100세이상,2018,10,X,8,25,10,X,8,25
21020, 서구,102,15세미만,2018,9207,4724,4483,105.4,9170,4707,4463,105.5
21020, 서구,103,15~64세,2018,73975,37729,36246,104.1,71918,36324,35594,102.1
21020, 서구,104,65세이상,2018,23846,10009,13837,72.3,23797,9988,13809,72.3
21020, 서구,086,85세이상,2018,1840,471,1369,34.4,1838,470,1368,34.4
21020, 서구,126,평균연령,2018,46.8,45.2,48.4,,47.1,45.5,48.6,
21020, 서구,127,중위연령,2018,49,47,51.2,,49.5,47.6,51.5,
21030, 동구,000,합계,2018,84557,41258,43299,95.3,82370,40251,42119,95.6
21030, 동구,005,0~4세,2018,1911,1008,903,111.6,1876,991,885,112
21030, 동구,005001, 0세,2018,321,191,130,146.9,314,186,128,145.3
21030, 동구,005002, 1세,2018,352,193,159,121.4,348,191,157,121.7
21030, 동구,005003, 2세,2018,401,201,200,100.5,388,195,193,101
21030, 동구,005004, 3세,2018,428,230,198,116.2,425,229,196,116.8
21030, 동구,005005, 4세,2018,409,193,216,89.4,401,190,211,90
21030, 동구,010,5~9세,2018,2106,1069,1037,103.1,2056,1038,1018,102
21030, 동구,010001, 5세,2018,409,215,194,110.8,395,208,187,111.2
21030, 동구,010002, 6세,2018,462,241,221,109,452,235,217,108.3
21030, 동구,010003, 7세,2018,419,213,206,103.4,412,209,203,103
21030, 동구,010004, 8세,2018,426,210,216,97.2,418,203,215,94.4
21030, 동구,010005, 9세,2018,390,190,200,95,379,183,196,93.4
21030, 동구,015,10~14세,2018,2171,1132,1039,109,2137,1116,1021,109.3
21030, 동구,015001, 10세,2018,404,214,190,112.6,398,213,185,115.1
21030, 동구,015002, 11세,2018,473,238,235,101.3,469,236,233,101.3
21030, 동구,015003, 12세,2018,414,204,210,97.1,407,201,206,97.6
21030, 동구,015004, 13세,2018,401,210,191,109.9,392,206,186,110.8
21030, 동구,015005, 14세,2018,479,266,213,124.9,471,260,211,123.2
21030, 동구,020,15~19세,2018,3359,1726,1633,105.7,3313,1704,1609,105.9
21030, 동구,020001, 15세,2018,531,286,245,116.7,520,281,239,117.6
21030, 동구,020002, 16세,2018,566,306,260,117.7,558,303,255,118.8
21030, 동구,020003, 17세,2018,781,384,397,96.7,775,380,395,96.2
21030, 동구,020004, 18세,2018,799,398,401,99.3,790,394,396,99.5
21030, 동구,020005, 19세,2018,682,352,330,106.7,670,346,324,106.8
21030, 동구,025,20~24세,2018,4652,2393,2259,105.9,4484,2337,2147,108.8
21030, 동구,025001, 20세,2018,803,438,365,120,787,429,358,119.8
21030, 동구,025002, 21세,2018,843,444,399,111.3,814,434,380,114.2
21030, 동구,025003, 22세,2018,948,480,468,102.6,914,472,442,106.8
21030, 동구,025004, 23세,2018,982,500,482,103.7,939,484,455,106.4
21030, 동구,025005, 24세,2018,1076,531,545,97.4,1030,518,512,101.2
21030, 동구,030,25~29세,2018,5420,2762,2658,103.9,5052,2593,2459,105.4
21030, 동구,030001, 25세,2018,1098,563,535,105.2,1026,535,491,109
21030, 동구,030002, 26세,2018,1214,627,587,106.8,1145,597,548,108.9
21030, 동구,030003, 27세,2018,1091,538,553,97.3,1016,498,518,96.1
21030, 동구,030004, 28세,2018,1037,535,502,106.6,968,504,464,108.6
21030, 동구,030005, 29세,2018,980,499,481,103.7,897,459,438,104.8
21030, 동구,035,30~34세,2018,4692,2560,2132,120.1,4353,2386,1967,121.3
21030, 동구,035001, 30세,2018,955,507,448,113.2,876,468,408,114.7
21030, 동구,035002, 31세,2018,957,548,409,134,891,512,379,135.1
21030, 동구,035003, 32세,2018,896,477,419,113.8,832,444,388,114.4
21030, 동구,035004, 33세,2018,941,518,423,122.5,885,488,397,122.9
21030, 동구,035005, 34세,2018,943,510,433,117.8,869,474,395,120
21030, 동구,040,35~39세,2018,5407,2996,2411,124.3,5116,2855,2261,126.3
21030, 동구,040001, 35세,2018,990,558,432,129.2,936,533,403,132.3
21030, 동구,040002, 36세,2018,1115,592,523,113.2,1047,560,487,115
21030, 동구,040003, 37세,2018,1078,602,476,126.5,1018,574,444,129.3
21030, 동구,040004, 38세,2018,1102,615,487,126.3,1049,588,461,127.5
21030, 동구,040005, 39세,2018,1122,629,493,127.6,1066,600,466,128.8
21030, 동구,045,40~44세,2018,5219,2802,2417,115.9,5011,2706,2305,117.4
21030, 동구,045001, 40세,2018,994,524,470,111.5,961,506,455,111.2
21030, 동구,045002, 41세,2018,987,524,463,113.2,936,506,430,117.7
21030, 동구,045003, 42세,2018,967,513,454,113,913,488,425,114.8
21030, 동구,045004, 43세,2018,1095,629,466,135,1063,613,450,136.2
21030, 동구,045005, 44세,2018,1176,612,564,108.5,1138,593,545,108.8
21030, 동구,050,45~49세,2018,6486,3442,3044,113.1,6322,3371,2951,114.2
21030, 동구,050001, 45세,2018,1180,621,559,111.1,1156,610,546,111.7
21030, 동구,050002, 46세,2018,1266,681,585,116.4,1236,668,568,117.6
21030, 동구,050003, 47세,2018,1365,716,649,110.3,1327,697,630,110.6
21030, 동구,050004, 48세,2018,1292,716,576,124.3,1247,698,549,127.1
21030, 동구,050005, 49세,2018,1383,708,675,104.9,1356,698,658,106.1
21030, 동구,055,50~54세,2018,6340,3221,3119,103.3,6207,3157,3050,103.5
21030, 동구,055001, 50세,2018,1314,659,655,100.6,1289,650,639,101.7
21030, 동구,055002, 51세,2018,1314,647,667,97,1281,629,652,96.5
21030, 동구,055003, 52세,2018,1234,627,607,103.3,1203,612,591,103.6
21030, 동구,055004, 53세,2018,1265,643,622,103.4,1242,631,611,103.3
21030, 동구,055005, 54세,2018,1213,645,568,113.6,1192,635,557,114
21030, 동구,060,55~59세,2018,8038,3812,4226,90.2,7915,3766,4149,90.8
21030, 동구,060001, 55세,2018,1382,687,695,98.8,1350,673,677,99.4
21030, 동구,060002, 56세,2018,1538,738,800,92.3,1516,736,780,94.4
21030, 동구,060003, 57세,2018,1693,777,916,84.8,1673,767,906,84.7
21030, 동구,060004, 58세,2018,1787,839,948,88.5,1761,829,932,88.9
21030, 동구,060005, 59세,2018,1638,771,867,88.9,1615,761,854,89.1
21030, 동구,065,60~64세,2018,7982,3800,4182,90.9,7873,3745,4128,90.7
21030, 동구,065001, 60세,2018,1608,815,793,102.8,1584,798,786,101.5
21030, 동구,065002, 61세,2018,1686,812,874,92.9,1666,804,862,93.3
21030, 동구,065003, 62세,2018,1602,750,852,88,1583,743,840,88.5
21030, 동구,065004, 63세,2018,1640,725,915,79.2,1616,714,902,79.2
21030, 동구,065005, 64세,2018,1446,698,748,93.3,1424,686,738,93
21030, 동구,070,65~69세,2018,6529,2990,3539,84.5,6451,2957,3494,84.6
21030, 동구,070001, 65세,2018,1318,612,706,86.7,1302,607,695,87.3
21030, 동구,070002, 66세,2018,1458,667,791,84.3,1438,657,781,84.1
21030, 동구,070003, 67세,2018,1245,585,660,88.6,1232,581,651,89.2
21030, 동구,070004, 68세,2018,1183,539,644,83.7,1166,533,633,84.2
21030, 동구,070005, 69세,2018,1325,587,738,79.5,1313,579,734,78.9
21030, 동구,075,70~74세,2018,5234,2270,2964,76.6,5215,2258,2957,76.4
21030, 동구,075001, 70세,2018,1252,579,673,86,1248,575,673,85.4
21030, 동구,075002, 71세,2018,1182,496,686,72.3,1174,491,683,71.9
21030, 동구,075003, 72세,2018,894,414,480,86.3,890,412,478,86.2
21030, 동구,075004, 73세,2018,931,374,557,67.1,929,373,556,67.1
21030, 동구,075005, 74세,2018,975,407,568,71.7,974,407,567,71.8
21030, 동구,080,75~79세,2018,4685,1870,2815,66.4,4673,1868,2805,66.6
21030, 동구,080001, 75세,2018,989,424,565,75,987,424,563,75.3
21030, 동구,080002, 76세,2018,1124,473,651,72.7,1122,472,650,72.6
21030, 동구,080003, 77세,2018,938,355,583,60.9,936,354,582,60.8
21030, 동구,080004, 78세,2018,817,307,510,60.2,813,307,506,60.7
21030, 동구,080005, 79세,2018,817,311,506,61.5,815,311,504,61.7
21030, 동구,085,80~84세,2018,2695,968,1727,56.1,2690,968,1722,56.2
21030, 동구,085001, 80세,2018,652,250,402,62.2,650,250,400,62.5
21030, 동구,085002, 81세,2018,637,256,381,67.2,636,256,380,67.4
21030, 동구,085003, 82세,2018,581,219,362,60.5,580,219,361,60.7
21030, 동구,085004, 83세,2018,477,148,329,45,477,148,329,45
21030, 동구,085005, 84세,2018,348,95,253,37.5,347,95,252,37.7
21030, 동구,090,85~89세,2018,1133,322,811,39.7,1131,321,810,39.6
21030, 동구,090001, 85세,2018,327,111,216,51.4,327,111,216,51.4
21030, 동구,090002, 86세,2018,285,73,212,34.4,284,73,211,34.6
21030, 동구,090003, 87세,2018,195,50,145,34.5,195,50,145,34.5
21030, 동구,090004, 88세,2018,171,48,123,39,170,47,123,38.2
21030, 동구,090005, 89세,2018,155,40,115,34.8,155,40,115,34.8
21030, 동구,095,90~94세,2018,416,99,317,31.2,415,98,317,30.9
21030, 동구,095001, 90세,2018,142,33,109,30.3,142,33,109,30.3
21030, 동구,095002, 91세,2018,117,26,91,28.6,117,26,91,28.6
21030, 동구,095003, 92세,2018,77,13,64,20.3,77,13,64,20.3
21030, 동구,095004, 93세,2018,49,20,29,69,48,19,29,65.5
21030, 동구,095005, 94세,2018,31,7,24,29.2,31,7,24,29.2
21030, 동구,100,95~99세,2018,74,15,59,25.4,72,15,57,26.3
21030, 동구,100001, 95세,2018,23,X,20,15,22,X,19,15.8
21030, 동구,100002, 96세,2018,24,8,16,50,24,8,16,50
21030, 동구,100003, 97세,2018,14,X,13,7.7,13,X,12,8.3
21030, 동구,100004, 98세,2018,7,X,5,40,7,X,5,40
21030, 동구,100005, 99세,2018,6,X,5,20,6,X,5,20
21030, 동구,101,100세이상,2018,8,X,7,14.3,8,X,7,14.3
21030, 동구,102,15세미만,2018,6188,3209,2979,107.7,6069,3145,2924,107.6
21030, 동구,103,15~64세,2018,57595,29514,28081,105.1,55646,28620,27026,105.9
21030, 동구,104,65세이상,2018,20774,8535,12239,69.7,20655,8486,12169,69.7
21030, 동구,086,85세이상,2018,1631,437,1194,36.6,1626,435,1191,36.5
21030, 동구,126,평균연령,2018,48.4,46.5,50.2,,48.6,46.7,50.5,
21030, 동구,127,중위연령,2018,50.7,48.2,53.3,,51.1,48.6,53.9,
21040, 영도구,000,합계,2018,120731,60778,59953,101.4,118812,59554,59258,100.5
21040, 영도구,005,0~4세,2018,2703,1374,1329,103.4,2681,1363,1318,103.4
21040, 영도구,005001, 0세,2018,430,217,213,101.9,426,215,211,101.9
21040, 영도구,005002, 1세,2018,471,239,232,103,465,236,229,103.1
21040, 영도구,005003, 2세,2018,579,291,288,101,576,289,287,100.7
21040, 영도구,005004, 3세,2018,595,311,284,109.5,589,307,282,108.9
21040, 영도구,005005, 4세,2018,628,316,312,101.3,625,316,309,102.3
21040, 영도구,010,5~9세,2018,3291,1670,1621,103,3281,1663,1618,102.8
21040, 영도구,010001, 5세,2018,604,310,294,105.4,602,309,293,105.5
21040, 영도구,010002, 6세,2018,667,351,316,111.1,663,349,314,111.1
21040, 영도구,010003, 7세,2018,708,341,367,92.9,706,339,367,92.4
21040, 영도구,010004, 8세,2018,697,356,341,104.4,695,354,341,103.8
21040, 영도구,010005, 9세,2018,615,312,303,103,615,312,303,103
21040, 영도구,015,10~14세,2018,3447,1763,1684,104.7,3435,1756,1679,104.6
21040, 영도구,015001, 10세,2018,669,346,323,107.1,668,345,323,106.8
21040, 영도구,015002, 11세,2018,708,378,330,114.5,707,377,330,114.2
21040, 영도구,015003, 12세,2018,663,325,338,96.2,661,324,337,96.1
21040, 영도구,015004, 13세,2018,651,328,323,101.5,647,326,321,101.6
21040, 영도구,015005, 14세,2018,756,386,370,104.3,752,384,368,104.3
21040, 영도구,020,15~19세,2018,6310,3539,2771,127.7,6271,3520,2751,128
21040, 영도구,020001, 15세,2018,803,439,364,120.6,798,436,362,120.4
21040, 영도구,020002, 16세,2018,856,454,402,112.9,854,452,402,112.4
21040, 영도구,020003, 17세,2018,1172,666,506,131.6,1170,665,505,131.7
21040, 영도구,020004, 18세,2018,1462,825,637,129.5,1453,820,633,129.5
21040, 영도구,020005, 19세,2018,2017,1155,862,134,1996,1147,849,135.1
21040, 영도구,025,20~24세,2018,9709,5763,3946,146,9518,5664,3854,147
21040, 영도구,025001, 20세,2018,2017,1140,877,130,1993,1134,859,132
21040, 영도구,025002, 21세,2018,1972,1116,856,130.4,1950,1107,843,131.3
21040, 영도구,025003, 22세,2018,2063,1279,784,163.1,2028,1257,771,163
21040, 영도구,025004, 23세,2018,1860,1113,747,149,1822,1093,729,149.9
21040, 영도구,025005, 24세,2018,1797,1115,682,163.5,1725,1073,652,164.6
21040, 영도구,030,25~29세,2018,6811,3977,2834,140.3,6486,3765,2721,138.4
21040, 영도구,030001, 25세,2018,1532,930,602,154.5,1478,894,584,153.1
21040, 영도구,030002, 26세,2018,1585,964,621,155.2,1526,926,600,154.3
21040, 영도구,030003, 27세,2018,1278,708,570,124.2,1216,666,550,121.1
21040, 영도구,030004, 28세,2018,1203,689,514,134,1131,643,488,131.8
21040, 영도구,030005, 29세,2018,1213,686,527,130.2,1135,636,499,127.5
21040, 영도구,035,30~34세,2018,5630,3192,2438,130.9,5266,2926,2340,125
21040, 영도구,035001, 30세,2018,1129,617,512,120.5,1049,565,484,116.7
21040, 영도구,035002, 31세,2018,1073,624,449,139,1002,567,435,130.3
21040, 영도구,035003, 32세,2018,1118,663,455,145.7,1044,613,431,142.2
21040, 영도구,035004, 33세,2018,1161,644,517,124.6,1082,582,500,116.4
21040, 영도구,035005, 34세,2018,1149,644,505,127.5,1089,599,490,122.2
21040, 영도구,040,35~39세,2018,7064,3780,3284,115.1,6796,3576,3220,111.1
21040, 영도구,040001, 35세,2018,1275,697,578,120.6,1217,653,564,115.8
21040, 영도구,040002, 36세,2018,1340,731,609,120,1281,687,594,115.7
21040, 영도구,040003, 37세,2018,1478,795,683,116.4,1430,759,671,113.1
21040, 영도구,040004, 38세,2018,1537,808,729,110.8,1486,766,720,106.4
21040, 영도구,040005, 39세,2018,1434,749,685,109.3,1382,711,671,106
21040, 영도구,045,40~44세,2018,7225,3866,3359,115.1,7008,3720,3288,113.1
21040, 영도구,045001, 40세,2018,1347,730,617,118.3,1303,700,603,116.1
21040, 영도구,045002, 41세,2018,1321,709,612,115.8,1270,679,591,114.9
21040, 영도구,045003, 42세,2018,1341,722,619,116.6,1299,694,605,114.7
21040, 영도구,045004, 43세,2018,1565,836,729,114.7,1518,804,714,112.6
21040, 영도구,045005, 44세,2018,1651,869,782,111.1,1618,843,775,108.8
21040, 영도구,050,45~49세,2018,8896,4688,4208,111.4,8716,4574,4142,110.4
21040, 영도구,050001, 45세,2018,1725,903,822,109.9,1693,877,816,107.5
21040, 영도구,050002, 46세,2018,1740,932,808,115.3,1699,909,790,115.1
21040, 영도구,050003, 47세,2018,1822,986,836,117.9,1790,966,824,117.2
21040, 영도구,050004, 48세,2018,1839,970,869,111.6,1802,949,853,111.3
21040, 영도구,050005, 49세,2018,1770,897,873,102.7,1732,873,859,101.6
21040, 영도구,055,50~54세,2018,9128,4646,4482,103.7,9001,4584,4417,103.8
21040, 영도구,055001, 50세,2018,1887,953,934,102,1861,942,919,102.5
21040, 영도구,055002, 51세,2018,1841,953,888,107.3,1813,940,873,107.7
21040, 영도구,055003, 52세,2018,1851,1015,836,121.4,1830,1002,828,121
21040, 영도구,055004, 53세,2018,1822,862,960,89.8,1800,857,943,90.9
21040, 영도구,055005, 54세,2018,1727,863,864,99.9,1697,843,854,98.7
21040, 영도구,060,55~59세,2018,11452,5521,5931,93.1,11379,5487,5892,93.1
21040, 영도구,060001, 55세,2018,1977,1009,968,104.2,1958,999,959,104.2
21040, 영도구,060002, 56세,2018,2232,1067,1165,91.6,2208,1054,1154,91.3
21040, 영도구,060003, 57세,2018,2422,1157,1265,91.5,2411,1153,1258,91.7
21040, 영도구,060004, 58세,2018,2484,1200,1284,93.5,2472,1196,1276,93.7
21040, 영도구,060005, 59세,2018,2337,1088,1249,87.1,2330,1085,1245,87.1
21040, 영도구,065,60~64세,2018,11495,5488,6007,91.4,11451,5460,5991,91.1
21040, 영도구,065001, 60세,2018,2323,1151,1172,98.2,2312,1146,1166,98.3
21040, 영도구,065002, 61세,2018,2301,1100,1201,91.6,2291,1092,1199,91.1
21040, 영도구,065003, 62세,2018,2317,1111,1206,92.1,2307,1104,1203,91.8
21040, 영도구,065004, 63세,2018,2491,1129,1362,82.9,2485,1126,1359,82.9
21040, 영도구,065005, 64세,2018,2063,997,1066,93.5,2056,992,1064,93.2
21040, 영도구,070,65~69세,2018,8896,4113,4783,86,8875,4103,4772,86
21040, 영도구,070001, 65세,2018,1754,810,944,85.8,1753,810,943,85.9
21040, 영도구,070002, 66세,2018,1982,939,1043,90,1976,935,1041,89.8
21040, 영도구,070003, 67세,2018,1682,765,917,83.4,1675,761,914,83.3
21040, 영도구,070004, 68세,2018,1664,774,890,87,1658,772,886,87.1
21040, 영도구,070005, 69세,2018,1814,825,989,83.4,1813,825,988,83.5
21040, 영도구,075,70~74세,2018,7205,3149,4056,77.6,7192,3145,4047,77.7
21040, 영도구,075001, 70세,2018,1665,753,912,82.6,1661,751,910,82.5
21040, 영도구,075002, 71세,2018,1723,760,963,78.9,1721,759,962,78.9
21040, 영도구,075003, 72세,2018,1270,564,706,79.9,1267,563,704,80
21040, 영도구,075004, 73세,2018,1253,533,720,74,1251,533,718,74.2
21040, 영도구,075005, 74세,2018,1294,539,755,71.4,1292,539,753,71.6
21040, 영도구,080,75~79세,2018,6309,2574,3735,68.9,6300,2573,3727,69
21040, 영도구,080001, 75세,2018,1419,614,805,76.3,1419,614,805,76.3
21040, 영도구,080002, 76세,2018,1469,626,843,74.3,1468,626,842,74.3
21040, 영도구,080003, 77세,2018,1234,511,723,70.7,1231,510,721,70.7
21040, 영도구,080004, 78세,2018,1124,420,704,59.7,1123,420,703,59.7
21040, 영도구,080005, 79세,2018,1063,403,660,61.1,1059,403,656,61.4
21040, 영도구,085,80~84세,2018,3321,1225,2096,58.4,3319,1225,2094,58.5
21040, 영도구,085001, 80세,2018,818,338,480,70.4,817,338,479,70.6
21040, 영도구,085002, 81세,2018,766,266,500,53.2,766,266,500,53.2
21040, 영도구,085003, 82세,2018,670,244,426,57.3,669,244,425,57.4
21040, 영도구,085004, 83세,2018,590,211,379,55.7,590,211,379,55.7
21040, 영도구,085005, 84세,2018,477,166,311,53.4,477,166,311,53.4
21040, 영도구,090,85~89세,2018,1339,363,976,37.2,1338,363,975,37.2
21040, 영도구,090001, 85세,2018,372,108,264,40.9,371,108,263,41.1
21040, 영도구,090002, 86세,2018,340,95,245,38.8,340,95,245,38.8
21040, 영도구,090003, 87세,2018,236,74,162,45.7,236,74,162,45.7
21040, 영도구,090004, 88세,2018,192,43,149,28.9,192,43,149,28.9
21040, 영도구,090005, 89세,2018,199,43,156,27.6,199,43,156,27.6
21040, 영도구,095,90~94세,2018,402,64,338,18.9,401,64,337,19
21040, 영도구,095001, 90세,2018,142,17,125,13.6,142,17,125,13.6
21040, 영도구,095002, 91세,2018,114,22,92,23.9,113,22,91,24.2
21040, 영도구,095003, 92세,2018,68,12,56,21.4,68,12,56,21.4
21040, 영도구,095004, 93세,2018,43,6,37,16.2,43,6,37,16.2
21040, 영도구,095005, 94세,2018,35,7,28,25,35,7,28,25
21040, 영도구,100,95~99세,2018,88,22,66,33.3,88,22,66,33.3
21040, 영도구,100001, 95세,2018,45,10,35,28.6,45,10,35,28.6
21040, 영도구,100002, 96세,2018,12,X,8,50,12,X,8,50
21040, 영도구,100003, 97세,2018,17,6,11,54.5,17,6,11,54.5
21040, 영도구,100004, 98세,2018,X,X,X,0,X,X,X,0
21040, 영도구,100005, 99세,2018,11,X,9,22.2,11,X,9,22.2
21040, 영도구,101,100세이상,2018,10,X,9,11.1,10,X,9,11.1
21040, 영도구,102,15세미만,2018,9441,4807,4634,103.7,9397,4782,4615,103.6
21040, 영도구,103,15~64세,2018,83720,44460,39260,113.2,81892,43276,38616,112.1
21040, 영도구,104,65세이상,2018,27570,11511,16059,71.7,27523,11496,16027,71.7
21040, 영도구,086,85세이상,2018,1839,450,1389,32.4,1837,450,1387,32.4
21040, 영도구,126,평균연령,2018,47,44.8,49.2,,47.2,45,49.4,
21040, 영도구,127,중위연령,2018,49.6,46.6,52.8,,50,47,53.1,
21050, 부산진구,000,합계,2018,357723,172741,184982,93.4,354781,171536,183245,93.6
21050, 부산진구,005,0~4세,2018,11418,5909,5509,107.3,11387,5887,5500,107
21050, 부산진구,005001, 0세,2018,2059,1089,970,112.3,2049,1082,967,111.9
21050, 부산진구,005002, 1세,2018,2072,1060,1012,104.7,2067,1057,1010,104.7
21050, 부산진구,005003, 2세,2018,2393,1219,1174,103.8,2387,1214,1173,103.5
21050, 부산진구,005004, 3세,2018,2442,1249,1193,104.7,2438,1246,1192,104.5
21050, 부산진구,005005, 4세,2018,2452,1292,1160,111.4,2446,1288,1158,111.2
21050, 부산진구,010,5~9세,2018,12103,6111,5992,102,12083,6100,5983,102
21050, 부산진구,010001, 5세,2018,2365,1194,1171,102,2356,1188,1168,101.7
21050, 부산진구,010002, 6세,2018,2573,1274,1299,98.1,2570,1273,1297,98.1
21050, 부산진구,010003, 7세,2018,2533,1257,1276,98.5,2531,1255,1276,98.4
21050, 부산진구,010004, 8세,2018,2355,1226,1129,108.6,2352,1224,1128,108.5
21050, 부산진구,010005, 9세,2018,2277,1160,1117,103.8,2274,1160,1114,104.1
21050, 부산진구,015,10~14세,2018,11655,5902,5753,102.6,11640,5893,5747,102.5
21050, 부산진구,015001, 10세,2018,2383,1206,1177,102.5,2378,1202,1176,102.2
21050, 부산진구,015002, 11세,2018,2419,1195,1224,97.6,2414,1193,1221,97.7
21050, 부산진구,015003, 12세,2018,2231,1128,1103,102.3,2229,1128,1101,102.5
21050, 부산진구,015004, 13세,2018,2144,1055,1089,96.9,2142,1053,1089,96.7
21050, 부산진구,015005, 14세,2018,2478,1318,1160,113.6,2477,1317,1160,113.5
21050, 부산진구,020,15~19세,2018,17155,8544,8611,99.2,17020,8481,8539,99.3
21050, 부산진구,020001, 15세,2018,2560,1325,1235,107.3,2550,1319,1231,107.1
21050, 부산진구,020002, 16세,2018,2665,1349,1316,102.5,2653,1341,1312,102.2
21050, 부산진구,020003, 17세,2018,3211,1652,1559,106,3187,1643,1544,106.4
21050, 부산진구,020004, 18세,2018,4038,2013,2025,99.4,4005,1996,2009,99.4
21050, 부산진구,020005, 19세,2018,4681,2205,2476,89.1,4625,2182,2443,89.3
21050, 부산진구,025,20~24세,2018,26175,12767,13408,95.2,25704,12592,13112,96
21050, 부산진구,025001, 20세,2018,4675,2043,2632,77.6,4567,2004,2563,78.2
21050, 부산진구,025002, 21세,2018,4995,2333,2662,87.6,4885,2293,2592,88.5
21050, 부산진구,025003, 22세,2018,5303,2699,2604,103.6,5221,2668,2553,104.5
21050, 부산진구,025004, 23세,2018,5542,2855,2687,106.3,5464,2825,2639,107
21050, 부산진구,025005, 24세,2018,5660,2837,2823,100.5,5567,2802,2765,101.3
21050, 부산진구,030,25~29세,2018,27035,13527,13508,100.1,26559,13351,13208,101.1
21050, 부산진구,030001, 25세,2018,5767,2946,2821,104.4,5675,2911,2764,105.3
21050, 부산진구,030002, 26세,2018,5778,2889,2889,100,5700,2857,2843,100.5
21050, 부산진구,030003, 27세,2018,5379,2671,2708,98.6,5273,2630,2643,99.5
21050, 부산진구,030004, 28세,2018,5158,2594,2564,101.2,5069,2561,2508,102.1
21050, 부산진구,030005, 29세,2018,4953,2427,2526,96.1,4842,2392,2450,97.6
21050, 부산진구,035,30~34세,2018,22986,11612,11374,102.1,22547,11448,11099,103.1
21050, 부산진구,035001, 30세,2018,4637,2308,2329,99.1,4531,2265,2266,100
21050, 부산진구,035002, 31세,2018,4656,2298,2358,97.5,4572,2276,2296,99.1
21050, 부산진구,035003, 32세,2018,4460,2223,2237,99.4,4361,2186,2175,100.5
21050, 부산진구,035004, 33세,2018,4608,2360,2248,105,4533,2329,2204,105.7
21050, 부산진구,035005, 34세,2018,4625,2423,2202,110,4550,2392,2158,110.8
21050, 부산진구,040,35~39세,2018,26605,13579,13026,104.2,26302,13452,12850,104.7
21050, 부산진구,040001, 35세,2018,5126,2587,2539,101.9,5041,2559,2482,103.1
21050, 부산진구,040002, 36세,2018,5414,2796,2618,106.8,5348,2764,2584,107
21050, 부산진구,040003, 37세,2018,5359,2753,2606,105.6,5306,2730,2576,106
21050, 부산진구,040004, 38세,2018,5495,2827,2668,106,5454,2812,2642,106.4
21050, 부산진구,040005, 39세,2018,5211,2616,2595,100.8,5153,2587,2566,100.8
21050, 부산진구,045,40~44세,2018,24004,12283,11721,104.8,23755,12182,11573,105.3
21050, 부산진구,045001, 40세,2018,4667,2456,2211,111.1,4605,2431,2174,111.8
21050, 부산진구,045002, 41세,2018,4595,2343,2252,104,4554,2330,2224,104.8
21050, 부산진구,045003, 42세,2018,4546,2268,2278,99.6,4490,2251,2239,100.5
21050, 부산진구,045004, 43세,2018,4774,2423,2351,103.1,4734,2403,2331,103.1
21050, 부산진구,045005, 44세,2018,5422,2793,2629,106.2,5372,2767,2605,106.2
21050, 부산진구,050,45~49세,2018,27827,13870,13957,99.4,27594,13756,13838,99.4
21050, 부산진구,050001, 45세,2018,5350,2716,2634,103.1,5297,2691,2606,103.3
21050, 부산진구,050002, 46세,2018,5551,2821,2730,103.3,5504,2795,2709,103.2
21050, 부산진구,050003, 47세,2018,5706,2777,2929,94.8,5664,2763,2901,95.2
21050, 부산진구,050004, 48세,2018,5629,2813,2816,99.9,5581,2790,2791,100
21050, 부산진구,050005, 49세,2018,5591,2743,2848,96.3,5548,2717,2831,96
21050, 부산진구,055,50~54세,2018,27297,13082,14215,92,27136,13014,14122,92.2
21050, 부산진구,055001, 50세,2018,5775,2757,3018,91.4,5732,2743,2989,91.8
21050, 부산진구,055002, 51세,2018,5378,2520,2858,88.2,5345,2505,2840,88.2
21050, 부산진구,055003, 52세,2018,5383,2604,2779,93.7,5343,2587,2756,93.9
21050, 부산진구,055004, 53세,2018,5504,2637,2867,92,5480,2624,2856,91.9
21050, 부산진구,055005, 54세,2018,5257,2564,2693,95.2,5236,2555,2681,95.3
21050, 부산진구,060,55~59세,2018,32074,15021,17053,88.1,31908,14955,16953,88.2
21050, 부산진구,060001, 55세,2018,5799,2778,3021,92,5754,2761,2993,92.2
21050, 부산진구,060002, 56세,2018,6269,3027,3242,93.4,6223,3008,3215,93.6
21050, 부산진구,060003, 57세,2018,6840,3164,3676,86.1,6814,3156,3658,86.3
21050, 부산진구,060004, 58세,2018,6863,3117,3746,83.2,6837,3107,3730,83.3
21050, 부산진구,060005, 59세,2018,6303,2935,3368,87.1,6280,2923,3357,87.1
21050, 부산진구,065,60~64세,2018,29177,13847,15330,90.3,29038,13782,15256,90.3
21050, 부산진구,065001, 60세,2018,6125,2893,3232,89.5,6093,2880,3213,89.6
21050, 부산진구,065002, 61세,2018,6136,2883,3253,88.6,6107,2870,3237,88.7
21050, 부산진구,065003, 62세,2018,5802,2784,3018,92.2,5777,2770,3007,92.1
21050, 부산진구,065004, 63세,2018,6052,2814,3238,86.9,6022,2799,3223,86.8
21050, 부산진구,065005, 64세,2018,5062,2473,2589,95.5,5039,2463,2576,95.6
21050, 부산진구,070,65~69세,2018,21310,9969,11341,87.9,21254,9945,11309,87.9
21050, 부산진구,070001, 65세,2018,4548,2050,2498,82.1,4524,2044,2480,82.4
21050, 부산진구,070002, 66세,2018,4837,2301,2536,90.7,4825,2294,2531,90.6
21050, 부산진구,070003, 67세,2018,3956,1876,2080,90.2,3944,1870,2074,90.2
21050, 부산진구,070004, 68세,2018,3865,1868,1997,93.5,3859,1865,1994,93.5
21050, 부산진구,070005, 69세,2018,4104,1874,2230,84,4102,1872,2230,83.9
21050, 부산진구,075,70~74세,2018,15946,7229,8717,82.9,15921,7214,8707,82.9
21050, 부산진구,075001, 70세,2018,4006,1839,2167,84.9,4001,1835,2166,84.7
21050, 부산진구,075002, 71세,2018,3685,1689,1996,84.6,3677,1684,1993,84.5
21050, 부산진구,075003, 72세,2018,2721,1207,1514,79.7,2718,1205,1513,79.6
21050, 부산진구,075004, 73세,2018,2667,1182,1485,79.6,2663,1181,1482,79.7
21050, 부산진구,075005, 74세,2018,2867,1312,1555,84.4,2862,1309,1553,84.3
21050, 부산진구,080,75~79세,2018,13486,5669,7817,72.5,13476,5667,7809,72.6
21050, 부산진구,080001, 75세,2018,2926,1317,1609,81.9,2923,1316,1607,81.9
21050, 부산진구,080002, 76세,2018,3206,1348,1858,72.6,3205,1348,1857,72.6
21050, 부산진구,080003, 77세,2018,2628,1105,1523,72.6,2626,1105,1521,72.6
21050, 부산진구,080004, 78세,2018,2424,995,1429,69.6,2423,995,1428,69.7
21050, 부산진구,080005, 79세,2018,2302,904,1398,64.7,2299,903,1396,64.7
21050, 부산진구,085,80~84세,2018,7287,2669,4618,57.8,7280,2667,4613,57.8
21050, 부산진구,085001, 80세,2018,1785,679,1106,61.4,1779,678,1101,61.6
21050, 부산진구,085002, 81세,2018,1748,653,1095,59.6,1748,653,1095,59.6
21050, 부산진구,085003, 82세,2018,1389,495,894,55.4,1389,495,894,55.4
21050, 부산진구,085004, 83세,2018,1311,442,869,50.9,1311,442,869,50.9
21050, 부산진구,085005, 84세,2018,1054,400,654,61.2,1053,399,654,61
21050, 부산진구,090,85~89세,2018,3086,937,2149,43.6,3083,937,2146,43.7
21050, 부산진구,090001, 85세,2018,890,300,590,50.8,887,300,587,51.1
21050, 부산진구,090002, 86세,2018,776,252,524,48.1,776,252,524,48.1
21050, 부산진구,090003, 87세,2018,553,149,404,36.9,553,149,404,36.9
21050, 부산진구,090004, 88세,2018,467,121,346,35,467,121,346,35
21050, 부산진구,090005, 89세,2018,400,115,285,40.4,400,115,285,40.4
21050, 부산진구,095,90~94세,2018,881,172,709,24.3,879,171,708,24.2
21050, 부산진구,095001, 90세,2018,326,64,262,24.4,326,64,262,24.4
21050, 부산진구,095002, 91세,2018,244,47,197,23.9,243,47,196,24
21050, 부산진구,095003, 92세,2018,128,27,101,26.7,127,26,101,25.7
21050, 부산진구,095004, 93세,2018,109,18,91,19.8,109,18,91,19.8
21050, 부산진구,095005, 94세,2018,74,16,58,27.6,74,16,58,27.6
21050, 부산진구,100,95~99세,2018,196,41,155,26.5,195,41,154,26.6
21050, 부산진구,100001, 95세,2018,72,19,53,35.8,72,19,53,35.8
21050, 부산진구,100002, 96세,2018,59,11,48,22.9,59,11,48,22.9
21050, 부산진구,100003, 97세,2018,31,5,26,19.2,31,5,26,19.2
21050, 부산진구,100004, 98세,2018,23,X,20,15,23,X,20,15
21050, 부산진구,100005, 99세,2018,11,X,8,37.5,10,X,7,42.9
21050, 부산진구,101,100세이상,2018,20,X,19,5.3,20,X,19,5.3
21050, 부산진구,102,15세미만,2018,35176,17922,17254,103.9,35110,17880,17230,103.8
21050, 부산진구,103,15~64세,2018,260335,128132,132203,96.9,257563,127013,130550,97.3
21050, 부산진구,104,65세이상,2018,62212,26687,35525,75.1,62108,26643,35465,75.1
21050, 부산진구,086,85세이상,2018,4183,1151,3032,38,4177,1150,3027,38
21050, 부산진구,126,평균연령,2018,43.9,42.7,44.9,,43.9,42.8,45,
21050, 부산진구,127,중위연령,2018,44.9,43.6,46.3,,45.1,43.6,46.5,
21060, 동래구,000,합계,2018,258386,125960,132426,95.1,257155,125470,131685,95.3
21060, 동래구,005,0~4세,2018,8262,4271,3991,107,8242,4264,3978,107.2
21060, 동래구,005001, 0세,2018,1308,663,645,102.8,1305,661,644,102.6
21060, 동래구,005002, 1세,2018,1511,756,755,100.1,1505,755,750,100.7
21060, 동래구,005003, 2세,2018,1722,880,842,104.5,1717,878,839,104.6
21060, 동래구,005004, 3세,2018,1893,1001,892,112.2,1891,1000,891,112.2
21060, 동래구,005005, 4세,2018,1828,971,857,113.3,1824,970,854,113.6
21060, 동래구,010,5~9세,2018,10626,5553,5073,109.5,10613,5545,5068,109.4
21060, 동래구,010001, 5세,2018,1937,999,938,106.5,1932,996,936,106.4
21060, 동래구,010002, 6세,2018,2232,1159,1073,108,2228,1158,1070,108.2
21060, 동래구,010003, 7세,2018,2148,1117,1031,108.3,2146,1115,1031,108.1
21060, 동래구,010004, 8세,2018,2254,1214,1040,116.7,2252,1212,1040,116.5
21060, 동래구,010005, 9세,2018,2055,1064,991,107.4,2055,1064,991,107.4
21060, 동래구,015,10~14세,2018,11260,5909,5351,110.4,11249,5904,5345,110.5
21060, 동래구,015001, 10세,2018,2206,1142,1064,107.3,2202,1139,1063,107.1
21060, 동래구,015002, 11세,2018,2366,1235,1131,109.2,2363,1233,1130,109.1
21060, 동래구,015003, 12세,2018,2167,1124,1043,107.8,2167,1124,1043,107.8
21060, 동래구,015004, 13세,2018,2112,1141,971,117.5,2110,1141,969,117.8
21060, 동래구,015005, 14세,2018,2409,1267,1142,110.9,2407,1267,1140,111.1
21060, 동래구,020,15~19세,2018,13155,6926,6229,111.2,13129,6921,6208,111.5
21060, 동래구,020001, 15세,2018,2436,1259,1177,107,2435,1259,1176,107.1
21060, 동래구,020002, 16세,2018,2397,1227,1170,104.9,2395,1227,1168,105.1
21060, 동래구,020003, 17세,2018,2753,1456,1297,112.3,2749,1455,1294,112.4
21060, 동래구,020004, 18세,2018,2919,1549,1370,113.1,2916,1548,1368,113.2
21060, 동래구,020005, 19세,2018,2650,1435,1215,118.1,2634,1432,1202,119.1
21060, 동래구,025,20~24세,2018,15479,8326,7153,116.4,15348,8286,7062,117.3
21060, 동래구,025001, 20세,2018,2795,1541,1254,122.9,2778,1537,1241,123.9
21060, 동래구,025002, 21세,2018,3025,1668,1357,122.9,3008,1664,1344,123.8
21060, 동래구,025003, 22세,2018,3182,1702,1480,115,3157,1697,1460,116.2
21060, 동래구,025004, 23세,2018,3182,1661,1521,109.2,3146,1650,1496,110.3
21060, 동래구,025005, 24세,2018,3295,1754,1541,113.8,3259,1738,1521,114.3
21060, 동래구,030,25~29세,2018,15849,8274,7575,109.2,15638,8197,7441,110.2
21060, 동래구,030001, 25세,2018,3392,1776,1616,109.9,3346,1759,1587,110.8
21060, 동래구,030002, 26세,2018,3395,1780,1615,110.2,3356,1771,1585,111.7
21060, 동래구,030003, 27세,2018,3072,1630,1442,113,3035,1615,1420,113.7
21060, 동래구,030004, 28세,2018,3031,1554,1477,105.2,2979,1535,1444,106.3
21060, 동래구,030005, 29세,2018,2959,1534,1425,107.6,2922,1517,1405,108
21060, 동래구,035,30~34세,2018,13882,7110,6772,105,13681,7033,6648,105.8
21060, 동래구,035001, 30세,2018,2808,1408,1400,100.6,2763,1389,1374,101.1
21060, 동래구,035002, 31세,2018,2632,1349,1283,105.1,2595,1341,1254,106.9
21060, 동래구,035003, 32세,2018,2757,1448,1309,110.6,2705,1431,1274,112.3
21060, 동래구,035004, 33세,2018,2763,1442,1321,109.2,2729,1424,1305,109.1
21060, 동래구,035005, 34세,2018,2922,1463,1459,100.3,2889,1448,1441,100.5
21060, 동래구,040,35~39세,2018,18731,9266,9465,97.9,18579,9200,9379,98.1
21060, 동래구,040001, 35세,2018,3375,1703,1672,101.9,3346,1687,1659,101.7
21060, 동래구,040002, 36세,2018,3702,1789,1913,93.5,3668,1773,1895,93.6
21060, 동래구,040003, 37세,2018,3722,1877,1845,101.7,3689,1865,1824,102.2
21060, 동래구,040004, 38세,2018,4070,2039,2031,100.4,4041,2028,2013,100.7
21060, 동래구,040005, 39세,2018,3862,1858,2004,92.7,3835,1847,1988,92.9
21060, 동래구,045,40~44세,2018,18860,9066,9794,92.6,18741,9020,9721,92.8
21060, 동래구,045001, 40세,2018,3541,1714,1827,93.8,3514,1703,1811,94
21060, 동래구,045002, 41세,2018,3550,1755,1795,97.8,3520,1740,1780,97.8
21060, 동래구,045003, 42세,2018,3581,1664,1917,86.8,3563,1660,1903,87.2
21060, 동래구,045004, 43세,2018,3976,1892,2084,90.8,3952,1885,2067,91.2
21060, 동래구,045005, 44세,2018,4212,2041,2171,94,4192,2032,2160,94.1
21060, 동래구,050,45~49세,2018,22438,10941,11497,95.2,22327,10886,11441,95.1
21060, 동래구,050001, 45세,2018,4343,2102,2241,93.8,4316,2090,2226,93.9
21060, 동래구,050002, 46세,2018,4388,2203,2185,100.8,4361,2189,2172,100.8
21060, 동래구,050003, 47세,2018,4611,2221,2390,92.9,4594,2215,2379,93.1
21060, 동래구,050004, 48세,2018,4543,2214,2329,95.1,4525,2204,2321,95
21060, 동래구,050005, 49세,2018,4553,2201,2352,93.6,4531,2188,2343,93.4
21060, 동래구,055,50~54세,2018,21001,9950,11051,90,20927,9915,11012,90
21060, 동래구,055001, 50세,2018,4515,2216,2299,96.4,4503,2212,2291,96.6
21060, 동래구,055002, 51세,2018,4340,2025,2315,87.5,4324,2017,2307,87.4
21060, 동래구,055003, 52세,2018,4074,1983,2091,94.8,4053,1972,2081,94.8
21060, 동래구,055004, 53세,2018,4139,1900,2239,84.9,4128,1892,2236,84.6
21060, 동래구,055005, 54세,2018,3933,1826,2107,86.7,3919,1822,2097,86.9
21060, 동래구,060,55~59세,2018,23507,10906,12601,86.5,23445,10880,12565,86.6
21060, 동래구,060001, 55세,2018,4222,1975,2247,87.9,4209,1969,2240,87.9
21060, 동래구,060002, 56세,2018,4602,2148,2454,87.5,4592,2141,2451,87.4
21060, 동래구,060003, 57세,2018,5034,2315,2719,85.1,5018,2309,2709,85.2
21060, 동래구,060004, 58세,2018,5046,2287,2759,82.9,5035,2283,2752,83
21060, 동래구,060005, 59세,2018,4603,2181,2422,90,4591,2178,2413,90.3
21060, 동래구,065,60~64세,2018,21359,10074,11285,89.3,21318,10059,11259,89.3
21060, 동래구,065001, 60세,2018,4521,2163,2358,91.7,4509,2157,2352,91.7
21060, 동래구,065002, 61세,2018,4480,2134,2346,91,4470,2131,2339,91.1
21060, 동래구,065003, 62세,2018,4194,1933,2261,85.5,4188,1929,2259,85.4
21060, 동래구,065004, 63세,2018,4456,2044,2412,84.7,4449,2043,2406,84.9
21060, 동래구,065005, 64세,2018,3708,1800,1908,94.3,3702,1799,1903,94.5
21060, 동래구,070,65~69세,2018,15692,7363,8329,88.4,15656,7347,8309,88.4
21060, 동래구,070001, 65세,2018,3439,1574,1865,84.4,3426,1568,1858,84.4
21060, 동래구,070002, 66세,2018,3560,1666,1894,88,3550,1660,1890,87.8
21060, 동래구,070003, 67세,2018,2926,1380,1546,89.3,2922,1379,1543,89.4
21060, 동래구,070004, 68세,2018,2906,1381,1525,90.6,2901,1379,1522,90.6
21060, 동래구,070005, 69세,2018,2861,1362,1499,90.9,2857,1361,1496,91
21060, 동래구,075,70~74세,2018,11286,5426,5860,92.6,11272,5418,5854,92.6
21060, 동래구,075001, 70세,2018,2821,1334,1487,89.7,2817,1332,1485,89.7
21060, 동래구,075002, 71세,2018,2601,1237,1364,90.7,2597,1236,1361,90.8
21060, 동래구,075003, 72세,2018,1951,973,978,99.5,1948,970,978,99.2
21060, 동래구,075004, 73세,2018,1882,934,948,98.5,1881,934,947,98.6
21060, 동래구,075005, 74세,2018,2031,948,1083,87.5,2029,946,1083,87.3
21060, 동래구,080,75~79세,2018,8757,3865,4892,79,8753,3862,4891,79
21060, 동래구,080001, 75세,2018,1945,899,1046,85.9,1944,898,1046,85.9
21060, 동래구,080002, 76세,2018,2094,927,1167,79.4,2092,926,1166,79.4
21060, 동래구,080003, 77세,2018,1773,776,997,77.8,1773,776,997,77.8
21060, 동래구,080004, 78세,2018,1548,665,883,75.3,1548,665,883,75.3
21060, 동래구,080005, 79세,2018,1397,598,799,74.8,1396,597,799,74.7
21060, 동래구,085,80~84세,2018,4952,1912,3040,62.9,4949,1912,3037,63
21060, 동래구,085001, 80세,2018,1174,491,683,71.9,1174,491,683,71.9
21060, 동래구,085002, 81세,2018,1105,444,661,67.2,1104,444,660,67.3
21060, 동래구,085003, 82세,2018,1002,417,585,71.3,1001,417,584,71.4
21060, 동래구,085004, 83세,2018,916,329,587,56,916,329,587,56
21060, 동래구,085005, 84세,2018,755,231,524,44.1,754,231,523,44.2
21060, 동래구,090,85~89세,2018,2292,638,1654,38.6,2291,638,1653,38.6
21060, 동래구,090001, 85세,2018,608,185,423,43.7,608,185,423,43.7
21060, 동래구,090002, 86세,2018,550,161,389,41.4,549,161,388,41.5
21060, 동래구,090003, 87세,2018,444,126,318,39.6,444,126,318,39.6
21060, 동래구,090004, 88세,2018,384,92,292,31.5,384,92,292,31.5
21060, 동래구,090005, 89세,2018,306,74,232,31.9,306,74,232,31.9
21060, 동래구,095,90~94세,2018,785,152,633,24,784,151,633,23.9
21060, 동래구,095001, 90세,2018,261,51,210,24.3,261,51,210,24.3
21060, 동래구,095002, 91세,2018,202,43,159,27,202,43,159,27
21060, 동래구,095003, 92세,2018,141,28,113,24.8,140,27,113,23.9
21060, 동래구,095004, 93세,2018,112,19,93,20.4,112,19,93,20.4
21060, 동래구,095005, 94세,2018,69,11,58,19,69,11,58,19
21060, 동래구,100,95~99세,2018,187,29,158,18.4,187,29,158,18.4
21060, 동래구,100001, 95세,2018,80,12,68,17.6,80,12,68,17.6
21060, 동래구,100002, 96세,2018,41,7,34,20.6,41,7,34,20.6
21060, 동래구,100003, 97세,2018,29,X,25,16,29,X,25,16
21060, 동래구,100004, 98세,2018,25,5,20,25,25,5,20,25
21060, 동래구,100005, 99세,2018,12,X,11,9.1,12,X,11,9.1
21060, 동래구,101,100세이상,2018,26,X,23,13,26,X,23,13
21060, 동래구,102,15세미만,2018,30148,15733,14415,109.1,30104,15713,14391,109.2
21060, 동래구,103,15~64세,2018,184261,90839,93422,97.2,183133,90397,92736,97.5
21060, 동래구,104,65세이상,2018,43977,19388,24589,78.8,43918,19360,24558,78.8
21060, 동래구,086,85세이상,2018,3290,822,2468,33.3,3288,821,2467,33.3
21060, 동래구,126,평균연령,2018,43.8,42.4,45.1,,43.8,42.4,45.2,
21060, 동래구,127,중위연령,2018,45.7,44.2,47.2,,45.8,44.2,47.2,
21070, 남구,000,합계,2018,282645,139027,143618,96.8,275914,135555,140359,96.6
21070, 남구,005,0~4세,2018,9011,4647,4364,106.5,8948,4614,4334,106.5
21070, 남구,005001, 0세,2018,1368,733,635,115.4,1359,726,633,114.7
21070, 남구,005002, 1세,2018,1659,840,819,102.6,1639,827,812,101.8
21070, 남구,005003, 2세,2018,1920,966,954,101.3,1909,961,948,101.4
21070, 남구,005004, 3세,2018,2046,1080,966,111.8,2035,1078,957,112.6
21070, 남구,005005, 4세,2018,2018,1028,990,103.8,2006,1022,984,103.9
21070, 남구,010,5~9세,2018,11001,5546,5455,101.7,10979,5533,5446,101.6
21070, 남구,010001, 5세,2018,2105,1074,1031,104.2,2099,1073,1026,104.6
21070, 남구,010002, 6세,2018,2272,1145,1127,101.6,2266,1140,1126,101.2
21070, 남구,010003, 7세,2018,2286,1123,1163,96.6,2285,1123,1162,96.6
21070, 남구,010004, 8세,2018,2256,1179,1077,109.5,2255,1179,1076,109.6
21070, 남구,010005, 9세,2018,2082,1025,1057,97,2074,1018,1056,96.4
21070, 남구,015,10~14세,2018,10978,5699,5279,108,10956,5690,5266,108.1
21070, 남구,015001, 10세,2018,2173,1104,1069,103.3,2170,1104,1066,103.6
21070, 남구,015002, 11세,2018,2335,1235,1100,112.3,2329,1231,1098,112.1
21070, 남구,015003, 12세,2018,2074,1071,1003,106.8,2072,1070,1002,106.8
21070, 남구,015004, 13세,2018,2130,1113,1017,109.4,2123,1111,1012,109.8
21070, 남구,015005, 14세,2018,2266,1176,1090,107.9,2262,1174,1088,107.9
21070, 남구,020,15~19세,2018,16517,8522,7995,106.6,15665,8058,7607,105.9
21070, 남구,020001, 15세,2018,2337,1181,1156,102.2,2330,1177,1153,102.1
21070, 남구,020002, 16세,2018,2378,1265,1113,113.7,2366,1259,1107,113.7
21070, 남구,020003, 17세,2018,2738,1463,1275,114.7,2707,1446,1261,114.7
21070, 남구,020004, 18세,2018,3775,1935,1840,105.2,3621,1871,1750,106.9
21070, 남구,020005, 19세,2018,5289,2678,2611,102.6,4641,2305,2336,98.7
21070, 남구,025,20~24세,2018,24011,12559,11452,109.7,21604,11293,10311,109.5
21070, 남구,025001, 20세,2018,4840,2250,2590,86.9,4173,1922,2251,85.4
21070, 남구,025002, 21세,2018,4720,2330,2390,97.5,4219,2037,2182,93.4
21070, 남구,025003, 22세,2018,4979,2672,2307,115.8,4509,2411,2098,114.9
21070, 남구,025004, 23세,2018,4905,2726,2179,125.1,4497,2521,1976,127.6
21070, 남구,025005, 24세,2018,4567,2581,1986,130,4206,2402,1804,133.1
21070, 남구,030,25~29세,2018,18195,9992,8203,121.8,17110,9494,7616,124.7
21070, 남구,030001, 25세,2018,4334,2481,1853,133.9,4052,2360,1692,139.5
21070, 남구,030002, 26세,2018,4052,2224,1828,121.7,3825,2116,1709,123.8
21070, 남구,030003, 27세,2018,3522,1920,1602,119.9,3316,1822,1494,122
21070, 남구,030004, 28세,2018,3197,1687,1510,111.7,3007,1596,1411,113.1
21070, 남구,030005, 29세,2018,3090,1680,1410,119.1,2910,1600,1310,122.1
21070, 남구,035,30~34세,2018,14588,7490,7098,105.5,13930,7154,6776,105.6
21070, 남구,035001, 30세,2018,2855,1468,1387,105.8,2692,1393,1299,107.2
21070, 남구,035002, 31세,2018,2885,1478,1407,105,2748,1409,1339,105.2
21070, 남구,035003, 32세,2018,2856,1490,1366,109.1,2728,1414,1314,107.6
21070, 남구,035004, 33세,2018,2815,1441,1374,104.9,2705,1384,1321,104.8
21070, 남구,035005, 34세,2018,3177,1613,1564,103.1,3057,1554,1503,103.4
21070, 남구,040,35~39세,2018,19882,10049,9833,102.2,19428,9798,9630,101.7
21070, 남구,040001, 35세,2018,3446,1757,1689,104,3353,1707,1646,103.7
21070, 남구,040002, 36세,2018,3942,2013,1929,104.4,3844,1958,1886,103.8
21070, 남구,040003, 37세,2018,4070,2072,1998,103.7,3979,2018,1961,102.9
21070, 남구,040004, 38세,2018,4235,2149,2086,103,4143,2102,2041,103
21070, 남구,040005, 39세,2018,4189,2058,2131,96.6,4109,2013,2096,96
21070, 남구,045,40~44세,2018,19941,10059,9882,101.8,19587,9870,9717,101.6
21070, 남구,045001, 40세,2018,3808,1921,1887,101.8,3729,1881,1848,101.8
21070, 남구,045002, 41세,2018,3851,1890,1961,96.4,3784,1854,1930,96.1
21070, 남구,045003, 42세,2018,3702,1835,1867,98.3,3626,1793,1833,97.8
21070, 남구,045004, 43세,2018,4107,2143,1964,109.1,4049,2112,1937,109
21070, 남구,045005, 44세,2018,4473,2270,2203,103,4399,2230,2169,102.8
21070, 남구,050,45~49세,2018,23441,11755,11686,100.6,23136,11585,11551,100.3
21070, 남구,050001, 45세,2018,4613,2327,2286,101.8,4534,2291,2243,102.1
21070, 남구,050002, 46세,2018,4582,2345,2237,104.8,4526,2312,2214,104.4
21070, 남구,050003, 47세,2018,4857,2397,2460,97.4,4794,2357,2437,96.7
21070, 남구,050004, 48세,2018,4673,2314,2359,98.1,4619,2282,2337,97.6
21070, 남구,050005, 49세,2018,4716,2372,2344,101.2,4663,2343,2320,101
21070, 남구,055,50~54세,2018,20997,10307,10690,96.4,20799,10210,10589,96.4
21070, 남구,055001, 50세,2018,4646,2294,2352,97.5,4602,2275,2327,97.8
21070, 남구,055002, 51세,2018,4254,2079,2175,95.6,4205,2059,2146,95.9
21070, 남구,055003, 52세,2018,4130,2014,2116,95.2,4100,1997,2103,95
21070, 남구,055004, 53세,2018,3992,1929,2063,93.5,3952,1909,2043,93.4
21070, 남구,055005, 54세,2018,3975,1991,1984,100.4,3940,1970,1970,100
21070, 남구,060,55~59세,2018,23473,10986,12487,88,23323,10914,12409,88
21070, 남구,060001, 55세,2018,4299,2053,2246,91.4,4266,2039,2227,91.6
21070, 남구,060002, 56세,2018,4488,2162,2326,92.9,4451,2143,2308,92.9
21070, 남구,060003, 57세,2018,4811,2219,2592,85.6,4781,2202,2579,85.4
21070, 남구,060004, 58세,2018,5216,2377,2839,83.7,5187,2364,2823,83.7
21070, 남구,060005, 59세,2018,4659,2175,2484,87.6,4638,2166,2472,87.6
21070, 남구,065,60~64세,2018,22109,10317,11792,87.5,22025,10274,11751,87.4
21070, 남구,065001, 60세,2018,4570,2158,2412,89.5,4548,2145,2403,89.3
21070, 남구,065002, 61세,2018,4662,2212,2450,90.3,4650,2207,2443,90.3
21070, 남구,065003, 62세,2018,4417,1985,2432,81.6,4393,1972,2421,81.5
21070, 남구,065004, 63세,2018,4568,2094,2474,84.6,4557,2089,2468,84.6
21070, 남구,065005, 64세,2018,3892,1868,2024,92.3,3877,1861,2016,92.3
21070, 남구,070,65~69세,2018,16673,7653,9020,84.8,16633,7636,8997,84.9
21070, 남구,070001, 65세,2018,3391,1571,1820,86.3,3383,1568,1815,86.4
21070, 남구,070002, 66세,2018,3738,1711,2027,84.4,3729,1706,2023,84.3
21070, 남구,070003, 67세,2018,3078,1427,1651,86.4,3071,1423,1648,86.3
21070, 남구,070004, 68세,2018,3196,1453,1743,83.4,3187,1451,1736,83.6
21070, 남구,070005, 69세,2018,3270,1491,1779,83.8,3263,1488,1775,83.8
21070, 남구,075,70~74세,2018,12877,5887,6990,84.2,12864,5881,6983,84.2
21070, 남구,075001, 70세,2018,3051,1379,1672,82.5,3044,1376,1668,82.5
21070, 남구,075002, 71세,2018,2985,1376,1609,85.5,2984,1375,1609,85.5
21070, 남구,075003, 72세,2018,2235,1034,1201,86.1,2233,1033,1200,86.1
21070, 남구,075004, 73세,2018,2240,1037,1203,86.2,2237,1036,1201,86.3
21070, 남구,075005, 74세,2018,2366,1061,1305,81.3,2366,1061,1305,81.3
21070, 남구,080,75~79세,2018,10376,4603,5773,79.7,10365,4600,5765,79.8
21070, 남구,080001, 75세,2018,2449,1083,1366,79.3,2447,1083,1364,79.4
21070, 남구,080002, 76세,2018,2471,1153,1318,87.5,2469,1152,1317,87.5
21070, 남구,080003, 77세,2018,1941,850,1091,77.9,1941,850,1091,77.9
21070, 남구,080004, 78세,2018,1863,801,1062,75.4,1860,801,1059,75.6
21070, 남구,080005, 79세,2018,1652,716,936,76.5,1648,714,934,76.4
21070, 남구,085,80~84세,2018,5517,2121,3396,62.5,5510,2118,3392,62.4
21070, 남구,085001, 80세,2018,1416,601,815,73.7,1413,600,813,73.8
21070, 남구,085002, 81세,2018,1262,512,750,68.3,1259,510,749,68.1
21070, 남구,085003, 82세,2018,1093,393,700,56.1,1093,393,700,56.1
21070, 남구,085004, 83세,2018,939,352,587,60,939,352,587,60
21070, 남구,085005, 84세,2018,807,263,544,48.3,806,263,543,48.4
21070, 남구,090,85~89세,2018,2226,669,1557,43,2222,667,1555,42.9
21070, 남구,090001, 85세,2018,626,218,408,53.4,625,217,408,53.2
21070, 남구,090002, 86세,2018,567,171,396,43.2,566,170,396,42.9
21070, 남구,090003, 87세,2018,389,111,278,39.9,388,111,277,40.1
21070, 남구,090004, 88세,2018,354,95,259,36.7,354,95,259,36.7
21070, 남구,090005, 89세,2018,290,74,216,34.3,289,74,215,34.4
21070, 남구,095,90~94세,2018,697,138,559,24.7,695,138,557,24.8
21070, 남구,095001, 90세,2018,242,55,187,29.4,241,55,186,29.6
21070, 남구,095002, 91세,2018,194,29,165,17.6,194,29,165,17.6
21070, 남구,095003, 92세,2018,112,22,90,24.4,111,22,89,24.7
21070, 남구,095004, 93세,2018,103,22,81,27.2,103,22,81,27.2
21070, 남구,095005, 94세,2018,46,10,36,27.8,46,10,36,27.8
21070, 남구,100,95~99세,2018,119,24,95,25.3,119,24,95,25.3
21070, 남구,100001, 95세,2018,45,11,34,32.4,45,11,34,32.4
21070, 남구,100002, 96세,2018,35,6,29,20.7,35,6,29,20.7
21070, 남구,100003, 97세,2018,19,X,17,11.8,19,X,17,11.8
21070, 남구,100004, 98세,2018,10,X,9,11.1,10,X,9,11.1
21070, 남구,100005, 99세,2018,10,X,6,66.7,10,X,6,66.7
21070, 남구,101,100세이상,2018,16,X,12,33.3,16,X,12,33.3
21070, 남구,102,15세미만,2018,30990,15892,15098,105.3,30883,15837,15046,105.3
21070, 남구,103,15~64세,2018,203154,102036,101118,100.9,196607,98650,97957,100.7
21070, 남구,104,65세이상,2018,48501,21099,27402,77,48424,21068,27356,77
21070, 남구,086,85세이상,2018,3058,835,2223,37.6,3052,833,2219,37.5
21070, 남구,126,평균연령,2018,43.1,41.7,44.4,,43.4,42.1,44.7,
21070, 남구,127,중위연령,2018,44.4,42.7,46,,44.9,43.3,46.6,
21080, 북구,000,합계,2018,291675,144311,147364,97.9,288803,142991,145812,98.1
21080, 북구,005,0~4세,2018,10461,5342,5119,104.4,10451,5336,5115,104.3
21080, 북구,005001, 0세,2018,1799,923,876,105.4,1796,920,876,105
21080, 북구,005002, 1세,2018,2002,1051,951,110.5,2000,1050,950,110.5
21080, 북구,005003, 2세,2018,2164,1084,1080,100.4,2163,1084,1079,100.5
21080, 북구,005004, 3세,2018,2284,1183,1101,107.4,2283,1182,1101,107.4
21080, 북구,005005, 4세,2018,2212,1101,1111,99.1,2209,1100,1109,99.2
21080, 북구,010,5~9세,2018,11062,5720,5342,107.1,11055,5716,5339,107.1
21080, 북구,010001, 5세,2018,2221,1143,1078,106,2221,1143,1078,106
21080, 북구,010002, 6세,2018,2322,1250,1072,116.6,2319,1247,1072,116.3
21080, 북구,010003, 7세,2018,2237,1146,1091,105,2236,1146,1090,105.1
21080, 북구,010004, 8세,2018,2107,1093,1014,107.8,2105,1092,1013,107.8
21080, 북구,010005, 9세,2018,2175,1088,1087,100.1,2174,1088,1086,100.2
21080, 북구,015,10~14세,2018,11221,5849,5372,108.9,11211,5843,5368,108.8
21080, 북구,015001, 10세,2018,2208,1130,1078,104.8,2208,1130,1078,104.8
21080, 북구,015002, 11세,2018,2203,1123,1080,104,2200,1121,1079,103.9
21080, 북구,015003, 12세,2018,2188,1178,1010,116.6,2187,1177,1010,116.5
21080, 북구,015004, 13세,2018,2251,1187,1064,111.6,2247,1186,1061,111.8
21080, 북구,015005, 14세,2018,2371,1231,1140,108,2369,1229,1140,107.8
21080, 북구,020,15~19세,2018,14991,7923,7068,112.1,14773,7810,6963,112.2
21080, 북구,020001, 15세,2018,2454,1289,1165,110.6,2453,1289,1164,110.7
21080, 북구,020002, 16세,2018,2507,1300,1207,107.7,2502,1299,1203,108
21080, 북구,020003, 17세,2018,3036,1567,1469,106.7,3030,1564,1466,106.7
21080, 북구,020004, 18세,2018,3539,1880,1659,113.3,3505,1865,1640,113.7
21080, 북구,020005, 19세,2018,3455,1887,1568,120.3,3283,1793,1490,120.3
21080, 북구,025,20~24세,2018,21064,11537,9527,121.1,20157,11013,9144,120.4
21080, 북구,025001, 20세,2018,3834,2130,1704,125,3634,2019,1615,125
21080, 북구,025002, 21세,2018,4084,2254,1830,123.2,3873,2134,1739,122.7
21080, 북구,025003, 22세,2018,4355,2386,1969,121.2,4167,2267,1900,119.3
21080, 북구,025004, 23세,2018,4369,2386,1983,120.3,4215,2295,1920,119.5
21080, 북구,025005, 24세,2018,4422,2381,2041,116.7,4268,2298,1970,116.6
21080, 북구,030,25~29세,2018,19916,10654,9262,115,19441,10444,8997,116.1
21080, 북구,030001, 25세,2018,4385,2410,1975,122,4251,2344,1907,122.9
21080, 북구,030002, 26세,2018,4346,2301,2045,112.5,4254,2263,1991,113.7
21080, 북구,030003, 27세,2018,3979,2171,1808,120.1,3888,2128,1760,120.9
21080, 북구,030004, 28세,2018,3696,1932,1764,109.5,3608,1900,1708,111.2
21080, 북구,030005, 29세,2018,3510,1840,1670,110.2,3440,1809,1631,110.9
21080, 북구,035,30~34세,2018,16505,8376,8129,103,16223,8293,7930,104.6
21080, 북구,035001, 30세,2018,3321,1637,1684,97.2,3247,1616,1631,99.1
21080, 북구,035002, 31세,2018,3304,1688,1616,104.5,3243,1670,1573,106.2
21080, 북구,035003, 32세,2018,3165,1637,1528,107.1,3116,1621,1495,108.4
21080, 북구,035004, 33세,2018,3309,1665,1644,101.3,3251,1649,1602,102.9
21080, 북구,035005, 34세,2018,3406,1749,1657,105.6,3366,1737,1629,106.6
21080, 북구,040,35~39세,2018,20335,10365,9970,104,20109,10289,9820,104.8
21080, 북구,040001, 35세,2018,3741,1914,1827,104.8,3682,1895,1787,106
21080, 북구,040002, 36세,2018,4124,2081,2043,101.9,4068,2064,2004,103
21080, 북구,040003, 37세,2018,4169,2153,2016,106.8,4138,2141,1997,107.2
21080, 북구,040004, 38세,2018,4212,2169,2043,106.2,4173,2152,2021,106.5
21080, 북구,040005, 39세,2018,4089,2048,2041,100.3,4048,2037,2011,101.3
21080, 북구,045,40~44세,2018,19137,9644,9493,101.6,18965,9585,9380,102.2
21080, 북구,045001, 40세,2018,3622,1877,1745,107.6,3584,1859,1725,107.8
21080, 북구,045002, 41세,2018,3764,1928,1836,105,3730,1917,1813,105.7
21080, 북구,045003, 42세,2018,3581,1825,1756,103.9,3539,1815,1724,105.3
21080, 북구,045004, 43세,2018,4041,1991,2050,97.1,4005,1978,2027,97.6
21080, 북구,045005, 44세,2018,4129,2023,2106,96.1,4107,2016,2091,96.4
21080, 북구,050,45~49세,2018,24238,11344,12894,88,24064,11278,12786,88.2
21080, 북구,050001, 45세,2018,4511,2116,2395,88.4,4482,2107,2375,88.7
21080, 북구,050002, 46세,2018,4489,2142,2347,91.3,4459,2128,2331,91.3
21080, 북구,050003, 47세,2018,4872,2284,2588,88.3,4832,2264,2568,88.2
21080, 북구,050004, 48세,2018,5054,2343,2711,86.4,5009,2328,2681,86.8
21080, 북구,050005, 49세,2018,5312,2459,2853,86.2,5282,2451,2831,86.6
21080, 북구,055,50~54세,2018,26565,12410,14155,87.7,26415,12348,14067,87.8
21080, 북구,055001, 50세,2018,5510,2498,3012,82.9,5474,2478,2996,82.7
21080, 북구,055002, 51세,2018,5302,2427,2875,84.4,5272,2419,2853,84.8
21080, 북구,055003, 52세,2018,5297,2521,2776,90.8,5263,2508,2755,91
21080, 북구,055004, 53세,2018,5352,2513,2839,88.5,5328,2502,2826,88.5
21080, 북구,055005, 54세,2018,5104,2451,2653,92.4,5078,2441,2637,92.6
21080, 북구,060,55~59세,2018,29966,14797,15169,97.5,29850,14740,15110,97.6
21080, 북구,060001, 55세,2018,5643,2760,2883,95.7,5612,2746,2866,95.8
21080, 북구,060002, 56세,2018,5863,2894,2969,97.5,5830,2877,2953,97.4
21080, 북구,060003, 57세,2018,6568,3241,3327,97.4,6548,3231,3317,97.4
21080, 북구,060004, 58세,2018,6325,3128,3197,97.8,6303,3117,3186,97.8
21080, 북구,060005, 59세,2018,5567,2774,2793,99.3,5557,2769,2788,99.3
21080, 북구,065,60~64세,2018,23842,11852,11990,98.8,23777,11821,11956,98.9
21080, 북구,065001, 60세,2018,5196,2613,2583,101.2,5181,2604,2577,101
21080, 북구,065002, 61세,2018,5186,2623,2563,102.3,5166,2613,2553,102.4
21080, 북구,065003, 62세,2018,4648,2312,2336,99,4635,2306,2329,99
21080, 북구,065004, 63세,2018,4845,2326,2519,92.3,4837,2322,2515,92.3
21080, 북구,065005, 64세,2018,3967,1978,1989,99.4,3958,1976,1982,99.7
21080, 북구,070,65~69세,2018,15513,7632,7881,96.8,15491,7624,7867,96.9
21080, 북구,070001, 65세,2018,3378,1651,1727,95.6,3372,1648,1724,95.6
21080, 북구,070002, 66세,2018,3642,1838,1804,101.9,3639,1837,1802,101.9
21080, 북구,070003, 67세,2018,2794,1361,1433,95,2790,1360,1430,95.1
21080, 북구,070004, 68세,2018,2940,1464,1476,99.2,2936,1463,1473,99.3
21080, 북구,070005, 69세,2018,2759,1318,1441,91.5,2754,1316,1438,91.5
21080, 북구,075,70~74세,2018,10568,4982,5586,89.2,10551,4976,5575,89.3
21080, 북구,075001, 70세,2018,2666,1264,1402,90.2,2660,1264,1396,90.5
21080, 북구,075002, 71세,2018,2505,1189,1316,90.3,2502,1187,1315,90.3
21080, 북구,075003, 72세,2018,1855,905,950,95.3,1853,905,948,95.5
21080, 북구,075004, 73세,2018,1747,830,917,90.5,1747,830,917,90.5
21080, 북구,075005, 74세,2018,1795,794,1001,79.3,1789,790,999,79.1
21080, 북구,080,75~79세,2018,8485,3562,4923,72.4,8471,3555,4916,72.3
21080, 북구,080001, 75세,2018,1911,865,1046,82.7,1908,864,1044,82.8
21080, 북구,080002, 76세,2018,2069,895,1174,76.2,2064,893,1171,76.3
21080, 북구,080003, 77세,2018,1627,665,962,69.1,1626,664,962,69
21080, 북구,080004, 78세,2018,1492,609,883,69,1489,607,882,68.8
21080, 북구,080005, 79세,2018,1386,528,858,61.5,1384,527,857,61.5
21080, 북구,085,80~84세,2018,4846,1650,3196,51.6,4839,1648,3191,51.6
21080, 북구,085001, 80세,2018,1231,453,778,58.2,1230,453,777,58.3
21080, 북구,085002, 81세,2018,1051,382,669,57.1,1050,382,668,57.2
21080, 북구,085003, 82세,2018,921,305,616,49.5,920,305,615,49.6
21080, 북구,085004, 83세,2018,898,290,608,47.7,896,289,607,47.6
21080, 북구,085005, 84세,2018,745,220,525,41.9,743,219,524,41.8
21080, 북구,090,85~89세,2018,2110,516,1594,32.4,2110,516,1594,32.4
21080, 북구,090001, 85세,2018,606,190,416,45.7,606,190,416,45.7
21080, 북구,090002, 86세,2018,507,113,394,28.7,507,113,394,28.7
21080, 북구,090003, 87세,2018,416,90,326,27.6,416,90,326,27.6
21080, 북구,090004, 88세,2018,309,58,251,23.1,309,58,251,23.1
21080, 북구,090005, 89세,2018,272,65,207,31.4,272,65,207,31.4
21080, 북구,095,90~94세,2018,679,138,541,25.5,679,138,541,25.5
21080, 북구,095001, 90세,2018,238,49,189,25.9,238,49,189,25.9
21080, 북구,095002, 91세,2018,172,40,132,30.3,172,40,132,30.3
21080, 북구,095003, 92세,2018,119,24,95,25.3,119,24,95,25.3
21080, 북구,095004, 93세,2018,96,12,84,14.3,96,12,84,14.3
21080, 북구,095005, 94세,2018,54,13,41,31.7,54,13,41,31.7
21080, 북구,100,95~99세,2018,152,17,135,12.6,152,17,135,12.6
21080, 북구,100001, 95세,2018,64,9,55,16.4,64,9,55,16.4
21080, 북구,100002, 96세,2018,31,X,28,10.7,31,X,28,10.7
21080, 북구,100003, 97세,2018,27,X,27,0,27,X,27,0
21080, 북구,100004, 98세,2018,17,X,14,21.4,17,X,14,21.4
21080, 북구,100005, 99세,2018,13,X,11,18.2,13,X,11,18.2
21080, 북구,101,100세이상,2018,19,X,18,5.6,19,X,18,5.6
21080, 북구,102,15세미만,2018,32744,16911,15833,106.8,32717,16895,15822,106.8
21080, 북구,103,15~64세,2018,216559,108902,107657,101.2,213774,107621,106153,101.4
21080, 북구,104,65세이상,2018,42372,18498,23874,77.5,42312,18475,23837,77.5
21080, 북구,086,85세이상,2018,2960,672,2288,29.4,2960,672,2288,29.4
21080, 북구,126,평균연령,2018,43,41.7,44.2,,43.1,41.8,44.3,
21080, 북구,127,중위연령,2018,45.3,43.4,46.9,,45.4,43.6,47.1,
21090, 해운대구,000,합계,2018,396311,191998,204313,94,391595,189541,202054,93.8
21090, 해운대구,005,0~4세,2018,13421,6960,6461,107.7,13273,6880,6393,107.6
21090, 해운대구,005001, 0세,2018,2157,1101,1056,104.3,2137,1091,1046,104.3
21090, 해운대구,005002, 1세,2018,2395,1257,1138,110.5,2359,1238,1121,110.4
21090, 해운대구,005003, 2세,2018,2788,1434,1354,105.9,2746,1404,1342,104.6
21090, 해운대구,005004, 3세,2018,3031,1558,1473,105.8,3007,1547,1460,106
21090, 해운대구,005005, 4세,2018,3050,1610,1440,111.8,3024,1600,1424,112.4
21090, 해운대구,010,5~9세,2018,16882,8786,8096,108.5,16765,8739,8026,108.9
21090, 해운대구,010001, 5세,2018,3214,1704,1510,112.8,3190,1694,1496,113.2
21090, 해운대구,010002, 6세,2018,3476,1799,1677,107.3,3446,1786,1660,107.6
21090, 해운대구,010003, 7세,2018,3478,1805,1673,107.9,3464,1802,1662,108.4
21090, 해운대구,010004, 8세,2018,3396,1756,1640,107.1,3370,1747,1623,107.6
21090, 해운대구,010005, 9세,2018,3318,1722,1596,107.9,3295,1710,1585,107.9
21090, 해운대구,015,10~14세,2018,18044,9211,8833,104.3,17966,9178,8788,104.4
21090, 해운대구,015001, 10세,2018,3562,1829,1733,105.5,3545,1819,1726,105.4
21090, 해운대구,015002, 11세,2018,3639,1827,1812,100.8,3621,1823,1798,101.4
21090, 해운대구,015003, 12세,2018,3503,1804,1699,106.2,3487,1798,1689,106.5
21090, 해운대구,015004, 13세,2018,3523,1803,1720,104.8,3514,1800,1714,105
21090, 해운대구,015005, 14세,2018,3817,1948,1869,104.2,3799,1938,1861,104.1
21090, 해운대구,020,15~19세,2018,23105,12338,10767,114.6,22926,12248,10678,114.7
21090, 해운대구,020001, 15세,2018,4040,2095,1945,107.7,4028,2092,1936,108.1
21090, 해운대구,020002, 16세,2018,4269,2208,2061,107.1,4254,2198,2056,106.9
21090, 해운대구,020003, 17세,2018,5026,2730,2296,118.9,5012,2721,2291,118.8
21090, 해운대구,020004, 18세,2018,5314,2919,2395,121.9,5281,2908,2373,122.5
21090, 해운대구,020005, 19세,2018,4456,2386,2070,115.3,4351,2329,2022,115.2
21090, 해운대구,025,20~24세,2018,24214,13015,11199,116.2,23526,12671,10855,116.7
21090, 해운대구,025001, 20세,2018,4584,2526,2058,122.7,4440,2448,1992,122.9
21090, 해운대구,025002, 21세,2018,4663,2552,2111,120.9,4544,2494,2050,121.7
21090, 해운대구,025003, 22세,2018,5110,2776,2334,118.9,4992,2719,2273,119.6
21090, 해운대구,025004, 23세,2018,4891,2547,2344,108.7,4730,2469,2261,109.2
21090, 해운대구,025005, 24세,2018,4966,2614,2352,111.1,4820,2541,2279,111.5
21090, 해운대구,030,25~29세,2018,23119,11821,11298,104.6,22401,11446,10955,104.5
21090, 해운대구,030001, 25세,2018,4988,2584,2404,107.5,4827,2498,2329,107.3
21090, 해운대구,030002, 26세,2018,5038,2622,2416,108.5,4886,2530,2356,107.4
21090, 해운대구,030003, 27세,2018,4645,2323,2322,100,4516,2254,2262,99.6
21090, 해운대구,030004, 28세,2018,4255,2172,2083,104.3,4112,2101,2011,104.5
21090, 해운대구,030005, 29세,2018,4193,2120,2073,102.3,4060,2063,1997,103.3
21090, 해운대구,035,30~34세,2018,20530,10093,10437,96.7,19913,9776,10137,96.4
21090, 해운대구,035001, 30세,2018,3969,2008,1961,102.4,3844,1947,1897,102.6
21090, 해운대구,035002, 31세,2018,3916,1909,2007,95.1,3776,1839,1937,94.9
21090, 해운대구,035003, 32세,2018,4078,1981,2097,94.5,3938,1918,2020,95
21090, 해운대구,035004, 33세,2018,4155,2042,2113,96.6,4054,1980,2074,95.5
21090, 해운대구,035005, 34세,2018,4412,2153,2259,95.3,4301,2092,2209,94.7
21090, 해운대구,040,35~39세,2018,28738,13662,15076,90.6,28182,13369,14813,90.3
21090, 해운대구,040001, 35세,2018,4957,2335,2622,89.1,4850,2284,2566,89
21090, 해운대구,040002, 36세,2018,5640,2760,2880,95.8,5510,2685,2825,95
21090, 해운대구,040003, 37세,2018,5907,2813,3094,90.9,5805,2762,3043,90.8
21090, 해운대구,040004, 38세,2018,6321,2978,3343,89.1,6209,2925,3284,89.1
21090, 해운대구,040005, 39세,2018,5913,2776,3137,88.5,5808,2713,3095,87.7
21090, 해운대구,045,40~44세,2018,30276,14484,15792,91.7,29860,14244,15616,91.2
21090, 해운대구,045001, 40세,2018,5560,2703,2857,94.6,5471,2654,2817,94.2
21090, 해운대구,045002, 41세,2018,5879,2879,3000,96,5794,2829,2965,95.4
21090, 해운대구,045003, 42세,2018,5783,2836,2947,96.2,5687,2780,2907,95.6
21090, 해운대구,045004, 43세,2018,6147,2842,3305,86,6072,2793,3279,85.2
21090, 해운대구,045005, 44세,2018,6907,3224,3683,87.5,6836,3188,3648,87.4
21090, 해운대구,050,45~49세,2018,37354,17799,19555,91,37007,17600,19407,90.7
21090, 해운대구,050001, 45세,2018,6982,3328,3654,91.1,6903,3280,3623,90.5
21090, 해운대구,050002, 46세,2018,7391,3519,3872,90.9,7322,3475,3847,90.3
21090, 해운대구,050003, 47세,2018,7798,3687,4111,89.7,7728,3649,4079,89.5
21090, 해운대구,050004, 48세,2018,7709,3659,4050,90.3,7635,3619,4016,90.1
21090, 해운대구,050005, 49세,2018,7474,3606,3868,93.2,7419,3577,3842,93.1
21090, 해운대구,055,50~54세,2018,34127,16252,17875,90.9,33840,16105,17735,90.8
21090, 해운대구,055001, 50세,2018,7522,3587,3935,91.2,7467,3560,3907,91.1
21090, 해운대구,055002, 51세,2018,6983,3292,3691,89.2,6922,3252,3670,88.6
21090, 해운대구,055003, 52세,2018,6582,3176,3406,93.2,6539,3153,3386,93.1
21090, 해운대구,055004, 53세,2018,6645,3156,3489,90.5,6578,3127,3451,90.6
21090, 해운대구,055005, 54세,2018,6395,3041,3354,90.7,6334,3013,3321,90.7
21090, 해운대구,060,55~59세,2018,35590,17055,18535,92,35335,16919,18416,91.9
21090, 해운대구,060001, 55세,2018,7034,3394,3640,93.2,6964,3357,3607,93.1
21090, 해운대구,060002, 56세,2018,7029,3397,3632,93.5,6971,3369,3602,93.5
21090, 해운대구,060003, 57세,2018,7481,3545,3936,90.1,7440,3521,3919,89.8
21090, 해운대구,060004, 58세,2018,7407,3491,3916,89.1,7356,3467,3889,89.1
21090, 해운대구,060005, 59세,2018,6639,3228,3411,94.6,6604,3205,3399,94.3
21090, 해운대구,065,60~64세,2018,30289,14605,15684,93.1,30131,14526,15605,93.1
21090, 해운대구,065001, 60세,2018,6551,3148,3403,92.5,6518,3130,3388,92.4
21090, 해운대구,065002, 61세,2018,6359,2966,3393,87.4,6330,2952,3378,87.4
21090, 해운대구,065003, 62세,2018,6123,3042,3081,98.7,6089,3029,3060,99
21090, 해운대구,065004, 63세,2018,6171,2898,3273,88.5,6135,2877,3258,88.3
21090, 해운대구,065005, 64세,2018,5085,2551,2534,100.7,5059,2538,2521,100.7
21090, 해운대구,070,65~69세,2018,20942,9663,11279,85.7,20872,9622,11250,85.5
21090, 해운대구,070001, 65세,2018,4556,2114,2442,86.6,4544,2107,2437,86.5
21090, 해운대구,070002, 66세,2018,4931,2278,2653,85.9,4906,2264,2642,85.7
21090, 해운대구,070003, 67세,2018,3708,1741,1967,88.5,3699,1737,1962,88.5
21090, 해운대구,070004, 68세,2018,3797,1745,2052,85,3780,1733,2047,84.7
21090, 해운대구,070005, 69세,2018,3950,1785,2165,82.4,3943,1781,2162,82.4
21090, 해운대구,075,70~74세,2018,15411,7134,8277,86.2,15381,7121,8260,86.2
21090, 해운대구,075001, 70세,2018,3827,1793,2034,88.2,3822,1791,2031,88.2
21090, 해운대구,075002, 71세,2018,3579,1665,1914,87,3572,1662,1910,87
21090, 해운대구,075003, 72세,2018,2544,1166,1378,84.6,2540,1164,1376,84.6
21090, 해운대구,075004, 73세,2018,2690,1243,1447,85.9,2684,1240,1444,85.9
21090, 해운대구,075005, 74세,2018,2771,1267,1504,84.2,2763,1264,1499,84.3
21090, 해운대구,080,75~79세,2018,12584,5231,7353,71.1,12561,5220,7341,71.1
21090, 해운대구,080001, 75세,2018,2770,1169,1601,73,2766,1167,1599,73
21090, 해운대구,080002, 76세,2018,2928,1238,1690,73.3,2921,1233,1688,73
21090, 해운대구,080003, 77세,2018,2494,1025,1469,69.8,2489,1023,1466,69.8
21090, 해운대구,080004, 78세,2018,2262,954,1308,72.9,2259,953,1306,73
21090, 해운대구,080005, 79세,2018,2130,845,1285,65.8,2126,844,1282,65.8
21090, 해운대구,085,80~84세,2018,7328,2700,4628,58.3,7311,2692,4619,58.3
21090, 해운대구,085001, 80세,2018,1811,717,1094,65.5,1810,717,1093,65.6
21090, 해운대구,085002, 81세,2018,1660,624,1036,60.2,1654,621,1033,60.1
21090, 해운대구,085003, 82세,2018,1468,516,952,54.2,1464,513,951,53.9
21090, 해운대구,085004, 83세,2018,1327,452,875,51.7,1323,451,872,51.7
21090, 해운대구,085005, 84세,2018,1062,391,671,58.3,1060,390,670,58.2
21090, 해운대구,090,85~89세,2018,3175,921,2254,40.9,3165,918,2247,40.9
21090, 해운대구,090001, 85세,2018,891,288,603,47.8,887,287,600,47.8
21090, 해운대구,090002, 86세,2018,767,230,537,42.8,764,229,535,42.8
21090, 해운대구,090003, 87세,2018,609,164,445,36.9,609,164,445,36.9
21090, 해운대구,090004, 88세,2018,474,121,353,34.3,474,121,353,34.3
21090, 해운대구,090005, 89세,2018,434,118,316,37.3,431,117,314,37.3
21090, 해운대구,095,90~94세,2018,984,216,768,28.1,982,215,767,28
21090, 해운대구,095001, 90세,2018,337,71,266,26.7,335,70,265,26.4
21090, 해운대구,095002, 91세,2018,263,69,194,35.6,263,69,194,35.6
21090, 해운대구,095003, 92세,2018,161,33,128,25.8,161,33,128,25.8
21090, 해운대구,095004, 93세,2018,132,27,105,25.7,132,27,105,25.7
21090, 해운대구,095005, 94세,2018,91,16,75,21.3,91,16,75,21.3
21090, 해운대구,100,95~99세,2018,186,50,136,36.8,186,50,136,36.8
21090, 해운대구,100001, 95세,2018,77,20,57,35.1,77,20,57,35.1
21090, 해운대구,100002, 96세,2018,53,17,36,47.2,53,17,36,47.2
21090, 해운대구,100003, 97세,2018,27,X,23,17.4,27,X,23,17.4
21090, 해운대구,100004, 98세,2018,13,X,10,30,13,X,10,30
21090, 해운대구,100005, 99세,2018,16,6,10,60,16,6,10,60
21090, 해운대구,101,100세이상,2018,12,X,10,20,12,X,10,20
21090, 해운대구,102,15세미만,2018,48347,24957,23390,106.7,48004,24797,23207,106.9
21090, 해운대구,103,15~64세,2018,287342,141124,146218,96.5,283121,138904,144217,96.3
21090, 해운대구,104,65세이상,2018,60622,25917,34705,74.7,60470,25840,34630,74.6
21090, 해운대구,086,85세이상,2018,4357,1189,3168,37.5,4345,1185,3160,37.5
21090, 해운대구,126,평균연령,2018,42.9,41.6,44.1,,43,41.6,44.3,
21090, 해운대구,127,중위연령,2018,45,43.6,46.1,,45.1,43.8,46.3,
21100, 사하구,000,합계,2018,326655,163050,163605,99.7,321246,159669,161577,98.8
21100, 사하구,005,0~4세,2018,11115,5706,5409,105.5,11072,5688,5384,105.6
21100, 사하구,005001, 0세,2018,1902,948,954,99.4,1895,944,951,99.3
21100, 사하구,005002, 1세,2018,2044,1089,955,114,2035,1083,952,113.8
21100, 사하구,005003, 2세,2018,2330,1194,1136,105.1,2316,1192,1124,106
21100, 사하구,005004, 3세,2018,2425,1255,1170,107.3,2418,1251,1167,107.2
21100, 사하구,005005, 4세,2018,2414,1220,1194,102.2,2408,1218,1190,102.4
21100, 사하구,010,5~9세,2018,12359,6311,6048,104.3,12336,6302,6034,104.4
21100, 사하구,010001, 5세,2018,2354,1184,1170,101.2,2348,1179,1169,100.9
21100, 사하구,010002, 6세,2018,2640,1339,1301,102.9,2637,1339,1298,103.2
21100, 사하구,010003, 7세,2018,2646,1334,1312,101.7,2643,1333,1310,101.8
21100, 사하구,010004, 8세,2018,2361,1204,1157,104.1,2354,1203,1151,104.5
21100, 사하구,010005, 9세,2018,2358,1250,1108,112.8,2354,1248,1106,112.8
21100, 사하구,015,10~14세,2018,12104,6209,5895,105.3,12086,6200,5886,105.3
21100, 사하구,015001, 10세,2018,2452,1269,1183,107.3,2450,1267,1183,107.1
21100, 사하구,015002, 11세,2018,2521,1308,1213,107.8,2518,1307,1211,107.9
21100, 사하구,015003, 12세,2018,2242,1153,1089,105.9,2238,1151,1087,105.9
21100, 사하구,015004, 13세,2018,2338,1187,1151,103.1,2336,1187,1149,103.3
21100, 사하구,015005, 14세,2018,2551,1292,1259,102.6,2544,1288,1256,102.5
21100, 사하구,020,15~19세,2018,17457,9230,8227,112.2,17397,9199,8198,112.2
21100, 사하구,020001, 15세,2018,2779,1504,1275,118,2775,1502,1273,118
21100, 사하구,020002, 16세,2018,2973,1585,1388,114.2,2965,1583,1382,114.5
21100, 사하구,020003, 17세,2018,3543,1923,1620,118.7,3535,1918,1617,118.6
21100, 사하구,020004, 18세,2018,3997,2104,1893,111.1,3985,2097,1888,111.1
21100, 사하구,020005, 19세,2018,4165,2114,2051,103.1,4137,2099,2038,103
21100, 사하구,025,20~24세,2018,22944,12156,10788,112.7,22288,11762,10526,111.7
21100, 사하구,025001, 20세,2018,4378,2156,2222,97,4323,2126,2197,96.8
21100, 사하구,025002, 21세,2018,4435,2231,2204,101.2,4319,2170,2149,101
21100, 사하구,025003, 22세,2018,4660,2530,2130,118.8,4517,2448,2069,118.3
21100, 사하구,025004, 23세,2018,4772,2620,2152,121.7,4606,2514,2092,120.2
21100, 사하구,025005, 24세,2018,4699,2619,2080,125.9,4523,2504,2019,124
21100, 사하구,030,25~29세,2018,21355,11665,9690,120.4,20269,10942,9327,117.3
21100, 사하구,030001, 25세,2018,4614,2581,2033,127,4426,2455,1971,124.6
21100, 사하구,030002, 26세,2018,4556,2446,2110,115.9,4354,2317,2037,113.7
21100, 사하구,030003, 27세,2018,4277,2352,1925,122.2,4026,2181,1845,118.2
21100, 사하구,030004, 28세,2018,4040,2231,1809,123.3,3810,2074,1736,119.5
21100, 사하구,030005, 29세,2018,3868,2055,1813,113.3,3653,1915,1738,110.2
21100, 사하구,035,30~34세,2018,19236,10362,8874,116.8,18197,9650,8547,112.9
21100, 사하구,035001, 30세,2018,3723,2017,1706,118.2,3532,1890,1642,115.1
21100, 사하구,035002, 31세,2018,3706,1982,1724,115,3469,1808,1661,108.9
21100, 사하구,035003, 32세,2018,3732,2046,1686,121.4,3533,1922,1611,119.3
21100, 사하구,035004, 33세,2018,3907,2085,1822,114.4,3704,1949,1755,111.1
21100, 사하구,035005, 34세,2018,4168,2232,1936,115.3,3959,2081,1878,110.8
21100, 사하구,040,35~39세,2018,24471,13037,11434,114,23630,12461,11169,111.6
21100, 사하구,040001, 35세,2018,4522,2383,2139,111.4,4339,2263,2076,109
21100, 사하구,040002, 36세,2018,4912,2603,2309,112.7,4724,2473,2251,109.9
21100, 사하구,040003, 37세,2018,5223,2776,2447,113.4,5053,2654,2399,110.6
21100, 사하구,040004, 38세,2018,5125,2756,2369,116.3,4987,2659,2328,114.2
21100, 사하구,040005, 39세,2018,4689,2519,2170,116.1,4527,2412,2115,114
21100, 사하구,045,40~44세,2018,22201,11465,10736,106.8,21695,11138,10557,105.5
21100, 사하구,045001, 40세,2018,4300,2285,2015,113.4,4200,2217,1983,111.8
21100, 사하구,045002, 41세,2018,4305,2266,2039,111.1,4183,2185,1998,109.4
21100, 사하구,045003, 42세,2018,4115,2112,2003,105.4,4029,2055,1974,104.1
21100, 사하구,045004, 43세,2018,4524,2284,2240,102,4420,2225,2195,101.4
21100, 사하구,045005, 44세,2018,4957,2518,2439,103.2,4863,2456,2407,102
21100, 사하구,050,45~49세,2018,26723,13252,13471,98.4,26334,13030,13304,97.9
21100, 사하구,050001, 45세,2018,5103,2594,2509,103.4,5015,2544,2471,103
21100, 사하구,050002, 46세,2018,5013,2513,2500,100.5,4938,2467,2471,99.8
21100, 사하구,050003, 47세,2018,5561,2788,2773,100.5,5491,2744,2747,99.9
21100, 사하구,050004, 48세,2018,5474,2689,2785,96.6,5396,2645,2751,96.1
21100, 사하구,050005, 49세,2018,5572,2668,2904,91.9,5494,2630,2864,91.8
21100, 사하구,055,50~54세,2018,26607,12958,13649,94.9,26305,12813,13492,95
21100, 사하구,055001, 50세,2018,5638,2784,2854,97.5,5583,2755,2828,97.4
21100, 사하구,055002, 51세,2018,5285,2527,2758,91.6,5220,2500,2720,91.9
21100, 사하구,055003, 52세,2018,5252,2613,2639,99,5188,2581,2607,99
21100, 사하구,055004, 53세,2018,5316,2514,2802,89.7,5253,2482,2771,89.6
21100, 사하구,055005, 54세,2018,5116,2520,2596,97.1,5061,2495,2566,97.2
21100, 사하구,060,55~59세,2018,30886,14839,16047,92.5,30679,14736,15943,92.4
21100, 사하구,060001, 55세,2018,5665,2782,2883,96.5,5605,2745,2860,96
21100, 사하구,060002, 56세,2018,6101,2970,3131,94.9,6057,2952,3105,95.1
21100, 사하구,060003, 57세,2018,6513,3093,3420,90.4,6481,3078,3403,90.4
21100, 사하구,060004, 58세,2018,6730,3209,3521,91.1,6687,3190,3497,91.2
21100, 사하구,060005, 59세,2018,5877,2785,3092,90.1,5849,2771,3078,90
21100, 사하구,065,60~64세,2018,27162,13187,13975,94.4,27022,13117,13905,94.3
21100, 사하구,065001, 60세,2018,5776,2834,2942,96.3,5744,2818,2926,96.3
21100, 사하구,065002, 61세,2018,5914,2829,3085,91.7,5868,2803,3065,91.5
21100, 사하구,065003, 62세,2018,5265,2513,2752,91.3,5247,2503,2744,91.2
21100, 사하구,065004, 63세,2018,5507,2639,2868,92,5490,2634,2856,92.2
21100, 사하구,065005, 64세,2018,4700,2372,2328,101.9,4673,2359,2314,101.9
21100, 사하구,070,65~69세,2018,18684,9030,9654,93.5,18628,9004,9624,93.6
21100, 사하구,070001, 65세,2018,4157,1986,2171,91.5,4138,1979,2159,91.7
21100, 사하구,070002, 66세,2018,4256,2108,2148,98.1,4245,2101,2144,98
21100, 사하구,070003, 67세,2018,3402,1623,1779,91.2,3390,1617,1773,91.2
21100, 사하구,070004, 68세,2018,3425,1648,1777,92.7,3417,1644,1773,92.7
21100, 사하구,070005, 69세,2018,3444,1665,1779,93.6,3438,1663,1775,93.7
21100, 사하구,075,70~74세,2018,13402,6279,7123,88.2,13382,6270,7112,88.2
21100, 사하구,075001, 70세,2018,3355,1582,1773,89.2,3352,1580,1772,89.2
21100, 사하구,075002, 71세,2018,3098,1402,1696,82.7,3094,1400,1694,82.6
21100, 사하구,075003, 72세,2018,2411,1161,1250,92.9,2407,1160,1247,93
21100, 사하구,075004, 73세,2018,2329,1128,1201,93.9,2325,1125,1200,93.8
21100, 사하구,075005, 74세,2018,2209,1006,1203,83.6,2204,1005,1199,83.8
21100, 사하구,080,75~79세,2018,10335,4467,5868,76.1,10322,4463,5859,76.2
21100, 사하구,080001, 75세,2018,2258,1040,1218,85.4,2256,1040,1216,85.5
21100, 사하구,080002, 76세,2018,2520,1131,1389,81.4,2518,1129,1389,81.3
21100, 사하구,080003, 77세,2018,2047,865,1182,73.2,2042,865,1177,73.5
21100, 사하구,080004, 78세,2018,1779,745,1034,72.1,1777,744,1033,72
21100, 사하구,080005, 79세,2018,1731,686,1045,65.6,1729,685,1044,65.6
21100, 사하구,085,80~84세,2018,5832,2023,3809,53.1,5827,2022,3805,53.1
21100, 사하구,085001, 80세,2018,1463,550,913,60.2,1462,549,913,60.1
21100, 사하구,085002, 81세,2018,1397,520,877,59.3,1396,520,876,59.4
21100, 사하구,085003, 82세,2018,1070,344,726,47.4,1069,344,725,47.4
21100, 사하구,085004, 83세,2018,1024,334,690,48.4,1023,334,689,48.5
21100, 사하구,085005, 84세,2018,878,275,603,45.6,877,275,602,45.7
21100, 사하구,090,85~89세,2018,2639,680,1959,34.7,2635,678,1957,34.6
21100, 사하구,090001, 85세,2018,702,207,495,41.8,701,207,494,41.9
21100, 사하구,090002, 86세,2018,588,165,423,39,587,165,422,39.1
21100, 사하구,090003, 87세,2018,483,114,369,30.9,482,113,369,30.6
21100, 사하구,090004, 88세,2018,460,101,359,28.1,459,100,359,27.9
21100, 사하구,090005, 89세,2018,406,93,313,29.7,406,93,313,29.7
21100, 사하구,095,90~94세,2018,935,166,769,21.6,934,166,768,21.6
21100, 사하구,095001, 90세,2018,319,71,248,28.6,319,71,248,28.6
21100, 사하구,095002, 91세,2018,253,43,210,20.5,253,43,210,20.5
21100, 사하구,095003, 92세,2018,132,23,109,21.1,132,23,109,21.1
21100, 사하구,095004, 93세,2018,129,14,115,12.2,128,14,114,12.3
21100, 사하구,095005, 94세,2018,102,15,87,17.2,102,15,87,17.2
21100, 사하구,100,95~99세,2018,193,26,167,15.6,193,26,167,15.6
21100, 사하구,100001, 95세,2018,79,11,68,16.2,79,11,68,16.2
21100, 사하구,100002, 96세,2018,46,6,40,15,46,6,40,15
21100, 사하구,100003, 97세,2018,27,X,24,12.5,27,X,24,12.5
21100, 사하구,100004, 98세,2018,26,X,22,18.2,26,X,22,18.2
21100, 사하구,100005, 99세,2018,15,X,13,15.4,15,X,13,15.4
21100, 사하구,101,100세이상,2018,15,X,13,15.4,15,X,13,15.4
21100, 사하구,102,15세미만,2018,35578,18226,17352,105,35494,18190,17304,105.1
21100, 사하구,103,15~64세,2018,239042,122151,116891,104.5,233816,118848,114968,103.4
21100, 사하구,104,65세이상,2018,52035,22673,29362,77.2,51936,22631,29305,77.2
21100, 사하구,086,85세이상,2018,3782,874,2908,30.1,3777,872,2905,30
21100, 사하구,126,평균연령,2018,43.3,42,44.7,,43.5,42.1,44.8,
21100, 사하구,127,중위연령,2018,45,43.1,46.9,,45.3,43.5,47.1,
21110, 금정구,000,합계,2018,247971,121135,126836,95.5,242782,118853,123929,95.9
21110, 금정구,005,0~4세,2018,6689,3447,3242,106.3,6633,3423,3210,106.6
21110, 금정구,005001, 0세,2018,1102,573,529,108.3,1086,564,522,108
21110, 금정구,005002, 1세,2018,1231,632,599,105.5,1214,621,593,104.7
21110, 금정구,005003, 2세,2018,1329,711,618,115,1319,709,610,116.2
21110, 금정구,005004, 3세,2018,1550,760,790,96.2,1543,759,784,96.8
21110, 금정구,005005, 4세,2018,1477,771,706,109.2,1471,770,701,109.8
21110, 금정구,010,5~9세,2018,7920,4143,3777,109.7,7897,4134,3763,109.9
21110, 금정구,010001, 5세,2018,1497,767,730,105.1,1492,766,726,105.5
21110, 금정구,010002, 6세,2018,1631,850,781,108.8,1624,848,776,109.3
21110, 금정구,010003, 7세,2018,1675,864,811,106.5,1673,862,811,106.3
21110, 금정구,010004, 8세,2018,1563,816,747,109.2,1557,814,743,109.6
21110, 금정구,010005, 9세,2018,1554,846,708,119.5,1551,844,707,119.4
21110, 금정구,015,10~14세,2018,8231,4279,3952,108.3,8213,4269,3944,108.2
21110, 금정구,015001, 10세,2018,1587,840,747,112.4,1586,839,747,112.3
21110, 금정구,015002, 11세,2018,1723,878,845,103.9,1718,877,841,104.3
21110, 금정구,015003, 12세,2018,1583,850,733,116,1578,847,731,115.9
21110, 금정구,015004, 13세,2018,1598,828,770,107.5,1596,827,769,107.5
21110, 금정구,015005, 14세,2018,1740,883,857,103,1735,879,856,102.7
21110, 금정구,020,15~19세,2018,13897,7016,6881,102,13513,6854,6659,102.9
21110, 금정구,020001, 15세,2018,1947,1028,919,111.9,1943,1025,918,111.7
21110, 금정구,020002, 16세,2018,1980,1009,971,103.9,1971,1008,963,104.7
21110, 금정구,020003, 17세,2018,2324,1153,1171,98.5,2290,1137,1153,98.6
21110, 금정구,020004, 18세,2018,3256,1715,1541,111.3,3140,1664,1476,112.7
21110, 금정구,020005, 19세,2018,4390,2111,2279,92.6,4169,2020,2149,94
21110, 금정구,025,20~24세,2018,23497,11749,11748,100,21618,11096,10522,105.5
21110, 금정구,025001, 20세,2018,4405,1938,2467,78.6,4017,1806,2211,81.7
21110, 금정구,025002, 21세,2018,4510,2017,2493,80.9,4139,1895,2244,84.4
21110, 금정구,025003, 22세,2018,4973,2426,2547,95.2,4546,2283,2263,100.9
21110, 금정구,025004, 23세,2018,4811,2594,2217,117,4452,2472,1980,124.8
21110, 금정구,025005, 24세,2018,4798,2774,2024,137.1,4464,2640,1824,144.7
21110, 금정구,030,25~29세,2018,17952,10154,7798,130.2,16998,9681,7317,132.3
21110, 금정구,030001, 25세,2018,4384,2538,1846,137.5,4122,2419,1703,142
21110, 금정구,030002, 26세,2018,4042,2350,1692,138.9,3850,2262,1588,142.4
21110, 금정구,030003, 27세,2018,3502,1995,1507,132.4,3339,1907,1432,133.2
21110, 금정구,030004, 28세,2018,3108,1727,1381,125.1,2932,1640,1292,126.9
21110, 금정구,030005, 29세,2018,2916,1544,1372,112.5,2755,1453,1302,111.6
21110, 금정구,035,30~34세,2018,12801,6839,5962,114.7,12228,6539,5689,114.9
21110, 금정구,035001, 30세,2018,2679,1488,1191,124.9,2541,1415,1126,125.7
21110, 금정구,035002, 31세,2018,2619,1370,1249,109.7,2496,1305,1191,109.6
21110, 금정구,035003, 32세,2018,2535,1388,1147,121,2416,1325,1091,121.4
21110, 금정구,035004, 33세,2018,2441,1282,1159,110.6,2344,1229,1115,110.2
21110, 금정구,035005, 34세,2018,2527,1311,1216,107.8,2431,1265,1166,108.5
21110, 금정구,040,35~39세,2018,15699,7972,7727,103.2,15354,7797,7557,103.2
21110, 금정구,040001, 35세,2018,2889,1480,1409,105,2810,1441,1369,105.3
21110, 금정구,040002, 36세,2018,3103,1594,1509,105.6,3014,1544,1470,105
21110, 금정구,040003, 37세,2018,3257,1639,1618,101.3,3199,1613,1586,101.7
21110, 금정구,040004, 38세,2018,3331,1669,1662,100.4,3268,1640,1628,100.7
21110, 금정구,040005, 39세,2018,3119,1590,1529,104,3063,1559,1504,103.7
21110, 금정구,045,40~44세,2018,15048,7651,7397,103.4,14796,7514,7282,103.2
21110, 금정구,045001, 40세,2018,2969,1539,1430,107.6,2910,1508,1402,107.6
21110, 금정구,045002, 41세,2018,2910,1475,1435,102.8,2857,1443,1414,102.1
21110, 금정구,045003, 42세,2018,2783,1422,1361,104.5,2739,1404,1335,105.2
21110, 금정구,045004, 43세,2018,3020,1497,1523,98.3,2973,1467,1506,97.4
21110, 금정구,045005, 44세,2018,3366,1718,1648,104.2,3317,1692,1625,104.1
21110, 금정구,050,45~49세,2018,18913,9044,9869,91.6,18663,8923,9740,91.6
21110, 금정구,050001, 45세,2018,3534,1711,1823,93.9,3473,1677,1796,93.4
21110, 금정구,050002, 46세,2018,3575,1740,1835,94.8,3528,1721,1807,95.2
21110, 금정구,050003, 47세,2018,3938,1898,2040,93,3886,1874,2012,93.1
21110, 금정구,050004, 48세,2018,3815,1825,1990,91.7,3768,1806,1962,92
21110, 금정구,050005, 49세,2018,4051,1870,2181,85.7,4008,1845,2163,85.3
21110, 금정구,055,50~54세,2018,19724,9327,10397,89.7,19533,9238,10295,89.7
21110, 금정구,055001, 50세,2018,4044,1944,2100,92.6,3997,1926,2071,93
21110, 금정구,055002, 51세,2018,3914,1770,2144,82.6,3879,1753,2126,82.5
21110, 금정구,055003, 52세,2018,3891,1867,2024,92.2,3864,1856,2008,92.4
21110, 금정구,055004, 53세,2018,3967,1892,2075,91.2,3934,1876,2058,91.2
21110, 금정구,055005, 54세,2018,3908,1854,2054,90.3,3859,1827,2032,89.9
21110, 금정구,060,55~59세,2018,23187,10867,12320,88.2,23057,10805,12252,88.2
21110, 금정구,060001, 55세,2018,4314,2048,2266,90.4,4268,2029,2239,90.6
21110, 금정구,060002, 56세,2018,4615,2186,2429,90,4589,2173,2416,89.9
21110, 금정구,060003, 57세,2018,4908,2281,2627,86.8,4895,2273,2622,86.7
21110, 금정구,060004, 58세,2018,4822,2222,2600,85.5,4793,2207,2586,85.3
21110, 금정구,060005, 59세,2018,4528,2130,2398,88.8,4512,2123,2389,88.9
21110, 금정구,065,60~64세,2018,20489,9725,10764,90.3,20411,9685,10726,90.3
21110, 금정구,065001, 60세,2018,4291,2030,2261,89.8,4275,2022,2253,89.7
21110, 금정구,065002, 61세,2018,4359,2112,2247,94,4338,2101,2237,93.9
21110, 금정구,065003, 62세,2018,4016,1928,2088,92.3,4004,1921,2083,92.2
21110, 금정구,065004, 63세,2018,4345,2003,2342,85.5,4329,1994,2335,85.4
21110, 금정구,065005, 64세,2018,3478,1652,1826,90.5,3465,1647,1818,90.6
21110, 금정구,070,65~69세,2018,15010,7017,7993,87.8,14993,7006,7987,87.7
21110, 금정구,070001, 65세,2018,3282,1512,1770,85.4,3276,1509,1767,85.4
21110, 금정구,070002, 66세,2018,3384,1600,1784,89.7,3382,1598,1784,89.6
21110, 금정구,070003, 67세,2018,2716,1269,1447,87.7,2714,1268,1446,87.7
21110, 금정구,070004, 68세,2018,2773,1337,1436,93.1,2770,1336,1434,93.2
21110, 금정구,070005, 69세,2018,2855,1299,1556,83.5,2851,1295,1556,83.2
21110, 금정구,075,70~74세,2018,11044,5139,5905,87,11032,5133,5899,87
21110, 금정구,075001, 70세,2018,2766,1323,1443,91.7,2763,1321,1442,91.6
21110, 금정구,075002, 71세,2018,2499,1147,1352,84.8,2496,1145,1351,84.8
21110, 금정구,075003, 72세,2018,1912,893,1019,87.6,1907,892,1015,87.9
21110, 금정구,075004, 73세,2018,1914,887,1027,86.4,1913,886,1027,86.3
21110, 금정구,075005, 74세,2018,1953,889,1064,83.6,1953,889,1064,83.6
21110, 금정구,080,75~79세,2018,8963,3938,5025,78.4,8953,3934,5019,78.4
21110, 금정구,080001, 75세,2018,2007,959,1048,91.5,2004,957,1047,91.4
21110, 금정구,080002, 76세,2018,2106,943,1163,81.1,2104,943,1161,81.2
21110, 금정구,080003, 77세,2018,1777,779,998,78.1,1776,778,998,78
21110, 금정구,080004, 78세,2018,1597,655,942,69.5,1594,655,939,69.8
21110, 금정구,080005, 79세,2018,1476,602,874,68.9,1475,601,874,68.8
21110, 금정구,085,80~84세,2018,5373,1953,3420,57.1,5361,1949,3412,57.1
21110, 금정구,085001, 80세,2018,1315,529,786,67.3,1310,528,782,67.5
21110, 금정구,085002, 81세,2018,1138,444,694,64,1136,444,692,64.2
21110, 금정구,085003, 82세,2018,1040,358,682,52.5,1036,356,680,52.4
21110, 금정구,085004, 83세,2018,1007,332,675,49.2,1006,331,675,49
21110, 금정구,085005, 84세,2018,873,290,583,49.7,873,290,583,49.7
21110, 금정구,090,85~89세,2018,2498,679,1819,37.3,2494,677,1817,37.3
21110, 금정구,090001, 85세,2018,672,212,460,46.1,670,211,459,46
21110, 금정구,090002, 86세,2018,594,177,417,42.4,592,176,416,42.3
21110, 금정구,090003, 87세,2018,497,114,383,29.8,497,114,383,29.8
21110, 금정구,090004, 88세,2018,396,100,296,33.8,396,100,296,33.8
21110, 금정구,090005, 89세,2018,339,76,263,28.9,339,76,263,28.9
21110, 금정구,095,90~94세,2018,842,164,678,24.2,841,164,677,24.2
21110, 금정구,095001, 90세,2018,279,61,218,28,278,61,217,28.1
21110, 금정구,095002, 91세,2018,204,40,164,24.4,204,40,164,24.4
21110, 금정구,095003, 92세,2018,154,30,124,24.2,154,30,124,24.2
21110, 금정구,095004, 93세,2018,123,21,102,20.6,123,21,102,20.6
21110, 금정구,095005, 94세,2018,82,12,70,17.1,82,12,70,17.1
21110, 금정구,100,95~99세,2018,176,31,145,21.4,176,31,145,21.4
21110, 금정구,100001, 95세,2018,63,12,51,23.5,63,12,51,23.5
21110, 금정구,100002, 96세,2018,51,5,46,10.9,51,5,46,10.9
21110, 금정구,100003, 97세,2018,28,6,22,27.3,28,6,22,27.3
21110, 금정구,100004, 98세,2018,23,5,18,27.8,23,5,18,27.8
21110, 금정구,100005, 99세,2018,11,X,8,37.5,11,X,8,37.5
21110, 금정구,101,100세이상,2018,18,X,17,5.9,18,X,17,5.9
21110, 금정구,102,15세미만,2018,22840,11869,10971,108.2,22743,11826,10917,108.3
21110, 금정구,103,15~64세,2018,181207,90344,90863,99.4,176171,88132,88039,100.1
21110, 금정구,104,65세이상,2018,43924,18922,25002,75.7,43868,18895,24973,75.7
21110, 금정구,086,85세이상,2018,3534,875,2659,32.9,3529,873,2656,32.9
21110, 금정구,126,평균연령,2018,44,42.5,45.4,,44.3,42.7,45.7,
21110, 금정구,127,중위연령,2018,45.6,43.4,47.6,,46.2,43.9,48.2,
21120, 강서구,000,합계,2018,121351,64289,57062,112.7,114842,58759,56083,104.8
21120, 강서구,005,0~4세,2018,9789,4988,4801,103.9,9754,4971,4783,103.9
21120, 강서구,005001, 0세,2018,1682,863,819,105.4,1677,860,817,105.3
21120, 강서구,005002, 1세,2018,1863,932,931,100.1,1851,925,926,99.9
21120, 강서구,005003, 2세,2018,2139,1088,1051,103.5,2136,1087,1049,103.6
21120, 강서구,005004, 3세,2018,2070,1041,1029,101.2,2067,1041,1026,101.5
21120, 강서구,005005, 4세,2018,2035,1064,971,109.6,2023,1058,965,109.6
21120, 강서구,010,5~9세,2018,8522,4391,4131,106.3,8495,4367,4128,105.8
21120, 강서구,010001, 5세,2018,1859,968,891,108.6,1856,965,891,108.3
21120, 강서구,010002, 6세,2018,1947,1018,929,109.6,1938,1010,928,108.8
21120, 강서구,010003, 7세,2018,1776,893,883,101.1,1771,888,883,100.6
21120, 강서구,010004, 8세,2018,1573,810,763,106.2,1568,806,762,105.8
21120, 강서구,010005, 9세,2018,1367,702,665,105.6,1362,698,664,105.1
21120, 강서구,015,10~14세,2018,5160,2602,2558,101.7,5146,2594,2552,101.6
21120, 강서구,015001, 10세,2018,1297,656,641,102.3,1293,653,640,102
21120, 강서구,015002, 11세,2018,1106,531,575,92.3,1103,530,573,92.5
21120, 강서구,015003, 12세,2018,935,467,468,99.8,931,466,465,100.2
21120, 강서구,015004, 13세,2018,909,467,442,105.7,909,467,442,105.7
21120, 강서구,015005, 14세,2018,913,481,432,111.3,910,478,432,110.6
21120, 강서구,020,15~19세,2018,3835,2036,1799,113.2,3794,2002,1792,111.7
21120, 강서구,020001, 15세,2018,769,409,360,113.6,768,408,360,113.3
21120, 강서구,020002, 16세,2018,786,388,398,97.5,783,387,396,97.7
21120, 강서구,020003, 17세,2018,865,434,431,100.7,855,427,428,99.8
21120, 강서구,020004, 18세,2018,752,431,321,134.3,745,424,321,132.1
21120, 강서구,020005, 19세,2018,663,374,289,129.4,643,356,287,124
21120, 강서구,025,20~24세,2018,4872,2920,1952,149.6,4219,2359,1860,126.8
21120, 강서구,025001, 20세,2018,827,476,351,135.6,765,427,338,126.3
21120, 강서구,025002, 21세,2018,848,525,323,162.5,757,448,309,145
21120, 강서구,025003, 22세,2018,981,578,403,143.4,849,468,381,122.8
21120, 강서구,025004, 23세,2018,1058,653,405,161.2,876,498,378,131.7
21120, 강서구,025005, 24세,2018,1158,688,470,146.4,972,518,454,114.1
21120, 강서구,030,25~29세,2018,7863,4551,3312,137.4,6229,3117,3112,100.2
21120, 강서구,030001, 25세,2018,1390,818,572,143,1128,582,546,106.6
21120, 강서구,030002, 26세,2018,1459,861,598,144,1140,587,553,106.1
21120, 강서구,030003, 27세,2018,1525,894,631,141.7,1195,607,588,103.2
21120, 강서구,030004, 28세,2018,1639,932,707,131.8,1281,621,660,94.1
21120, 강서구,030005, 29세,2018,1850,1046,804,130.1,1485,720,765,94.1
21120, 강서구,035,30~34세,2018,11869,6481,5388,120.3,10105,4918,5187,94.8
21120, 강서구,035001, 30세,2018,1963,1105,858,128.8,1603,792,811,97.7
21120, 강서구,035002, 31세,2018,2170,1186,984,120.5,1804,856,948,90.3
21120, 강서구,035003, 32세,2018,2333,1265,1068,118.4,1977,959,1018,94.2
21120, 강서구,035004, 33세,2018,2527,1378,1149,119.9,2173,1055,1118,94.4
21120, 강서구,035005, 34세,2018,2876,1547,1329,116.4,2548,1256,1292,97.2
21120, 강서구,040,35~39세,2018,15973,8802,7171,122.7,14883,7842,7041,111.4
21120, 강서구,040001, 35세,2018,3165,1715,1450,118.3,2899,1479,1420,104.2
21120, 강서구,040002, 36세,2018,3441,1929,1512,127.6,3184,1700,1484,114.6
21120, 강서구,040003, 37세,2018,3332,1782,1550,115,3137,1608,1529,105.2
21120, 강서구,040004, 38세,2018,3195,1782,1413,126.1,2992,1606,1386,115.9
21120, 강서구,040005, 39세,2018,2840,1594,1246,127.9,2671,1449,1222,118.6
21120, 강서구,045,40~44세,2018,10474,6076,4398,138.2,9927,5618,4309,130.4
21120, 강서구,045001, 40세,2018,2433,1420,1013,140.2,2280,1292,988,130.8
21120, 강서구,045002, 41세,2018,2223,1263,960,131.6,2112,1167,945,123.5
21120, 강서구,045003, 42세,2018,1974,1167,807,144.6,1871,1081,790,136.8
21120, 강서구,045004, 43세,2018,1975,1123,852,131.8,1872,1037,835,124.2
21120, 강서구,045005, 44세,2018,1869,1103,766,144,1792,1041,751,138.6
21120, 강서구,050,45~49세,2018,7977,4478,3499,128,7671,4246,3425,124
21120, 강서구,050001, 45세,2018,1771,987,784,125.9,1690,929,761,122.1
21120, 강서구,050002, 46세,2018,1569,920,649,141.8,1507,869,638,136.2
21120, 강서구,050003, 47세,2018,1640,936,704,133,1580,889,691,128.7
21120, 강서구,050004, 48세,2018,1530,812,718,113.1,1481,779,702,111
21120, 강서구,050005, 49세,2018,1467,823,644,127.8,1413,780,633,123.2
21120, 강서구,055,50~54세,2018,6844,3490,3354,104.1,6672,3372,3300,102.2
21120, 강서구,055001, 50세,2018,1464,753,711,105.9,1425,722,703,102.7
21120, 강서구,055002, 51세,2018,1359,688,671,102.5,1322,659,663,99.4
21120, 강서구,055003, 52세,2018,1345,735,610,120.5,1303,709,594,119.4
21120, 강서구,055004, 53세,2018,1373,689,684,100.7,1343,672,671,100.1
21120, 강서구,055005, 54세,2018,1303,625,678,92.2,1279,610,669,91.2
21120, 강서구,060,55~59세,2018,8232,4007,4225,94.8,8118,3941,4177,94.4
21120, 강서구,060001, 55세,2018,1462,757,705,107.4,1430,739,691,106.9
21120, 강서구,060002, 56세,2018,1620,778,842,92.4,1597,765,832,91.9
21120, 강서구,060003, 57세,2018,1749,823,926,88.9,1730,812,918,88.5
21120, 강서구,060004, 58세,2018,1768,865,903,95.8,1744,847,897,94.4
21120, 강서구,060005, 59세,2018,1633,784,849,92.3,1617,778,839,92.7
21120, 강서구,065,60~64세,2018,7391,3682,3709,99.3,7326,3646,3680,99.1
21120, 강서구,065001, 60세,2018,1633,823,810,101.6,1620,818,802,102
21120, 강서구,065002, 61세,2018,1590,763,827,92.3,1579,756,823,91.9
21120, 강서구,065003, 62세,2018,1466,725,741,97.8,1449,715,734,97.4
21120, 강서구,065004, 63세,2018,1478,753,725,103.9,1464,747,717,104.2
21120, 강서구,065005, 64세,2018,1224,618,606,102,1214,610,604,101
21120, 강서구,070,65~69세,2018,4805,2430,2375,102.3,4773,2418,2355,102.7
21120, 강서구,070001, 65세,2018,1105,546,559,97.7,1094,541,553,97.8
21120, 강서구,070002, 66세,2018,1097,559,538,103.9,1089,557,532,104.7
21120, 강서구,070003, 67세,2018,933,492,441,111.6,927,490,437,112.1
21120, 강서구,070004, 68세,2018,824,424,400,106,820,423,397,106.5
21120, 강서구,070005, 69세,2018,846,409,437,93.6,843,407,436,93.3
21120, 강서구,075,70~74세,2018,3105,1578,1527,103.3,3097,1573,1524,103.2
21120, 강서구,075001, 70세,2018,781,391,390,100.3,778,389,389,100
21120, 강서구,075002, 71세,2018,736,399,337,118.4,736,399,337,118.4
21120, 강서구,075003, 72세,2018,551,281,270,104.1,549,279,270,103.3
21120, 강서구,075004, 73세,2018,498,238,260,91.5,497,238,259,91.9
21120, 강서구,075005, 74세,2018,539,269,270,99.6,537,268,269,99.6
21120, 강서구,080,75~79세,2018,2426,1074,1352,79.4,2423,1073,1350,79.5
21120, 강서구,080001, 75세,2018,516,229,287,79.8,514,228,286,79.7
21120, 강서구,080002, 76세,2018,578,268,310,86.5,578,268,310,86.5
21120, 강서구,080003, 77세,2018,482,224,258,86.8,481,224,257,87.2
21120, 강서구,080004, 78세,2018,434,184,250,73.6,434,184,250,73.6
21120, 강서구,080005, 79세,2018,416,169,247,68.4,416,169,247,68.4
21120, 강서구,085,80~84세,2018,1349,471,878,53.6,1347,471,876,53.8
21120, 강서구,085001, 80세,2018,338,120,218,55,336,120,216,55.6
21120, 강서구,085002, 81세,2018,305,125,180,69.4,305,125,180,69.4
21120, 강서구,085003, 82세,2018,246,69,177,39,246,69,177,39
21120, 강서구,085004, 83세,2018,248,82,166,49.4,248,82,166,49.4
21120, 강서구,085005, 84세,2018,212,75,137,54.7,212,75,137,54.7
21120, 강서구,090,85~89세,2018,645,183,462,39.6,644,183,461,39.7
21120, 강서구,090001, 85세,2018,163,59,104,56.7,162,59,103,57.3
21120, 강서구,090002, 86세,2018,150,41,109,37.6,150,41,109,37.6
21120, 강서구,090003, 87세,2018,125,38,87,43.7,125,38,87,43.7
21120, 강서구,090004, 88세,2018,107,20,87,23,107,20,87,23
21120, 강서구,090005, 89세,2018,100,25,75,33.3,100,25,75,33.3
21120, 강서구,095,90~94세,2018,176,38,138,27.5,175,37,138,26.8
21120, 강서구,095001, 90세,2018,64,14,50,28,64,14,50,28
21120, 강서구,095002, 91세,2018,44,7,37,18.9,44,7,37,18.9
21120, 강서구,095003, 92세,2018,24,X,20,20,24,X,20,20
21120, 강서구,095004, 93세,2018,29,8,21,38.1,28,7,21,33.3
21120, 강서구,095005, 94세,2018,15,5,10,50,15,5,10,50
21120, 강서구,100,95~99세,2018,40,9,31,29,40,9,31,29
21120, 강서구,100001, 95세,2018,12,X,10,20,12,X,10,20
21120, 강서구,100002, 96세,2018,14,X,11,27.3,14,X,11,27.3
21120, 강서구,100003, 97세,2018,5,X,X,25,5,X,X,25
21120, 강서구,100004, 98세,2018,8,X,6,33.3,8,X,6,33.3
21120, 강서구,100005, 99세,2018,X,X,X,,X,X,X,
21120, 강서구,101,100세이상,2018,X,X,X,100,X,X,X,100
21120, 강서구,102,15세미만,2018,23471,11981,11490,104.3,23395,11932,11463,104.1
21120, 강서구,103,15~64세,2018,85330,46523,38807,119.9,78944,41061,37883,108.4
21120, 강서구,104,65세이상,2018,12550,5785,6765,85.5,12503,5766,6737,85.6
21120, 강서구,086,85세이상,2018,865,232,633,36.7,863,231,632,36.6
21120, 강서구,126,평균연령,2018,37.7,37,38.4,,37.9,37.4,38.5,
21120, 강서구,127,중위연령,2018,37.6,37.3,38.1,,38.2,38.2,38.1,
21130, 연제구,000,합계,2018,199887,96346,103541,93.1,198927,95966,102961,93.2
21130, 연제구,005,0~4세,2018,7077,3634,3443,105.5,7069,3631,3438,105.6
21130, 연제구,005001, 0세,2018,1179,631,548,115.1,1178,631,547,115.4
21130, 연제구,005002, 1세,2018,1278,654,624,104.8,1274,652,622,104.8
21130, 연제구,005003, 2세,2018,1571,794,777,102.2,1569,793,776,102.2
21130, 연제구,005004, 3세,2018,1528,764,764,100,1527,764,763,100.1
21130, 연제구,005005, 4세,2018,1521,791,730,108.4,1521,791,730,108.4
21130, 연제구,010,5~9세,2018,7636,3872,3764,102.9,7632,3871,3761,102.9
21130, 연제구,010001, 5세,2018,1489,716,773,92.6,1486,715,771,92.7
21130, 연제구,010002, 6세,2018,1614,801,813,98.5,1614,801,813,98.5
21130, 연제구,010003, 7세,2018,1621,854,767,111.3,1621,854,767,111.3
21130, 연제구,010004, 8세,2018,1509,758,751,100.9,1508,758,750,101.1
21130, 연제구,010005, 9세,2018,1403,743,660,112.6,1403,743,660,112.6
21130, 연제구,015,10~14세,2018,7516,3887,3629,107.1,7515,3886,3629,107.1
21130, 연제구,015001, 10세,2018,1517,785,732,107.2,1516,784,732,107.1
21130, 연제구,015002, 11세,2018,1572,835,737,113.3,1572,835,737,113.3
21130, 연제구,015003, 12세,2018,1434,749,685,109.3,1434,749,685,109.3
21130, 연제구,015004, 13세,2018,1458,750,708,105.9,1458,750,708,105.9
21130, 연제구,015005, 14세,2018,1535,768,767,100.1,1535,768,767,100.1
21130, 연제구,020,15~19세,2018,9299,4810,4489,107.2,9286,4806,4480,107.3
21130, 연제구,020001, 15세,2018,1645,839,806,104.1,1644,839,805,104.2
21130, 연제구,020002, 16세,2018,1610,814,796,102.3,1609,814,795,102.4
21130, 연제구,020003, 17세,2018,1851,999,852,117.3,1850,998,852,117.1
21130, 연제구,020004, 18세,2018,2095,1073,1022,105,2092,1072,1020,105.1
21130, 연제구,020005, 19세,2018,2098,1085,1013,107.1,2091,1083,1008,107.4
21130, 연제구,025,20~24세,2018,12690,6542,6148,106.4,12597,6509,6088,106.9
21130, 연제구,025001, 20세,2018,2388,1251,1137,110,2372,1243,1129,110.1
21130, 연제구,025002, 21세,2018,2445,1262,1183,106.7,2433,1258,1175,107.1
21130, 연제구,025003, 22세,2018,2665,1406,1259,111.7,2650,1403,1247,112.5
21130, 연제구,025004, 23세,2018,2527,1264,1263,100.1,2503,1256,1247,100.7
21130, 연제구,025005, 24세,2018,2665,1359,1306,104.1,2639,1349,1290,104.6
21130, 연제구,030,25~29세,2018,12732,6452,6280,102.7,12573,6408,6165,103.9
21130, 연제구,030001, 25세,2018,2630,1377,1253,109.9,2605,1369,1236,110.8
21130, 연제구,030002, 26세,2018,2736,1408,1328,106,2701,1395,1306,106.8
21130, 연제구,030003, 27세,2018,2579,1278,1301,98.2,2535,1270,1265,100.4
21130, 연제구,030004, 28세,2018,2401,1181,1220,96.8,2375,1173,1202,97.6
21130, 연제구,030005, 29세,2018,2386,1208,1178,102.5,2357,1201,1156,103.9
21130, 연제구,035,30~34세,2018,11790,5877,5913,99.4,11626,5817,5809,100.1
21130, 연제구,035001, 30세,2018,2255,1085,1170,92.7,2218,1073,1145,93.7
21130, 연제구,035002, 31세,2018,2263,1142,1121,101.9,2218,1124,1094,102.7
21130, 연제구,035003, 32세,2018,2410,1218,1192,102.2,2380,1208,1172,103.1
21130, 연제구,035004, 33세,2018,2331,1163,1168,99.6,2302,1150,1152,99.8
21130, 연제구,035005, 34세,2018,2531,1269,1262,100.6,2508,1262,1246,101.3
21130, 연제구,040,35~39세,2018,15302,7657,7645,100.2,15184,7604,7580,100.3
21130, 연제구,040001, 35세,2018,2747,1387,1360,102,2729,1375,1354,101.6
21130, 연제구,040002, 36세,2018,3027,1495,1532,97.6,2993,1483,1510,98.2
21130, 연제구,040003, 37세,2018,3220,1652,1568,105.4,3197,1645,1552,106
21130, 연제구,040004, 38세,2018,3283,1620,1663,97.4,3259,1609,1650,97.5
21130, 연제구,040005, 39세,2018,3025,1503,1522,98.8,3006,1492,1514,98.5
21130, 연제구,045,40~44세,2018,14102,6941,7161,96.9,14005,6896,7109,97
21130, 연제구,045001, 40세,2018,2703,1301,1402,92.8,2679,1290,1389,92.9
21130, 연제구,045002, 41세,2018,2696,1300,1396,93.1,2680,1292,1388,93.1
21130, 연제구,045003, 42세,2018,2701,1361,1340,101.6,2690,1357,1333,101.8
21130, 연제구,045004, 43세,2018,2811,1389,1422,97.7,2790,1375,1415,97.2
21130, 연제구,045005, 44세,2018,3191,1590,1601,99.3,3166,1582,1584,99.9
21130, 연제구,050,45~49세,2018,16363,7914,8449,93.7,16272,7869,8403,93.6
21130, 연제구,050001, 45세,2018,3165,1536,1629,94.3,3144,1527,1617,94.4
21130, 연제구,050002, 46세,2018,3239,1612,1627,99.1,3226,1604,1622,98.9
21130, 연제구,050003, 47세,2018,3368,1632,1736,94,3354,1624,1730,93.9
21130, 연제구,050004, 48세,2018,3320,1600,1720,93,3297,1591,1706,93.3
21130, 연제구,050005, 49세,2018,3271,1534,1737,88.3,3251,1523,1728,88.1
21130, 연제구,055,50~54세,2018,15844,7513,8331,90.2,15754,7475,8279,90.3
21130, 연제구,055001, 50세,2018,3497,1660,1837,90.4,3475,1651,1824,90.5
21130, 연제구,055002, 51세,2018,3284,1518,1766,86,3262,1508,1754,86
21130, 연제구,055003, 52세,2018,3076,1508,1568,96.2,3064,1504,1560,96.4
21130, 연제구,055004, 53세,2018,3100,1448,1652,87.7,3083,1438,1645,87.4
21130, 연제구,055005, 54세,2018,2887,1379,1508,91.4,2870,1374,1496,91.8
21130, 연제구,060,55~59세,2018,17972,8257,9715,85,17916,8234,9682,85
21130, 연제구,060001, 55세,2018,3194,1465,1729,84.7,3176,1459,1717,85
21130, 연제구,060002, 56세,2018,3520,1672,1848,90.5,3509,1668,1841,90.6
21130, 연제구,060003, 57세,2018,3868,1744,2124,82.1,3857,1742,2115,82.4
21130, 연제구,060004, 58세,2018,3857,1766,2091,84.5,3846,1758,2088,84.2
21130, 연제구,060005, 59세,2018,3533,1610,1923,83.7,3528,1607,1921,83.7
21130, 연제구,065,60~64세,2018,16764,7843,8921,87.9,16726,7832,8894,88.1
21130, 연제구,065001, 60세,2018,3472,1609,1863,86.4,3462,1606,1856,86.5
21130, 연제구,065002, 61세,2018,3533,1630,1903,85.7,3523,1626,1897,85.7
21130, 연제구,065003, 62세,2018,3408,1600,1808,88.5,3401,1597,1804,88.5
21130, 연제구,065004, 63세,2018,3428,1582,1846,85.7,3425,1581,1844,85.7
21130, 연제구,065005, 64세,2018,2923,1422,1501,94.7,2915,1422,1493,95.2
21130, 연제구,070,65~69세,2018,12093,5644,6449,87.5,12080,5635,6445,87.4
21130, 연제구,070001, 65세,2018,2627,1240,1387,89.4,2623,1237,1386,89.2
21130, 연제구,070002, 66세,2018,2778,1250,1528,81.8,2774,1246,1528,81.5
21130, 연제구,070003, 67세,2018,2178,1005,1173,85.7,2175,1004,1171,85.7
21130, 연제구,070004, 68세,2018,2203,1065,1138,93.6,2203,1065,1138,93.6
21130, 연제구,070005, 69세,2018,2307,1084,1223,88.6,2305,1083,1222,88.6
21130, 연제구,075,70~74세,2018,8923,4115,4808,85.6,8912,4106,4806,85.4
21130, 연제구,075001, 70세,2018,2248,1021,1227,83.2,2242,1016,1226,82.9
21130, 연제구,075002, 71세,2018,2109,959,1150,83.4,2108,958,1150,83.3
21130, 연제구,075003, 72세,2018,1517,738,779,94.7,1513,735,778,94.5
21130, 연제구,075004, 73세,2018,1512,717,795,90.2,1512,717,795,90.2
21130, 연제구,075005, 74세,2018,1537,680,857,79.3,1537,680,857,79.3
21130, 연제구,080,75~79세,2018,7266,3270,3996,81.8,7263,3269,3994,81.8
21130, 연제구,080001, 75세,2018,1661,764,897,85.2,1661,764,897,85.2
21130, 연제구,080002, 76세,2018,1700,826,874,94.5,1699,826,873,94.6
21130, 연제구,080003, 77세,2018,1467,631,836,75.5,1466,630,836,75.4
21130, 연제구,080004, 78세,2018,1232,535,697,76.8,1231,535,696,76.9
21130, 연제구,080005, 79세,2018,1206,514,692,74.3,1206,514,692,74.3
21130, 연제구,085,80~84세,2018,3994,1515,2479,61.1,3994,1515,2479,61.1
21130, 연제구,085001, 80세,2018,946,410,536,76.5,946,410,536,76.5
21130, 연제구,085002, 81세,2018,933,355,578,61.4,933,355,578,61.4
21130, 연제구,085003, 82세,2018,810,325,485,67,810,325,485,67
21130, 연제구,085004, 83세,2018,720,251,469,53.5,720,251,469,53.5
21130, 연제구,085005, 84세,2018,585,174,411,42.3,585,174,411,42.3
21130, 연제구,090,85~89세,2018,1801,476,1325,35.9,1800,476,1324,36
21130, 연제구,090001, 85세,2018,477,154,323,47.7,476,154,322,47.8
21130, 연제구,090002, 86세,2018,420,97,323,30,420,97,323,30
21130, 연제구,090003, 87세,2018,339,87,252,34.5,339,87,252,34.5
21130, 연제구,090004, 88세,2018,290,70,220,31.8,290,70,220,31.8
21130, 연제구,090005, 89세,2018,275,68,207,32.9,275,68,207,32.9
21130, 연제구,095,90~94세,2018,575,106,469,22.6,575,106,469,22.6
21130, 연제구,095001, 90세,2018,189,36,153,23.5,189,36,153,23.5
21130, 연제구,095002, 91세,2018,152,31,121,25.6,152,31,121,25.6
21130, 연제구,095003, 92세,2018,93,13,80,16.3,93,13,80,16.3
21130, 연제구,095004, 93세,2018,87,16,71,22.5,87,16,71,22.5
21130, 연제구,095005, 94세,2018,54,10,44,22.7,54,10,44,22.7
21130, 연제구,100,95~99세,2018,133,19,114,16.7,133,19,114,16.7
21130, 연제구,100001, 95세,2018,54,8,46,17.4,54,8,46,17.4
21130, 연제구,100002, 96세,2018,27,X,23,17.4,27,X,23,17.4
21130, 연제구,100003, 97세,2018,29,X,25,16,29,X,25,16
21130, 연제구,100004, 98세,2018,12,X,11,9.1,12,X,11,9.1
21130, 연제구,100005, 99세,2018,11,X,9,22.2,11,X,9,22.2
21130, 연제구,101,100세이상,2018,15,X,13,15.4,15,X,13,15.4
21130, 연제구,102,15세미만,2018,22229,11393,10836,105.1,22216,11388,10828,105.2
21130, 연제구,103,15~64세,2018,142858,69806,73052,95.6,141939,69450,72489,95.8
21130, 연제구,104,65세이상,2018,34800,15147,19653,77.1,34772,15128,19644,77
21130, 연제구,086,85세이상,2018,2524,603,1921,31.4,2523,603,1920,31.4
21130, 연제구,126,평균연령,2018,44,42.7,45.2,,44,42.7,45.2,
21130, 연제구,127,중위연령,2018,45.6,44.1,47,,45.6,44.1,47.1,
21140, 수영구,000,합계,2018,170296,80837,89459,90.4,168558,79965,88593,90.3
21140, 수영구,005,0~4세,2018,5330,2712,2618,103.6,5296,2695,2601,103.6
21140, 수영구,005001, 0세,2018,919,478,441,108.4,910,472,438,107.8
21140, 수영구,005002, 1세,2018,1027,492,535,92,1020,491,529,92.8
21140, 수영구,005003, 2세,2018,1136,585,551,106.2,1132,582,550,105.8
21140, 수영구,005004, 3세,2018,1167,588,579,101.6,1158,584,574,101.7
21140, 수영구,005005, 4세,2018,1081,569,512,111.1,1076,566,510,111
21140, 수영구,010,5~9세,2018,5211,2693,2518,106.9,5192,2687,2505,107.3
21140, 수영구,010001, 5세,2018,1072,540,532,101.5,1066,539,527,102.3
21140, 수영구,010002, 6세,2018,1090,577,513,112.5,1088,576,512,112.5
21140, 수영구,010003, 7세,2018,1075,541,534,101.3,1071,540,531,101.7
21140, 수영구,010004, 8세,2018,979,531,448,118.5,974,529,445,118.9
21140, 수영구,010005, 9세,2018,995,504,491,102.6,993,503,490,102.7
21140, 수영구,015,10~14세,2018,5374,2804,2570,109.1,5361,2798,2563,109.2
21140, 수영구,015001, 10세,2018,1047,542,505,107.3,1045,542,503,107.8
21140, 수영구,015002, 11세,2018,1086,541,545,99.3,1083,541,542,99.8
21140, 수영구,015003, 12세,2018,974,526,448,117.4,972,525,447,117.4
21140, 수영구,015004, 13세,2018,1073,557,516,107.9,1071,555,516,107.6
21140, 수영구,015005, 14세,2018,1194,638,556,114.7,1190,635,555,114.4
21140, 수영구,020,15~19세,2018,6550,3380,3170,106.6,6513,3359,3154,106.5
21140, 수영구,020001, 15세,2018,1142,591,551,107.3,1138,588,550,106.9
21140, 수영구,020002, 16세,2018,1174,592,582,101.7,1171,591,580,101.9
21140, 수영구,020003, 17세,2018,1366,707,659,107.3,1361,702,659,106.5
21140, 수영구,020004, 18세,2018,1476,758,718,105.6,1469,753,716,105.2
21140, 수영구,020005, 19세,2018,1392,732,660,110.9,1374,725,649,111.7
21140, 수영구,025,20~24세,2018,10073,5109,4964,102.9,9906,5029,4877,103.1
21140, 수영구,025001, 20세,2018,1643,890,753,118.2,1617,876,741,118.2
21140, 수영구,025002, 21세,2018,1822,928,894,103.8,1805,920,885,104
21140, 수영구,025003, 22세,2018,2041,1079,962,112.2,2016,1069,947,112.9
21140, 수영구,025004, 23세,2018,2185,1077,1108,97.2,2136,1053,1083,97.2
21140, 수영구,025005, 24세,2018,2382,1135,1247,91,2332,1111,1221,91
21140, 수영구,030,25~29세,2018,12647,6212,6435,96.5,12336,6054,6282,96.4
21140, 수영구,030001, 25세,2018,2543,1276,1267,100.7,2475,1237,1238,99.9
21140, 수영구,030002, 26세,2018,2648,1289,1359,94.8,2578,1252,1326,94.4
21140, 수영구,030003, 27세,2018,2558,1240,1318,94.1,2499,1209,1290,93.7
21140, 수영구,030004, 28세,2018,2500,1214,1286,94.4,2437,1191,1246,95.6
21140, 수영구,030005, 29세,2018,2398,1193,1205,99,2347,1165,1182,98.6
21140, 수영구,035,30~34세,2018,11099,5520,5579,98.9,10811,5388,5423,99.4
21140, 수영구,035001, 30세,2018,2147,1047,1100,95.2,2095,1025,1070,95.8
21140, 수영구,035002, 31세,2018,2253,1110,1143,97.1,2172,1078,1094,98.5
21140, 수영구,035003, 32세,2018,2262,1129,1133,99.6,2209,1103,1106,99.7
21140, 수영구,035004, 33세,2018,2190,1101,1089,101.1,2137,1077,1060,101.6
21140, 수영구,035005, 34세,2018,2247,1133,1114,101.7,2198,1105,1093,101.1
21140, 수영구,040,35~39세,2018,13016,6581,6435,102.3,12782,6452,6330,101.9
21140, 수영구,040001, 35세,2018,2470,1227,1243,98.7,2411,1197,1214,98.6
21140, 수영구,040002, 36세,2018,2657,1363,1294,105.3,2604,1334,1270,105
21140, 수영구,040003, 37세,2018,2651,1351,1300,103.9,2609,1325,1284,103.2
21140, 수영구,040004, 38세,2018,2717,1385,1332,104,2669,1353,1316,102.8
21140, 수영구,040005, 39세,2018,2521,1255,1266,99.1,2489,1243,1246,99.8
21140, 수영구,045,40~44세,2018,11360,5668,5692,99.6,11192,5567,5625,99
21140, 수영구,045001, 40세,2018,2274,1161,1113,104.3,2233,1132,1101,102.8
21140, 수영구,045002, 41세,2018,2225,1089,1136,95.9,2186,1066,1120,95.2
21140, 수영구,045003, 42세,2018,2096,1071,1025,104.5,2064,1054,1010,104.4
21140, 수영구,045004, 43세,2018,2266,1117,1149,97.2,2236,1103,1133,97.4
21140, 수영구,045005, 44세,2018,2499,1230,1269,96.9,2473,1212,1261,96.1
21140, 수영구,050,45~49세,2018,13347,6381,6966,91.6,13202,6310,6892,91.6
21140, 수영구,050001, 45세,2018,2555,1213,1342,90.4,2530,1200,1330,90.2
21140, 수영구,050002, 46세,2018,2632,1297,1335,97.2,2602,1284,1318,97.4
21140, 수영구,050003, 47세,2018,2744,1302,1442,90.3,2712,1288,1424,90.4
21140, 수영구,050004, 48세,2018,2765,1322,1443,91.6,2734,1302,1432,90.9
21140, 수영구,050005, 49세,2018,2651,1247,1404,88.8,2624,1236,1388,89
21140, 수영구,055,50~54세,2018,12587,5847,6740,86.8,12482,5793,6689,86.6
21140, 수영구,055001, 50세,2018,2730,1290,1440,89.6,2710,1281,1429,89.6
21140, 수영구,055002, 51세,2018,2513,1148,1365,84.1,2492,1137,1355,83.9
21140, 수영구,055003, 52세,2018,2436,1150,1286,89.4,2418,1140,1278,89.2
21140, 수영구,055004, 53세,2018,2509,1167,1342,87,2484,1155,1329,86.9
21140, 수영구,055005, 54세,2018,2399,1092,1307,83.6,2378,1080,1298,83.2
21140, 수영구,060,55~59세,2018,15199,6721,8478,79.3,15111,6675,8436,79.1
21140, 수영구,060001, 55세,2018,2746,1224,1522,80.4,2729,1216,1513,80.4
21140, 수영구,060002, 56세,2018,2879,1282,1597,80.3,2857,1273,1584,80.4
21140, 수영구,060003, 57세,2018,3198,1372,1826,75.1,3181,1361,1820,74.8
21140, 수영구,060004, 58세,2018,3240,1434,1806,79.4,3224,1428,1796,79.5
21140, 수영구,060005, 59세,2018,3136,1409,1727,81.6,3120,1397,1723,81.1
21140, 수영구,065,60~64세,2018,15052,6748,8304,81.3,14978,6719,8259,81.4
21140, 수영구,065001, 60세,2018,3053,1350,1703,79.3,3036,1344,1692,79.4
21140, 수영구,065002, 61세,2018,3136,1391,1745,79.7,3118,1382,1736,79.6
21140, 수영구,065003, 62세,2018,2994,1337,1657,80.7,2980,1334,1646,81
21140, 수영구,065004, 63세,2018,3160,1415,1745,81.1,3144,1407,1737,81
21140, 수영구,065005, 64세,2018,2709,1255,1454,86.3,2700,1252,1448,86.5
21140, 수영구,070,65~69세,2018,11294,5155,6139,84,11259,5140,6119,84
21140, 수영구,070001, 65세,2018,2422,1110,1312,84.6,2411,1107,1304,84.9
21140, 수영구,070002, 66세,2018,2554,1168,1386,84.3,2547,1165,1382,84.3
21140, 수영구,070003, 67세,2018,1991,911,1080,84.4,1986,907,1079,84.1
21140, 수영구,070004, 68세,2018,2128,919,1209,76,2125,919,1206,76.2
21140, 수영구,070005, 69세,2018,2199,1047,1152,90.9,2190,1042,1148,90.8
21140, 수영구,075,70~74세,2018,8718,4021,4697,85.6,8709,4019,4690,85.7
21140, 수영구,075001, 70세,2018,2154,989,1165,84.9,2151,989,1162,85.1
21140, 수영구,075002, 71세,2018,2115,933,1182,78.9,2113,933,1180,79.1
21140, 수영구,075003, 72세,2018,1555,757,798,94.9,1553,756,797,94.9
21140, 수영구,075004, 73세,2018,1394,644,750,85.9,1393,644,749,86
21140, 수영구,075005, 74세,2018,1500,698,802,87,1499,697,802,86.9
21140, 수영구,080,75~79세,2018,6813,3061,3752,81.6,6807,3058,3749,81.6
21140, 수영구,080001, 75세,2018,1493,698,795,87.8,1493,698,795,87.8
21140, 수영구,080002, 76세,2018,1631,748,883,84.7,1629,746,883,84.5
21140, 수영구,080003, 77세,2018,1340,578,762,75.9,1338,578,760,76.1
21140, 수영구,080004, 78세,2018,1207,543,664,81.8,1205,542,663,81.7
21140, 수영구,080005, 79세,2018,1142,494,648,76.2,1142,494,648,76.2
21140, 수영구,085,80~84세,2018,3941,1485,2456,60.5,3937,1484,2453,60.5
21140, 수영구,085001, 80세,2018,981,406,575,70.6,981,406,575,70.6
21140, 수영구,085002, 81세,2018,908,355,553,64.2,906,355,551,64.4
21140, 수영구,085003, 82세,2018,745,302,443,68.2,744,301,443,67.9
21140, 수영구,085004, 83세,2018,706,234,472,49.6,706,234,472,49.6
21140, 수영구,085005, 84세,2018,601,188,413,45.5,600,188,412,45.6
21140, 수영구,090,85~89세,2018,1891,564,1327,42.5,1890,563,1327,42.4
21140, 수영구,090001, 85세,2018,511,166,345,48.1,510,165,345,47.8
21140, 수영구,090002, 86세,2018,449,125,324,38.6,449,125,324,38.6
21140, 수영구,090003, 87세,2018,372,115,257,44.7,372,115,257,44.7
21140, 수영구,090004, 88세,2018,292,81,211,38.4,292,81,211,38.4
21140, 수영구,090005, 89세,2018,267,77,190,40.5,267,77,190,40.5
21140, 수영구,095,90~94세,2018,656,150,506,29.6,656,150,506,29.6
21140, 수영구,095001, 90세,2018,236,51,185,27.6,236,51,185,27.6
21140, 수영구,095002, 91세,2018,160,40,120,33.3,160,40,120,33.3
21140, 수영구,095003, 92세,2018,123,34,89,38.2,123,34,89,38.2
21140, 수영구,095004, 93세,2018,82,13,69,18.8,82,13,69,18.8
21140, 수영구,095005, 94세,2018,55,12,43,27.9,55,12,43,27.9
21140, 수영구,100,95~99세,2018,122,23,99,23.2,122,23,99,23.2
21140, 수영구,100001, 95세,2018,45,6,39,15.4,45,6,39,15.4
21140, 수영구,100002, 96세,2018,25,6,19,31.6,25,6,19,31.6
21140, 수영구,100003, 97세,2018,25,5,20,25,25,5,20,25
21140, 수영구,100004, 98세,2018,19,X,17,11.8,19,X,17,11.8
21140, 수영구,100005, 99세,2018,8,X,X,100,8,X,X,100
21140, 수영구,101,100세이상,2018,16,X,14,14.3,16,X,14,14.3
21140, 수영구,102,15세미만,2018,15915,8209,7706,106.5,15849,8180,7669,106.7
21140, 수영구,103,15~64세,2018,120930,58167,62763,92.7,119313,57346,61967,92.5
21140, 수영구,104,65세이상,2018,33451,14461,18990,76.2,33396,14439,18957,76.2
21140, 수영구,086,85세이상,2018,2685,739,1946,38,2684,738,1946,37.9
21140, 수영구,126,평균연령,2018,45.4,44,46.7,,45.5,44.1,46.8,
21140, 수영구,127,중위연령,2018,46.7,44.8,48.4,,46.9,45,48.6,
21150, 사상구,000,합계,2018,226961,114236,112725,101.3,220675,110845,109830,100.9
21150, 사상구,005,0~4세,2018,7175,3666,3509,104.5,7124,3642,3482,104.6
21150, 사상구,005001, 0세,2018,1252,681,571,119.3,1235,673,562,119.8
21150, 사상구,005002, 1세,2018,1336,674,662,101.8,1326,668,658,101.5
21150, 사상구,005003, 2세,2018,1499,760,739,102.8,1489,754,735,102.6
21150, 사상구,005004, 3세,2018,1569,781,788,99.1,1561,779,782,99.6
21150, 사상구,005005, 4세,2018,1519,770,749,102.8,1513,768,745,103.1
21150, 사상구,010,5~9세,2018,7580,3852,3728,103.3,7549,3838,3711,103.4
21150, 사상구,010001, 5세,2018,1550,754,796,94.7,1541,750,791,94.8
21150, 사상구,010002, 6세,2018,1670,856,814,105.2,1663,854,809,105.6
21150, 사상구,010003, 7세,2018,1550,793,757,104.8,1547,792,755,104.9
21150, 사상구,010004, 8세,2018,1442,744,698,106.6,1434,738,696,106
21150, 사상구,010005, 9세,2018,1368,705,663,106.3,1364,704,660,106.7
21150, 사상구,015,10~14세,2018,7306,3809,3497,108.9,7280,3797,3483,109
21150, 사상구,015001, 10세,2018,1513,766,747,102.5,1508,763,745,102.4
21150, 사상구,015002, 11세,2018,1468,772,696,110.9,1458,770,688,111.9
21150, 사상구,015003, 12세,2018,1398,744,654,113.8,1395,743,652,114
21150, 사상구,015004, 13세,2018,1327,689,638,108,1325,688,637,108
21150, 사상구,015005, 14세,2018,1600,838,762,110,1594,833,761,109.5
21150, 사상구,020,15~19세,2018,10924,5598,5326,105.1,10609,5470,5139,106.4
21150, 사상구,020001, 15세,2018,1611,845,766,110.3,1608,843,765,110.2
21150, 사상구,020002, 16세,2018,1632,865,767,112.8,1620,862,758,113.7
21150, 사상구,020003, 17세,2018,1952,1069,883,121.1,1929,1059,870,121.7
21150, 사상구,020004, 18세,2018,2473,1263,1210,104.4,2390,1225,1165,105.2
21150, 사상구,020005, 19세,2018,3256,1556,1700,91.5,3062,1481,1581,93.7
21150, 사상구,025,20~24세,2018,18408,9427,8981,105,16773,8685,8088,107.4
21150, 사상구,025001, 20세,2018,3622,1611,2011,80.1,3088,1406,1682,83.6
21150, 사상구,025002, 21세,2018,3502,1692,1810,93.5,3142,1539,1603,96
21150, 사상구,025003, 22세,2018,3695,1956,1739,112.5,3435,1811,1624,111.5
21150, 사상구,025004, 23세,2018,3800,2109,1691,124.7,3546,1976,1570,125.9
21150, 사상구,025005, 24세,2018,3789,2059,1730,119,3562,1953,1609,121.4
21150, 사상구,030,25~29세,2018,16545,9093,7452,122,15514,8497,7017,121.1
21150, 사상구,030001, 25세,2018,3640,2061,1579,130.5,3432,1931,1501,128.6
21150, 사상구,030002, 26세,2018,3563,1976,1587,124.5,3354,1852,1502,123.3
21150, 사상구,030003, 27세,2018,3259,1781,1478,120.5,3063,1660,1403,118.3
21150, 사상구,030004, 28세,2018,3126,1698,1428,118.9,2908,1576,1332,118.3
21150, 사상구,030005, 29세,2018,2957,1577,1380,114.3,2757,1478,1279,115.6
21150, 사상구,035,30~34세,2018,13710,7452,6258,119.1,12715,6841,5874,116.5
21150, 사상구,035001, 30세,2018,2736,1484,1252,118.5,2526,1367,1159,117.9
21150, 사상구,035002, 31세,2018,2780,1511,1269,119.1,2565,1380,1185,116.5
21150, 사상구,035003, 32세,2018,2693,1499,1194,125.5,2481,1367,1114,122.7
21150, 사상구,035004, 33세,2018,2726,1475,1251,117.9,2534,1356,1178,115.1
21150, 사상구,035005, 34세,2018,2775,1483,1292,114.8,2609,1371,1238,110.7
21150, 사상구,040,35~39세,2018,16253,8707,7546,115.4,15578,8274,7304,113.3
21150, 사상구,040001, 35세,2018,2994,1625,1369,118.7,2843,1521,1322,115.1
21150, 사상구,040002, 36세,2018,3337,1768,1569,112.7,3168,1669,1499,111.3
21150, 사상구,040003, 37세,2018,3390,1822,1568,116.2,3253,1734,1519,114.2
21150, 사상구,040004, 38세,2018,3423,1837,1586,115.8,3305,1757,1548,113.5
21150, 사상구,040005, 39세,2018,3109,1655,1454,113.8,3009,1593,1416,112.5
21150, 사상구,045,40~44세,2018,14351,7696,6655,115.6,13929,7447,6482,114.9
21150, 사상구,045001, 40세,2018,2770,1537,1233,124.7,2690,1489,1201,124
21150, 사상구,045002, 41세,2018,2785,1472,1313,112.1,2690,1415,1275,111
21150, 사상구,045003, 42세,2018,2749,1511,1238,122.1,2670,1464,1206,121.4
21150, 사상구,045004, 43세,2018,2943,1532,1411,108.6,2862,1486,1376,108
21150, 사상구,045005, 44세,2018,3104,1644,1460,112.6,3017,1593,1424,111.9
21150, 사상구,050,45~49세,2018,17562,8844,8718,101.4,17170,8625,8545,100.9
21150, 사상구,050001, 45세,2018,3249,1677,1572,106.7,3175,1630,1545,105.5
21150, 사상구,050002, 46세,2018,3295,1677,1618,103.6,3207,1630,1577,103.4
21150, 사상구,050003, 47세,2018,3477,1764,1713,103,3397,1719,1678,102.4
21150, 사상구,050004, 48세,2018,3670,1833,1837,99.8,3593,1793,1800,99.6
21150, 사상구,050005, 49세,2018,3871,1893,1978,95.7,3798,1853,1945,95.3
21150, 사상구,055,50~54세,2018,20225,9844,10381,94.8,19923,9681,10242,94.5
21150, 사상구,055001, 50세,2018,4095,1929,2166,89.1,4027,1894,2133,88.8
21150, 사상구,055002, 51세,2018,3969,1883,2086,90.3,3921,1852,2069,89.5
21150, 사상구,055003, 52세,2018,3999,1995,2004,99.6,3928,1956,1972,99.2
21150, 사상구,055004, 53세,2018,4145,2012,2133,94.3,4086,1981,2105,94.1
21150, 사상구,055005, 54세,2018,4017,2025,1992,101.7,3961,1998,1963,101.8
21150, 사상구,060,55~59세,2018,23625,11739,11886,98.8,23430,11643,11787,98.8
21150, 사상구,060001, 55세,2018,4214,2143,2071,103.5,4170,2117,2053,103.1
21150, 사상구,060002, 56세,2018,4671,2336,2335,100,4616,2313,2303,100.4
21150, 사상구,060003, 57세,2018,5182,2521,2661,94.7,5154,2511,2643,95
21150, 사상구,060004, 58세,2018,5061,2473,2588,95.6,5018,2448,2570,95.3
21150, 사상구,060005, 59세,2018,4497,2266,2231,101.6,4472,2254,2218,101.6
21150, 사상구,065,60~64세,2018,19314,9611,9703,99.1,19196,9543,9653,98.9
21150, 사상구,065001, 60세,2018,4197,2125,2072,102.6,4165,2107,2058,102.4
21150, 사상구,065002, 61세,2018,4094,2049,2045,100.2,4065,2031,2034,99.9
21150, 사상구,065003, 62세,2018,3818,1883,1935,97.3,3796,1870,1926,97.1
21150, 사상구,065004, 63세,2018,3873,1883,1990,94.6,3853,1872,1981,94.5
21150, 사상구,065005, 64세,2018,3332,1671,1661,100.6,3317,1663,1654,100.5
21150, 사상구,070,65~69세,2018,12953,6330,6623,95.6,12899,6305,6594,95.6
21150, 사상구,070001, 65세,2018,2816,1394,1422,98,2797,1383,1414,97.8
21150, 사상구,070002, 66세,2018,2964,1452,1512,96,2953,1451,1502,96.6
21150, 사상구,070003, 67세,2018,2473,1201,1272,94.4,2464,1195,1269,94.2
21150, 사상구,070004, 68세,2018,2340,1132,1208,93.7,2329,1127,1202,93.8
21150, 사상구,070005, 69세,2018,2360,1151,1209,95.2,2356,1149,1207,95.2
21150, 사상구,075,70~74세,2018,8745,4119,4626,89,8722,4111,4611,89.2
21150, 사상구,075001, 70세,2018,2262,1096,1166,94,2250,1092,1158,94.3
21150, 사상구,075002, 71세,2018,2053,966,1087,88.9,2050,965,1085,88.9
21150, 사상구,075003, 72세,2018,1479,728,751,96.9,1477,727,750,96.9
21150, 사상구,075004, 73세,2018,1448,642,806,79.7,1442,640,802,79.8
21150, 사상구,075005, 74세,2018,1503,687,816,84.2,1503,687,816,84.2
21150, 사상구,080,75~79세,2018,6496,2841,3655,77.7,6483,2838,3645,77.9
21150, 사상구,080001, 75세,2018,1488,678,810,83.7,1485,678,807,84
21150, 사상구,080002, 76세,2018,1527,723,804,89.9,1525,722,803,89.9
21150, 사상구,080003, 77세,2018,1324,572,752,76.1,1320,570,750,76
21150, 사상구,080004, 78세,2018,1134,465,669,69.5,1131,465,666,69.8
21150, 사상구,080005, 79세,2018,1023,403,620,65,1022,403,619,65.1
21150, 사상구,085,80~84세,2018,3604,1150,2454,46.9,3599,1150,2449,47
21150, 사상구,085001, 80세,2018,911,325,586,55.5,909,325,584,55.7
21150, 사상구,085002, 81세,2018,827,276,551,50.1,827,276,551,50.1
21150, 사상구,085003, 82세,2018,701,230,471,48.8,698,230,468,49.1
21150, 사상구,085004, 83세,2018,633,177,456,38.8,633,177,456,38.8
21150, 사상구,085005, 84세,2018,532,142,390,36.4,532,142,390,36.4
21150, 사상구,090,85~89세,2018,1527,363,1164,31.2,1526,363,1163,31.2
21150, 사상구,090001, 85세,2018,457,119,338,35.2,456,119,337,35.3
21150, 사상구,090002, 86세,2018,352,97,255,38,352,97,255,38
21150, 사상구,090003, 87세,2018,257,56,201,27.9,257,56,201,27.9
21150, 사상구,090004, 88세,2018,241,51,190,26.8,241,51,190,26.8
21150, 사상구,090005, 89세,2018,220,40,180,22.2,220,40,180,22.2
21150, 사상구,095,90~94세,2018,534,86,448,19.2,532,86,446,19.3
21150, 사상구,095001, 90세,2018,162,33,129,25.6,160,33,127,26
21150, 사상구,095002, 91세,2018,139,22,117,18.8,139,22,117,18.8
21150, 사상구,095003, 92세,2018,93,15,78,19.2,93,15,78,19.2
21150, 사상구,095004, 93세,2018,83,12,71,16.9,83,12,71,16.9
21150, 사상구,095005, 94세,2018,57,X,53,7.5,57,X,53,7.5
21150, 사상구,100,95~99세,2018,111,9,102,8.8,111,9,102,8.8
21150, 사상구,100001, 95세,2018,43,X,41,4.9,43,X,41,4.9
21150, 사상구,100002, 96세,2018,28,X,25,12,28,X,25,12
21150, 사상구,100003, 97세,2018,16,X,13,23.1,16,X,13,23.1
21150, 사상구,100004, 98세,2018,12,X,12,0,12,X,12,0
21150, 사상구,100005, 99세,2018,12,X,11,9.1,12,X,11,9.1
21150, 사상구,101,100세이상,2018,13,X,13,0,13,X,13,0
21150, 사상구,102,15세미만,2018,22061,11327,10734,105.5,21953,11277,10676,105.6
21150, 사상구,103,15~64세,2018,170917,88011,82906,106.2,164837,84706,80131,105.7
21150, 사상구,104,65세이상,2018,33983,14898,19085,78.1,33885,14862,19023,78.1
21150, 사상구,086,85세이상,2018,2185,458,1727,26.5,2182,458,1724,26.6
21150, 사상구,126,평균연령,2018,43.4,42.3,44.5,,43.7,42.6,44.9,
21150, 사상구,127,중위연령,2018,45.4,43.6,47.1,,46,44.3,47.7,
21310, 기장군,000,합계,2018,160335,79362,80973,98,157753,77543,80210,96.7
21310, 기장군,005,0~4세,2018,9415,4770,4645,102.7,9395,4757,4638,102.6
21310, 기장군,005001, 0세,2018,1450,719,731,98.4,1446,716,730,98.1
21310, 기장군,005002, 1세,2018,1693,872,821,106.2,1690,870,820,106.1
21310, 기장군,005003, 2세,2018,1992,962,1030,93.4,1990,961,1029,93.4
21310, 기장군,005004, 3세,2018,2124,1089,1035,105.2,2118,1085,1033,105
21310, 기장군,005005, 4세,2018,2156,1128,1028,109.7,2151,1125,1026,109.6
21310, 기장군,010,5~9세,2018,10245,5222,5023,104,10237,5220,5017,104
21310, 기장군,010001, 5세,2018,2148,1104,1044,105.7,2145,1103,1042,105.9
21310, 기장군,010002, 6세,2018,2206,1145,1061,107.9,2203,1145,1058,108.2
21310, 기장군,010003, 7세,2018,2181,1108,1073,103.3,2179,1107,1072,103.3
21310, 기장군,010004, 8세,2018,1936,973,963,101,1936,973,963,101
21310, 기장군,010005, 9세,2018,1774,892,882,101.1,1774,892,882,101.1
21310, 기장군,015,10~14세,2018,8324,4392,3932,111.7,8315,4386,3929,111.6
21310, 기장군,015001, 10세,2018,1810,949,861,110.2,1808,948,860,110.2
21310, 기장군,015002, 11세,2018,1806,942,864,109,1806,942,864,109
21310, 기장군,015003, 12세,2018,1542,813,729,111.5,1540,811,729,111.2
21310, 기장군,015004, 13세,2018,1543,822,721,114,1542,822,720,114.2
21310, 기장군,015005, 14세,2018,1623,866,757,114.4,1619,863,756,114.2
21310, 기장군,020,15~19세,2018,7579,3951,3628,108.9,7543,3925,3618,108.5
21310, 기장군,020001, 15세,2018,1534,791,743,106.5,1530,790,740,106.8
21310, 기장군,020002, 16세,2018,1512,787,725,108.6,1509,786,723,108.7
21310, 기장군,020003, 17세,2018,1641,870,771,112.8,1632,861,771,111.7
21310, 기장군,020004, 18세,2018,1678,856,822,104.1,1671,850,821,103.5
21310, 기장군,020005, 19세,2018,1214,647,567,114.1,1201,638,563,113.3
21310, 기장군,025,20~24세,2018,7116,3972,3144,126.3,6843,3771,3072,122.8
21310, 기장군,025001, 20세,2018,1330,758,572,132.5,1315,745,570,130.7
21310, 기장군,025002, 21세,2018,1363,803,560,143.4,1336,787,549,143.4
21310, 기장군,025003, 22세,2018,1448,798,650,122.8,1390,758,632,119.9
21310, 기장군,025004, 23세,2018,1464,802,662,121.1,1382,739,643,114.9
21310, 기장군,025005, 24세,2018,1511,811,700,115.9,1420,742,678,109.4
21310, 기장군,030,25~29세,2018,7917,4199,3718,112.9,7402,3817,3585,106.5
21310, 기장군,030001, 25세,2018,1563,830,733,113.2,1473,766,707,108.3
21310, 기장군,030002, 26세,2018,1560,853,707,120.7,1459,776,683,113.6
21310, 기장군,030003, 27세,2018,1632,868,764,113.6,1518,781,737,106
21310, 기장군,030004, 28세,2018,1544,818,726,112.7,1432,740,692,106.9
21310, 기장군,030005, 29세,2018,1618,830,788,105.3,1520,754,766,98.4
21310, 기장군,035,30~34세,2018,10171,5073,5098,99.5,9578,4620,4958,93.2
21310, 기장군,035001, 30세,2018,1799,930,869,107,1666,825,841,98.1
21310, 기장군,035002, 31세,2018,1826,890,936,95.1,1701,802,899,89.2
21310, 기장군,035003, 32세,2018,1980,966,1014,95.3,1862,873,989,88.3
21310, 기장군,035004, 33세,2018,2103,1065,1038,102.6,2000,985,1015,97
21310, 기장군,035005, 34세,2018,2463,1222,1241,98.5,2349,1135,1214,93.5
21310, 기장군,040,35~39세,2018,16595,8320,8275,100.5,16182,8016,8166,98.2
21310, 기장군,040001, 35세,2018,2812,1364,1448,94.2,2722,1301,1421,91.6
21310, 기장군,040002, 36세,2018,3279,1651,1628,101.4,3182,1578,1604,98.4
21310, 기장군,040003, 37세,2018,3460,1766,1694,104.3,3369,1695,1674,101.3
21310, 기장군,040004, 38세,2018,3644,1823,1821,100.1,3571,1769,1802,98.2
21310, 기장군,040005, 39세,2018,3400,1716,1684,101.9,3338,1673,1665,100.5
21310, 기장군,045,40~44세,2018,14860,7624,7236,105.4,14623,7461,7162,104.2
21310, 기장군,045001, 40세,2018,3054,1527,1527,100,2998,1486,1512,98.3
21310, 기장군,045002, 41세,2018,2986,1565,1421,110.1,2933,1527,1406,108.6
21310, 기장군,045003, 42세,2018,2862,1483,1379,107.5,2823,1454,1369,106.2
21310, 기장군,045004, 43세,2018,2949,1503,1446,103.9,2908,1478,1430,103.4
21310, 기장군,045005, 44세,2018,3009,1546,1463,105.7,2961,1516,1445,104.9
21310, 기장군,050,45~49세,2018,13539,7094,6445,110.1,13344,6975,6369,109.5
21310, 기장군,050001, 45세,2018,2878,1471,1407,104.5,2829,1441,1388,103.8
21310, 기장군,050002, 46세,2018,2833,1495,1338,111.7,2799,1472,1327,110.9
21310, 기장군,050003, 47세,2018,2781,1498,1283,116.8,2735,1466,1269,115.5
21310, 기장군,050004, 48세,2018,2574,1369,1205,113.6,2539,1350,1189,113.5
21310, 기장군,050005, 49세,2018,2473,1261,1212,104,2442,1246,1196,104.2
21310, 기장군,055,50~54세,2018,10399,5270,5129,102.7,10293,5208,5085,102.4
21310, 기장군,055001, 50세,2018,2312,1175,1137,103.3,2288,1160,1128,102.8
21310, 기장군,055002, 51세,2018,2171,1087,1084,100.3,2152,1074,1078,99.6
21310, 기장군,055003, 52세,2018,2071,1094,977,112,2042,1081,961,112.5
21310, 기장군,055004, 53세,2018,1980,951,1029,92.4,1957,936,1021,91.7
21310, 기장군,055005, 54세,2018,1865,963,902,106.8,1854,957,897,106.7
21310, 기장군,060,55~59세,2018,10930,5198,5732,90.7,10859,5163,5696,90.6
21310, 기장군,060001, 55세,2018,2052,996,1056,94.3,2028,987,1041,94.8
21310, 기장군,060002, 56세,2018,2138,1032,1106,93.3,2127,1026,1101,93.2
21310, 기장군,060003, 57세,2018,2211,1058,1153,91.8,2200,1048,1152,91
21310, 기장군,060004, 58세,2018,2316,1080,1236,87.4,2301,1073,1228,87.4
21310, 기장군,060005, 59세,2018,2213,1032,1181,87.4,2203,1029,1174,87.6
21310, 기장군,065,60~64세,2018,10042,4605,5437,84.7,9990,4578,5412,84.6
21310, 기장군,065001, 60세,2018,2032,948,1084,87.5,2020,939,1081,86.9
21310, 기장군,065002, 61세,2018,2144,958,1186,80.8,2134,955,1179,81
21310, 기장군,065003, 62세,2018,2010,904,1106,81.7,1998,900,1098,82
21310, 기장군,065004, 63세,2018,2086,978,1108,88.3,2081,975,1106,88.2
21310, 기장군,065005, 64세,2018,1770,817,953,85.7,1757,809,948,85.3
21310, 기장군,070,65~69세,2018,7662,3519,4143,84.9,7633,3509,4124,85.1
21310, 기장군,070001, 65세,2018,1628,719,909,79.1,1622,718,904,79.4
21310, 기장군,070002, 66세,2018,1741,794,947,83.8,1735,792,943,84
21310, 기장군,070003, 67세,2018,1456,686,770,89.1,1450,685,765,89.5
21310, 기장군,070004, 68세,2018,1396,639,757,84.4,1390,636,754,84.4
21310, 기장군,070005, 69세,2018,1441,681,760,89.6,1436,678,758,89.4
21310, 기장군,075,70~74세,2018,5922,2729,3193,85.5,5904,2719,3185,85.4
21310, 기장군,075001, 70세,2018,1421,658,763,86.2,1419,657,762,86.2
21310, 기장군,075002, 71세,2018,1374,658,716,91.9,1370,656,714,91.9
21310, 기장군,075003, 72세,2018,1027,465,562,82.7,1022,461,561,82.2
21310, 기장군,075004, 73세,2018,1019,462,557,82.9,1016,460,556,82.7
21310, 기장군,075005, 74세,2018,1081,486,595,81.7,1077,485,592,81.9
21310, 기장군,080,75~79세,2018,4723,1969,2754,71.5,4720,1966,2754,71.4
21310, 기장군,080001, 75세,2018,1049,481,568,84.7,1048,480,568,84.5
21310, 기장군,080002, 76세,2018,1091,466,625,74.6,1091,466,625,74.6
21310, 기장군,080003, 77세,2018,874,366,508,72,873,365,508,71.9
21310, 기장군,080004, 78세,2018,851,325,526,61.8,851,325,526,61.8
21310, 기장군,080005, 79세,2018,858,331,527,62.8,857,330,527,62.6
21310, 기장군,085,80~84세,2018,2853,981,1872,52.4,2852,981,1871,52.4
21310, 기장군,085001, 80세,2018,689,249,440,56.6,689,249,440,56.6
21310, 기장군,085002, 81세,2018,639,232,407,57,639,232,407,57
21310, 기장군,085003, 82세,2018,542,189,353,53.5,541,189,352,53.7
21310, 기장군,085004, 83세,2018,522,184,338,54.4,522,184,338,54.4
21310, 기장군,085005, 84세,2018,461,127,334,38,461,127,334,38
21310, 기장군,090,85~89세,2018,1430,382,1048,36.5,1429,381,1048,36.4
21310, 기장군,090001, 85세,2018,391,104,287,36.2,391,104,287,36.2
21310, 기장군,090002, 86세,2018,360,113,247,45.7,359,112,247,45.3
21310, 기장군,090003, 87세,2018,287,79,208,38,287,79,208,38
21310, 기장군,090004, 88세,2018,227,51,176,29,227,51,176,29
21310, 기장군,090005, 89세,2018,165,35,130,26.9,165,35,130,26.9
21310, 기장군,095,90~94세,2018,472,75,397,18.9,472,75,397,18.9
21310, 기장군,095001, 90세,2018,152,35,117,29.9,152,35,117,29.9
21310, 기장군,095002, 91세,2018,123,17,106,16,123,17,106,16
21310, 기장군,095003, 92세,2018,69,13,56,23.2,69,13,56,23.2
21310, 기장군,095004, 93세,2018,79,5,74,6.8,79,5,74,6.8
21310, 기장군,095005, 94세,2018,49,5,44,11.4,49,5,44,11.4
21310, 기장군,100,95~99세,2018,128,17,111,15.3,126,15,111,13.5
21310, 기장군,100001, 95세,2018,47,6,41,14.6,47,6,41,14.6
21310, 기장군,100002, 96세,2018,36,7,29,24.1,35,6,29,20.7
21310, 기장군,100003, 97세,2018,22,X,20,10,22,X,20,10
21310, 기장군,100004, 98세,2018,16,X,14,14.3,15,X,14,7.1
21310, 기장군,100005, 99세,2018,7,X,7,0,7,X,7,0
21310, 기장군,101,100세이상,2018,13,X,13,0,13,X,13,0
21310, 기장군,102,15세미만,2018,27984,14384,13600,105.8,27947,14363,13584,105.7
21310, 기장군,103,15~64세,2018,109148,55306,53842,102.7,106657,53534,53123,100.8
21310, 기장군,104,65세이상,2018,23203,9672,13531,71.5,23149,9646,13503,71.4
21310, 기장군,086,85세이상,2018,2043,474,1569,30.2,2040,471,1569,30
21310, 기장군,126,평균연령,2018,40.4,38.9,41.8,,40.4,39,41.8,
21310, 기장군,127,중위연령,2018,40.9,39.9,42.1,,41.1,40.2,42.1,
22,대구광역시,000,합계,2018,2444412,1212777,1231635,98.5,2409132,1192938,1216194,98.1
22,대구광역시,005,0~4세,2018,89739,45833,43906,104.4,89246,45593,43653,104.4
22,대구광역시,005001, 0세,2018,14781,7484,7297,102.6,14691,7438,7253,102.6
22,대구광역시,005002, 1세,2018,16540,8551,7989,107,16420,8494,7926,107.2
22,대구광역시,005003, 2세,2018,19018,9710,9308,104.3,18911,9653,9258,104.3
22,대구광역시,005004, 3세,2018,19731,10096,9635,104.8,19643,10054,9589,104.8
22,대구광역시,005005, 4세,2018,19669,9992,9677,103.3,19581,9954,9627,103.4
22,대구광역시,010,5~9세,2018,104033,53549,50484,106.1,103736,53404,50332,106.1
22,대구광역시,010001, 5세,2018,19936,10175,9761,104.2,19864,10138,9726,104.2
22,대구광역시,010002, 6세,2018,21944,11224,10720,104.7,21888,11196,10692,104.7
22,대구광역시,010003, 7세,2018,21381,11019,10362,106.3,21319,10990,10329,106.4
22,대구광역시,010004, 8세,2018,20704,10662,10042,106.2,20659,10637,10022,106.1
22,대구광역시,010005, 9세,2018,20068,10469,9599,109.1,20006,10443,9563,109.2
22,대구광역시,015,10~14세,2018,107821,56116,51705,108.5,107604,56004,51600,108.5
22,대구광역시,015001, 10세,2018,21389,11111,10278,108.1,21342,11087,10255,108.1
22,대구광역시,015002, 11세,2018,22141,11318,10823,104.6,22091,11289,10802,104.5
22,대구광역시,015003, 12세,2018,20589,10803,9786,110.4,20555,10787,9768,110.4
22,대구광역시,015004, 13세,2018,20884,10923,9961,109.7,20842,10907,9935,109.8
22,대구광역시,015005, 14세,2018,22818,11961,10857,110.2,22774,11934,10840,110.1
22,대구광역시,020,15~19세,2018,138818,73362,65456,112.1,137675,72825,64850,112.3
22,대구광역시,020001, 15세,2018,23950,12710,11240,113.1,23920,12695,11225,113.1
22,대구광역시,020002, 16세,2018,24313,12892,11421,112.9,24259,12866,11393,112.9
22,대구광역시,020003, 17세,2018,28626,15005,13621,110.2,28550,14973,13577,110.3
22,대구광역시,020004, 18세,2018,31851,16932,14919,113.5,31606,16820,14786,113.8
22,대구광역시,020005, 19세,2018,30078,15823,14255,111,29340,15471,13869,111.6
22,대구광역시,025,20~24세,2018,171337,92437,78900,117.2,166310,89795,76515,117.4
22,대구광역시,025001, 20세,2018,31867,17032,14835,114.8,31018,16641,14377,115.7
22,대구광역시,025002, 21세,2018,34107,18160,15947,113.9,33207,17694,15513,114.1
22,대구광역시,025003, 22세,2018,35375,19207,16168,118.8,34357,18645,15712,118.7
22,대구광역시,025004, 23세,2018,35185,19004,16181,117.4,34035,18381,15654,117.4
22,대구광역시,025005, 24세,2018,34803,19034,15769,120.7,33693,18434,15259,120.8
22,대구광역시,030,25~29세,2018,160410,87897,72513,121.2,153809,84028,69781,120.4
22,대구광역시,030001, 25세,2018,34365,18947,15418,122.9,33134,18236,14898,122.4
22,대구광역시,030002, 26세,2018,34480,18879,15601,121,33218,18129,15089,120.1
22,대구광역시,030003, 27세,2018,31954,17472,14482,120.6,30610,16695,13915,120
22,대구광역시,030004, 28세,2018,30441,16683,13758,121.3,29019,15856,13163,120.5
22,대구광역시,030005, 29세,2018,29170,15916,13254,120.1,27828,15112,12716,118.8
22,대구광역시,035,30~34세,2018,140352,74752,65600,114,133980,70900,63080,112.4
22,대구광역시,035001, 30세,2018,27253,14865,12388,120,25838,14037,11801,118.9
22,대구광역시,035002, 31세,2018,27985,14919,13066,114.2,26570,14081,12489,112.7
22,대구광역시,035003, 32세,2018,27848,14978,12870,116.4,26574,14202,12372,114.8
22,대구광역시,035004, 33세,2018,27908,14761,13147,112.3,26696,14025,12671,110.7
22,대구광역시,035005, 34세,2018,29358,15229,14129,107.8,28302,14555,13747,105.9
22,대구광역시,040,35~39세,2018,180401,90566,89835,100.8,175863,87793,88070,99.7
22,대구광역시,040001, 35세,2018,33054,16759,16295,102.8,31981,16099,15882,101.4
22,대구광역시,040002, 36세,2018,36425,18265,18160,100.6,35408,17632,17776,99.2
22,대구광역시,040003, 37세,2018,36833,18534,18299,101.3,35988,18032,17956,100.4
22,대구광역시,040004, 38세,2018,38081,19091,18990,100.5,37267,18594,18673,99.6
22,대구광역시,040005, 39세,2018,36008,17917,18091,99,35219,17436,17783,98
22,대구광역시,045,40~44세,2018,181974,90588,91386,99.1,178952,88808,90144,98.5
22,대구광역시,045001, 40세,2018,33248,16702,16546,100.9,32534,16270,16264,100
22,대구광역시,045002, 41세,2018,35026,17461,17565,99.4,34384,17076,17308,98.7
22,대구광역시,045003, 42세,2018,35231,17773,17458,101.8,34651,17417,17234,101.1
22,대구광역시,045004, 43세,2018,37295,18291,19004,96.2,36767,17988,18779,95.8
22,대구광역시,045005, 44세,2018,41174,20361,20813,97.8,40616,20057,20559,97.6
22,대구광역시,050,45~49세,2018,218536,107037,111499,96,215968,105585,110383,95.7
22,대구광역시,050001, 45세,2018,41718,20343,21375,95.2,41209,20032,21177,94.6
22,대구광역시,050002, 46세,2018,42656,20995,21661,96.9,42140,20680,21460,96.4
22,대구광역시,050003, 47세,2018,45050,22200,22850,97.2,44518,21908,22610,96.9
22,대구광역시,050004, 48세,2018,44428,21722,22706,95.7,43875,21442,22433,95.6
22,대구광역시,050005, 49세,2018,44684,21777,22907,95.1,44226,21523,22703,94.8
22,대구광역시,055,50~54세,2018,211168,103557,107611,96.2,209211,102568,106643,96.2
22,대구광역시,055001, 50세,2018,45952,22624,23328,97,45504,22390,23114,96.9
22,대구광역시,055002, 51세,2018,42743,20682,22061,93.7,42353,20495,21858,93.8
22,대구광역시,055003, 52세,2018,41138,20575,20563,100.1,40768,20394,20374,100.1
22,대구광역시,055004, 53세,2018,41798,20213,21585,93.6,41412,20006,21406,93.5
22,대구광역시,055005, 54세,2018,39537,19463,20074,97,39174,19283,19891,96.9
22,대구광역시,060,55~59세,2018,215213,105143,110070,95.5,213833,104466,109367,95.5
22,대구광역시,060001, 55세,2018,41313,20437,20876,97.9,40945,20254,20691,97.9
22,대구광역시,060002, 56세,2018,43024,21299,21725,98,42705,21146,21559,98.1
22,대구광역시,060003, 57세,2018,46017,22379,23638,94.7,45829,22286,23543,94.7
22,대구광역시,060004, 58세,2018,44464,21451,23013,93.2,44179,21311,22868,93.2
22,대구광역시,060005, 59세,2018,40395,19577,20818,94,40175,19469,20706,94
22,대구광역시,065,60~64세,2018,166957,81276,85681,94.9,166103,80865,85238,94.9
22,대구광역시,065001, 60세,2018,35247,17529,17718,98.9,35040,17425,17615,98.9
22,대구광역시,065002, 61세,2018,36320,17881,18439,97,36132,17788,18344,97
22,대구광역시,065003, 62세,2018,33718,16476,17242,95.6,33566,16400,17166,95.5
22,대구광역시,065004, 63세,2018,33697,15861,17836,88.9,33550,15791,17759,88.9
22,대구광역시,065005, 64세,2018,27975,13529,14446,93.7,27815,13461,14354,93.8
22,대구광역시,070,65~69세,2018,122153,57029,65124,87.6,121687,56818,64869,87.6
22,대구광역시,070001, 65세,2018,26936,12512,14424,86.7,26802,12449,14353,86.7
22,대구광역시,070002, 66세,2018,28397,13263,15134,87.6,28285,13215,15070,87.7
22,대구광역시,070003, 67세,2018,21614,10126,11488,88.1,21526,10085,11441,88.1
22,대구광역시,070004, 68세,2018,21879,10371,11508,90.1,21817,10345,11472,90.2
22,대구광역시,070005, 69세,2018,23327,10757,12570,85.6,23257,10724,12533,85.6
22,대구광역시,075,70~74세,2018,86015,38458,47557,80.9,85850,38378,47472,80.8
22,대구광역시,075001, 70세,2018,21827,10017,11810,84.8,21789,9997,11792,84.8
22,대구광역시,075002, 71세,2018,20213,9100,11113,81.9,20178,9087,11091,81.9
22,대구광역시,075003, 72세,2018,13729,6293,7436,84.6,13688,6273,7415,84.6
22,대구광역시,075004, 73세,2018,14116,6161,7955,77.4,14090,6149,7941,77.4
22,대구광역시,075005, 74세,2018,16130,6887,9243,74.5,16105,6872,9233,74.4
22,대구광역시,080,75~79세,2018,75948,31409,44539,70.5,75864,31378,44486,70.5
22,대구광역시,080001, 75세,2018,16802,7266,9536,76.2,16785,7260,9525,76.2
22,대구광역시,080002, 76세,2018,18116,7776,10340,75.2,18105,7772,10333,75.2
22,대구광역시,080003, 77세,2018,14752,6044,8708,69.4,14723,6033,8690,69.4
22,대구광역시,080004, 78세,2018,13291,5157,8134,63.4,13279,5154,8125,63.4
22,대구광역시,080005, 79세,2018,12987,5166,7821,66.1,12972,5159,7813,66
22,대구광역시,085,80~84세,2018,46011,16550,29461,56.2,45955,16532,29423,56.2
22,대구광역시,085001, 80세,2018,11180,4232,6948,60.9,11163,4230,6933,61
22,대구광역시,085002, 81세,2018,10147,3744,6403,58.5,10136,3740,6396,58.5
22,대구광역시,085003, 82세,2018,9159,3271,5888,55.6,9148,3267,5881,55.6
22,대구광역시,085004, 83세,2018,8382,2921,5461,53.5,8374,2919,5455,53.5
22,대구광역시,085005, 84세,2018,7143,2382,4761,50,7134,2376,4758,49.9
22,대구광역시,090,85~89세,2018,20069,5627,14442,39,20038,5610,14428,38.9
22,대구광역시,090001, 85세,2018,5629,1740,3889,44.7,5615,1734,3881,44.7
22,대구광역시,090002, 86세,2018,5015,1538,3477,44.2,5009,1534,3475,44.1
22,대구광역시,090003, 87세,2018,3782,1006,2776,36.2,3779,1005,2774,36.2
22,대구광역시,090004, 88세,2018,3095,711,2384,29.8,3090,707,2383,29.7
22,대구광역시,090005, 89세,2018,2548,632,1916,33,2545,630,1915,32.9
22,대구광역시,095,90~94세,2018,6096,1333,4763,28,6089,1331,4758,28
22,대구광역시,095001, 90세,2018,2058,491,1567,31.3,2056,490,1566,31.3
22,대구광역시,095002, 91세,2018,1636,366,1270,28.8,1634,365,1269,28.8
22,대구광역시,095003, 92세,2018,964,198,766,25.8,963,198,765,25.9
22,대구광역시,095004, 93세,2018,888,182,706,25.8,886,182,704,25.9
22,대구광역시,095005, 94세,2018,550,96,454,21.1,550,96,454,21.1
22,대구광역시,100,95~99세,2018,1226,241,985,24.5,1226,241,985,24.5
22,대구광역시,100001, 95세,2018,439,92,347,26.5,439,92,347,26.5
22,대구광역시,100002, 96세,2018,333,69,264,26.1,333,69,264,26.1
22,대구광역시,100003, 97세,2018,217,38,179,21.2,217,38,179,21.2
22,대구광역시,100004, 98세,2018,150,25,125,20,150,25,125,20
22,대구광역시,100005, 99세,2018,87,17,70,24.3,87,17,70,24.3
22,대구광역시,101,100세이상,2018,135,17,118,14.4,133,16,117,13.7
22,대구광역시,102,15세미만,2018,301593,155498,146095,106.4,300586,155001,145585,106.5
22,대구광역시,103,15~64세,2018,1785166,906615,878551,103.2,1751704,887633,864071,102.7
22,대구광역시,104,65세이상,2018,357653,150664,206989,72.8,356842,150304,206538,72.8
22,대구광역시,086,85세이상,2018,27526,7218,20308,35.5,27486,7198,20288,35.5
22,대구광역시,126,평균연령,2018,42.1,40.7,43.5,,42.2,40.8,43.6,
22,대구광역시,127,중위연령,2018,43.7,41.9,45.3,,43.9,42.2,45.5,
22004, 읍부,000,합계,2018,229433,117229,112204,104.5,223123,113224,109899,103
22004, 읍부,005,0~4세,2018,14637,7358,7279,101.1,14525,7316,7209,101.5
22004, 읍부,005001, 0세,2018,2689,1345,1344,100.1,2667,1336,1331,100.4
22004, 읍부,005002, 1세,2018,2821,1410,1411,99.9,2796,1399,1397,100.1
22004, 읍부,005003, 2세,2018,3135,1573,1562,100.7,3112,1563,1549,100.9
22004, 읍부,005004, 3세,2018,3055,1536,1519,101.1,3034,1531,1503,101.9
22004, 읍부,005005, 4세,2018,2937,1494,1443,103.5,2916,1487,1429,104.1
22004, 읍부,010,5~9세,2018,13576,6954,6622,105,13495,6910,6585,104.9
22004, 읍부,010001, 5세,2018,2865,1503,1362,110.4,2846,1491,1355,110
22004, 읍부,010002, 6세,2018,2961,1499,1462,102.5,2950,1496,1454,102.9
22004, 읍부,010003, 7세,2018,2831,1436,1395,102.9,2806,1423,1383,102.9
22004, 읍부,010004, 8세,2018,2579,1325,1254,105.7,2570,1317,1253,105.1
22004, 읍부,010005, 9세,2018,2340,1191,1149,103.7,2323,1183,1140,103.8
22004, 읍부,015,10~14세,2018,10783,5588,5195,107.6,10720,5557,5163,107.6
22004, 읍부,015001, 10세,2018,2396,1259,1137,110.7,2382,1250,1132,110.4
22004, 읍부,015002, 11세,2018,2279,1141,1138,100.3,2266,1136,1130,100.5
22004, 읍부,015003, 12세,2018,2012,1067,945,112.9,1997,1061,936,113.4
22004, 읍부,015004, 13세,2018,2073,1082,991,109.2,2059,1076,983,109.5
22004, 읍부,015005, 14세,2018,2023,1039,984,105.6,2016,1034,982,105.3
22004, 읍부,020,15~19세,2018,10948,5919,5029,117.7,10888,5889,4999,117.8
22004, 읍부,020001, 15세,2018,2121,1152,969,118.9,2110,1146,964,118.9
22004, 읍부,020002, 16세,2018,2063,1113,950,117.2,2056,1108,948,116.9
22004, 읍부,020003, 17세,2018,2362,1238,1124,110.1,2353,1232,1121,109.9
22004, 읍부,020004, 18세,2018,2349,1242,1107,112.2,2333,1236,1097,112.7
22004, 읍부,020005, 19세,2018,2053,1174,879,133.6,2036,1167,869,134.3
22004, 읍부,025,20~24세,2018,12928,7427,5501,135,12411,7116,5295,134.4
22004, 읍부,025001, 20세,2018,2408,1429,979,146,2372,1413,959,147.3
22004, 읍부,025002, 21세,2018,2655,1535,1120,137.1,2574,1497,1077,139
22004, 읍부,025003, 22세,2018,2632,1529,1103,138.6,2523,1463,1060,138
22004, 읍부,025004, 23세,2018,2620,1489,1131,131.7,2478,1395,1083,128.8
22004, 읍부,025005, 24세,2018,2613,1445,1168,123.7,2464,1348,1116,120.8
22004, 읍부,030,25~29세,2018,15081,8349,6732,124,13855,7493,6362,117.8
22004, 읍부,030001, 25세,2018,2794,1590,1204,132.1,2618,1463,1155,126.7
22004, 읍부,030002, 26세,2018,3035,1654,1381,119.8,2809,1497,1312,114.1
22004, 읍부,030003, 27세,2018,3008,1689,1319,128.1,2732,1498,1234,121.4
22004, 읍부,030004, 28세,2018,3076,1678,1398,120,2815,1504,1311,114.7
22004, 읍부,030005, 29세,2018,3168,1738,1430,121.5,2881,1531,1350,113.4
22004, 읍부,035,30~34세,2018,18262,9670,8592,112.5,16950,8750,8200,106.7
22004, 읍부,035001, 30세,2018,3241,1743,1498,116.4,2961,1546,1415,109.3
22004, 읍부,035002, 31세,2018,3513,1818,1695,107.3,3229,1623,1606,101.1
22004, 읍부,035003, 32세,2018,3701,1994,1707,116.8,3438,1806,1632,110.7
22004, 읍부,035004, 33세,2018,3799,1993,1806,110.4,3553,1828,1725,106
22004, 읍부,035005, 34세,2018,4008,2122,1886,112.5,3769,1947,1822,106.9
22004, 읍부,040,35~39세,2018,23812,12277,11535,106.4,22859,11642,11217,103.8
22004, 읍부,040001, 35세,2018,4585,2310,2275,101.5,4357,2157,2200,98
22004, 읍부,040002, 36세,2018,4971,2555,2416,105.8,4750,2399,2351,102
22004, 읍부,040003, 37세,2018,4857,2525,2332,108.3,4680,2417,2263,106.8
22004, 읍부,040004, 38세,2018,4987,2578,2409,107,4817,2469,2348,105.2
22004, 읍부,040005, 39세,2018,4412,2309,2103,109.8,4255,2200,2055,107.1
22004, 읍부,045,40~44세,2018,19425,10300,9125,112.9,18818,9910,8908,111.2
22004, 읍부,045001, 40세,2018,3948,2072,1876,110.4,3779,1960,1819,107.8
22004, 읍부,045002, 41세,2018,4010,2139,1871,114.3,3881,2061,1820,113.2
22004, 읍부,045003, 42세,2018,3689,1981,1708,116,3578,1908,1670,114.3
22004, 읍부,045004, 43세,2018,3796,1994,1802,110.7,3698,1929,1769,109
22004, 읍부,045005, 44세,2018,3982,2114,1868,113.2,3882,2052,1830,112.1
22004, 읍부,050,45~49세,2018,18795,9559,9236,103.5,18310,9274,9036,102.6
22004, 읍부,050001, 45세,2018,3747,1945,1802,107.9,3651,1889,1762,107.2
22004, 읍부,050002, 46세,2018,3761,1977,1784,110.8,3651,1904,1747,109
22004, 읍부,050003, 47세,2018,3819,1968,1851,106.3,3724,1918,1806,106.2
22004, 읍부,050004, 48세,2018,3733,1869,1864,100.3,3637,1818,1819,99.9
22004, 읍부,050005, 49세,2018,3735,1800,1935,93,3647,1745,1902,91.7
22004, 읍부,055,50~54세,2018,17687,8726,8961,97.4,17297,8516,8781,97
22004, 읍부,055001, 50세,2018,3809,1874,1935,96.8,3723,1831,1892,96.8
22004, 읍부,055002, 51세,2018,3586,1738,1848,94,3507,1703,1804,94.4
22004, 읍부,055003, 52세,2018,3484,1739,1745,99.7,3411,1695,1716,98.8
22004, 읍부,055004, 53세,2018,3539,1724,1815,95,3458,1675,1783,93.9
22004, 읍부,055005, 54세,2018,3269,1651,1618,102,3198,1612,1586,101.6
22004, 읍부,060,55~59세,2018,17777,8883,8894,99.9,17533,8760,8773,99.9
22004, 읍부,060001, 55세,2018,3406,1689,1717,98.4,3346,1660,1686,98.5
22004, 읍부,060002, 56세,2018,3716,1866,1850,100.9,3665,1840,1825,100.8
22004, 읍부,060003, 57세,2018,3861,1938,1923,100.8,3822,1921,1901,101.1
22004, 읍부,060004, 58세,2018,3536,1751,1785,98.1,3480,1722,1758,98
22004, 읍부,060005, 59세,2018,3258,1639,1619,101.2,3220,1617,1603,100.9
22004, 읍부,065,60~64세,2018,12633,6320,6313,100.1,12493,6240,6253,99.8
22004, 읍부,065001, 60세,2018,2838,1428,1410,101.3,2806,1409,1397,100.9
22004, 읍부,065002, 61세,2018,2817,1430,1387,103.1,2777,1407,1370,102.7
22004, 읍부,065003, 62세,2018,2572,1306,1266,103.2,2549,1291,1258,102.6
22004, 읍부,065004, 63세,2018,2444,1174,1270,92.4,2418,1161,1257,92.4
22004, 읍부,065005, 64세,2018,1962,982,980,100.2,1943,972,971,100.1
22004, 읍부,070,65~69세,2018,8562,4189,4373,95.8,8486,4157,4329,96
22004, 읍부,070001, 65세,2018,1911,926,985,94,1889,917,972,94.3
22004, 읍부,070002, 66세,2018,2043,1011,1032,98,2023,1003,1020,98.3
22004, 읍부,070003, 67세,2018,1523,751,772,97.3,1508,744,764,97.4
22004, 읍부,070004, 68세,2018,1521,750,771,97.3,1511,746,765,97.5
22004, 읍부,070005, 69세,2018,1564,751,813,92.4,1555,747,808,92.5
22004, 읍부,075,70~74세,2018,5471,2585,2886,89.6,5446,2572,2874,89.5
22004, 읍부,075001, 70세,2018,1424,688,736,93.5,1419,684,735,93.1
22004, 읍부,075002, 71세,2018,1282,605,677,89.4,1278,605,673,89.9
22004, 읍부,075003, 72세,2018,914,450,464,97,904,445,459,96.9
22004, 읍부,075004, 73세,2018,865,397,468,84.8,862,395,467,84.6
22004, 읍부,075005, 74세,2018,986,445,541,82.3,983,443,540,82
22004, 읍부,080,75~79세,2018,4554,1766,2788,63.3,4546,1765,2781,63.5
22004, 읍부,080001, 75세,2018,1006,421,585,72,1004,421,583,72.2
22004, 읍부,080002, 76세,2018,1087,446,641,69.6,1085,446,639,69.8
22004, 읍부,080003, 77세,2018,894,342,552,62,892,341,551,61.9
22004, 읍부,080004, 78세,2018,794,275,519,53,793,275,518,53.1
22004, 읍부,080005, 79세,2018,773,282,491,57.4,772,282,490,57.6
22004, 읍부,085,80~84세,2018,2819,936,1883,49.7,2811,934,1877,49.8
22004, 읍부,085001, 80세,2018,707,251,456,55,703,251,452,55.5
22004, 읍부,085002, 81세,2018,620,215,405,53.1,618,214,404,53
22004, 읍부,085003, 82세,2018,531,180,351,51.3,529,179,350,51.1
22004, 읍부,085004, 83세,2018,514,157,357,44,514,157,357,44
22004, 읍부,085005, 84세,2018,447,133,314,42.4,447,133,314,42.4
22004, 읍부,090,85~89세,2018,1248,334,914,36.5,1246,334,912,36.6
22004, 읍부,090001, 85세,2018,340,104,236,44.1,339,104,235,44.3
22004, 읍부,090002, 86세,2018,310,91,219,41.6,310,91,219,41.6
22004, 읍부,090003, 87세,2018,247,71,176,40.3,247,71,176,40.3
22004, 읍부,090004, 88세,2018,201,37,164,22.6,201,37,164,22.6
22004, 읍부,090005, 89세,2018,150,31,119,26.1,149,31,118,26.3
22004, 읍부,095,90~94세,2018,358,71,287,24.7,357,71,286,24.8
22004, 읍부,095001, 90세,2018,107,23,84,27.4,107,23,84,27.4
22004, 읍부,095002, 91세,2018,109,20,89,22.5,108,20,88,22.7
22004, 읍부,095003, 92세,2018,61,11,50,22,61,11,50,22
22004, 읍부,095004, 93세,2018,53,12,41,29.3,53,12,41,29.3
22004, 읍부,095005, 94세,2018,28,5,23,21.7,28,5,23,21.7
22004, 읍부,100,95~99세,2018,69,17,52,32.7,69,17,52,32.7
22004, 읍부,100001, 95세,2018,27,5,22,22.7,27,5,22,22.7
22004, 읍부,100002, 96세,2018,22,9,13,69.2,22,9,13,69.2
22004, 읍부,100003, 97세,2018,11,X,9,22.2,11,X,9,22.2
22004, 읍부,100004, 98세,2018,5,X,5,0,5,X,5,0
22004, 읍부,100005, 99세,2018,X,X,X,33.3,X,X,X,33.3
22004, 읍부,101,100세이상,2018,8,X,7,14.3,8,X,7,14.3
22004, 읍부,102,15세미만,2018,38996,19900,19096,104.2,38740,19783,18957,104.4
22004, 읍부,103,15~64세,2018,167348,87430,79918,109.4,161414,83590,77824,107.4
22004, 읍부,104,65세이상,2018,23089,9899,13190,75,22969,9851,13118,75.1
22004, 읍부,086,85세이상,2018,1683,423,1260,33.6,1680,423,1257,33.7
22004, 읍부,126,평균연령,2018,38.4,37.4,39.5,,38.5,37.5,39.5,
22004, 읍부,127,중위연령,2018,38.8,38,39.8,,39,38.2,40,
22005, 면부,000,합계,2018,21320,11240,10080,111.5,19886,10081,9805,102.8
22005, 면부,005,0~4세,2018,897,427,470,90.9,874,419,455,92.1
22005, 면부,005001, 0세,2018,165,84,81,103.7,158,81,77,105.2
22005, 면부,005002, 1세,2018,174,89,85,104.7,167,86,81,106.2
22005, 면부,005003, 2세,2018,186,88,98,89.8,184,88,96,91.7
22005, 면부,005004, 3세,2018,181,86,95,90.5,179,85,94,90.4
22005, 면부,005005, 4세,2018,191,80,111,72.1,186,79,107,73.8
22005, 면부,010,5~9세,2018,861,429,432,99.3,852,425,427,99.5
22005, 면부,010001, 5세,2018,172,75,97,77.3,168,74,94,78.7
22005, 면부,010002, 6세,2018,191,102,89,114.6,190,101,89,113.5
22005, 면부,010003, 7세,2018,197,103,94,109.6,196,102,94,108.5
22005, 면부,010004, 8세,2018,164,84,80,105,164,84,80,105
22005, 면부,010005, 9세,2018,137,65,72,90.3,134,64,70,91.4
22005, 면부,015,10~14세,2018,549,264,285,92.6,547,263,284,92.6
22005, 면부,015001, 10세,2018,129,67,62,108.1,129,67,62,108.1
22005, 면부,015002, 11세,2018,142,67,75,89.3,141,67,74,90.5
22005, 면부,015003, 12세,2018,100,53,47,112.8,100,53,47,112.8
22005, 면부,015004, 13세,2018,93,43,50,86,93,43,50,86
22005, 면부,015005, 14세,2018,85,34,51,66.7,84,33,51,64.7
22005, 면부,020,15~19세,2018,654,405,249,162.7,648,401,247,162.3
22005, 면부,020001, 15세,2018,102,59,43,137.2,101,59,42,140.5
22005, 면부,020002, 16세,2018,102,63,39,161.5,102,63,39,161.5
22005, 면부,020003, 17세,2018,178,105,73,143.8,178,105,73,143.8
22005, 면부,020004, 18세,2018,179,110,69,159.4,178,110,68,161.8
22005, 면부,020005, 19세,2018,93,68,25,272,89,64,25,256
22005, 면부,025,20~24세,2018,904,580,324,179,767,463,304,152.3
22005, 면부,025001, 20세,2018,131,79,52,151.9,122,73,49,149
22005, 면부,025002, 21세,2018,162,101,61,165.6,145,87,58,150
22005, 면부,025003, 22세,2018,206,139,67,207.5,179,113,66,171.2
22005, 면부,025004, 23세,2018,210,132,78,169.2,164,95,69,137.7
22005, 면부,025005, 24세,2018,195,129,66,195.5,157,95,62,153.2
22005, 면부,030,25~29세,2018,1417,932,485,192.2,1053,623,430,144.9
22005, 면부,030001, 25세,2018,262,168,94,178.7,201,115,86,133.7
22005, 면부,030002, 26세,2018,270,169,101,167.3,202,110,92,119.6
22005, 면부,030003, 27세,2018,278,181,97,186.6,199,112,87,128.7
22005, 면부,030004, 28세,2018,300,199,101,197,224,138,86,160.5
22005, 면부,030005, 29세,2018,307,215,92,233.7,227,148,79,187.3
22005, 면부,035,30~34세,2018,1673,1068,605,176.5,1289,743,546,136.1
22005, 면부,035001, 30세,2018,325,209,116,180.2,222,123,99,124.2
22005, 면부,035002, 31세,2018,336,217,119,182.4,254,155,99,156.6
22005, 면부,035003, 32세,2018,335,202,133,151.9,261,138,123,112.2
22005, 면부,035004, 33세,2018,340,219,121,181,277,162,115,140.9
22005, 면부,035005, 34세,2018,337,221,116,190.5,275,165,110,150
22005, 면부,040,35~39세,2018,1741,1039,702,148,1505,840,665,126.3
22005, 면부,040001, 35세,2018,347,215,132,162.9,288,163,125,130.4
22005, 면부,040002, 36세,2018,357,208,149,139.6,317,173,144,120.1
22005, 면부,040003, 37세,2018,369,230,139,165.5,319,188,131,143.5
22005, 면부,040004, 38세,2018,336,203,133,152.6,287,164,123,133.3
22005, 면부,040005, 39세,2018,332,183,149,122.8,294,152,142,107
22005, 면부,045,40~44세,2018,1293,798,495,161.2,1195,719,476,151.1
22005, 면부,045001, 40세,2018,312,188,124,151.6,280,162,118,137.3
22005, 면부,045002, 41세,2018,247,152,95,160,228,137,91,150.5
22005, 면부,045003, 42세,2018,236,155,81,191.4,225,145,80,181.3
22005, 면부,045004, 43세,2018,248,149,99,150.5,230,134,96,139.6
22005, 면부,045005, 44세,2018,250,154,96,160.4,232,141,91,154.9
22005, 면부,050,45~49세,2018,1351,757,594,127.4,1270,698,572,122
22005, 면부,050001, 45세,2018,257,149,108,138,232,127,105,121
22005, 면부,050002, 46세,2018,259,147,112,131.3,246,137,109,125.7
22005, 면부,050003, 47세,2018,260,144,116,124.1,244,133,111,119.8
22005, 면부,050004, 48세,2018,314,176,138,127.5,297,167,130,128.5
22005, 면부,050005, 49세,2018,261,141,120,117.5,251,134,117,114.5
22005, 면부,055,50~54세,2018,1438,778,660,117.9,1402,756,646,117
22005, 면부,055001, 50세,2018,286,154,132,116.7,274,146,128,114.1
22005, 면부,055002, 51세,2018,272,148,124,119.4,266,144,122,118
22005, 면부,055003, 52세,2018,296,149,147,101.4,288,144,144,100
22005, 면부,055004, 53세,2018,282,155,127,122,277,152,125,121.6
22005, 면부,055005, 54세,2018,302,172,130,132.3,297,170,127,133.9
22005, 면부,060,55~59세,2018,1781,873,908,96.1,1758,861,897,96
22005, 면부,060001, 55세,2018,307,148,159,93.1,299,146,153,95.4
22005, 면부,060002, 56세,2018,338,181,157,115.3,331,177,154,114.9
22005, 면부,060003, 57세,2018,367,175,192,91.1,364,173,191,90.6
22005, 면부,060004, 58세,2018,382,179,203,88.2,380,178,202,88.1
22005, 면부,060005, 59세,2018,387,190,197,96.4,384,187,197,94.9
22005, 면부,065,60~64세,2018,1657,832,825,100.8,1637,822,815,100.9
22005, 면부,065001, 60세,2018,338,171,167,102.4,335,168,167,100.6
22005, 면부,065002, 61세,2018,334,167,167,100,326,162,164,98.8
22005, 면부,065003, 62세,2018,342,174,168,103.6,338,173,165,104.8
22005, 면부,065004, 63세,2018,348,170,178,95.5,344,169,175,96.6
22005, 면부,065005, 64세,2018,295,150,145,103.4,294,150,144,104.2
22005, 면부,070,65~69세,2018,1332,653,679,96.2,1322,645,677,95.3
22005, 면부,070001, 65세,2018,270,130,140,92.9,266,126,140,90
22005, 면부,070002, 66세,2018,315,139,176,79,315,139,176,79
22005, 면부,070003, 67세,2018,228,110,118,93.2,225,107,118,90.7
22005, 면부,070004, 68세,2018,262,129,133,97,260,129,131,98.5
22005, 면부,070005, 69세,2018,257,145,112,129.5,256,144,112,128.6
22005, 면부,075,70~74세,2018,1002,499,503,99.2,999,497,502,99
22005, 면부,075001, 70세,2018,246,132,114,115.8,244,130,114,114
22005, 면부,075002, 71세,2018,234,115,119,96.6,233,115,118,97.5
22005, 면부,075003, 72세,2018,134,61,73,83.6,134,61,73,83.6
22005, 면부,075004, 73세,2018,179,85,94,90.4,179,85,94,90.4
22005, 면부,075005, 74세,2018,209,106,103,102.9,209,106,103,102.9
22005, 면부,080,75~79세,2018,1058,379,679,55.8,1057,379,678,55.9
22005, 면부,080001, 75세,2018,189,74,115,64.3,189,74,115,64.3
22005, 면부,080002, 76세,2018,231,90,141,63.8,231,90,141,63.8
22005, 면부,080003, 77세,2018,214,77,137,56.2,213,77,136,56.6
22005, 면부,080004, 78세,2018,198,60,138,43.5,198,60,138,43.5
22005, 면부,080005, 79세,2018,226,78,148,52.7,226,78,148,52.7
22005, 면부,085,80~84세,2018,910,303,607,49.9,909,303,606,50
22005, 면부,085001, 80세,2018,184,71,113,62.8,183,71,112,63.4
22005, 면부,085002, 81세,2018,200,70,130,53.8,200,70,130,53.8
22005, 면부,085003, 82세,2018,164,58,106,54.7,164,58,106,54.7
22005, 면부,085004, 83세,2018,183,57,126,45.2,183,57,126,45.2
22005, 면부,085005, 84세,2018,179,47,132,35.6,179,47,132,35.6
22005, 면부,090,85~89세,2018,551,158,393,40.2,551,158,393,40.2
22005, 면부,090001, 85세,2018,130,38,92,41.3,130,38,92,41.3
22005, 면부,090002, 86세,2018,139,49,90,54.4,139,49,90,54.4
22005, 면부,090003, 87세,2018,121,31,90,34.4,121,31,90,34.4
22005, 면부,090004, 88세,2018,87,22,65,33.8,87,22,65,33.8
22005, 면부,090005, 89세,2018,74,18,56,32.1,74,18,56,32.1
22005, 면부,095,90~94세,2018,203,56,147,38.1,203,56,147,38.1
22005, 면부,095001, 90세,2018,71,22,49,44.9,71,22,49,44.9
22005, 면부,095002, 91세,2018,47,13,34,38.2,47,13,34,38.2
22005, 면부,095003, 92세,2018,42,11,31,35.5,42,11,31,35.5
22005, 면부,095004, 93세,2018,29,X,25,16,29,X,25,16
22005, 면부,095005, 94세,2018,14,6,8,75,14,6,8,75
22005, 면부,100,95~99세,2018,45,10,35,28.6,45,10,35,28.6
22005, 면부,100001, 95세,2018,17,X,15,13.3,17,X,15,13.3
22005, 면부,100002, 96세,2018,9,X,7,28.6,9,X,7,28.6
22005, 면부,100003, 97세,2018,8,X,6,33.3,8,X,6,33.3
22005, 면부,100004, 98세,2018,7,X,5,40,7,X,5,40
22005, 면부,100005, 99세,2018,X,X,X,100,X,X,X,100
22005, 면부,101,100세이상,2018,X,X,X,0,X,X,X,0
22005, 면부,102,15세미만,2018,2307,1120,1187,94.4,2273,1107,1166,94.9
22005, 면부,103,15~64세,2018,13909,8062,5847,137.9,12524,6926,5598,123.7
22005, 면부,104,65세이상,2018,5104,2058,3046,67.6,5089,2048,3041,67.3
22005, 면부,086,85세이상,2018,802,224,578,38.8,802,224,578,38.8
22005, 면부,126,평균연령,2018,46.8,44,49.9,,47.7,45.2,50.3,
22005, 면부,127,중위연령,2018,47.6,42.9,53,,49.8,46.1,53.8,
22003, 동부,000,합계,2018,2193659,1084308,1109351,97.7,2166123,1069633,1096490,97.6
22003, 동부,005,0~4세,2018,74205,38048,36157,105.2,73847,37858,35989,105.2
22003, 동부,005001, 0세,2018,11927,6055,5872,103.1,11866,6021,5845,103
22003, 동부,005002, 1세,2018,13545,7052,6493,108.6,13457,7009,6448,108.7
22003, 동부,005003, 2세,2018,15697,8049,7648,105.2,15615,8002,7613,105.1
22003, 동부,005004, 3세,2018,16495,8474,8021,105.6,16430,8438,7992,105.6
22003, 동부,005005, 4세,2018,16541,8418,8123,103.6,16479,8388,8091,103.7
22003, 동부,010,5~9세,2018,89596,46166,43430,106.3,89389,46069,43320,106.3
22003, 동부,010001, 5세,2018,16899,8597,8302,103.6,16850,8573,8277,103.6
22003, 동부,010002, 6세,2018,18792,9623,9169,105,18748,9599,9149,104.9
22003, 동부,010003, 7세,2018,18353,9480,8873,106.8,18317,9465,8852,106.9
22003, 동부,010004, 8세,2018,17961,9253,8708,106.3,17925,9236,8689,106.3
22003, 동부,010005, 9세,2018,17591,9213,8378,110,17549,9196,8353,110.1
22003, 동부,015,10~14세,2018,96489,50264,46225,108.7,96337,50184,46153,108.7
22003, 동부,015001, 10세,2018,18864,9785,9079,107.8,18831,9770,9061,107.8
22003, 동부,015002, 11세,2018,19720,10110,9610,105.2,19684,10086,9598,105.1
22003, 동부,015003, 12세,2018,18477,9683,8794,110.1,18458,9673,8785,110.1
22003, 동부,015004, 13세,2018,18718,9798,8920,109.8,18690,9788,8902,110
22003, 동부,015005, 14세,2018,20710,10888,9822,110.9,20674,10867,9807,110.8
22003, 동부,020,15~19세,2018,127216,67038,60178,111.4,126139,66535,59604,111.6
22003, 동부,020001, 15세,2018,21727,11499,10228,112.4,21709,11490,10219,112.4
22003, 동부,020002, 16세,2018,22148,11716,10432,112.3,22101,11695,10406,112.4
22003, 동부,020003, 17세,2018,26086,13662,12424,110,26019,13636,12383,110.1
22003, 동부,020004, 18세,2018,29323,15580,13743,113.4,29095,15474,13621,113.6
22003, 동부,020005, 19세,2018,27932,14581,13351,109.2,27215,14240,12975,109.7
22003, 동부,025,20~24세,2018,157505,84430,73075,115.5,153132,82216,70916,115.9
22003, 동부,025001, 20세,2018,29328,15524,13804,112.5,28524,15155,13369,113.4
22003, 동부,025002, 21세,2018,31290,16524,14766,111.9,30488,16110,14378,112
22003, 동부,025003, 22세,2018,32537,17539,14998,116.9,31655,17069,14586,117
22003, 동부,025004, 23세,2018,32355,17383,14972,116.1,31393,16891,14502,116.5
22003, 동부,025005, 24세,2018,31995,17460,14535,120.1,31072,16991,14081,120.7
22003, 동부,030,25~29세,2018,143912,78616,65296,120.4,138901,75912,62989,120.5
22003, 동부,030001, 25세,2018,31309,17189,14120,121.7,30315,16658,13657,122
22003, 동부,030002, 26세,2018,31175,17056,14119,120.8,30207,16522,13685,120.7
22003, 동부,030003, 27세,2018,28668,15602,13066,119.4,27679,15085,12594,119.8
22003, 동부,030004, 28세,2018,27065,14806,12259,120.8,25980,14214,11766,120.8
22003, 동부,030005, 29세,2018,25695,13963,11732,119,24720,13433,11287,119
22003, 동부,035,30~34세,2018,120417,64014,56403,113.5,115741,61407,54334,113
22003, 동부,035001, 30세,2018,23687,12913,10774,119.9,22655,12368,10287,120.2
22003, 동부,035002, 31세,2018,24136,12884,11252,114.5,23087,12303,10784,114.1
22003, 동부,035003, 32세,2018,23812,12782,11030,115.9,22875,12258,10617,115.5
22003, 동부,035004, 33세,2018,23769,12549,11220,111.8,22866,12035,10831,111.1
22003, 동부,035005, 34세,2018,25013,12886,12127,106.3,24258,12443,11815,105.3
22003, 동부,040,35~39세,2018,154848,77250,77598,99.6,151499,75311,76188,98.8
22003, 동부,040001, 35세,2018,28122,14234,13888,102.5,27336,13779,13557,101.6
22003, 동부,040002, 36세,2018,31097,15502,15595,99.4,30341,15060,15281,98.6
22003, 동부,040003, 37세,2018,31607,15779,15828,99.7,30989,15427,15562,99.1
22003, 동부,040004, 38세,2018,32758,16310,16448,99.2,32163,15961,16202,98.5
22003, 동부,040005, 39세,2018,31264,15425,15839,97.4,30670,15084,15586,96.8
22003, 동부,045,40~44세,2018,161256,79490,81766,97.2,158939,78179,80760,96.8
22003, 동부,045001, 40세,2018,28988,14442,14546,99.3,28475,14148,14327,98.8
22003, 동부,045002, 41세,2018,30769,15170,15599,97.2,30275,14878,15397,96.6
22003, 동부,045003, 42세,2018,31306,15637,15669,99.8,30848,15364,15484,99.2
22003, 동부,045004, 43세,2018,33251,16148,17103,94.4,32839,15925,16914,94.2
22003, 동부,045005, 44세,2018,36942,18093,18849,96,36502,17864,18638,95.8
22003, 동부,050,45~49세,2018,198390,96721,101669,95.1,196388,95613,100775,94.9
22003, 동부,050001, 45세,2018,37714,18249,19465,93.8,37326,18016,19310,93.3
22003, 동부,050002, 46세,2018,38636,18871,19765,95.5,38243,18639,19604,95.1
22003, 동부,050003, 47세,2018,40971,20088,20883,96.2,40550,19857,20693,96
22003, 동부,050004, 48세,2018,40381,19677,20704,95,39941,19457,20484,95
22003, 동부,050005, 49세,2018,40688,19836,20852,95.1,40328,19644,20684,95
22003, 동부,055,50~54세,2018,192043,94053,97990,96,190512,93296,97216,96
22003, 동부,055001, 50세,2018,41857,20596,21261,96.9,41507,20413,21094,96.8
22003, 동부,055002, 51세,2018,38885,18796,20089,93.6,38580,18648,19932,93.6
22003, 동부,055003, 52세,2018,37358,18687,18671,100.1,37069,18555,18514,100.2
22003, 동부,055004, 53세,2018,37977,18334,19643,93.3,37677,18179,19498,93.2
22003, 동부,055005, 54세,2018,35966,17640,18326,96.3,35679,17501,18178,96.3
22003, 동부,060,55~59세,2018,195655,95387,100268,95.1,194542,94845,99697,95.1
22003, 동부,060001, 55세,2018,37600,18600,19000,97.9,37300,18448,18852,97.9
22003, 동부,060002, 56세,2018,38970,19252,19718,97.6,38709,19129,19580,97.7
22003, 동부,060003, 57세,2018,41789,20266,21523,94.2,41643,20192,21451,94.1
22003, 동부,060004, 58세,2018,40546,19521,21025,92.8,40319,19411,20908,92.8
22003, 동부,060005, 59세,2018,36750,17748,19002,93.4,36571,17665,18906,93.4
22003, 동부,065,60~64세,2018,152667,74124,78543,94.4,151973,73803,78170,94.4
22003, 동부,065001, 60세,2018,32071,15930,16141,98.7,31899,15848,16051,98.7
22003, 동부,065002, 61세,2018,33169,16284,16885,96.4,33029,16219,16810,96.5
22003, 동부,065003, 62세,2018,30804,14996,15808,94.9,30679,14936,15743,94.9
22003, 동부,065004, 63세,2018,30905,14517,16388,88.6,30788,14461,16327,88.6
22003, 동부,065005, 64세,2018,25718,12397,13321,93.1,25578,12339,13239,93.2
22003, 동부,070,65~69세,2018,112259,52187,60072,86.9,111879,52016,59863,86.9
22003, 동부,070001, 65세,2018,24755,11456,13299,86.1,24647,11406,13241,86.1
22003, 동부,070002, 66세,2018,26039,12113,13926,87,25947,12073,13874,87
22003, 동부,070003, 67세,2018,19863,9265,10598,87.4,19793,9234,10559,87.5
22003, 동부,070004, 68세,2018,20096,9492,10604,89.5,20046,9470,10576,89.5
22003, 동부,070005, 69세,2018,21506,9861,11645,84.7,21446,9833,11613,84.7
22003, 동부,075,70~74세,2018,79542,35374,44168,80.1,79405,35309,44096,80.1
22003, 동부,075001, 70세,2018,20157,9197,10960,83.9,20126,9183,10943,83.9
22003, 동부,075002, 71세,2018,18697,8380,10317,81.2,18667,8367,10300,81.2
22003, 동부,075003, 72세,2018,12681,5782,6899,83.8,12650,5767,6883,83.8
22003, 동부,075004, 73세,2018,13072,5679,7393,76.8,13049,5669,7380,76.8
22003, 동부,075005, 74세,2018,14935,6336,8599,73.7,14913,6323,8590,73.6
22003, 동부,080,75~79세,2018,70336,29264,41072,71.3,70261,29234,41027,71.3
22003, 동부,080001, 75세,2018,15607,6771,8836,76.6,15592,6765,8827,76.6
22003, 동부,080002, 76세,2018,16798,7240,9558,75.7,16789,7236,9553,75.7
22003, 동부,080003, 77세,2018,13644,5625,8019,70.1,13618,5615,8003,70.2
22003, 동부,080004, 78세,2018,12299,4822,7477,64.5,12288,4819,7469,64.5
22003, 동부,080005, 79세,2018,11988,4806,7182,66.9,11974,4799,7175,66.9
22003, 동부,085,80~84세,2018,42282,15311,26971,56.8,42235,15295,26940,56.8
22003, 동부,085001, 80세,2018,10289,3910,6379,61.3,10277,3908,6369,61.4
22003, 동부,085002, 81세,2018,9327,3459,5868,58.9,9318,3456,5862,59
22003, 동부,085003, 82세,2018,8464,3033,5431,55.8,8455,3030,5425,55.9
22003, 동부,085004, 83세,2018,7685,2707,4978,54.4,7677,2705,4972,54.4
22003, 동부,085005, 84세,2018,6517,2202,4315,51,6508,2196,4312,50.9
22003, 동부,090,85~89세,2018,18270,5135,13135,39.1,18241,5118,13123,39
22003, 동부,090001, 85세,2018,5159,1598,3561,44.9,5146,1592,3554,44.8
22003, 동부,090002, 86세,2018,4566,1398,3168,44.1,4560,1394,3166,44
22003, 동부,090003, 87세,2018,3414,904,2510,36,3411,903,2508,36
22003, 동부,090004, 88세,2018,2807,652,2155,30.3,2802,648,2154,30.1
22003, 동부,090005, 89세,2018,2324,583,1741,33.5,2322,581,1741,33.4
22003, 동부,095,90~94세,2018,5535,1206,4329,27.9,5529,1204,4325,27.8
22003, 동부,095001, 90세,2018,1880,446,1434,31.1,1878,445,1433,31.1
22003, 동부,095002, 91세,2018,1480,333,1147,29,1479,332,1147,28.9
22003, 동부,095003, 92세,2018,861,176,685,25.7,860,176,684,25.7
22003, 동부,095004, 93세,2018,806,166,640,25.9,804,166,638,26
22003, 동부,095005, 94세,2018,508,85,423,20.1,508,85,423,20.1
22003, 동부,100,95~99세,2018,1112,214,898,23.8,1112,214,898,23.8
22003, 동부,100001, 95세,2018,395,85,310,27.4,395,85,310,27.4
22003, 동부,100002, 96세,2018,302,58,244,23.8,302,58,244,23.8
22003, 동부,100003, 97세,2018,198,34,164,20.7,198,34,164,20.7
22003, 동부,100004, 98세,2018,138,23,115,20,138,23,115,20
22003, 동부,100005, 99세,2018,79,14,65,21.5,79,14,65,21.5
22003, 동부,101,100세이상,2018,124,16,108,14.8,122,15,107,14
22003, 동부,102,15세미만,2018,260290,134478,125812,106.9,259573,134111,125462,106.9
22003, 동부,103,15~64세,2018,1603909,811123,792786,102.3,1577766,797117,780649,102.1
22003, 동부,104,65세이상,2018,329460,138707,190753,72.7,328784,138405,190379,72.7
22003, 동부,086,85세이상,2018,25041,6571,18470,35.6,25004,6551,18453,35.5
22003, 동부,126,평균연령,2018,42.5,41,43.9,,42.6,41.1,44,
22003, 동부,127,중위연령,2018,44.2,42.4,45.7,,44.4,42.7,45.9,
22010, 중구,000,합계,2018,76935,37209,39726,93.7,76089,36779,39310,93.6
22010, 중구,005,0~4세,2018,2924,1496,1428,104.8,2913,1490,1423,104.7
22010, 중구,005001, 0세,2018,522,268,254,105.5,521,268,253,105.9
22010, 중구,005002, 1세,2018,577,306,271,112.9,574,303,271,111.8
22010, 중구,005003, 2세,2018,659,324,335,96.7,657,323,334,96.7
22010, 중구,005004, 3세,2018,607,298,309,96.4,604,297,307,96.7
22010, 중구,005005, 4세,2018,559,300,259,115.8,557,299,258,115.9
22010, 중구,010,5~9세,2018,2733,1422,1311,108.5,2728,1418,1310,108.2
22010, 중구,010001, 5세,2018,584,284,300,94.7,582,283,299,94.6
22010, 중구,010002, 6세,2018,591,331,260,127.3,589,329,260,126.5
22010, 중구,010003, 7세,2018,574,276,298,92.6,574,276,298,92.6
22010, 중구,010004, 8세,2018,520,272,248,109.7,519,271,248,109.3
22010, 중구,010005, 9세,2018,464,259,205,126.3,464,259,205,126.3
22010, 중구,015,10~14세,2018,2255,1155,1100,105,2244,1145,1099,104.2
22010, 중구,015001, 10세,2018,452,225,227,99.1,448,222,226,98.2
22010, 중구,015002, 11세,2018,484,271,213,127.2,481,268,213,125.8
22010, 중구,015003, 12세,2018,439,217,222,97.7,438,216,222,97.3
22010, 중구,015004, 13세,2018,405,217,188,115.4,403,215,188,114.4
22010, 중구,015005, 14세,2018,475,225,250,90,474,224,250,89.6
22010, 중구,020,15~19세,2018,3022,1464,1558,94,3013,1459,1554,93.9
22010, 중구,020001, 15세,2018,536,267,269,99.3,536,267,269,99.3
22010, 중구,020002, 16세,2018,533,269,264,101.9,532,268,264,101.5
22010, 중구,020003, 17세,2018,604,287,317,90.5,603,287,316,90.8
22010, 중구,020004, 18세,2018,656,315,341,92.4,654,314,340,92.4
22010, 중구,020005, 19세,2018,693,326,367,88.8,688,323,365,88.5
22010, 중구,025,20~24세,2018,5084,2454,2630,93.3,4990,2400,2590,92.7
22010, 중구,025001, 20세,2018,740,372,368,101.1,733,367,366,100.3
22010, 중구,025002, 21세,2018,907,454,453,100.2,892,444,448,99.1
22010, 중구,025003, 22세,2018,1030,495,535,92.5,1009,485,524,92.6
22010, 중구,025004, 23세,2018,1141,527,614,85.8,1114,513,601,85.4
22010, 중구,025005, 24세,2018,1266,606,660,91.8,1242,591,651,90.8
22010, 중구,030,25~29세,2018,6507,3336,3171,105.2,6365,3260,3105,105
22010, 중구,030001, 25세,2018,1322,657,665,98.8,1295,642,653,98.3
22010, 중구,030002, 26세,2018,1421,719,702,102.4,1391,702,689,101.9
22010, 중구,030003, 27세,2018,1323,700,623,112.4,1302,689,613,112.4
22010, 중구,030004, 28세,2018,1290,683,607,112.5,1257,662,595,111.3
22010, 중구,030005, 29세,2018,1151,577,574,100.5,1120,565,555,101.8
22010, 중구,035,30~34세,2018,5467,2841,2626,108.2,5325,2760,2565,107.6
22010, 중구,035001, 30세,2018,1027,555,472,117.6,990,533,457,116.6
22010, 중구,035002, 31세,2018,1092,552,540,102.2,1063,541,522,103.6
22010, 중구,035003, 32세,2018,1121,572,549,104.2,1091,556,535,103.9
22010, 중구,035004, 33세,2018,1115,603,512,117.8,1089,585,504,116.1
22010, 중구,035005, 34세,2018,1112,559,553,101.1,1092,545,547,99.6
22010, 중구,040,35~39세,2018,6082,3146,2936,107.2,5988,3101,2887,107.4
22010, 중구,040001, 35세,2018,1218,613,605,101.3,1198,604,594,101.7
22010, 중구,040002, 36세,2018,1282,639,643,99.4,1254,626,628,99.7
22010, 중구,040003, 37세,2018,1247,672,575,116.9,1237,668,569,117.4
22010, 중구,040004, 38세,2018,1234,652,582,112,1210,637,573,111.2
22010, 중구,040005, 39세,2018,1101,570,531,107.3,1089,566,523,108.2
22010, 중구,045,40~44세,2018,5060,2612,2448,106.7,4994,2587,2407,107.5
22010, 중구,045001, 40세,2018,915,482,433,111.3,903,477,426,112
22010, 중구,045002, 41세,2018,991,520,471,110.4,975,515,460,112
22010, 중구,045003, 42세,2018,1017,526,491,107.1,1009,524,485,108
22010, 중구,045004, 43세,2018,1011,510,501,101.8,990,502,488,102.9
22010, 중구,045005, 44세,2018,1126,574,552,104,1117,569,548,103.8
22010, 중구,050,45~49세,2018,5790,2938,2852,103,5723,2904,2819,103
22010, 중구,050001, 45세,2018,1119,569,550,103.5,1109,562,547,102.7
22010, 중구,050002, 46세,2018,1162,604,558,108.2,1150,594,556,106.8
22010, 중구,050003, 47세,2018,1238,627,611,102.6,1222,621,601,103.3
22010, 중구,050004, 48세,2018,1170,583,587,99.3,1153,576,577,99.8
22010, 중구,050005, 49세,2018,1101,555,546,101.6,1089,551,538,102.4
22010, 중구,055,50~54세,2018,5622,2776,2846,97.5,5558,2740,2818,97.2
22010, 중구,055001, 50세,2018,1188,606,582,104.1,1175,598,577,103.6
22010, 중구,055002, 51세,2018,1138,551,587,93.9,1128,544,584,93.2
22010, 중구,055003, 52세,2018,1057,504,553,91.1,1045,501,544,92.1
22010, 중구,055004, 53세,2018,1098,539,559,96.4,1083,528,555,95.1
22010, 중구,055005, 54세,2018,1141,576,565,101.9,1127,569,558,102
22010, 중구,060,55~59세,2018,6102,2947,3155,93.4,6047,2920,3127,93.4
22010, 중구,060001, 55세,2018,1079,534,545,98,1067,526,541,97.2
22010, 중구,060002, 56세,2018,1226,601,625,96.2,1210,595,615,96.7
22010, 중구,060003, 57세,2018,1274,606,668,90.7,1263,603,660,91.4
22010, 중구,060004, 58세,2018,1316,641,675,95,1304,634,670,94.6
22010, 중구,060005, 59세,2018,1207,565,642,88,1203,562,641,87.7
22010, 중구,065,60~64세,2018,5489,2589,2900,89.3,5460,2581,2879,89.6
22010, 중구,065001, 60세,2018,1074,536,538,99.6,1064,535,529,101.1
22010, 중구,065002, 61세,2018,1202,550,652,84.4,1195,548,647,84.7
22010, 중구,065003, 62세,2018,1153,546,607,90,1146,542,604,89.7
22010, 중구,065004, 63세,2018,1113,506,607,83.4,1112,506,606,83.5
22010, 중구,065005, 64세,2018,947,451,496,90.9,943,450,493,91.3
22010, 중구,070,65~69세,2018,4376,1893,2483,76.2,4357,1887,2470,76.4
22010, 중구,070001, 65세,2018,892,392,500,78.4,887,391,496,78.8
22010, 중구,070002, 66세,2018,996,430,566,76,993,429,564,76.1
22010, 중구,070003, 67세,2018,757,328,429,76.5,751,325,426,76.3
22010, 중구,070004, 68세,2018,846,378,468,80.8,844,378,466,81.1
22010, 중구,070005, 69세,2018,885,365,520,70.2,882,364,518,70.3
22010, 중구,075,70~74세,2018,3776,1584,2192,72.3,3765,1579,2186,72.2
22010, 중구,075001, 70세,2018,914,393,521,75.4,910,391,519,75.3
22010, 중구,075002, 71세,2018,811,334,477,70,810,334,476,70.2
22010, 중구,075003, 72세,2018,631,265,366,72.4,630,265,365,72.6
22010, 중구,075004, 73세,2018,639,267,372,71.8,638,266,372,71.5
22010, 중구,075005, 74세,2018,781,325,456,71.3,777,323,454,71.1
22010, 중구,080,75~79세,2018,3380,1440,1940,74.2,3376,1440,1936,74.4
22010, 중구,080001, 75세,2018,784,356,428,83.2,782,356,426,83.6
22010, 중구,080002, 76세,2018,831,371,460,80.7,830,371,459,80.8
22010, 중구,080003, 77세,2018,596,245,351,69.8,595,245,350,70
22010, 중구,080004, 78세,2018,598,242,356,68,598,242,356,68
22010, 중구,080005, 79세,2018,571,226,345,65.5,571,226,345,65.5
22010, 중구,085,80~84세,2018,2025,782,1243,62.9,2011,779,1232,63.2
22010, 중구,085001, 80세,2018,515,198,317,62.5,509,197,312,63.1
22010, 중구,085002, 81세,2018,452,180,272,66.2,450,180,270,66.7
22010, 중구,085003, 82세,2018,412,164,248,66.1,409,163,246,66.3
22010, 중구,085004, 83세,2018,349,139,210,66.2,349,139,210,66.2
22010, 중구,085005, 84세,2018,297,101,196,51.5,294,100,194,51.5
22010, 중구,090,85~89세,2018,873,244,629,38.8,864,239,625,38.2
22010, 중구,090001, 85세,2018,231,67,164,40.9,226,65,161,40.4
22010, 중구,090002, 86세,2018,220,68,152,44.7,219,67,152,44.1
22010, 중구,090003, 87세,2018,174,47,127,37,173,47,126,37.3
22010, 중구,090004, 88세,2018,125,30,95,31.6,124,29,95,30.5
22010, 중구,090005, 89세,2018,123,32,91,35.2,122,31,91,34.1
22010, 중구,095,90~94세,2018,292,76,216,35.2,292,76,216,35.2
22010, 중구,095001, 90세,2018,106,33,73,45.2,106,33,73,45.2
22010, 중구,095002, 91세,2018,81,16,65,24.6,81,16,65,24.6
22010, 중구,095003, 92세,2018,43,11,32,34.4,43,11,32,34.4
22010, 중구,095004, 93세,2018,38,7,31,22.6,38,7,31,22.6
22010, 중구,095005, 94세,2018,24,9,15,60,24,9,15,60
22010, 중구,100,95~99세,2018,71,14,57,24.6,71,14,57,24.6
22010, 중구,100001, 95세,2018,19,X,15,26.7,19,X,15,26.7
22010, 중구,100002, 96세,2018,19,X,18,5.6,19,X,18,5.6
22010, 중구,100003, 97세,2018,15,X,12,25,15,X,12,25
22010, 중구,100004, 98세,2018,14,5,9,55.6,14,5,9,55.6
22010, 중구,100005, 99세,2018,X,X,X,33.3,X,X,X,33.3
22010, 중구,101,100세이상,2018,5,X,5,0,5,X,5,0
22010, 중구,102,15세미만,2018,7912,4073,3839,106.1,7885,4053,3832,105.8
22010, 중구,103,15~64세,2018,54225,27103,27122,99.9,53463,26712,26751,99.9
22010, 중구,104,65세이상,2018,14798,6033,8765,68.8,14741,6014,8727,68.9
22010, 중구,086,85세이상,2018,1241,334,907,36.8,1232,329,903,36.4
22010, 중구,126,평균연령,2018,44.1,42.6,45.5,,44.2,42.7,45.6,
22010, 중구,127,중위연령,2018,44.4,42.5,46.2,,44.5,42.7,46.3,
22020, 동구,000,합계,2018,342396,168812,173584,97.3,340032,167969,172063,97.6
22020, 동구,005,0~4세,2018,13848,7085,6763,104.8,13806,7063,6743,104.7
22020, 동구,005001, 0세,2018,2306,1176,1130,104.1,2298,1171,1127,103.9
22020, 동구,005002, 1세,2018,2622,1387,1235,112.3,2612,1381,1231,112.2
22020, 동구,005003, 2세,2018,2863,1401,1462,95.8,2854,1398,1456,96
22020, 동구,005004, 3세,2018,3071,1602,1469,109.1,3064,1598,1466,109
22020, 동구,005005, 4세,2018,2986,1519,1467,103.5,2978,1515,1463,103.6
22020, 동구,010,5~9세,2018,14575,7597,6978,108.9,14554,7589,6965,109
22020, 동구,010001, 5세,2018,2927,1492,1435,104,2921,1490,1431,104.1
22020, 동구,010002, 6세,2018,3152,1634,1518,107.6,3150,1633,1517,107.6
22020, 동구,010003, 7세,2018,2931,1551,1380,112.4,2927,1551,1376,112.7
22020, 동구,010004, 8세,2018,2855,1499,1356,110.5,2852,1497,1355,110.5
22020, 동구,010005, 9세,2018,2710,1421,1289,110.2,2704,1418,1286,110.3
22020, 동구,015,10~14세,2018,13015,6803,6212,109.5,12994,6794,6200,109.6
22020, 동구,015001, 10세,2018,2770,1406,1364,103.1,2765,1404,1361,103.2
22020, 동구,015002, 11세,2018,2760,1430,1330,107.5,2756,1428,1328,107.5
22020, 동구,015003, 12세,2018,2408,1275,1133,112.5,2404,1273,1131,112.6
22020, 동구,015004, 13세,2018,2475,1334,1141,116.9,2471,1332,1139,116.9
22020, 동구,015005, 14세,2018,2602,1358,1244,109.2,2598,1357,1241,109.3
22020, 동구,020,15~19세,2018,15133,8111,7022,115.5,15084,8088,6996,115.6
22020, 동구,020001, 15세,2018,2721,1406,1315,106.9,2715,1401,1314,106.6
22020, 동구,020002, 16세,2018,2762,1489,1273,117,2757,1485,1272,116.7
22020, 동구,020003, 17세,2018,3119,1647,1472,111.9,3114,1644,1470,111.8
22020, 동구,020004, 18세,2018,3418,1876,1542,121.7,3411,1874,1537,121.9
22020, 동구,020005, 19세,2018,3113,1693,1420,119.2,3087,1684,1403,120
22020, 동구,025,20~24세,2018,20044,10780,9264,116.4,19795,10724,9071,118.2
22020, 동구,025001, 20세,2018,3515,1973,1542,128,3485,1965,1520,129.3
22020, 동구,025002, 21세,2018,3903,2086,1817,114.8,3854,2072,1782,116.3
22020, 동구,025003, 22세,2018,4088,2152,1936,111.2,4037,2143,1894,113.1
22020, 동구,025004, 23세,2018,4229,2247,1982,113.4,4172,2237,1935,115.6
22020, 동구,025005, 24세,2018,4309,2322,1987,116.9,4247,2307,1940,118.9
22020, 동구,030,25~29세,2018,21654,11742,9912,118.5,21283,11636,9647,120.6
22020, 동구,030001, 25세,2018,4369,2372,1997,118.8,4304,2359,1945,121.3
22020, 동구,030002, 26세,2018,4557,2457,2100,117,4481,2436,2045,119.1
22020, 동구,030003, 27세,2018,4362,2377,1985,119.7,4296,2354,1942,121.2
22020, 동구,030004, 28세,2018,4211,2329,1882,123.8,4128,2306,1822,126.6
22020, 동구,030005, 29세,2018,4155,2207,1948,113.3,4074,2181,1893,115.2
22020, 동구,035,30~34세,2018,20738,10832,9906,109.3,20383,10715,9668,110.8
22020, 동구,035001, 30세,2018,3947,2053,1894,108.4,3856,2025,1831,110.6
22020, 동구,035002, 31세,2018,4214,2201,2013,109.3,4145,2180,1965,110.9
22020, 동구,035003, 32세,2018,4060,2156,1904,113.2,3986,2130,1856,114.8
22020, 동구,035004, 33세,2018,4156,2149,2007,107.1,4087,2123,1964,108.1
22020, 동구,035005, 34세,2018,4361,2273,2088,108.9,4309,2257,2052,110
22020, 동구,040,35~39세,2018,26964,13616,13348,102,26686,13531,13155,102.9
22020, 동구,040001, 35세,2018,4870,2485,2385,104.2,4815,2471,2344,105.4
22020, 동구,040002, 36세,2018,5494,2727,2767,98.6,5425,2707,2718,99.6
22020, 동구,040003, 37세,2018,5647,2844,2803,101.5,5597,2831,2766,102.3
22020, 동구,040004, 38세,2018,5722,2905,2817,103.1,5668,2885,2783,103.7
22020, 동구,040005, 39세,2018,5231,2655,2576,103.1,5181,2637,2544,103.7
22020, 동구,045,40~44세,2018,25033,13123,11910,110.2,24800,13026,11774,110.6
22020, 동구,045001, 40세,2018,4829,2552,2277,112.1,4784,2532,2252,112.4
22020, 동구,045002, 41세,2018,4955,2530,2425,104.3,4899,2506,2393,104.7
22020, 동구,045003, 42세,2018,4859,2598,2261,114.9,4813,2577,2236,115.3
22020, 동구,045004, 43세,2018,5079,2698,2381,113.3,5034,2678,2356,113.7
22020, 동구,045005, 44세,2018,5311,2745,2566,107,5270,2733,2537,107.7
22020, 동구,050,45~49세,2018,27210,13776,13434,102.5,27004,13691,13313,102.8
22020, 동구,050001, 45세,2018,5338,2723,2615,104.1,5310,2712,2598,104.4
22020, 동구,050002, 46세,2018,5337,2766,2571,107.6,5298,2746,2552,107.6
22020, 동구,050003, 47세,2018,5563,2899,2664,108.8,5526,2885,2641,109.2
22020, 동구,050004, 48세,2018,5438,2705,2733,99,5386,2689,2697,99.7
22020, 동구,050005, 49세,2018,5534,2683,2851,94.1,5484,2659,2825,94.1
22020, 동구,055,50~54세,2018,27273,13197,14076,93.8,27075,13116,13959,94
22020, 동구,055001, 50세,2018,5752,2822,2930,96.3,5712,2807,2905,96.6
22020, 동구,055002, 51세,2018,5355,2559,2796,91.5,5320,2545,2775,91.7
22020, 동구,055003, 52세,2018,5323,2614,2709,96.5,5275,2592,2683,96.6
22020, 동구,055004, 53세,2018,5492,2628,2864,91.8,5456,2611,2845,91.8
22020, 동구,055005, 54세,2018,5351,2574,2777,92.7,5312,2561,2751,93.1
22020, 동구,060,55~59세,2018,30309,14274,16035,89,30160,14211,15949,89.1
22020, 동구,060001, 55세,2018,5566,2671,2895,92.3,5520,2652,2868,92.5
22020, 동구,060002, 56세,2018,5903,2836,3067,92.5,5873,2821,3052,92.4
22020, 동구,060003, 57세,2018,6479,3042,3437,88.5,6462,3034,3428,88.5
22020, 동구,060004, 58세,2018,6465,3000,3465,86.6,6434,2988,3446,86.7
22020, 동구,060005, 59세,2018,5896,2725,3171,85.9,5871,2716,3155,86.1
22020, 동구,065,60~64세,2018,26324,12372,13952,88.7,26223,12325,13898,88.7
22020, 동구,065001, 60세,2018,5378,2620,2758,95,5349,2608,2741,95.1
22020, 동구,065002, 61세,2018,5556,2614,2942,88.9,5535,2605,2930,88.9
22020, 동구,065003, 62세,2018,5354,2513,2841,88.5,5337,2503,2834,88.3
22020, 동구,065004, 63세,2018,5452,2482,2970,83.6,5433,2472,2961,83.5
22020, 동구,065005, 64세,2018,4584,2143,2441,87.8,4569,2137,2432,87.9
22020, 동구,070,65~69세,2018,20446,9491,10955,86.6,20392,9462,10930,86.6
22020, 동구,070001, 65세,2018,4327,2004,2323,86.3,4311,1993,2318,86
22020, 동구,070002, 66세,2018,4669,2184,2485,87.9,4657,2180,2477,88
22020, 동구,070003, 67세,2018,3669,1701,1968,86.4,3660,1697,1963,86.4
22020, 동구,070004, 68세,2018,3689,1738,1951,89.1,3681,1734,1947,89.1
22020, 동구,070005, 69세,2018,4092,1864,2228,83.7,4083,1858,2225,83.5
22020, 동구,075,70~74세,2018,14785,6596,8189,80.5,14763,6587,8176,80.6
22020, 동구,075001, 70세,2018,3734,1709,2025,84.4,3732,1708,2024,84.4
22020, 동구,075002, 71세,2018,3441,1561,1880,83,3433,1559,1874,83.2
22020, 동구,075003, 72세,2018,2357,1075,1282,83.9,2351,1070,1281,83.5
22020, 동구,075004, 73세,2018,2512,1071,1441,74.3,2510,1070,1440,74.3
22020, 동구,075005, 74세,2018,2741,1180,1561,75.6,2737,1180,1557,75.8
22020, 동구,080,75~79세,2018,13045,5471,7574,72.2,13038,5470,7568,72.3
22020, 동구,080001, 75세,2018,2909,1268,1641,77.3,2909,1268,1641,77.3
22020, 동구,080002, 76세,2018,3048,1284,1764,72.8,3048,1284,1764,72.8
22020, 동구,080003, 77세,2018,2573,1075,1498,71.8,2569,1074,1495,71.8
22020, 동구,080004, 78세,2018,2295,930,1365,68.1,2294,930,1364,68.2
22020, 동구,080005, 79세,2018,2220,914,1306,70,2218,914,1304,70.1
22020, 동구,085,80~84세,2018,7641,2792,4849,57.6,7636,2789,4847,57.5
22020, 동구,085001, 80세,2018,1863,687,1176,58.4,1863,687,1176,58.4
22020, 동구,085002, 81세,2018,1695,659,1036,63.6,1693,658,1035,63.6
22020, 동구,085003, 82세,2018,1535,560,975,57.4,1534,559,975,57.3
22020, 동구,085004, 83세,2018,1383,499,884,56.4,1382,499,883,56.5
22020, 동구,085005, 84세,2018,1165,387,778,49.7,1164,386,778,49.6
22020, 동구,090,85~89세,2018,3143,895,2248,39.8,3140,893,2247,39.7
22020, 동구,090001, 85세,2018,904,273,631,43.3,903,273,630,43.3
22020, 동구,090002, 86세,2018,814,258,556,46.4,813,257,556,46.2
22020, 동구,090003, 87세,2018,574,160,414,38.6,574,160,414,38.6
22020, 동구,090004, 88세,2018,470,114,356,32,470,114,356,32
22020, 동구,090005, 89세,2018,381,90,291,30.9,380,89,291,30.6
22020, 동구,095,90~94세,2018,987,214,773,27.7,987,214,773,27.7
22020, 동구,095001, 90세,2018,330,82,248,33.1,330,82,248,33.1
22020, 동구,095002, 91세,2018,266,63,203,31,266,63,203,31
22020, 동구,095003, 92세,2018,139,24,115,20.9,139,24,115,20.9
22020, 동구,095004, 93세,2018,160,30,130,23.1,160,30,130,23.1
22020, 동구,095005, 94세,2018,92,15,77,19.5,92,15,77,19.5
22020, 동구,100,95~99세,2018,205,42,163,25.8,205,42,163,25.8
22020, 동구,100001, 95세,2018,73,15,58,25.9,73,15,58,25.9
22020, 동구,100002, 96세,2018,57,11,46,23.9,57,11,46,23.9
22020, 동구,100003, 97세,2018,38,11,27,40.7,38,11,27,40.7
22020, 동구,100004, 98세,2018,20,X,18,11.1,20,X,18,11.1
22020, 동구,100005, 99세,2018,17,X,14,21.4,17,X,14,21.4
22020, 동구,101,100세이상,2018,24,X,21,14.3,24,X,21,14.3
22020, 동구,102,15세미만,2018,41438,21485,19953,107.7,41354,21446,19908,107.7
22020, 동구,103,15~64세,2018,240682,121823,118859,102.5,238493,121063,117430,103.1
22020, 동구,104,65세이상,2018,60276,25504,34772,73.3,60185,25460,34725,73.3
22020, 동구,086,85세이상,2018,4359,1154,3205,36,4356,1152,3204,36
22020, 동구,126,평균연령,2018,43.7,42.1,45.3,,43.7,42.1,45.3,
22020, 동구,127,중위연령,2018,45,43.1,47.1,,45.1,43.1,47.3,
22030, 서구,000,합계,2018,183857,92304,91553,100.8,180774,90628,90146,100.5
22030, 서구,005,0~4세,2018,4385,2230,2155,103.5,4340,2211,2129,103.9
22030, 서구,005001, 0세,2018,719,354,365,97,701,344,357,96.4
22030, 서구,005002, 1세,2018,804,409,395,103.5,799,409,390,104.9
22030, 서구,005003, 2세,2018,963,501,462,108.4,957,497,460,108
22030, 서구,005004, 3세,2018,940,486,454,107,931,484,447,108.3
22030, 서구,005005, 4세,2018,959,480,479,100.2,952,477,475,100.4
22030, 서구,010,5~9세,2018,4912,2488,2424,102.6,4895,2477,2418,102.4
22030, 서구,010001, 5세,2018,956,475,481,98.8,953,472,481,98.1
22030, 서구,010002, 6세,2018,1065,546,519,105.2,1061,545,516,105.6
22030, 서구,010003, 7세,2018,1015,517,498,103.8,1011,513,498,103
22030, 서구,010004, 8세,2018,926,466,460,101.3,923,464,459,101.1
22030, 서구,010005, 9세,2018,950,484,466,103.9,947,483,464,104.1
22030, 서구,015,10~14세,2018,5166,2686,2480,108.3,5151,2680,2471,108.5
22030, 서구,015001, 10세,2018,979,505,474,106.5,975,503,472,106.6
22030, 서구,015002, 11세,2018,1043,517,526,98.3,1039,514,525,97.9
22030, 서구,015003, 12세,2018,1002,515,487,105.7,1001,515,486,106
22030, 서구,015004, 13세,2018,1010,526,484,108.7,1006,526,480,109.6
22030, 서구,015005, 14세,2018,1132,623,509,122.4,1130,622,508,122.4
22030, 서구,020,15~19세,2018,8278,4517,3761,120.1,8232,4489,3743,119.9
22030, 서구,020001, 15세,2018,1330,713,617,115.6,1328,712,616,115.6
22030, 서구,020002, 16세,2018,1441,784,657,119.3,1435,782,653,119.8
22030, 서구,020003, 17세,2018,1803,974,829,117.5,1796,968,828,116.9
22030, 서구,020004, 18세,2018,1997,1092,905,120.7,1985,1083,902,120.1
22030, 서구,020005, 19세,2018,1707,954,753,126.7,1688,944,744,126.9
22030, 서구,025,20~24세,2018,12202,6814,5388,126.5,11920,6668,5252,127
22030, 서구,025001, 20세,2018,2050,1161,889,130.6,2014,1148,866,132.6
22030, 서구,025002, 21세,2018,2338,1310,1028,127.4,2291,1280,1011,126.6
22030, 서구,025003, 22세,2018,2483,1373,1110,123.7,2433,1348,1085,124.2
22030, 서구,025004, 23세,2018,2652,1477,1175,125.7,2581,1439,1142,126
22030, 서구,025005, 24세,2018,2679,1493,1186,125.9,2601,1453,1148,126.6
22030, 서구,030,25~29세,2018,12670,7152,5518,129.6,12148,6880,5268,130.6
22030, 서구,030001, 25세,2018,2779,1581,1198,132,2686,1531,1155,132.6
22030, 서구,030002, 26세,2018,2825,1580,1245,126.9,2726,1528,1198,127.5
22030, 서구,030003, 27세,2018,2547,1392,1155,120.5,2454,1344,1110,121.1
22030, 서구,030004, 28세,2018,2313,1330,983,135.3,2189,1268,921,137.7
22030, 서구,030005, 29세,2018,2206,1269,937,135.4,2093,1209,884,136.8
22030, 서구,035,30~34세,2018,9713,5570,4143,134.4,9118,5235,3883,134.8
22030, 서구,035001, 30세,2018,1974,1177,797,147.7,1856,1121,735,152.5
22030, 서구,035002, 31세,2018,2002,1173,829,141.5,1849,1076,773,139.2
22030, 서구,035003, 32세,2018,1991,1117,874,127.8,1874,1051,823,127.7
22030, 서구,035004, 33세,2018,1865,1049,816,128.6,1749,991,758,130.7
22030, 서구,035005, 34세,2018,1881,1054,827,127.4,1790,996,794,125.4
22030, 서구,040,35~39세,2018,11439,6257,5182,120.7,10999,5996,5003,119.8
22030, 서구,040001, 35세,2018,2168,1190,978,121.7,2065,1129,936,120.6
22030, 서구,040002, 36세,2018,2305,1259,1046,120.4,2223,1211,1012,119.7
22030, 서구,040003, 37세,2018,2313,1301,1012,128.6,2230,1253,977,128.2
22030, 서구,040004, 38세,2018,2380,1269,1111,114.2,2303,1223,1080,113.2
22030, 서구,040005, 39세,2018,2273,1238,1035,119.6,2178,1180,998,118.2
22030, 서구,045,40~44세,2018,11256,6159,5097,120.8,10934,5974,4960,120.4
22030, 서구,045001, 40세,2018,2010,1070,940,113.8,1935,1026,909,112.9
22030, 서구,045002, 41세,2018,2121,1184,937,126.4,2049,1142,907,125.9
22030, 서구,045003, 42세,2018,2170,1199,971,123.5,2103,1158,945,122.5
22030, 서구,045004, 43세,2018,2379,1282,1097,116.9,2330,1258,1072,117.4
22030, 서구,045005, 44세,2018,2576,1424,1152,123.6,2517,1390,1127,123.3
22030, 서구,050,45~49세,2018,14781,7579,7202,105.2,14532,7434,7098,104.7
22030, 서구,050001, 45세,2018,2743,1452,1291,112.5,2702,1429,1273,112.3
22030, 서구,050002, 46세,2018,2702,1411,1291,109.3,2647,1379,1268,108.8
22030, 서구,050003, 47세,2018,3006,1554,1452,107,2951,1527,1424,107.2
22030, 서구,050004, 48세,2018,3102,1566,1536,102,3046,1531,1515,101.1
22030, 서구,050005, 49세,2018,3228,1596,1632,97.8,3186,1568,1618,96.9
22030, 서구,055,50~54세,2018,17311,8626,8685,99.3,17106,8526,8580,99.4
22030, 서구,055001, 50세,2018,3437,1722,1715,100.4,3394,1701,1693,100.5
22030, 서구,055002, 51세,2018,3277,1620,1657,97.8,3237,1601,1636,97.9
22030, 서구,055003, 52세,2018,3460,1752,1708,102.6,3426,1735,1691,102.6
22030, 서구,055004, 53세,2018,3621,1779,1842,96.6,3570,1753,1817,96.5
22030, 서구,055005, 54세,2018,3516,1753,1763,99.4,3479,1736,1743,99.6
22030, 서구,060,55~59세,2018,19677,9555,10122,94.4,19508,9470,10038,94.3
22030, 서구,060001, 55세,2018,3531,1770,1761,100.5,3479,1744,1735,100.5
22030, 서구,060002, 56세,2018,3948,1921,2027,94.8,3913,1906,2007,95
22030, 서구,060003, 57세,2018,4256,2073,2183,95,4232,2056,2176,94.5
22030, 서구,060004, 58세,2018,4137,1988,2149,92.5,4103,1971,2132,92.4
22030, 서구,060005, 59세,2018,3805,1803,2002,90.1,3781,1793,1988,90.2
22030, 서구,065,60~64세,2018,16168,7661,8507,90.1,16082,7614,8468,89.9
22030, 서구,065001, 60세,2018,3247,1580,1667,94.8,3227,1572,1655,95
22030, 서구,065002, 61세,2018,3473,1701,1772,96,3455,1689,1766,95.6
22030, 서구,065003, 62세,2018,3287,1538,1749,87.9,3270,1531,1739,88
22030, 서구,065004, 63세,2018,3318,1504,1814,82.9,3304,1492,1812,82.3
22030, 서구,065005, 64세,2018,2843,1338,1505,88.9,2826,1330,1496,88.9
22030, 서구,070,65~69세,2018,12682,5906,6776,87.2,12628,5883,6745,87.2
22030, 서구,070001, 65세,2018,2799,1305,1494,87.3,2784,1297,1487,87.2
22030, 서구,070002, 66세,2018,3066,1373,1693,81.1,3052,1367,1685,81.1
22030, 서구,070003, 67세,2018,2209,1018,1191,85.5,2202,1017,1185,85.8
22030, 서구,070004, 68세,2018,2201,1079,1122,96.2,2193,1076,1117,96.3
22030, 서구,070005, 69세,2018,2407,1131,1276,88.6,2397,1126,1271,88.6
22030, 서구,075,70~74세,2018,8760,3863,4897,78.9,8740,3856,4884,79
22030, 서구,075001, 70세,2018,2261,1015,1246,81.5,2255,1013,1242,81.6
22030, 서구,075002, 71세,2018,2056,907,1149,78.9,2053,906,1147,79
22030, 서구,075003, 72세,2018,1346,590,756,78,1343,589,754,78.1
22030, 서구,075004, 73세,2018,1404,648,756,85.7,1400,648,752,86.2
22030, 서구,075005, 74세,2018,1693,703,990,71,1689,700,989,70.8
22030, 서구,080,75~79세,2018,7610,3158,4452,70.9,7603,3156,4447,71
22030, 서구,080001, 75세,2018,1736,768,968,79.3,1736,768,968,79.3
22030, 서구,080002, 76세,2018,1842,779,1063,73.3,1840,778,1062,73.3
22030, 서구,080003, 77세,2018,1473,616,857,71.9,1471,615,856,71.8
22030, 서구,080004, 78세,2018,1262,482,780,61.8,1260,482,778,62
22030, 서구,080005, 79세,2018,1297,513,784,65.4,1296,513,783,65.5
22030, 서구,085,80~84세,2018,4299,1528,2771,55.1,4297,1528,2769,55.2
22030, 서구,085001, 80세,2018,1063,408,655,62.3,1062,408,654,62.4
22030, 서구,085002, 81세,2018,988,334,654,51.1,988,334,654,51.1
22030, 서구,085003, 82세,2018,863,318,545,58.3,863,318,545,58.3
22030, 서구,085004, 83세,2018,728,246,482,51,727,246,481,51.1
22030, 서구,085005, 84세,2018,657,222,435,51,657,222,435,51
22030, 서구,090,85~89세,2018,1788,427,1361,31.4,1785,424,1361,31.2
22030, 서구,090001, 85세,2018,505,145,360,40.3,504,144,360,40
22030, 서구,090002, 86세,2018,448,111,337,32.9,447,110,337,32.6
22030, 서구,090003, 87세,2018,324,75,249,30.1,324,75,249,30.1
22030, 서구,090004, 88세,2018,283,51,232,22,282,50,232,21.6
22030, 서구,090005, 89세,2018,228,45,183,24.6,228,45,183,24.6
22030, 서구,095,90~94세,2018,614,110,504,21.8,611,109,502,21.7
22030, 서구,095001, 90세,2018,204,42,162,25.9,202,41,161,25.5
22030, 서구,095002, 91세,2018,152,24,128,18.8,152,24,128,18.8
22030, 서구,095003, 92세,2018,108,20,88,22.7,107,20,87,23
22030, 서구,095004, 93세,2018,82,15,67,22.4,82,15,67,22.4
22030, 서구,095005, 94세,2018,68,9,59,15.3,68,9,59,15.3
22030, 서구,100,95~99세,2018,130,17,113,15,130,17,113,15
22030, 서구,100001, 95세,2018,57,9,48,18.8,57,9,48,18.8
22030, 서구,100002, 96세,2018,28,X,26,7.7,28,X,26,7.7
22030, 서구,100003, 97세,2018,26,X,22,18.2,26,X,22,18.2
22030, 서구,100004, 98세,2018,13,X,12,8.3,13,X,12,8.3
22030, 서구,100005, 99세,2018,6,X,5,20,6,X,5,20
22030, 서구,101,100세이상,2018,16,X,15,6.7,15,X,14,7.1
22030, 서구,102,15세미만,2018,14463,7404,7059,104.9,14386,7368,7018,105
22030, 서구,103,15~64세,2018,133495,69890,63605,109.9,130579,68286,62293,109.6
22030, 서구,104,65세이상,2018,35899,15010,20889,71.9,35809,14974,20835,71.9
22030, 서구,086,85세이상,2018,2548,555,1993,27.8,2541,551,1990,27.7
22030, 서구,126,평균연령,2018,46.3,44.5,48.2,,46.5,44.6,48.4,
22030, 서구,127,중위연령,2018,49.1,46.6,51.4,,49.4,46.9,51.7,
22040, 남구,000,합계,2018,150132,72097,78035,92.4,148553,71475,77078,92.7
22040, 남구,005,0~4세,2018,3544,1790,1754,102.1,3524,1779,1745,101.9
22040, 남구,005001, 0세,2018,623,309,314,98.4,620,307,313,98.1
22040, 남구,005002, 1세,2018,648,336,312,107.7,640,330,310,106.5
22040, 남구,005003, 2세,2018,755,373,382,97.6,750,371,379,97.9
22040, 남구,005004, 3세,2018,746,381,365,104.4,743,381,362,105.2
22040, 남구,005005, 4세,2018,772,391,381,102.6,771,390,381,102.4
22040, 남구,010,5~9세,2018,3924,2036,1888,107.8,3913,2030,1883,107.8
22040, 남구,010001, 5세,2018,779,411,368,111.7,776,410,366,112
22040, 남구,010002, 6세,2018,834,429,405,105.9,833,429,404,106.2
22040, 남구,010003, 7세,2018,779,416,363,114.6,777,414,363,114
22040, 남구,010004, 8세,2018,772,400,372,107.5,770,399,371,107.5
22040, 남구,010005, 9세,2018,760,380,380,100,757,378,379,99.7
22040, 남구,015,10~14세,2018,4327,2275,2052,110.9,4314,2267,2047,110.7
22040, 남구,015001, 10세,2018,824,446,378,118,822,444,378,117.5
22040, 남구,015002, 11세,2018,897,463,434,106.7,894,461,433,106.5
22040, 남구,015003, 12세,2018,833,450,383,117.5,831,449,382,117.5
22040, 남구,015004, 13세,2018,818,436,382,114.1,817,436,381,114.4
22040, 남구,015005, 14세,2018,955,480,475,101.1,950,477,473,100.8
22040, 남구,020,15~19세,2018,6921,3442,3479,98.9,6765,3373,3392,99.4
22040, 남구,020001, 15세,2018,1038,542,496,109.3,1036,541,495,109.3
22040, 남구,020002, 16세,2018,1094,554,540,102.6,1094,554,540,102.6
22040, 남구,020003, 17세,2018,1314,648,666,97.3,1308,646,662,97.6
22040, 남구,020004, 18세,2018,1591,778,813,95.7,1567,767,800,95.9
22040, 남구,020005, 19세,2018,1884,920,964,95.4,1760,865,895,96.6
22040, 남구,025,20~24세,2018,10917,5547,5370,103.3,10728,5477,5251,104.3
22040, 남구,025001, 20세,2018,1891,890,1001,88.9,1839,862,977,88.2
22040, 남구,025002, 21세,2018,2138,1068,1070,99.8,2106,1056,1050,100.6
22040, 남구,025003, 22세,2018,2348,1221,1127,108.3,2319,1214,1105,109.9
22040, 남구,025004, 23세,2018,2316,1188,1128,105.3,2276,1175,1101,106.7
22040, 남구,025005, 24세,2018,2224,1180,1044,113,2188,1170,1018,114.9
22040, 남구,030,25~29세,2018,10385,5403,4982,108.5,10160,5333,4827,110.5
22040, 남구,030001, 25세,2018,2167,1107,1060,104.4,2134,1097,1037,105.8
22040, 남구,030002, 26세,2018,2311,1219,1092,111.6,2275,1209,1066,113.4
22040, 남구,030003, 27세,2018,2092,1066,1026,103.9,2044,1054,990,106.5
22040, 남구,030004, 28세,2018,1953,997,956,104.3,1900,977,923,105.9
22040, 남구,030005, 29세,2018,1862,1014,848,119.6,1807,996,811,122.8
22040, 남구,035,30~34세,2018,8433,4450,3983,111.7,8225,4386,3839,114.2
22040, 남구,035001, 30세,2018,1694,884,810,109.1,1651,872,779,111.9
22040, 남구,035002, 31세,2018,1645,909,736,123.5,1603,891,712,125.1
22040, 남구,035003, 32세,2018,1661,909,752,120.9,1626,897,729,123
22040, 남구,035004, 33세,2018,1701,885,816,108.5,1649,872,777,112.2
22040, 남구,035005, 34세,2018,1732,863,869,99.3,1696,854,842,101.4
22040, 남구,040,35~39세,2018,9843,5032,4811,104.6,9706,4980,4726,105.4
22040, 남구,040001, 35세,2018,1854,971,883,110,1818,955,863,110.7
22040, 남구,040002, 36세,2018,2036,1016,1020,99.6,2007,1005,1002,100.3
22040, 남구,040003, 37세,2018,2032,1032,1000,103.2,2007,1025,982,104.4
22040, 남구,040004, 38세,2018,2033,1070,963,111.1,2005,1060,945,112.2
22040, 남구,040005, 39세,2018,1888,943,945,99.8,1869,935,934,100.1
22040, 남구,045,40~44세,2018,9469,4792,4677,102.5,9344,4745,4599,103.2
22040, 남구,045001, 40세,2018,1778,898,880,102,1750,890,860,103.5
22040, 남구,045002, 41세,2018,1828,932,896,104,1809,925,884,104.6
22040, 남구,045003, 42세,2018,1819,926,893,103.7,1793,914,879,104
22040, 남구,045004, 43세,2018,1948,963,985,97.8,1922,953,969,98.3
22040, 남구,045005, 44세,2018,2096,1073,1023,104.9,2070,1063,1007,105.6
22040, 남구,050,45~49세,2018,11905,5964,5941,100.4,11788,5913,5875,100.6
22040, 남구,050001, 45세,2018,2268,1148,1120,102.5,2244,1138,1106,102.9
22040, 남구,050002, 46세,2018,2312,1146,1166,98.3,2291,1134,1157,98
22040, 남구,050003, 47세,2018,2426,1224,1202,101.8,2402,1213,1189,102
22040, 남구,050004, 48세,2018,2468,1218,1250,97.4,2439,1206,1233,97.8
22040, 남구,050005, 49세,2018,2431,1228,1203,102.1,2412,1222,1190,102.7
22040, 남구,055,50~54세,2018,11927,5763,6164,93.5,11813,5710,6103,93.6
22040, 남구,055001, 50세,2018,2550,1278,1272,100.5,2524,1266,1258,100.6
22040, 남구,055002, 51세,2018,2453,1171,1282,91.3,2430,1163,1267,91.8
22040, 남구,055003, 52세,2018,2283,1162,1121,103.7,2257,1150,1107,103.9
22040, 남구,055004, 53세,2018,2360,1114,1246,89.4,2344,1103,1241,88.9
22040, 남구,055005, 54세,2018,2281,1038,1243,83.5,2258,1028,1230,83.6
22040, 남구,060,55~59세,2018,13945,6528,7417,88,13852,6489,7363,88.1
22040, 남구,060001, 55세,2018,2478,1187,1291,91.9,2461,1176,1285,91.5
22040, 남구,060002, 56세,2018,2760,1336,1424,93.8,2741,1328,1413,94
22040, 남구,060003, 57세,2018,2945,1403,1542,91,2930,1397,1533,91.1
22040, 남구,060004, 58세,2018,2937,1320,1617,81.6,2910,1310,1600,81.9
22040, 남구,060005, 59세,2018,2825,1282,1543,83.1,2810,1278,1532,83.4
22040, 남구,065,60~64세,2018,12577,5901,6676,88.4,12483,5855,6628,88.3
22040, 남구,065001, 60세,2018,2554,1224,1330,92,2532,1211,1321,91.7
22040, 남구,065002, 61세,2018,2611,1231,1380,89.2,2595,1224,1371,89.3
22040, 남구,065003, 62세,2018,2507,1175,1332,88.2,2484,1164,1320,88.2
22040, 남구,065004, 63세,2018,2709,1251,1458,85.8,2693,1244,1449,85.9
22040, 남구,065005, 64세,2018,2196,1020,1176,86.7,2179,1012,1167,86.7
22040, 남구,070,65~69세,2018,10027,4500,5527,81.4,9990,4481,5509,81.3
22040, 남구,070001, 65세,2018,2136,931,1205,77.3,2126,927,1199,77.3
22040, 남구,070002, 66세,2018,2295,1057,1238,85.4,2286,1052,1234,85.3
22040, 남구,070003, 67세,2018,1795,773,1022,75.6,1788,769,1019,75.5
22040, 남구,070004, 68세,2018,1800,858,942,91.1,1797,857,940,91.2
22040, 남구,070005, 69세,2018,2001,881,1120,78.7,1993,876,1117,78.4
22040, 남구,075,70~74세,2018,7620,3324,4296,77.4,7603,3316,4287,77.4
22040, 남구,075001, 70세,2018,1885,837,1048,79.9,1882,837,1045,80.1
22040, 남구,075002, 71세,2018,1803,802,1001,80.1,1801,800,1001,79.9
22040, 남구,075003, 72세,2018,1283,565,718,78.7,1276,562,714,78.7
22040, 남구,075004, 73세,2018,1225,508,717,70.9,1222,506,716,70.7
22040, 남구,075005, 74세,2018,1424,612,812,75.4,1422,611,811,75.3
22040, 남구,080,75~79세,2018,7092,2949,4143,71.2,7079,2944,4135,71.2
22040, 남구,080001, 75세,2018,1581,664,917,72.4,1580,663,917,72.3
22040, 남구,080002, 76세,2018,1634,730,904,80.8,1630,729,901,80.9
22040, 남구,080003, 77세,2018,1429,587,842,69.7,1427,587,840,69.9
22040, 남구,080004, 78세,2018,1233,475,758,62.7,1231,475,756,62.8
22040, 남구,080005, 79세,2018,1215,493,722,68.3,1211,490,721,68
22040, 남구,085,80~84세,2018,4436,1617,2819,57.4,4430,1615,2815,57.4
22040, 남구,085001, 80세,2018,1043,392,651,60.2,1042,392,650,60.3
22040, 남구,085002, 81세,2018,985,360,625,57.6,985,360,625,57.6
22040, 남구,085003, 82세,2018,881,317,564,56.2,879,316,563,56.1
22040, 남구,085004, 83세,2018,817,294,523,56.2,815,294,521,56.4
22040, 남구,085005, 84세,2018,710,254,456,55.7,709,253,456,55.5
22040, 남구,090,85~89세,2018,2043,612,1431,42.8,2040,610,1430,42.7
22040, 남구,090001, 85세,2018,554,189,365,51.8,553,188,365,51.5
22040, 남구,090002, 86세,2018,493,162,331,48.9,492,162,330,49.1
22040, 남구,090003, 87세,2018,403,102,301,33.9,402,101,301,33.6
22040, 남구,090004, 88세,2018,310,80,230,34.8,310,80,230,34.8
22040, 남구,090005, 89세,2018,283,79,204,38.7,283,79,204,38.7
22040, 남구,095,90~94세,2018,649,146,503,29,648,146,502,29.1
22040, 남구,095001, 90세,2018,221,62,159,39,221,62,159,39
22040, 남구,095002, 91세,2018,183,40,143,28,183,40,143,28
22040, 남구,095003, 92세,2018,112,22,90,24.4,112,22,90,24.4
22040, 남구,095004, 93세,2018,72,15,57,26.3,71,15,56,26.8
22040, 남구,095005, 94세,2018,61,7,54,13,61,7,54,13
22040, 남구,100,95~99세,2018,135,22,113,19.5,135,22,113,19.5
22040, 남구,100001, 95세,2018,51,12,39,30.8,51,12,39,30.8
22040, 남구,100002, 96세,2018,33,5,28,17.9,33,5,28,17.9
22040, 남구,100003, 97세,2018,24,X,22,9.1,24,X,22,9.1
22040, 남구,100004, 98세,2018,22,X,19,15.8,22,X,19,15.8
22040, 남구,100005, 99세,2018,5,X,5,0,5,X,5,0
22040, 남구,101,100세이상,2018,13,X,9,44.4,13,X,9,44.4
22040, 남구,102,15세미만,2018,11795,6101,5694,107.1,11751,6076,5675,107.1
22040, 남구,103,15~64세,2018,106322,52822,53500,98.7,104864,52261,52603,99.3
22040, 남구,104,65세이상,2018,32015,13174,18841,69.9,31938,13138,18800,69.9
22040, 남구,086,85세이상,2018,2840,784,2056,38.1,2836,782,2054,38.1
22040, 남구,126,평균연령,2018,46.4,44.7,48,,46.5,44.8,48.1,
22040, 남구,127,중위연령,2018,48.1,46.1,50.1,,48.3,46.2,50.3,
22050, 북구,000,합계,2018,444759,222248,222511,99.9,438525,219022,219503,99.8
22050, 북구,005,0~4세,2018,17239,8753,8486,103.1,17158,8702,8456,102.9
22050, 북구,005001, 0세,2018,2859,1434,1425,100.6,2849,1427,1422,100.4
22050, 북구,005002, 1세,2018,3180,1593,1587,100.4,3159,1581,1578,100.2
22050, 북구,005003, 2세,2018,3680,1890,1790,105.6,3660,1874,1786,104.9
22050, 북구,005004, 3세,2018,3779,1937,1842,105.2,3765,1929,1836,105.1
22050, 북구,005005, 4세,2018,3741,1899,1842,103.1,3725,1891,1834,103.1
22050, 북구,010,5~9세,2018,19584,10081,9503,106.1,19540,10064,9476,106.2
22050, 북구,010001, 5세,2018,3822,1957,1865,104.9,3810,1953,1857,105.2
22050, 북구,010002, 6세,2018,4142,2124,2018,105.3,4133,2120,2013,105.3
22050, 북구,010003, 7세,2018,4041,2099,1942,108.1,4033,2097,1936,108.3
22050, 북구,010004, 8세,2018,3848,1991,1857,107.2,3838,1986,1852,107.2
22050, 북구,010005, 9세,2018,3731,1910,1821,104.9,3726,1908,1818,105
22050, 북구,015,10~14세,2018,20835,10806,10029,107.7,20811,10793,10018,107.7
22050, 북구,015001, 10세,2018,4092,2123,1969,107.8,4090,2123,1967,107.9
22050, 북구,015002, 11세,2018,4323,2213,2110,104.9,4317,2207,2110,104.6
22050, 북구,015003, 12세,2018,3948,2046,1902,107.6,3947,2045,1902,107.5
22050, 북구,015004, 13세,2018,4008,2054,1954,105.1,4000,2051,1949,105.2
22050, 북구,015005, 14세,2018,4464,2370,2094,113.2,4457,2367,2090,113.3
22050, 북구,020,15~19세,2018,27849,14414,13435,107.3,27558,14299,13259,107.8
22050, 북구,020001, 15세,2018,4633,2428,2205,110.1,4629,2428,2201,110.3
22050, 북구,020002, 16세,2018,4613,2409,2204,109.3,4604,2406,2198,109.5
22050, 북구,020003, 17세,2018,5320,2762,2558,108,5308,2758,2550,108.2
22050, 북구,020004, 18세,2018,6339,3321,3018,110,6281,3295,2986,110.3
22050, 북구,020005, 19세,2018,6944,3494,3450,101.3,6736,3412,3324,102.6
22050, 북구,025,20~24세,2018,36915,19751,17164,115.1,35555,19080,16475,115.8
22050, 북구,025001, 20세,2018,7084,3511,3573,98.3,6822,3396,3426,99.1
22050, 북구,025002, 21세,2018,7505,3756,3749,100.2,7257,3633,3624,100.2
22050, 북구,025003, 22세,2018,7639,4199,3440,122.1,7360,4052,3308,122.5
22050, 북구,025004, 23세,2018,7401,4126,3275,126,7101,3975,3126,127.2
22050, 북구,025005, 24세,2018,7286,4159,3127,133,7015,4024,2991,134.5
22050, 북구,030,25~29세,2018,29497,16506,12991,127.1,28327,15914,12413,128.2
22050, 북구,030001, 25세,2018,6777,3913,2864,136.6,6491,3761,2730,137.8
22050, 북구,030002, 26세,2018,6334,3640,2694,135.1,6120,3528,2592,136.1
22050, 북구,030003, 27세,2018,5791,3171,2620,121,5554,3068,2486,123.4
22050, 북구,030004, 28세,2018,5442,2981,2461,121.1,5196,2851,2345,121.6
22050, 북구,030005, 29세,2018,5153,2801,2352,119.1,4966,2706,2260,119.7
22050, 북구,035,30~34세,2018,25449,13579,11870,114.4,24432,13007,11425,113.8
22050, 북구,035001, 30세,2018,4919,2687,2232,120.4,4707,2581,2126,121.4
22050, 북구,035002, 31세,2018,5066,2673,2393,111.7,4850,2552,2298,111.1
22050, 북구,035003, 32세,2018,5133,2749,2384,115.3,4904,2630,2274,115.7
22050, 북구,035004, 33세,2018,4942,2660,2282,116.6,4754,2544,2210,115.1
22050, 북구,035005, 34세,2018,5389,2810,2579,109,5217,2700,2517,107.3
22050, 북구,040,35~39세,2018,32626,16350,16276,100.5,31964,15978,15986,99.9
22050, 북구,040001, 35세,2018,5956,3000,2956,101.5,5800,2917,2883,101.2
22050, 북구,040002, 36세,2018,6482,3281,3201,102.5,6337,3191,3146,101.4
22050, 북구,040003, 37세,2018,6758,3370,3388,99.5,6624,3296,3328,99
22050, 북구,040004, 38세,2018,6906,3449,3457,99.8,6797,3389,3408,99.4
22050, 북구,040005, 39세,2018,6524,3250,3274,99.3,6406,3185,3221,98.9
22050, 북구,045,40~44세,2018,34397,16906,17491,96.7,33943,16650,17293,96.3
22050, 북구,045001, 40세,2018,6073,3020,3053,98.9,5981,2964,3017,98.2
22050, 북구,045002, 41세,2018,6519,3207,3312,96.8,6432,3161,3271,96.6
22050, 북구,045003, 42세,2018,6563,3249,3314,98,6468,3188,3280,97.2
22050, 북구,045004, 43세,2018,7226,3504,3722,94.1,7144,3461,3683,94
22050, 북구,045005, 44세,2018,8016,3926,4090,96,7918,3876,4042,95.9
22050, 북구,050,45~49세,2018,41588,20453,21135,96.8,41207,20252,20955,96.6
22050, 북구,050001, 45세,2018,8007,3894,4113,94.7,7939,3856,4083,94.4
22050, 북구,050002, 46세,2018,8245,4065,4180,97.2,8163,4016,4147,96.8
22050, 북구,050003, 47세,2018,8501,4188,4313,97.1,8421,4143,4278,96.8
22050, 북구,050004, 48세,2018,8454,4148,4306,96.3,8378,4114,4264,96.5
22050, 북구,050005, 49세,2018,8381,4158,4223,98.5,8306,4123,4183,98.6
22050, 북구,055,50~54세,2018,38175,19036,19139,99.5,37897,18903,18994,99.5
22050, 북구,055001, 50세,2018,8546,4302,4244,101.4,8478,4267,4211,101.3
22050, 북구,055002, 51세,2018,7814,3840,3974,96.6,7764,3817,3947,96.7
22050, 북구,055003, 52세,2018,7552,3864,3688,104.8,7498,3841,3657,105
22050, 북구,055004, 53세,2018,7464,3635,3829,94.9,7411,3609,3802,94.9
22050, 북구,055005, 54세,2018,6799,3395,3404,99.7,6746,3369,3377,99.8
22050, 북구,060,55~59세,2018,37112,18534,18578,99.8,36898,18422,18476,99.7
22050, 북구,060001, 55세,2018,7277,3635,3642,99.8,7210,3605,3605,100
22050, 북구,060002, 56세,2018,7494,3812,3682,103.5,7443,3785,3658,103.5
22050, 북구,060003, 57세,2018,8052,3989,4063,98.2,8034,3980,4054,98.2
22050, 북구,060004, 58세,2018,7593,3729,3864,96.5,7556,3709,3847,96.4
22050, 북구,060005, 59세,2018,6696,3369,3327,101.3,6655,3343,3312,100.9
22050, 북구,065,60~64세,2018,27116,13514,13602,99.4,26985,13454,13531,99.4
22050, 북구,065001, 60세,2018,5991,3061,2930,104.5,5966,3047,2919,104.4
22050, 북구,065002, 61세,2018,5849,2981,2868,103.9,5820,2969,2851,104.1
22050, 북구,065003, 62세,2018,5448,2716,2732,99.4,5424,2703,2721,99.3
22050, 북구,065004, 63세,2018,5304,2534,2770,91.5,5283,2528,2755,91.8
22050, 북구,065005, 64세,2018,4524,2222,2302,96.5,4492,2207,2285,96.6
22050, 북구,070,65~69세,2018,19215,8987,10228,87.9,19139,8950,10189,87.8
22050, 북구,070001, 65세,2018,4246,1983,2263,87.6,4221,1973,2248,87.8
22050, 북구,070002, 66세,2018,4408,2106,2302,91.5,4392,2097,2295,91.4
22050, 북구,070003, 67세,2018,3445,1624,1821,89.2,3430,1617,1813,89.2
22050, 북구,070004, 68세,2018,3425,1589,1836,86.5,3416,1584,1832,86.5
22050, 북구,070005, 69세,2018,3691,1685,2006,84,3680,1679,2001,83.9
22050, 북구,075,70~74세,2018,13688,5965,7723,77.2,13663,5952,7711,77.2
22050, 북구,075001, 70세,2018,3495,1575,1920,82,3489,1571,1918,81.9
22050, 북구,075002, 71세,2018,3157,1421,1736,81.9,3153,1420,1733,81.9
22050, 북구,075003, 72세,2018,2175,963,1212,79.5,2168,961,1207,79.6
22050, 북구,075004, 73세,2018,2265,970,1295,74.9,2259,966,1293,74.7
22050, 북구,075005, 74세,2018,2596,1036,1560,66.4,2594,1034,1560,66.3
22050, 북구,080,75~79세,2018,12349,5086,7263,70,12334,5079,7255,70
22050, 북구,080001, 75세,2018,2645,1120,1525,73.4,2639,1117,1522,73.4
22050, 북구,080002, 76세,2018,3016,1323,1693,78.1,3016,1323,1693,78.1
22050, 북구,080003, 77세,2018,2391,959,1432,67,2385,956,1429,66.9
22050, 북구,080004, 78세,2018,2206,850,1356,62.7,2203,849,1354,62.7
22050, 북구,080005, 79세,2018,2091,834,1257,66.3,2091,834,1257,66.3
22050, 북구,085,80~84세,2018,7070,2509,4561,55,7064,2506,4558,55
22050, 북구,085001, 80세,2018,1716,663,1053,63,1715,662,1053,62.9
22050, 북구,085002, 81세,2018,1544,573,971,59,1541,572,969,59
22050, 북구,085003, 82세,2018,1378,485,893,54.3,1378,485,893,54.3
22050, 북구,085004, 83세,2018,1312,443,869,51,1311,442,869,50.9
22050, 북구,085005, 84세,2018,1120,345,775,44.5,1119,345,774,44.6
22050, 북구,090,85~89세,2018,2965,811,2154,37.7,2960,810,2150,37.7
22050, 북구,090001, 85세,2018,864,267,597,44.7,862,267,595,44.9
22050, 북구,090002, 86세,2018,723,221,502,44,722,221,501,44.1
22050, 북구,090003, 87세,2018,557,137,420,32.6,556,137,419,32.7
22050, 북구,090004, 88세,2018,472,95,377,25.2,471,94,377,24.9
22050, 북구,090005, 89세,2018,349,91,258,35.3,349,91,258,35.3
22050, 북구,095,90~94세,2018,869,175,694,25.2,869,175,694,25.2
22050, 북구,095001, 90세,2018,291,62,229,27.1,291,62,229,27.1
22050, 북구,095002, 91세,2018,248,56,192,29.2,248,56,192,29.2
22050, 북구,095003, 92세,2018,127,23,104,22.1,127,23,104,22.1
22050, 북구,095004, 93세,2018,137,27,110,24.5,137,27,110,24.5
22050, 북구,095005, 94세,2018,66,7,59,11.9,66,7,59,11.9
22050, 북구,100,95~99세,2018,204,31,173,17.9,204,31,173,17.9
22050, 북구,100001, 95세,2018,72,9,63,14.3,72,9,63,14.3
22050, 북구,100002, 96세,2018,60,14,46,30.4,60,14,46,30.4
22050, 북구,100003, 97세,2018,27,X,25,8,27,X,25,8
22050, 북구,100004, 98세,2018,31,X,27,14.8,31,X,27,14.8
22050, 북구,100005, 99세,2018,14,X,12,16.7,14,X,12,16.7
22050, 북구,101,100세이상,2018,17,X,16,6.3,17,X,16,6.3
22050, 북구,102,15세미만,2018,57658,29640,28018,105.8,57509,29559,27950,105.8
22050, 북구,103,15~64세,2018,330724,169043,161681,104.6,324766,165959,158807,104.5
22050, 북구,104,65세이상,2018,56377,23565,32812,71.8,56250,23504,32746,71.8
22050, 북구,086,85세이상,2018,4055,1018,3037,33.5,4050,1017,3033,33.5
22050, 북구,126,평균연령,2018,40.7,39.4,41.9,,40.8,39.5,42,
22050, 북구,127,중위연령,2018,42,40.3,43.5,,42.2,40.6,43.7,
22060, 수성구,000,합계,2018,418834,204032,214802,95,416581,203033,213548,95.1
22060, 수성구,005,0~4세,2018,12123,6261,5862,106.8,12098,6249,5849,106.8
22060, 수성구,005001, 0세,2018,1757,901,856,105.3,1753,899,854,105.3
22060, 수성구,005002, 1세,2018,2093,1071,1022,104.8,2084,1068,1016,105.1
22060, 수성구,005003, 2세,2018,2517,1325,1192,111.2,2511,1322,1189,111.2
22060, 수성구,005004, 3세,2018,2737,1415,1322,107,2735,1413,1322,106.9
22060, 수성구,005005, 4세,2018,3019,1549,1470,105.4,3015,1547,1468,105.4
22060, 수성구,010,5~9세,2018,18952,9746,9206,105.9,18924,9731,9193,105.9
22060, 수성구,010001, 5세,2018,3253,1649,1604,102.8,3247,1645,1602,102.7
22060, 수성구,010002, 6세,2018,3774,1922,1852,103.8,3768,1918,1850,103.7
22060, 수성구,010003, 7세,2018,3930,2019,1911,105.7,3923,2016,1907,105.7
22060, 수성구,010004, 8세,2018,3952,2028,1924,105.4,3948,2026,1922,105.4
22060, 수성구,010005, 9세,2018,4043,2128,1915,111.1,4038,2126,1912,111.2
22060, 수성구,015,10~14세,2018,24444,12846,11598,110.8,24419,12833,11586,110.8
22060, 수성구,015001, 10세,2018,4551,2366,2185,108.3,4547,2365,2182,108.4
22060, 수성구,015002, 11세,2018,4820,2493,2327,107.1,4816,2490,2326,107.1
22060, 수성구,015003, 12세,2018,4830,2577,2253,114.4,4825,2575,2250,114.4
22060, 수성구,015004, 13세,2018,4854,2549,2305,110.6,4850,2547,2303,110.6
22060, 수성구,015005, 14세,2018,5389,2861,2528,113.2,5381,2856,2525,113.1
22060, 수성구,020,15~19세,2018,29872,16058,13814,116.2,29786,16024,13762,116.4
22060, 수성구,020001, 15세,2018,5614,3060,2554,119.8,5611,3059,2552,119.9
22060, 수성구,020002, 16세,2018,5501,2925,2576,113.5,5493,2923,2570,113.7
22060, 수성구,020003, 17세,2018,6519,3516,3003,117.1,6512,3515,2997,117.3
22060, 수성구,020004, 18세,2018,6751,3651,3100,117.8,6740,3648,3092,118
22060, 수성구,020005, 19세,2018,5487,2906,2581,112.6,5430,2879,2551,112.9
22060, 수성구,025,20~24세,2018,28329,15544,12785,121.6,27996,15398,12598,122.2
22060, 수성구,025001, 20세,2018,5598,3121,2477,126,5514,3079,2435,126.4
22060, 수성구,025002, 21세,2018,5783,3236,2547,127.1,5722,3211,2511,127.9
22060, 수성구,025003, 22세,2018,5791,3218,2573,125.1,5746,3197,2549,125.4
22060, 수성구,025004, 23세,2018,5621,2998,2623,114.3,5546,2965,2581,114.9
22060, 수성구,025005, 24세,2018,5536,2971,2565,115.8,5468,2946,2522,116.8
22060, 수성구,030,25~29세,2018,23548,12534,11014,113.8,23151,12385,10766,115
22060, 수성구,030001, 25세,2018,5170,2787,2383,117,5083,2761,2322,118.9
22060, 수성구,030002, 26세,2018,5145,2747,2398,114.6,5061,2711,2350,115.4
22060, 수성구,030003, 27세,2018,4801,2538,2263,112.2,4723,2505,2218,112.9
22060, 수성구,030004, 28세,2018,4408,2298,2110,108.9,4330,2267,2063,109.9
22060, 수성구,030005, 29세,2018,4024,2164,1860,116.3,3954,2141,1813,118.1
22060, 수성구,035,30~34세,2018,17910,9145,8765,104.3,17596,9015,8581,105.1
22060, 수성구,035001, 30세,2018,3527,1900,1627,116.8,3469,1872,1597,117.2
22060, 수성구,035002, 31세,2018,3521,1792,1729,103.6,3457,1778,1679,105.9
22060, 수성구,035003, 32세,2018,3464,1781,1683,105.8,3404,1756,1648,106.6
22060, 수성구,035004, 33세,2018,3571,1799,1772,101.5,3510,1767,1743,101.4
22060, 수성구,035005, 34세,2018,3827,1873,1954,95.9,3756,1842,1914,96.2
22060, 수성구,040,35~39세,2018,26289,12015,14274,84.2,26021,11886,14135,84.1
22060, 수성구,040001, 35세,2018,4402,2049,2353,87.1,4329,2021,2308,87.6
22060, 수성구,040002, 36세,2018,5072,2343,2729,85.9,5012,2314,2698,85.8
22060, 수성구,040003, 37세,2018,5288,2373,2915,81.4,5240,2349,2891,81.3
22060, 수성구,040004, 38세,2018,5720,2620,3100,84.5,5679,2600,3079,84.4
22060, 수성구,040005, 39세,2018,5807,2630,3177,82.8,5761,2602,3159,82.4
22060, 수성구,045,40~44세,2018,32846,14698,18148,81,32676,14611,18065,80.9
22060, 수성구,045001, 40세,2018,5523,2490,3033,82.1,5482,2471,3011,82.1
22060, 수성구,045002, 41세,2018,6035,2715,3320,81.8,6002,2701,3301,81.8
22060, 수성구,045003, 42세,2018,6454,2947,3507,84,6421,2927,3494,83.8
22060, 수성구,045004, 43세,2018,6955,3062,3893,78.7,6930,3049,3881,78.6
22060, 수성구,045005, 44세,2018,7879,3484,4395,79.3,7841,3463,4378,79.1
22060, 수성구,050,45~49세,2018,43375,20187,23188,87.1,43193,20101,23092,87
22060, 수성구,050001, 45세,2018,8186,3660,4526,80.9,8141,3633,4508,80.6
22060, 수성구,050002, 46세,2018,8513,3949,4564,86.5,8485,3936,4549,86.5
22060, 수성구,050003, 47세,2018,9065,4267,4798,88.9,9033,4255,4778,89.1
22060, 수성구,050004, 48세,2018,8905,4155,4750,87.5,8864,4136,4728,87.5
22060, 수성구,050005, 49세,2018,8706,4156,4550,91.3,8670,4141,4529,91.4
22060, 수성구,055,50~54세,2018,38830,19137,19693,97.2,38666,19061,19605,97.2
22060, 수성구,055001, 50세,2018,8834,4317,4517,95.6,8804,4300,4504,95.5
22060, 수성구,055002, 51세,2018,8083,3943,4140,95.2,8042,3926,4116,95.4
22060, 수성구,055003, 52세,2018,7362,3723,3639,102.3,7334,3711,3623,102.4
22060, 수성구,055004, 53세,2018,7493,3638,3855,94.4,7462,3623,3839,94.4
22060, 수성구,055005, 54세,2018,7058,3516,3542,99.3,7024,3501,3523,99.4
22060, 수성구,060,55~59세,2018,35403,17365,18038,96.3,35279,17311,17968,96.3
22060, 수성구,060001, 55세,2018,7203,3533,3670,96.3,7176,3522,3654,96.4
22060, 수성구,060002, 56세,2018,7039,3480,3559,97.8,7014,3467,3547,97.7
22060, 수성구,060003, 57세,2018,7326,3574,3752,95.3,7308,3566,3742,95.3
22060, 수성구,060004, 58세,2018,7224,3552,3672,96.7,7202,3544,3658,96.9
22060, 수성구,060005, 59세,2018,6611,3226,3385,95.3,6579,3212,3367,95.4
22060, 수성구,065,60~64세,2018,27118,13154,13964,94.2,27050,13121,13929,94.2
22060, 수성구,065001, 60세,2018,5725,2796,2929,95.5,5709,2788,2921,95.4
22060, 수성구,065002, 61세,2018,6001,2931,3070,95.5,5983,2923,3060,95.5
22060, 수성구,065003, 62세,2018,5477,2645,2832,93.4,5464,2638,2826,93.3
22060, 수성구,065004, 63세,2018,5434,2618,2816,93,5427,2614,2813,92.9
22060, 수성구,065005, 64세,2018,4481,2164,2317,93.4,4467,2158,2309,93.5
22060, 수성구,070,65~69세,2018,19738,9133,10605,86.1,19700,9116,10584,86.1
22060, 수성구,070001, 65세,2018,4460,2047,2413,84.8,4451,2042,2409,84.8
22060, 수성구,070002, 66세,2018,4485,2109,2376,88.8,4473,2104,2369,88.8
22060, 수성구,070003, 67세,2018,3463,1609,1854,86.8,3459,1607,1852,86.8
22060, 수성구,070004, 68세,2018,3593,1667,1926,86.6,3586,1663,1923,86.5
22060, 수성구,070005, 69세,2018,3737,1701,2036,83.5,3731,1700,2031,83.7
22060, 수성구,075,70~74세,2018,14122,6318,7804,81,14104,6308,7796,80.9
22060, 수성구,075001, 70세,2018,3486,1570,1916,81.9,3483,1569,1914,82
22060, 수성구,075002, 71세,2018,3392,1510,1882,80.2,3385,1506,1879,80.1
22060, 수성구,075003, 72세,2018,2231,1032,1199,86.1,2230,1031,1199,86
22060, 수성구,075004, 73세,2018,2348,1027,1321,77.7,2344,1026,1318,77.8
22060, 수성구,075005, 74세,2018,2665,1179,1486,79.3,2662,1176,1486,79.1
22060, 수성구,080,75~79세,2018,12730,5397,7333,73.6,12725,5394,7331,73.6
22060, 수성구,080001, 75세,2018,2881,1246,1635,76.2,2879,1245,1634,76.2
22060, 수성구,080002, 76세,2018,2963,1297,1666,77.9,2963,1297,1666,77.9
22060, 수성구,080003, 77세,2018,2474,1049,1425,73.6,2472,1048,1424,73.6
22060, 수성구,080004, 78세,2018,2240,893,1347,66.3,2239,892,1347,66.2
22060, 수성구,080005, 79세,2018,2172,912,1260,72.4,2172,912,1260,72.4
22060, 수성구,085,80~84세,2018,8195,3068,5127,59.8,8192,3067,5125,59.8
22060, 수성구,085001, 80세,2018,1990,765,1225,62.4,1990,765,1225,62.4
22060, 수성구,085002, 81세,2018,1767,681,1086,62.7,1767,681,1086,62.7
22060, 수성구,085003, 82세,2018,1618,603,1015,59.4,1616,603,1013,59.5
22060, 수성구,085004, 83세,2018,1555,555,1000,55.5,1555,555,1000,55.5
22060, 수성구,085005, 84세,2018,1265,464,801,57.9,1264,463,801,57.8
22060, 수성구,090,85~89세,2018,3729,1123,2606,43.1,3726,1121,2605,43
22060, 수성구,090001, 85세,2018,1064,350,714,49,1062,349,713,48.9
22060, 수성구,090002, 86세,2018,938,304,634,47.9,938,304,634,47.9
22060, 수성구,090003, 87세,2018,697,200,497,40.2,697,200,497,40.2
22060, 수성구,090004, 88세,2018,545,144,401,35.9,544,143,401,35.7
22060, 수성구,090005, 89세,2018,485,125,360,34.7,485,125,360,34.7
22060, 수성구,095,90~94세,2018,1067,252,815,30.9,1066,251,815,30.8
22060, 수성구,095001, 90세,2018,367,85,282,30.1,367,85,282,30.1
22060, 수성구,095002, 91세,2018,274,68,206,33,273,67,206,32.5
22060, 수성구,095003, 92세,2018,169,45,124,36.3,169,45,124,36.3
22060, 수성구,095004, 93세,2018,156,40,116,34.5,156,40,116,34.5
22060, 수성구,095005, 94세,2018,101,14,87,16.1,101,14,87,16.1
22060, 수성구,100,95~99세,2018,185,47,138,34.1,185,47,138,34.1
22060, 수성구,100001, 95세,2018,64,20,44,45.5,64,20,44,45.5
22060, 수성구,100002, 96세,2018,49,14,35,40,49,14,35,40
22060, 수성구,100003, 97세,2018,30,X,26,15.4,30,X,26,15.4
22060, 수성구,100004, 98세,2018,24,X,21,14.3,24,X,21,14.3
22060, 수성구,100005, 99세,2018,18,6,12,50,18,6,12,50
22060, 수성구,101,100세이상,2018,29,X,25,16,28,X,25,12
22060, 수성구,102,15세미만,2018,55519,28853,26666,108.2,55441,28813,26628,108.2
22060, 수성구,103,15~64세,2018,303520,149837,153683,97.5,301414,148913,152501,97.6
22060, 수성구,104,65세이상,2018,59795,25342,34453,73.6,59726,25307,34419,73.5
22060, 수성구,086,85세이상,2018,5010,1426,3584,39.8,5005,1422,3583,39.7
22060, 수성구,126,평균연령,2018,41.9,40.4,43.2,,41.9,40.5,43.3,
22060, 수성구,127,중위연령,2018,44.4,42.9,45.4,,44.4,43,45.5,
22070, 달서구,000,합계,2018,576746,287606,289140,99.5,565569,280727,284842,98.6
22070, 달서구,005,0~4세,2018,20142,10433,9709,107.5,20008,10364,9644,107.5
22070, 달서구,005001, 0세,2018,3141,1613,1528,105.6,3124,1605,1519,105.7
22070, 달서구,005002, 1세,2018,3621,1950,1671,116.7,3589,1937,1652,117.3
22070, 달서구,005003, 2세,2018,4260,2235,2025,110.4,4226,2217,2009,110.4
22070, 달서구,005004, 3세,2018,4615,2355,2260,104.2,4588,2336,2252,103.7
22070, 달서구,005005, 4세,2018,4505,2280,2225,102.5,4481,2269,2212,102.6
22070, 달서구,010,5~9세,2018,24916,12796,12120,105.6,24835,12760,12075,105.7
22070, 달서구,010001, 5세,2018,4578,2329,2249,103.6,4561,2320,2241,103.5
22070, 달서구,010002, 6세,2018,5234,2637,2597,101.5,5214,2625,2589,101.4
22070, 달서구,010003, 7세,2018,5083,2602,2481,104.9,5072,2598,2474,105
22070, 달서구,010004, 8세,2018,5088,2597,2491,104.3,5075,2593,2482,104.5
22070, 달서구,010005, 9세,2018,4933,2631,2302,114.3,4913,2624,2289,114.6
22070, 달서구,015,10~14세,2018,26447,13693,12754,107.4,26404,13672,12732,107.4
22070, 달서구,015001, 10세,2018,5196,2714,2482,109.3,5184,2709,2475,109.5
22070, 달서구,015002, 11세,2018,5393,2723,2670,102,5381,2718,2663,102.1
22070, 달서구,015003, 12세,2018,5017,2603,2414,107.8,5012,2600,2412,107.8
22070, 달서구,015004, 13세,2018,5148,2682,2466,108.8,5143,2681,2462,108.9
22070, 달서구,015005, 14세,2018,5693,2971,2722,109.1,5684,2964,2720,109
22070, 달서구,020,15~19세,2018,36141,19032,17109,111.2,35701,18803,16898,111.3
22070, 달서구,020001, 15세,2018,5855,3083,2772,111.2,5854,3082,2772,111.2
22070, 달서구,020002, 16세,2018,6204,3286,2918,112.6,6186,3277,2909,112.7
22070, 달서구,020003, 17세,2018,7407,3828,3579,107,7378,3818,3560,107.2
22070, 달서구,020004, 18세,2018,8571,4547,4024,113,8457,4493,3964,113.3
22070, 달서구,020005, 19세,2018,8104,4288,3816,112.4,7826,4133,3693,111.9
22070, 달서구,025,20~24세,2018,44014,23540,20474,115,42148,22469,19679,114.2
22070, 달서구,025001, 20세,2018,8450,4496,3954,113.7,8117,4338,3779,114.8
22070, 달서구,025002, 21세,2018,8716,4614,4102,112.5,8366,4414,3952,111.7
22070, 달서구,025003, 22세,2018,9158,4881,4277,114.1,8751,4630,4121,112.4
22070, 달서구,025004, 23세,2018,8995,4820,4175,115.4,8603,4587,4016,114.2
22070, 달서구,025005, 24세,2018,8695,4729,3966,119.2,8311,4500,3811,118.1
22070, 달서구,030,25~29세,2018,39651,21943,17708,123.9,37467,20504,16963,120.9
22070, 달서구,030001, 25세,2018,8725,4772,3953,120.7,8322,4507,3815,118.1
22070, 달서구,030002, 26세,2018,8582,4694,3888,120.7,8153,4408,3745,117.7
22070, 달서구,030003, 27세,2018,7752,4358,3394,128.4,7306,4071,3235,125.8
22070, 달서구,030004, 28세,2018,7448,4188,3260,128.5,6980,3883,3097,125.4
22070, 달서구,030005, 29세,2018,7144,3931,3213,122.3,6706,3635,3071,118.4
22070, 달서구,035,30~34세,2018,32707,17597,15110,116.5,30662,16289,14373,113.3
22070, 달서구,035001, 30세,2018,6599,3657,2942,124.3,6126,3364,2762,121.8
22070, 달서구,035002, 31세,2018,6596,3584,3012,119,6120,3285,2835,115.9
22070, 달서구,035003, 32세,2018,6382,3498,2884,121.3,5990,3238,2752,117.7
22070, 달서구,035004, 33세,2018,6419,3404,3015,112.9,6028,3153,2875,109.7
22070, 달서구,035005, 34세,2018,6711,3454,3257,106,6398,3249,3149,103.2
22070, 달서구,040,35~39세,2018,41605,20834,20771,100.3,40135,19839,20296,97.7
22070, 달서구,040001, 35세,2018,7654,3926,3728,105.3,7311,3682,3629,101.5
22070, 달서구,040002, 36세,2018,8426,4237,4189,101.1,8083,4006,4077,98.3
22070, 달서구,040003, 37세,2018,8322,4187,4135,101.3,8054,4005,4049,98.9
22070, 달서구,040004, 38세,2018,8763,4345,4418,98.3,8501,4167,4334,96.1
22070, 달서구,040005, 39세,2018,8440,4139,4301,96.2,8186,3979,4207,94.6
22070, 달서구,045,40~44세,2018,43195,21200,21995,96.4,42248,20586,21662,95
22070, 달서구,045001, 40세,2018,7860,3930,3930,100,7640,3788,3852,98.3
22070, 달서구,045002, 41세,2018,8320,4082,4238,96.3,8109,3928,4181,93.9
22070, 달서구,045003, 42세,2018,8424,4192,4232,99.1,8241,4076,4165,97.9
22070, 달서구,045004, 43세,2018,8653,4129,4524,91.3,8489,4024,4465,90.1
22070, 달서구,045005, 44세,2018,9938,4867,5071,96,9769,4770,4999,95.4
22070, 달서구,050,45~49세,2018,53741,25824,27917,92.5,52941,25318,27623,91.7
22070, 달서구,050001, 45세,2018,10053,4803,5250,91.5,9881,4686,5195,90.2
22070, 달서구,050002, 46세,2018,10365,4930,5435,90.7,10209,4834,5375,89.9
22070, 달서구,050003, 47세,2018,11172,5329,5843,91.2,10995,5213,5782,90.2
22070, 달서구,050004, 48세,2018,10844,5302,5542,95.7,10675,5205,5470,95.2
22070, 달서구,050005, 49세,2018,11307,5460,5847,93.4,11181,5380,5801,92.7
22070, 달서구,055,50~54세,2018,52905,25518,27387,93.2,52397,25240,27157,92.9
22070, 달서구,055001, 50세,2018,11550,5549,6001,92.5,11420,5474,5946,92.1
22070, 달서구,055002, 51세,2018,10765,5112,5653,90.4,10659,5052,5607,90.1
22070, 달서구,055003, 52세,2018,10321,5068,5253,96.5,10234,5025,5209,96.5
22070, 달서구,055004, 53세,2018,10449,5001,5448,91.8,10351,4952,5399,91.7
22070, 달서구,055005, 54세,2018,9820,4788,5032,95.2,9733,4737,4996,94.8
22070, 달서구,060,55~59세,2018,53107,26184,26923,97.3,52798,26022,26776,97.2
22070, 달서구,060001, 55세,2018,10466,5270,5196,101.4,10387,5223,5164,101.1
22070, 달서구,060002, 56세,2018,10600,5266,5334,98.7,10515,5227,5288,98.8
22070, 달서구,060003, 57세,2018,11457,5579,5878,94.9,11414,5556,5858,94.8
22070, 달서구,060004, 58세,2018,10874,5291,5583,94.8,10810,5255,5555,94.6
22070, 달서구,060005, 59세,2018,9710,4778,4932,96.9,9672,4761,4911,96.9
22070, 달서구,065,60~64세,2018,37875,18933,18942,100,37690,18853,18837,100.1
22070, 달서구,065001, 60세,2018,8102,4113,3989,103.1,8052,4087,3965,103.1
22070, 달서구,065002, 61세,2018,8477,4276,4201,101.8,8446,4261,4185,101.8
22070, 달서구,065003, 62세,2018,7578,3863,3715,104,7554,3855,3699,104.2
22070, 달서구,065004, 63세,2018,7575,3622,3953,91.6,7536,3605,3931,91.7
22070, 달서구,065005, 64세,2018,6143,3059,3084,99.2,6102,3045,3057,99.6
22070, 달서구,070,65~69세,2018,25775,12277,13498,91,25673,12237,13436,91.1
22070, 달서구,070001, 65세,2018,5895,2794,3101,90.1,5867,2783,3084,90.2
22070, 달서구,070002, 66세,2018,6120,2854,3266,87.4,6094,2844,3250,87.5
22070, 달서구,070003, 67세,2018,4525,2212,2313,95.6,4503,2202,2301,95.7
22070, 달서구,070004, 68세,2018,4542,2183,2359,92.5,4529,2178,2351,92.6
22070, 달서구,070005, 69세,2018,4693,2234,2459,90.8,4680,2230,2450,91
22070, 달서구,075,70~74세,2018,16791,7724,9067,85.2,16767,7711,9056,85.1
22070, 달서구,075001, 70세,2018,4382,2098,2284,91.9,4375,2094,2281,91.8
22070, 달서구,075002, 71세,2018,4037,1845,2192,84.2,4032,1842,2190,84.1
22070, 달서구,075003, 72세,2018,2658,1292,1366,94.6,2652,1289,1363,94.6
22070, 달서구,075004, 73세,2018,2679,1188,1491,79.7,2676,1187,1489,79.7
22070, 달서구,075005, 74세,2018,3035,1301,1734,75,3032,1299,1733,75
22070, 달서구,080,75~79세,2018,14130,5763,8367,68.9,14106,5751,8355,68.8
22070, 달서구,080001, 75세,2018,3071,1349,1722,78.3,3067,1348,1719,78.4
22070, 달서구,080002, 76세,2018,3464,1456,2008,72.5,3462,1454,2008,72.4
22070, 달서구,080003, 77세,2018,2708,1094,1614,67.8,2699,1090,1609,67.7
22070, 달서구,080004, 78세,2018,2465,950,1515,62.7,2463,949,1514,62.7
22070, 달서구,080005, 79세,2018,2422,914,1508,60.6,2415,910,1505,60.5
22070, 달서구,085,80~84세,2018,8616,3015,5601,53.8,8605,3011,5594,53.8
22070, 달서구,085001, 80세,2018,2099,797,1302,61.2,2096,797,1299,61.4
22070, 달서구,085002, 81세,2018,1896,672,1224,54.9,1894,671,1223,54.9
22070, 달서구,085003, 82세,2018,1777,586,1191,49.2,1776,586,1190,49.2
22070, 달서구,085004, 83세,2018,1541,531,1010,52.6,1538,530,1008,52.6
22070, 달서구,085005, 84세,2018,1303,429,874,49.1,1301,427,874,48.9
22070, 달서구,090,85~89세,2018,3729,1023,2706,37.8,3726,1021,2705,37.7
22070, 달서구,090001, 85세,2018,1037,307,730,42.1,1036,306,730,41.9
22070, 달서구,090002, 86세,2018,930,274,656,41.8,929,273,656,41.6
22070, 달서구,090003, 87세,2018,685,183,502,36.5,685,183,502,36.5
22070, 달서구,090004, 88세,2018,602,138,464,29.7,601,138,463,29.8
22070, 달서구,090005, 89세,2018,475,121,354,34.2,475,121,354,34.2
22070, 달서구,095,90~94세,2018,1057,233,824,28.3,1056,233,823,28.3
22070, 달서구,095001, 90세,2018,361,80,281,28.5,361,80,281,28.5
22070, 달서구,095002, 91세,2018,276,66,210,31.4,276,66,210,31.4
22070, 달서구,095003, 92세,2018,163,31,132,23.5,163,31,132,23.5
22070, 달서구,095004, 93세,2018,161,32,129,24.8,160,32,128,25
22070, 달서구,095005, 94세,2018,96,24,72,33.3,96,24,72,33.3
22070, 달서구,100,95~99세,2018,182,41,141,29.1,182,41,141,29.1
22070, 달서구,100001, 95세,2018,59,16,43,37.2,59,16,43,37.2
22070, 달서구,100002, 96세,2018,56,11,45,24.4,56,11,45,24.4
22070, 달서구,100003, 97세,2018,38,8,30,26.7,38,8,30,26.7
22070, 달서구,100004, 98세,2018,14,5,9,55.6,14,5,9,55.6
22070, 달서구,100005, 99세,2018,15,X,14,7.1,15,X,14,7.1
22070, 달서구,101,100세이상,2018,20,X,17,17.6,20,X,17,17.6
22070, 달서구,102,15세미만,2018,71505,36922,34583,106.8,71247,36796,34451,106.8
22070, 달서구,103,15~64세,2018,434941,220605,214336,102.9,424187,213923,210264,101.7
22070, 달서구,104,65세이상,2018,70300,30079,40221,74.8,70135,30008,40127,74.8
22070, 달서구,086,85세이상,2018,4988,1300,3688,35.2,4984,1298,3686,35.2
22070, 달서구,126,평균연령,2018,41.1,39.9,42.3,,41.2,40,42.4,
22070, 달서구,127,중위연령,2018,42.8,41,44.4,,43.2,41.5,44.6,
22310, 달성군,000,합계,2018,250753,128469,122284,105.1,243009,123305,119704,103
22310, 달성군,005,0~4세,2018,15534,7785,7749,100.5,15399,7735,7664,100.9
22310, 달성군,005001, 0세,2018,2854,1429,1425,100.3,2825,1417,1408,100.6
22310, 달성군,005002, 1세,2018,2995,1499,1496,100.2,2963,1485,1478,100.5
22310, 달성군,005003, 2세,2018,3321,1661,1660,100.1,3296,1651,1645,100.4
22310, 달성군,005004, 3세,2018,3236,1622,1614,100.5,3213,1616,1597,101.2
22310, 달성군,005005, 4세,2018,3128,1574,1554,101.3,3102,1566,1536,102
22310, 달성군,010,5~9세,2018,14437,7383,7054,104.7,14347,7335,7012,104.6
22310, 달성군,010001, 5세,2018,3037,1578,1459,108.2,3014,1565,1449,108
22310, 달성군,010002, 6세,2018,3152,1601,1551,103.2,3140,1597,1543,103.5
22310, 달성군,010003, 7세,2018,3028,1539,1489,103.4,3002,1525,1477,103.2
22310, 달성군,010004, 8세,2018,2743,1409,1334,105.6,2734,1401,1333,105.1
22310, 달성군,010005, 9세,2018,2477,1256,1221,102.9,2457,1247,1210,103.1
22310, 달성군,015,10~14세,2018,11332,5852,5480,106.8,11267,5820,5447,106.8
22310, 달성군,015001, 10세,2018,2525,1326,1199,110.6,2511,1317,1194,110.3
22310, 달성군,015002, 11세,2018,2421,1208,1213,99.6,2407,1203,1204,99.9
22310, 달성군,015003, 12세,2018,2112,1120,992,112.9,2097,1114,983,113.3
22310, 달성군,015004, 13세,2018,2166,1125,1041,108.1,2152,1119,1033,108.3
22310, 달성군,015005, 14세,2018,2108,1073,1035,103.7,2100,1067,1033,103.3
22310, 달성군,020,15~19세,2018,11602,6324,5278,119.8,11536,6290,5246,119.9
22310, 달성군,020001, 15세,2018,2223,1211,1012,119.7,2211,1205,1006,119.8
22310, 달성군,020002, 16세,2018,2165,1176,989,118.9,2158,1171,987,118.6
22310, 달성군,020003, 17세,2018,2540,1343,1197,112.2,2531,1337,1194,112
22310, 달성군,020004, 18세,2018,2528,1352,1176,115,2511,1346,1165,115.5
22310, 달성군,020005, 19세,2018,2146,1242,904,137.4,2125,1231,894,137.7
22310, 달성군,025,20~24세,2018,13832,8007,5825,137.5,13178,7579,5599,135.4
22310, 달성군,025001, 20세,2018,2539,1508,1031,146.3,2494,1486,1008,147.4
22310, 달성군,025002, 21세,2018,2817,1636,1181,138.5,2719,1584,1135,139.6
22310, 달성군,025003, 22세,2018,2838,1668,1170,142.6,2702,1576,1126,140
22310, 달성군,025004, 23세,2018,2830,1621,1209,134.1,2642,1490,1152,129.3
22310, 달성군,025005, 24세,2018,2808,1574,1234,127.6,2621,1443,1178,122.5
22310, 달성군,030,25~29세,2018,16498,9281,7217,128.6,14908,8116,6792,119.5
22310, 달성군,030001, 25세,2018,3056,1758,1298,135.4,2819,1578,1241,127.2
22310, 달성군,030002, 26세,2018,3305,1823,1482,123,3011,1607,1404,114.5
22310, 달성군,030003, 27세,2018,3286,1870,1416,132.1,2931,1610,1321,121.9
22310, 달성군,030004, 28세,2018,3376,1877,1499,125.2,3039,1642,1397,117.5
22310, 달성군,030005, 29세,2018,3475,1953,1522,128.3,3108,1679,1429,117.5
22310, 달성군,035,30~34세,2018,19935,10738,9197,116.8,18239,9493,8746,108.5
22310, 달성군,035001, 30세,2018,3566,1952,1614,120.9,3183,1669,1514,110.2
22310, 달성군,035002, 31세,2018,3849,2035,1814,112.2,3483,1778,1705,104.3
22310, 달성군,035003, 32세,2018,4036,2196,1840,119.3,3699,1944,1755,110.8
22310, 달성군,035004, 33세,2018,4139,2212,1927,114.8,3830,1990,1840,108.2
22310, 달성군,035005, 34세,2018,4345,2343,2002,117,4044,2112,1932,109.3
22310, 달성군,040,35~39세,2018,25553,13316,12237,108.8,24364,12482,11882,105
22310, 달성군,040001, 35세,2018,4932,2525,2407,104.9,4645,2320,2325,99.8
22310, 달성군,040002, 36세,2018,5328,2763,2565,107.7,5067,2572,2495,103.1
22310, 달성군,040003, 37세,2018,5226,2755,2471,111.5,4999,2605,2394,108.8
22310, 달성군,040004, 38세,2018,5323,2781,2542,109.4,5104,2633,2471,106.6
22310, 달성군,040005, 39세,2018,4744,2492,2252,110.7,4549,2352,2197,107.1
22310, 달성군,045,40~44세,2018,20718,11098,9620,115.4,20013,10629,9384,113.3
22310, 달성군,045001, 40세,2018,4260,2260,2000,113,4059,2122,1937,109.6
22310, 달성군,045002, 41세,2018,4257,2291,1966,116.5,4109,2198,1911,115
22310, 달성군,045003, 42세,2018,3925,2136,1789,119.4,3803,2053,1750,117.3
22310, 달성군,045004, 43세,2018,4044,2143,1901,112.7,3928,2063,1865,110.6
22310, 달성군,045005, 44세,2018,4232,2268,1964,115.5,4114,2193,1921,114.2
22310, 달성군,050,45~49세,2018,20146,10316,9830,104.9,19580,9972,9608,103.8
22310, 달성군,050001, 45세,2018,4004,2094,1910,109.6,3883,2016,1867,108
22310, 달성군,050002, 46세,2018,4020,2124,1896,112,3897,2041,1856,110
22310, 달성군,050003, 47세,2018,4079,2112,1967,107.4,3968,2051,1917,107
22310, 달성군,050004, 48세,2018,4047,2045,2002,102.1,3934,1985,1949,101.8
22310, 달성군,050005, 49세,2018,3996,1941,2055,94.5,3898,1879,2019,93.1
22310, 달성군,055,50~54세,2018,19125,9504,9621,98.8,18699,9272,9427,98.4
22310, 달성군,055001, 50세,2018,4095,2028,2067,98.1,3997,1977,2020,97.9
22310, 달성군,055002, 51세,2018,3858,1886,1972,95.6,3773,1847,1926,95.9
22310, 달성군,055003, 52세,2018,3780,1888,1892,99.8,3699,1839,1860,98.9
22310, 달성군,055004, 53세,2018,3821,1879,1942,96.8,3735,1827,1908,95.8
22310, 달성군,055005, 54세,2018,3571,1823,1748,104.3,3495,1782,1713,104
22310, 달성군,060,55~59세,2018,19558,9756,9802,99.5,19291,9621,9670,99.5
22310, 달성군,060001, 55세,2018,3713,1837,1876,97.9,3645,1806,1839,98.2
22310, 달성군,060002, 56세,2018,4054,2047,2007,102,3996,2017,1979,101.9
22310, 달성군,060003, 57세,2018,4228,2113,2115,99.9,4186,2094,2092,100.1
22310, 달성군,060004, 58세,2018,3918,1930,1988,97.1,3860,1900,1960,96.9
22310, 달성군,060005, 59세,2018,3645,1829,1816,100.7,3604,1804,1800,100.2
22310, 달성군,065,60~64세,2018,14290,7152,7138,100.2,14130,7062,7068,99.9
22310, 달성군,065001, 60세,2018,3176,1599,1577,101.4,3141,1577,1564,100.8
22310, 달성군,065002, 61세,2018,3151,1597,1554,102.8,3103,1569,1534,102.3
22310, 달성군,065003, 62세,2018,2914,1480,1434,103.2,2887,1464,1423,102.9
22310, 달성군,065004, 63세,2018,2792,1344,1448,92.8,2762,1330,1432,92.9
22310, 달성군,065005, 64세,2018,2257,1132,1125,100.6,2237,1122,1115,100.6
22310, 달성군,070,65~69세,2018,9894,4842,5052,95.8,9808,4802,5006,95.9
22310, 달성군,070001, 65세,2018,2181,1056,1125,93.9,2155,1043,1112,93.8
22310, 달성군,070002, 66세,2018,2358,1150,1208,95.2,2338,1142,1196,95.5
22310, 달성군,070003, 67세,2018,1751,861,890,96.7,1733,851,882,96.5
22310, 달성군,070004, 68세,2018,1783,879,904,97.2,1771,875,896,97.7
22310, 달성군,070005, 69세,2018,1821,896,925,96.9,1811,891,920,96.8
22310, 달성군,075,70~74세,2018,6473,3084,3389,91,6445,3069,3376,90.9
22310, 달성군,075001, 70세,2018,1670,820,850,96.5,1663,814,849,95.9
22310, 달성군,075002, 71세,2018,1516,720,796,90.5,1511,720,791,91
22310, 달성군,075003, 72세,2018,1048,511,537,95.2,1038,506,532,95.1
22310, 달성군,075004, 73세,2018,1044,482,562,85.8,1041,480,561,85.6
22310, 달성군,075005, 74세,2018,1195,551,644,85.6,1192,549,643,85.4
22310, 달성군,080,75~79세,2018,5612,2145,3467,61.9,5603,2144,3459,62
22310, 달성군,080001, 75세,2018,1195,495,700,70.7,1193,495,698,70.9
22310, 달성군,080002, 76세,2018,1318,536,782,68.5,1316,536,780,68.7
22310, 달성군,080003, 77세,2018,1108,419,689,60.8,1105,418,687,60.8
22310, 달성군,080004, 78세,2018,992,335,657,51,991,335,656,51.1
22310, 달성군,080005, 79세,2018,999,360,639,56.3,998,360,638,56.4
22310, 달성군,085,80~84세,2018,3729,1239,2490,49.8,3720,1237,2483,49.8
22310, 달성군,085001, 80세,2018,891,322,569,56.6,886,322,564,57.1
22310, 달성군,085002, 81세,2018,820,285,535,53.3,818,284,534,53.2
22310, 달성군,085003, 82세,2018,695,238,457,52.1,693,237,456,52
22310, 달성군,085004, 83세,2018,697,214,483,44.3,697,214,483,44.3
22310, 달성군,085005, 84세,2018,626,180,446,40.4,626,180,446,40.4
22310, 달성군,090,85~89세,2018,1799,492,1307,37.6,1797,492,1305,37.7
22310, 달성군,090001, 85세,2018,470,142,328,43.3,469,142,327,43.4
22310, 달성군,090002, 86세,2018,449,140,309,45.3,449,140,309,45.3
22310, 달성군,090003, 87세,2018,368,102,266,38.3,368,102,266,38.3
22310, 달성군,090004, 88세,2018,288,59,229,25.8,288,59,229,25.8
22310, 달성군,090005, 89세,2018,224,49,175,28,223,49,174,28.2
22310, 달성군,095,90~94세,2018,561,127,434,29.3,560,127,433,29.3
22310, 달성군,095001, 90세,2018,178,45,133,33.8,178,45,133,33.8
22310, 달성군,095002, 91세,2018,156,33,123,26.8,155,33,122,27
22310, 달성군,095003, 92세,2018,103,22,81,27.2,103,22,81,27.2
22310, 달성군,095004, 93세,2018,82,16,66,24.2,82,16,66,24.2
22310, 달성군,095005, 94세,2018,42,11,31,35.5,42,11,31,35.5
22310, 달성군,100,95~99세,2018,114,27,87,31,114,27,87,31
22310, 달성군,100001, 95세,2018,44,7,37,18.9,44,7,37,18.9
22310, 달성군,100002, 96세,2018,31,11,20,55,31,11,20,55
22310, 달성군,100003, 97세,2018,19,X,15,26.7,19,X,15,26.7
22310, 달성군,100004, 98세,2018,12,X,10,20,12,X,10,20
22310, 달성군,100005, 99세,2018,8,X,5,60,8,X,5,60
22310, 달성군,101,100세이상,2018,11,X,10,10,11,X,10,10
22310, 달성군,102,15세미만,2018,41303,21020,20283,103.6,41013,20890,20123,103.8
22310, 달성군,103,15~64세,2018,181257,95492,85765,111.3,173938,90516,83422,108.5
22310, 달성군,104,65세이상,2018,28193,11957,16236,73.6,28058,11899,16159,73.6
22310, 달성군,086,85세이상,2018,2485,647,1838,35.2,2482,647,1835,35.3
22310, 달성군,126,평균연령,2018,39.1,38,40.3,,39.3,38.1,40.4,
22310, 달성군,127,중위연령,2018,39.3,38.3,40.6,,39.6,38.7,40.8,
23,인천광역시,000,합계,2018,2936117,1476097,1460020,101.1,2847628,1425355,1422273,100.2
23,인천광역시,005,0~4세,2018,118036,60489,57547,105.1,115194,59017,56177,105.1
23,인천광역시,005001, 0세,2018,19959,10293,9666,106.5,19388,9989,9399,106.3
23,인천광역시,005002, 1세,2018,21626,11091,10535,105.3,21016,10772,10244,105.2
23,인천광역시,005003, 2세,2018,24660,12571,12089,104,24010,12232,11778,103.9
23,인천광역시,005004, 3세,2018,26135,13393,12742,105.1,25600,13128,12472,105.3
23,인천광역시,005005, 4세,2018,25656,13141,12515,105,25180,12896,12284,105
23,인천광역시,010,5~9세,2018,134334,69029,65305,105.7,132732,68203,64529,105.7
23,인천광역시,010001, 5세,2018,26014,13243,12771,103.7,25632,13058,12574,103.8
23,인천광역시,010002, 6세,2018,28040,14400,13640,105.6,27659,14208,13451,105.6
23,인천광역시,010003, 7세,2018,27939,14495,13444,107.8,27617,14317,13300,107.6
23,인천광역시,010004, 8세,2018,26522,13636,12886,105.8,26268,13501,12767,105.7
23,인천광역시,010005, 9세,2018,25819,13255,12564,105.5,25556,13119,12437,105.5
23,인천광역시,015,10~14세,2018,131033,67299,63734,105.6,129962,66761,63201,105.6
23,인천광역시,015001, 10세,2018,26981,13710,13271,103.3,26708,13562,13146,103.2
23,인천광역시,015002, 11세,2018,27831,14350,13481,106.4,27598,14238,13360,106.6
23,인천광역시,015003, 12세,2018,25109,12973,12136,106.9,24912,12869,12043,106.9
23,인천광역시,015004, 13세,2018,24512,12591,11921,105.6,24324,12496,11828,105.6
23,인천광역시,015005, 14세,2018,26600,13675,12925,105.8,26420,13596,12824,106
23,인천광역시,020,15~19세,2018,154377,79492,74885,106.2,152415,78508,73907,106.2
23,인천광역시,020001, 15세,2018,27284,14013,13271,105.6,27134,13937,13197,105.6
23,인천광역시,020002, 16세,2018,27876,14483,13393,108.1,27701,14381,13320,108
23,인천광역시,020003, 17세,2018,31878,16451,15427,106.6,31646,16334,15312,106.7
23,인천광역시,020004, 18세,2018,34731,17788,16943,105,34219,17546,16673,105.2
23,인천광역시,020005, 19세,2018,32608,16757,15851,105.7,31715,16310,15405,105.9
23,인천광역시,025,20~24세,2018,191027,100888,90139,111.9,183634,96524,87110,110.8
23,인천광역시,025001, 20세,2018,34543,18429,16114,114.4,33479,17873,15606,114.5
23,인천광역시,025002, 21세,2018,36635,19671,16964,116,35421,18988,16433,115.5
23,인천광역시,025003, 22세,2018,38054,20131,17923,112.3,36551,19244,17307,111.2
23,인천광역시,025004, 23세,2018,40047,20834,19213,108.4,38277,19754,18523,106.6
23,인천광역시,025005, 24세,2018,41748,21823,19925,109.5,39906,20665,19241,107.4
23,인천광역시,030,25~29세,2018,211776,111540,100236,111.3,199068,103655,95413,108.6
23,인천광역시,030001, 25세,2018,43701,22964,20737,110.7,41619,21659,19960,108.5
23,인천광역시,030002, 26세,2018,44894,23396,21498,108.8,42530,21901,20629,106.2
23,인천광역시,030003, 27세,2018,43084,22769,20315,112.1,40527,21219,19308,109.9
23,인천광역시,030004, 28세,2018,40750,21597,19153,112.8,37917,19868,18049,110.1
23,인천광역시,030005, 29세,2018,39347,20814,18533,112.3,36475,19008,17467,108.8
23,인천광역시,035,30~34세,2018,197752,103992,93760,110.9,182629,94429,88200,107.1
23,인천광역시,035001, 30세,2018,38377,20118,18259,110.2,35264,18187,17077,106.5
23,인천광역시,035002, 31세,2018,38377,20113,18264,110.1,35157,18065,17092,105.7
23,인천광역시,035003, 32세,2018,39499,20892,18607,112.3,36378,18940,17438,108.6
23,인천광역시,035004, 33세,2018,39843,21041,18802,111.9,36918,19180,17738,108.1
23,인천광역시,035005, 34세,2018,41656,21828,19828,110.1,38912,20057,18855,106.4
23,인천광역시,040,35~39세,2018,246585,128284,118301,108.4,235177,120955,114222,105.9
23,인천광역시,040001, 35세,2018,46173,23968,22205,107.9,43525,22245,21280,104.5
23,인천광역시,040002, 36세,2018,50141,26052,24089,108.1,47587,24393,23194,105.2
23,인천광역시,040003, 37세,2018,50580,26517,24063,110.2,48432,25144,23288,108
23,인천광역시,040004, 38세,2018,51198,26510,24688,107.4,49133,25191,23942,105.2
23,인천광역시,040005, 39세,2018,48493,25237,23256,108.5,46500,23982,22518,106.5
23,인천광역시,045,40~44세,2018,229935,118706,111229,106.7,222363,114071,108292,105.3
23,인천광역시,045001, 40세,2018,44514,22954,21560,106.5,42688,21814,20874,104.5
23,인천광역시,045002, 41세,2018,45155,23344,21811,107,43632,22396,21236,105.5
23,인천광역시,045003, 42세,2018,43639,22605,21034,107.5,42187,21727,20460,106.2
23,인천광역시,045004, 43세,2018,46538,23928,22610,105.8,45153,23099,22054,104.7
23,인천광역시,045005, 44세,2018,50089,25875,24214,106.9,48703,25035,23668,105.8
23,인천광역시,050,45~49세,2018,261999,131828,130171,101.3,254782,127906,126876,100.8
23,인천광역시,050001, 45세,2018,50874,25557,25317,100.9,49450,24750,24700,100.2
23,인천광역시,050002, 46세,2018,51186,26109,25077,104.1,49740,25326,24414,103.7
23,인천광역시,050003, 47세,2018,53902,27292,26610,102.6,52430,26488,25942,102.1
23,인천광역시,050004, 48세,2018,52449,26435,26014,101.6,50929,25602,25327,101.1
23,인천광역시,050005, 49세,2018,53588,26435,27153,97.4,52233,25740,26493,97.2
23,인천광역시,055,50~54세,2018,250929,124114,126815,97.9,244686,120985,123701,97.8
23,인천광역시,055001, 50세,2018,53551,26151,27400,95.4,52134,25406,26728,95.1
23,인천광역시,055002, 51세,2018,48916,23997,24919,96.3,47863,23455,24408,96.1
23,인천광역시,055003, 52세,2018,48491,24259,24232,100.1,47351,23695,23656,100.2
23,인천광역시,055004, 53세,2018,51570,25530,26040,98,50257,24887,25370,98.1
23,인천광역시,055005, 54세,2018,48401,24177,24224,99.8,47081,23542,23539,100
23,인천광역시,060,55~59세,2018,258924,130359,128565,101.4,253606,127802,125804,101.6
23,인천광역시,060001, 55세,2018,51072,25854,25218,102.5,49649,25165,24484,102.8
23,인천광역시,060002, 56세,2018,51934,26166,25768,101.5,50824,25631,25193,101.7
23,인천광역시,060003, 57세,2018,54766,27581,27185,101.5,53984,27225,26759,101.7
23,인천광역시,060004, 58세,2018,53843,27010,26833,100.7,52731,26484,26247,100.9
23,인천광역시,060005, 59세,2018,47309,23748,23561,100.8,46418,23297,23121,100.8
23,인천광역시,065,60~64세,2018,192973,96094,96879,99.2,188689,94087,94602,99.5
23,인천광역시,065001, 60세,2018,44597,22511,22086,101.9,43638,22041,21597,102.1
23,인천광역시,065002, 61세,2018,42013,21110,20903,101,41039,20643,20396,101.2
23,인천광역시,065003, 62세,2018,37587,18663,18924,98.6,36793,18304,18489,99
23,인천광역시,065004, 63세,2018,37850,18600,19250,96.6,37009,18214,18795,96.9
23,인천광역시,065005, 64세,2018,30926,15210,15716,96.8,30210,14885,15325,97.1
23,인천광역시,070,65~69세,2018,118397,57999,60398,96,116217,56989,59228,96.2
23,인천광역시,070001, 65세,2018,26478,13004,13474,96.5,25897,12723,13174,96.6
23,인천광역시,070002, 66세,2018,28626,14110,14516,97.2,28124,13873,14251,97.3
23,인천광역시,070003, 67세,2018,19251,9386,9865,95.1,18814,9186,9628,95.4
23,인천광역시,070004, 68세,2018,21805,10739,11066,97,21459,10586,10873,97.4
23,인천광역시,070005, 69세,2018,22237,10760,11477,93.8,21923,10621,11302,94
23,인천광역시,075,70~74세,2018,89707,41983,47724,88,88949,41691,47258,88.2
23,인천광역시,075001, 70세,2018,21351,10417,10934,95.3,21141,10329,10812,95.5
23,인천광역시,075002, 71세,2018,21453,9983,11470,87,21275,9908,11367,87.2
23,인천광역시,075003, 72세,2018,16379,7632,8747,87.3,16240,7581,8659,87.6
23,인천광역시,075004, 73세,2018,15359,7056,8303,85,15224,7008,8216,85.3
23,인천광역시,075005, 74세,2018,15165,6895,8270,83.4,15069,6865,8204,83.7
23,인천광역시,080,75~79세,2018,71759,30051,41708,72.1,71359,29917,41442,72.2
23,인천광역시,080001, 75세,2018,15614,6887,8727,78.9,15536,6862,8674,79.1
23,인천광역시,080002, 76세,2018,17518,7519,9999,75.2,17434,7479,9955,75.1
23,인천광역시,080003, 77세,2018,13948,5851,8097,72.3,13865,5825,8040,72.5
23,인천광역시,080004, 78세,2018,12384,5002,7382,67.8,12303,4977,7326,67.9
23,인천광역시,080005, 79세,2018,12295,4792,7503,63.9,12221,4774,7447,64.1
23,인천광역시,085,80~84세,2018,45096,16003,29093,55,44825,15935,28890,55.2
23,인천광역시,085001, 80세,2018,11228,4314,6914,62.4,11149,4299,6850,62.8
23,인천광역시,085002, 81세,2018,9594,3500,6094,57.4,9546,3484,6062,57.5
23,인천광역시,085003, 82세,2018,9035,3156,5879,53.7,8978,3141,5837,53.8
23,인천광역시,085004, 83세,2018,8439,2893,5546,52.2,8392,2877,5515,52.2
23,인천광역시,085005, 84세,2018,6800,2140,4660,45.9,6760,2134,4626,46.1
23,인천광역시,090,85~89세,2018,21839,5837,16002,36.5,21736,5820,15916,36.6
23,인천광역시,090001, 85세,2018,5916,1749,4167,42,5887,1748,4139,42.2
23,인천광역시,090002, 86세,2018,5115,1416,3699,38.3,5093,1411,3682,38.3
23,인천광역시,090003, 87세,2018,3945,1041,2904,35.8,3920,1037,2883,36
23,인천광역시,090004, 88세,2018,3683,830,2853,29.1,3663,827,2836,29.2
23,인천광역시,090005, 89세,2018,3180,801,2379,33.7,3173,797,2376,33.5
23,인천광역시,095,90~94세,2018,7571,1640,5931,27.7,7542,1634,5908,27.7
23,인천광역시,095001, 90세,2018,2448,566,1882,30.1,2441,565,1876,30.1
23,인천광역시,095002, 91세,2018,1914,424,1490,28.5,1905,423,1482,28.5
23,인천광역시,095003, 92세,2018,1307,273,1034,26.4,1300,270,1030,26.2
23,인천광역시,095004, 93세,2018,1125,208,917,22.7,1123,207,916,22.6
23,인천광역시,095005, 94세,2018,777,169,608,27.8,773,169,604,28
23,인천광역시,100,95~99세,2018,1849,441,1408,31.3,1845,438,1407,31.1
23,인천광역시,100001, 95세,2018,701,183,518,35.3,700,182,518,35.1
23,인천광역시,100002, 96세,2018,466,93,373,24.9,463,91,372,24.5
23,인천광역시,100003, 97세,2018,328,75,253,29.6,328,75,253,29.6
23,인천광역시,100004, 98세,2018,208,50,158,31.6,208,50,158,31.6
23,인천광역시,100005, 99세,2018,146,40,106,37.7,146,40,106,37.7
23,인천광역시,101,100세이상,2018,219,29,190,15.3,218,28,190,14.7
23,인천광역시,102,15세미만,2018,383403,196817,186586,105.5,377888,193981,183907,105.5
23,인천광역시,103,15~64세,2018,2196277,1125297,1070980,105.1,2117049,1078922,1038127,103.9
23,인천광역시,104,65세이상,2018,356437,153983,202454,76.1,352691,152452,200239,76.1
23,인천광역시,086,85세이상,2018,31478,7947,23531,33.8,31341,7920,23421,33.8
23,인천광역시,126,평균연령,2018,41,40,42,,41.1,40.1,42,
23,인천광역시,127,중위연령,2018,41.9,40.7,43.1,,42.2,41.1,43.3,
23004, 읍부,000,합계,2018,21526,10629,10897,97.5,21214,10485,10729,97.7
23004, 읍부,005,0~4세,2018,599,303,296,102.4,597,302,295,102.4
23004, 읍부,005001, 0세,2018,98,55,43,127.9,98,55,43,127.9
23004, 읍부,005002, 1세,2018,110,60,50,120,109,60,49,122.4
23004, 읍부,005003, 2세,2018,115,63,52,121.2,115,63,52,121.2
23004, 읍부,005004, 3세,2018,135,64,71,90.1,135,64,71,90.1
23004, 읍부,005005, 4세,2018,141,61,80,76.3,140,60,80,75
23004, 읍부,010,5~9세,2018,832,421,411,102.4,828,421,407,103.4
23004, 읍부,010001, 5세,2018,155,76,79,96.2,154,76,78,97.4
23004, 읍부,010002, 6세,2018,157,74,83,89.2,156,74,82,90.2
23004, 읍부,010003, 7세,2018,183,91,92,98.9,183,91,92,98.9
23004, 읍부,010004, 8세,2018,172,94,78,120.5,171,94,77,122.1
23004, 읍부,010005, 9세,2018,165,86,79,108.9,164,86,78,110.3
23004, 읍부,015,10~14세,2018,958,458,500,91.6,955,456,499,91.4
23004, 읍부,015001, 10세,2018,188,74,114,64.9,187,73,114,64
23004, 읍부,015002, 11세,2018,177,94,83,113.3,177,94,83,113.3
23004, 읍부,015003, 12세,2018,202,95,107,88.8,202,95,107,88.8
23004, 읍부,015004, 13세,2018,190,91,99,91.9,190,91,99,91.9
23004, 읍부,015005, 14세,2018,201,104,97,107.2,199,103,96,107.3
23004, 읍부,020,15~19세,2018,1683,825,858,96.2,1678,823,855,96.3
23004, 읍부,020001, 15세,2018,304,159,145,109.7,304,159,145,109.7
23004, 읍부,020002, 16세,2018,384,196,188,104.3,382,195,187,104.3
23004, 읍부,020003, 17세,2018,385,148,237,62.4,385,148,237,62.4
23004, 읍부,020004, 18세,2018,422,222,200,111,422,222,200,111
23004, 읍부,020005, 19세,2018,188,100,88,113.6,185,99,86,115.1
23004, 읍부,025,20~24세,2018,988,578,410,141,959,563,396,142.2
23004, 읍부,025001, 20세,2018,193,113,80,141.3,191,112,79,141.8
23004, 읍부,025002, 21세,2018,198,128,70,182.9,193,125,68,183.8
23004, 읍부,025003, 22세,2018,181,106,75,141.3,172,101,71,142.3
23004, 읍부,025004, 23세,2018,201,109,92,118.5,195,106,89,119.1
23004, 읍부,025005, 24세,2018,215,122,93,131.2,208,119,89,133.7
23004, 읍부,030,25~29세,2018,1046,578,468,123.5,988,547,441,124
23004, 읍부,030001, 25세,2018,217,121,96,126,206,116,90,128.9
23004, 읍부,030002, 26세,2018,212,126,86,146.5,195,118,77,153.2
23004, 읍부,030003, 27세,2018,221,111,110,100.9,208,103,105,98.1
23004, 읍부,030004, 28세,2018,205,120,85,141.2,192,112,80,140
23004, 읍부,030005, 29세,2018,191,100,91,109.9,187,98,89,110.1
23004, 읍부,035,30~34세,2018,878,471,407,115.7,831,447,384,116.4
23004, 읍부,035001, 30세,2018,173,87,86,101.2,164,82,82,100
23004, 읍부,035002, 31세,2018,174,103,71,145.1,166,98,68,144.1
23004, 읍부,035003, 32세,2018,146,80,66,121.2,137,77,60,128.3
23004, 읍부,035004, 33세,2018,192,105,87,120.7,183,100,83,120.5
23004, 읍부,035005, 34세,2018,193,96,97,99,181,90,91,98.9
23004, 읍부,040,35~39세,2018,1260,623,637,97.8,1233,611,622,98.2
23004, 읍부,040001, 35세,2018,242,129,113,114.2,234,125,109,114.7
23004, 읍부,040002, 36세,2018,258,123,135,91.1,251,118,133,88.7
23004, 읍부,040003, 37세,2018,264,132,132,100,261,132,129,102.3
23004, 읍부,040004, 38세,2018,265,134,131,102.3,259,131,128,102.3
23004, 읍부,040005, 39세,2018,231,105,126,83.3,228,105,123,85.4
23004, 읍부,045,40~44세,2018,1384,697,687,101.5,1368,691,677,102.1
23004, 읍부,045001, 40세,2018,226,107,119,89.9,220,106,114,93
23004, 읍부,045002, 41세,2018,276,149,127,117.3,274,149,125,119.2
23004, 읍부,045003, 42세,2018,244,120,124,96.8,240,117,123,95.1
23004, 읍부,045004, 43세,2018,303,148,155,95.5,302,147,155,94.8
23004, 읍부,045005, 44세,2018,335,173,162,106.8,332,172,160,107.5
23004, 읍부,050,45~49세,2018,1782,941,841,111.9,1754,929,825,112.6
23004, 읍부,050001, 45세,2018,348,180,168,107.1,345,178,167,106.6
23004, 읍부,050002, 46세,2018,330,163,167,97.6,326,160,166,96.4
23004, 읍부,050003, 47세,2018,383,200,183,109.3,375,197,178,110.7
23004, 읍부,050004, 48세,2018,374,215,159,135.2,366,212,154,137.7
23004, 읍부,050005, 49세,2018,347,183,164,111.6,342,182,160,113.8
23004, 읍부,055,50~54세,2018,1702,856,846,101.2,1664,838,826,101.5
23004, 읍부,055001, 50세,2018,357,181,176,102.8,345,175,170,102.9
23004, 읍부,055002, 51세,2018,331,171,160,106.9,326,168,158,106.3
23004, 읍부,055003, 52세,2018,334,181,153,118.3,330,178,152,117.1
23004, 읍부,055004, 53세,2018,352,173,179,96.6,344,170,174,97.7
23004, 읍부,055005, 54세,2018,328,150,178,84.3,319,147,172,85.5
23004, 읍부,060,55~59세,2018,1956,958,998,96,1932,949,983,96.5
23004, 읍부,060001, 55세,2018,343,163,180,90.6,337,161,176,91.5
23004, 읍부,060002, 56세,2018,391,197,194,101.5,387,197,190,103.7
23004, 읍부,060003, 57세,2018,426,197,229,86,425,197,228,86.4
23004, 읍부,060004, 58세,2018,399,203,196,103.6,392,198,194,102.1
23004, 읍부,060005, 59세,2018,397,198,199,99.5,391,196,195,100.5
23004, 읍부,065,60~64세,2018,1758,862,896,96.2,1743,856,887,96.5
23004, 읍부,065001, 60세,2018,403,187,216,86.6,398,187,211,88.6
23004, 읍부,065002, 61세,2018,367,189,178,106.2,363,187,176,106.3
23004, 읍부,065003, 62세,2018,334,170,164,103.7,331,168,163,103.1
23004, 읍부,065004, 63세,2018,349,170,179,95,348,170,178,95.5
23004, 읍부,065005, 64세,2018,305,146,159,91.8,303,144,159,90.6
23004, 읍부,070,65~69세,2018,1314,630,684,92.1,1308,629,679,92.6
23004, 읍부,070001, 65세,2018,312,153,159,96.2,310,153,157,97.5
23004, 읍부,070002, 66세,2018,312,154,158,97.5,311,154,157,98.1
23004, 읍부,070003, 67세,2018,195,89,106,84,194,89,105,84.8
23004, 읍부,070004, 68세,2018,230,115,115,100,230,115,115,100
23004, 읍부,070005, 69세,2018,265,119,146,81.5,263,118,145,81.4
23004, 읍부,075,70~74세,2018,1217,553,664,83.3,1212,550,662,83.1
23004, 읍부,075001, 70세,2018,263,124,139,89.2,263,124,139,89.2
23004, 읍부,075002, 71세,2018,299,133,166,80.1,298,132,166,79.5
23004, 읍부,075003, 72세,2018,214,94,120,78.3,213,94,119,79
23004, 읍부,075004, 73세,2018,219,97,122,79.5,216,95,121,78.5
23004, 읍부,075005, 74세,2018,222,105,117,89.7,222,105,117,89.7
23004, 읍부,080,75~79세,2018,1047,456,591,77.2,1044,455,589,77.2
23004, 읍부,080001, 75세,2018,235,113,122,92.6,235,113,122,92.6
23004, 읍부,080002, 76세,2018,246,105,141,74.5,246,105,141,74.5
23004, 읍부,080003, 77세,2018,209,94,115,81.7,208,93,115,80.9
23004, 읍부,080004, 78세,2018,169,64,105,61,168,64,104,61.5
23004, 읍부,080005, 79세,2018,188,80,108,74.1,187,80,107,74.8
23004, 읍부,085,80~84세,2018,702,285,417,68.3,700,284,416,68.3
23004, 읍부,085001, 80세,2018,174,71,103,68.9,174,71,103,68.9
23004, 읍부,085002, 81세,2018,139,69,70,98.6,139,69,70,98.6
23004, 읍부,085003, 82세,2018,134,49,85,57.6,134,49,85,57.6
23004, 읍부,085004, 83세,2018,148,56,92,60.9,146,55,91,60.4
23004, 읍부,085005, 84세,2018,107,40,67,59.7,107,40,67,59.7
23004, 읍부,090,85~89세,2018,316,105,211,49.8,316,105,211,49.8
23004, 읍부,090001, 85세,2018,96,32,64,50,96,32,64,50
23004, 읍부,090002, 86세,2018,86,28,58,48.3,86,28,58,48.3
23004, 읍부,090003, 87세,2018,45,18,27,66.7,45,18,27,66.7
23004, 읍부,090004, 88세,2018,42,13,29,44.8,42,13,29,44.8
23004, 읍부,090005, 89세,2018,47,14,33,42.4,47,14,33,42.4
23004, 읍부,095,90~94세,2018,85,19,66,28.8,85,19,66,28.8
23004, 읍부,095001, 90세,2018,31,6,25,24,31,6,25,24
23004, 읍부,095002, 91세,2018,14,X,11,27.3,14,X,11,27.3
23004, 읍부,095003, 92세,2018,12,X,10,20,12,X,10,20
23004, 읍부,095004, 93세,2018,17,6,11,54.5,17,6,11,54.5
23004, 읍부,095005, 94세,2018,11,X,9,22.2,11,X,9,22.2
23004, 읍부,100,95~99세,2018,16,8,8,100,16,8,8,100
23004, 읍부,100001, 95세,2018,6,X,X,100,6,X,X,100
23004, 읍부,100002, 96세,2018,X,X,X,,X,X,X,
23004, 읍부,100003, 97세,2018,5,X,X,66.7,5,X,X,66.7
23004, 읍부,100004, 98세,2018,X,X,X,0,X,X,X,0
23004, 읍부,100005, 99세,2018,X,X,X,100,X,X,X,100
23004, 읍부,101,100세이상,2018,X,X,X,200,X,X,X,200
23004, 읍부,102,15세미만,2018,2389,1182,1207,97.9,2380,1179,1201,98.2
23004, 읍부,103,15~64세,2018,14437,7389,7048,104.8,14150,7254,6896,105.2
23004, 읍부,104,65세이상,2018,4700,2058,2642,77.9,4684,2052,2632,78
23004, 읍부,086,85세이상,2018,420,134,286,46.9,420,134,286,46.9
23004, 읍부,126,평균연령,2018,45.7,44.5,46.9,,45.8,44.6,47,
23004, 읍부,127,중위연령,2018,48.2,47.1,49.6,,48.3,47.2,49.8,
23005, 면부,000,합계,2018,62113,32732,29381,111.4,61046,31985,29061,110.1
23005, 면부,005,0~4세,2018,1333,674,659,102.3,1327,669,658,101.7
23005, 면부,005001, 0세,2018,256,141,115,122.6,255,140,115,121.7
23005, 면부,005002, 1세,2018,225,104,121,86,225,104,121,86
23005, 면부,005003, 2세,2018,278,137,141,97.2,278,137,141,97.2
23005, 면부,005004, 3세,2018,286,146,140,104.3,284,144,140,102.9
23005, 면부,005005, 4세,2018,288,146,142,102.8,285,144,141,102.1
23005, 면부,010,5~9세,2018,1610,862,748,115.2,1602,856,746,114.7
23005, 면부,010001, 5세,2018,290,147,143,102.8,288,146,142,102.8
23005, 면부,010002, 6세,2018,331,178,153,116.3,330,177,153,115.7
23005, 면부,010003, 7세,2018,329,184,145,126.9,327,183,144,127.1
23005, 면부,010004, 8세,2018,329,169,160,105.6,327,167,160,104.4
23005, 면부,010005, 9세,2018,331,184,147,125.2,330,183,147,124.5
23005, 면부,015,10~14세,2018,1590,809,781,103.6,1588,807,781,103.3
23005, 면부,015001, 10세,2018,350,173,177,97.7,350,173,177,97.7
23005, 면부,015002, 11세,2018,335,172,163,105.5,335,172,163,105.5
23005, 면부,015003, 12세,2018,292,156,136,114.7,291,155,136,114
23005, 면부,015004, 13세,2018,293,154,139,110.8,293,154,139,110.8
23005, 면부,015005, 14세,2018,320,154,166,92.8,319,153,166,92.2
23005, 면부,020,15~19세,2018,1543,848,695,122,1540,846,694,121.9
23005, 면부,020001, 15세,2018,313,161,152,105.9,313,161,152,105.9
23005, 면부,020002, 16세,2018,263,143,120,119.2,262,143,119,120.2
23005, 면부,020003, 17세,2018,357,199,158,125.9,357,199,158,125.9
23005, 면부,020004, 18세,2018,330,175,155,112.9,330,175,155,112.9
23005, 면부,020005, 19세,2018,280,170,110,154.5,278,168,110,152.7
23005, 면부,025,20~24세,2018,2673,1893,780,242.7,2557,1808,749,241.4
23005, 면부,025001, 20세,2018,408,296,112,264.3,398,288,110,261.8
23005, 면부,025002, 21세,2018,487,353,134,263.4,476,345,131,263.4
23005, 면부,025003, 22세,2018,553,394,159,247.8,530,377,153,246.4
23005, 면부,025004, 23세,2018,575,406,169,240.2,541,383,158,242.4
23005, 면부,025005, 24세,2018,650,444,206,215.5,612,415,197,210.7
23005, 면부,030,25~29세,2018,2935,1940,995,195,2682,1745,937,186.2
23005, 면부,030001, 25세,2018,626,412,214,192.5,576,371,205,181
23005, 면부,030002, 26세,2018,608,399,209,190.9,558,360,198,181.8
23005, 면부,030003, 27세,2018,608,392,216,181.5,569,364,205,177.6
23005, 면부,030004, 28세,2018,560,375,185,202.7,507,334,173,193.1
23005, 면부,030005, 29세,2018,533,362,171,211.7,472,316,156,202.6
23005, 면부,035,30~34세,2018,2436,1456,980,148.6,2204,1273,931,136.7
23005, 면부,035001, 30세,2018,530,341,189,180.4,472,293,179,163.7
23005, 면부,035002, 31세,2018,500,304,196,155.1,455,272,183,148.6
23005, 면부,035003, 32세,2018,482,296,186,159.1,434,257,177,145.2
23005, 면부,035004, 33세,2018,451,246,205,120,408,210,198,106.1
23005, 면부,035005, 34세,2018,473,269,204,131.9,435,241,194,124.2
23005, 면부,040,35~39세,2018,2820,1647,1173,140.4,2678,1541,1137,135.5
23005, 면부,040001, 35세,2018,542,331,211,156.9,498,297,201,147.8
23005, 면부,040002, 36세,2018,581,348,233,149.4,548,326,222,146.8
23005, 면부,040003, 37세,2018,563,326,237,137.6,540,306,234,130.8
23005, 면부,040004, 38세,2018,584,333,251,132.7,562,318,244,130.3
23005, 면부,040005, 39세,2018,550,309,241,128.2,530,294,236,124.6
23005, 면부,045,40~44세,2018,3004,1808,1196,151.2,2916,1753,1163,150.7
23005, 면부,045001, 40세,2018,564,337,227,148.5,548,326,222,146.8
23005, 면부,045002, 41세,2018,573,335,238,140.8,557,323,234,138
23005, 면부,045003, 42세,2018,580,342,238,143.7,561,331,230,143.9
23005, 면부,045004, 43세,2018,606,367,239,153.6,588,356,232,153.4
23005, 면부,045005, 44세,2018,681,427,254,168.1,662,417,245,170.2
23005, 면부,050,45~49세,2018,3821,2239,1582,141.5,3759,2206,1553,142
23005, 면부,050001, 45세,2018,738,447,291,153.6,726,439,287,153
23005, 면부,050002, 46세,2018,713,443,270,164.1,701,439,262,167.6
23005, 면부,050003, 47세,2018,767,446,321,138.9,754,438,316,138.6
23005, 면부,050004, 48세,2018,757,444,313,141.9,743,436,307,142
23005, 면부,050005, 49세,2018,846,459,387,118.6,835,454,381,119.2
23005, 면부,055,50~54세,2018,4783,2552,2231,114.4,4734,2528,2206,114.6
23005, 면부,055001, 50세,2018,879,466,413,112.8,869,462,407,113.5
23005, 면부,055002, 51세,2018,860,461,399,115.5,855,459,396,115.9
23005, 면부,055003, 52세,2018,924,503,421,119.5,912,497,415,119.8
23005, 면부,055004, 53세,2018,1075,565,510,110.8,1063,558,505,110.5
23005, 면부,055005, 54세,2018,1045,557,488,114.1,1035,552,483,114.3
23005, 면부,060,55~59세,2018,7057,3615,3442,105,7021,3599,3422,105.2
23005, 면부,060001, 55세,2018,1146,604,542,111.4,1136,600,536,111.9
23005, 면부,060002, 56세,2018,1351,691,660,104.7,1346,688,658,104.6
23005, 면부,060003, 57세,2018,1490,780,710,109.9,1488,779,709,109.9
23005, 면부,060004, 58세,2018,1527,769,758,101.5,1522,767,755,101.6
23005, 면부,060005, 59세,2018,1543,771,772,99.9,1529,765,764,100.1
23005, 면부,065,60~64세,2018,6759,3419,3340,102.4,6732,3408,3324,102.5
23005, 면부,065001, 60세,2018,1380,712,668,106.6,1377,712,665,107.1
23005, 면부,065002, 61세,2018,1393,724,669,108.2,1393,724,669,108.2
23005, 면부,065003, 62세,2018,1382,677,705,96,1378,674,704,95.7
23005, 면부,065004, 63세,2018,1438,724,714,101.4,1423,718,705,101.8
23005, 면부,065005, 64세,2018,1166,582,584,99.7,1161,580,581,99.8
23005, 면부,070,65~69세,2018,5175,2633,2542,103.6,5156,2621,2535,103.4
23005, 면부,070001, 65세,2018,1111,579,532,108.8,1108,577,531,108.7
23005, 면부,070002, 66세,2018,1212,592,620,95.5,1206,588,618,95.1
23005, 면부,070003, 67세,2018,769,372,397,93.7,767,371,396,93.7
23005, 면부,070004, 68세,2018,1042,534,508,105.1,1040,534,506,105.5
23005, 면부,070005, 69세,2018,1041,556,485,114.6,1035,551,484,113.8
23005, 면부,075,70~74세,2018,4713,2314,2399,96.5,4700,2308,2392,96.5
23005, 면부,075001, 70세,2018,976,493,483,102.1,971,492,479,102.7
23005, 면부,075002, 71세,2018,1160,583,577,101,1156,581,575,101
23005, 면부,075003, 72세,2018,924,444,480,92.5,922,442,480,92.1
23005, 면부,075004, 73세,2018,835,415,420,98.8,833,414,419,98.8
23005, 면부,075005, 74세,2018,818,379,439,86.3,818,379,439,86.3
23005, 면부,080,75~79세,2018,4228,1985,2243,88.5,4224,1982,2242,88.4
23005, 면부,080001, 75세,2018,927,454,473,96,926,453,473,95.8
23005, 면부,080002, 76세,2018,954,448,506,88.5,953,448,505,88.7
23005, 면부,080003, 77세,2018,846,394,452,87.2,845,393,452,86.9
23005, 면부,080004, 78세,2018,752,362,390,92.8,751,361,390,92.6
23005, 면부,080005, 79세,2018,749,327,422,77.5,749,327,422,77.5
23005, 면부,085,80~84세,2018,3201,1341,1860,72.1,3198,1340,1858,72.1
23005, 면부,085001, 80세,2018,723,338,385,87.8,722,337,385,87.5
23005, 면부,085002, 81세,2018,647,273,374,73,647,273,374,73
23005, 면부,085003, 82세,2018,704,287,417,68.8,702,287,415,69.2
23005, 면부,085004, 83세,2018,607,248,359,69.1,607,248,359,69.1
23005, 면부,085005, 84세,2018,520,195,325,60,520,195,325,60
23005, 면부,090,85~89세,2018,1673,508,1165,43.6,1671,507,1164,43.6
23005, 면부,090001, 85세,2018,452,169,283,59.7,451,169,282,59.9
23005, 면부,090002, 86세,2018,412,119,293,40.6,412,119,293,40.6
23005, 면부,090003, 87세,2018,322,92,230,40,321,91,230,39.6
23005, 면부,090004, 88세,2018,272,68,204,33.3,272,68,204,33.3
23005, 면부,090005, 89세,2018,215,60,155,38.7,215,60,155,38.7
23005, 면부,095,90~94세,2018,597,144,453,31.8,595,143,452,31.6
23005, 면부,095001, 90세,2018,192,48,144,33.3,192,48,144,33.3
23005, 면부,095002, 91세,2018,144,33,111,29.7,143,32,111,28.8
23005, 면부,095003, 92세,2018,98,24,74,32.4,97,24,73,32.9
23005, 면부,095004, 93세,2018,97,19,78,24.4,97,19,78,24.4
23005, 면부,095005, 94세,2018,66,20,46,43.5,66,20,46,43.5
23005, 면부,100,95~99세,2018,145,40,105,38.1,145,40,105,38.1
23005, 면부,100001, 95세,2018,55,16,39,41,55,16,39,41
23005, 면부,100002, 96세,2018,33,6,27,22.2,33,6,27,22.2
23005, 면부,100003, 97세,2018,26,8,18,44.4,26,8,18,44.4
23005, 면부,100004, 98세,2018,20,9,11,81.8,20,9,11,81.8
23005, 면부,100005, 99세,2018,11,X,10,10,11,X,10,10
23005, 면부,101,100세이상,2018,17,5,12,41.7,17,5,12,41.7
23005, 면부,102,15세미만,2018,4533,2345,2188,107.2,4517,2332,2185,106.7
23005, 면부,103,15~64세,2018,37831,21417,16414,130.5,36823,20707,16116,128.5
23005, 면부,104,65세이상,2018,19749,8970,10779,83.2,19706,8946,10760,83.1
23005, 면부,086,85세이상,2018,2432,697,1735,40.2,2428,695,1733,40.1
23005, 면부,126,평균연령,2018,52.7,50.4,55.4,,53,50.7,55.6,
23005, 면부,127,중위연령,2018,57,54.3,59.3,,57.3,54.9,59.4,
23003, 동부,000,합계,2018,2852478,1432736,1419742,100.9,2765368,1382885,1382483,100
23003, 동부,005,0~4세,2018,116104,59512,56592,105.2,113270,58046,55224,105.1
23003, 동부,005001, 0세,2018,19605,10097,9508,106.2,19035,9794,9241,106
23003, 동부,005002, 1세,2018,21291,10927,10364,105.4,20682,10608,10074,105.3
23003, 동부,005003, 2세,2018,24267,12371,11896,104,23617,12032,11585,103.9
23003, 동부,005004, 3세,2018,25714,13183,12531,105.2,25181,12920,12261,105.4
23003, 동부,005005, 4세,2018,25227,12934,12293,105.2,24755,12692,12063,105.2
23003, 동부,010,5~9세,2018,131892,67746,64146,105.6,130302,66926,63376,105.6
23003, 동부,010001, 5세,2018,25569,13020,12549,103.8,25190,12836,12354,103.9
23003, 동부,010002, 6세,2018,27552,14148,13404,105.6,27173,13957,13216,105.6
23003, 동부,010003, 7세,2018,27427,14220,13207,107.7,27107,14043,13064,107.5
23003, 동부,010004, 8세,2018,26021,13373,12648,105.7,25770,13240,12530,105.7
23003, 동부,010005, 9세,2018,25323,12985,12338,105.2,25062,12850,12212,105.2
23003, 동부,015,10~14세,2018,128485,66032,62453,105.7,127419,65498,61921,105.8
23003, 동부,015001, 10세,2018,26443,13463,12980,103.7,26171,13316,12855,103.6
23003, 동부,015002, 11세,2018,27319,14084,13235,106.4,27086,13972,13114,106.5
23003, 동부,015003, 12세,2018,24615,12722,11893,107,24419,12619,11800,106.9
23003, 동부,015004, 13세,2018,24029,12346,11683,105.7,23841,12251,11590,105.7
23003, 동부,015005, 14세,2018,26079,13417,12662,106,25902,13340,12562,106.2
23003, 동부,020,15~19세,2018,151151,77819,73332,106.1,149197,76839,72358,106.2
23003, 동부,020001, 15세,2018,26667,13693,12974,105.5,26517,13617,12900,105.6
23003, 동부,020002, 16세,2018,27229,14144,13085,108.1,27057,14043,13014,107.9
23003, 동부,020003, 17세,2018,31136,16104,15032,107.1,30904,15987,14917,107.2
23003, 동부,020004, 18세,2018,33979,17391,16588,104.8,33467,17149,16318,105.1
23003, 동부,020005, 19세,2018,32140,16487,15653,105.3,31252,16043,15209,105.5
23003, 동부,025,20~24세,2018,187366,98417,88949,110.6,180118,94153,85965,109.5
23003, 동부,025001, 20세,2018,33942,18020,15922,113.2,32890,17473,15417,113.3
23003, 동부,025002, 21세,2018,35950,19190,16760,114.5,34752,18518,16234,114.1
23003, 동부,025003, 22세,2018,37320,19631,17689,111,35849,18766,17083,109.9
23003, 동부,025004, 23세,2018,39271,20319,18952,107.2,37541,19265,18276,105.4
23003, 동부,025005, 24세,2018,40883,21257,19626,108.3,39086,20131,18955,106.2
23003, 동부,030,25~29세,2018,207795,109022,98773,110.4,195398,101363,94035,107.8
23003, 동부,030001, 25세,2018,42858,22431,20427,109.8,40837,21172,19665,107.7
23003, 동부,030002, 26세,2018,44074,22871,21203,107.9,41777,21423,20354,105.3
23003, 동부,030003, 27세,2018,42255,22266,19989,111.4,39750,20752,18998,109.2
23003, 동부,030004, 28세,2018,39985,21102,18883,111.8,37218,19422,17796,109.1
23003, 동부,030005, 29세,2018,38623,20352,18271,111.4,35816,18594,17222,108
23003, 동부,035,30~34세,2018,194438,102065,92373,110.5,179594,92709,86885,106.7
23003, 동부,035001, 30세,2018,37674,19690,17984,109.5,34628,17812,16816,105.9
23003, 동부,035002, 31세,2018,37703,19706,17997,109.5,34536,17695,16841,105.1
23003, 동부,035003, 32세,2018,38871,20516,18355,111.8,35807,18606,17201,108.2
23003, 동부,035004, 33세,2018,39200,20690,18510,111.8,36327,18870,17457,108.1
23003, 동부,035005, 34세,2018,40990,21463,19527,109.9,38296,19726,18570,106.2
23003, 동부,040,35~39세,2018,242505,126014,116491,108.2,231266,118803,112463,105.6
23003, 동부,040001, 35세,2018,45389,23508,21881,107.4,42793,21823,20970,104.1
23003, 동부,040002, 36세,2018,49302,25581,23721,107.8,46788,23949,22839,104.9
23003, 동부,040003, 37세,2018,49753,26059,23694,110,47631,24706,22925,107.8
23003, 동부,040004, 38세,2018,50349,26043,24306,107.1,48312,24742,23570,105
23003, 동부,040005, 39세,2018,47712,24823,22889,108.4,45742,23583,22159,106.4
23003, 동부,045,40~44세,2018,225547,116201,109346,106.3,218079,111627,106452,104.9
23003, 동부,045001, 40세,2018,43724,22510,21214,106.1,41920,21382,20538,104.1
23003, 동부,045002, 41세,2018,44306,22860,21446,106.6,42801,21924,20877,105
23003, 동부,045003, 42세,2018,42815,22143,20672,107.1,41386,21279,20107,105.8
23003, 동부,045004, 43세,2018,45629,23413,22216,105.4,44263,22596,21667,104.3
23003, 동부,045005, 44세,2018,49073,25275,23798,106.2,47709,24446,23263,105.1
23003, 동부,050,45~49세,2018,256396,128648,127748,100.7,249269,124771,124498,100.2
23003, 동부,050001, 45세,2018,49788,24930,24858,100.3,48379,24133,24246,99.5
23003, 동부,050002, 46세,2018,50143,25503,24640,103.5,48713,24727,23986,103.1
23003, 동부,050003, 47세,2018,52752,26646,26106,102.1,51301,25853,25448,101.6
23003, 동부,050004, 48세,2018,51318,25776,25542,100.9,49820,24954,24866,100.4
23003, 동부,050005, 49세,2018,52395,25793,26602,97,51056,25104,25952,96.7
23003, 동부,055,50~54세,2018,244444,120706,123738,97.5,238288,117619,120669,97.5
23003, 동부,055001, 50세,2018,52315,25504,26811,95.1,50920,24769,26151,94.7
23003, 동부,055002, 51세,2018,47725,23365,24360,95.9,46682,22828,23854,95.7
23003, 동부,055003, 52세,2018,47233,23575,23658,99.6,46109,23020,23089,99.7
23003, 동부,055004, 53세,2018,50143,24792,25351,97.8,48850,24159,24691,97.8
23003, 동부,055005, 54세,2018,47028,23470,23558,99.6,45727,22843,22884,99.8
23003, 동부,060,55~59세,2018,249911,125786,124125,101.3,244653,123254,121399,101.5
23003, 동부,060001, 55세,2018,49583,25087,24496,102.4,48176,24404,23772,102.7
23003, 동부,060002, 56세,2018,50192,25278,24914,101.5,49091,24746,24345,101.6
23003, 동부,060003, 57세,2018,52850,26604,26246,101.4,52071,26249,25822,101.7
23003, 동부,060004, 58세,2018,51917,26038,25879,100.6,50817,25519,25298,100.9
23003, 동부,060005, 59세,2018,45369,22779,22590,100.8,44498,22336,22162,100.8
23003, 동부,065,60~64세,2018,184456,91813,92643,99.1,180214,89823,90391,99.4
23003, 동부,065001, 60세,2018,42814,21612,21202,101.9,41863,21142,20721,102
23003, 동부,065002, 61세,2018,40253,20197,20056,100.7,39283,19732,19551,100.9
23003, 동부,065003, 62세,2018,35871,17816,18055,98.7,35084,17462,17622,99.1
23003, 동부,065004, 63세,2018,36063,17706,18357,96.5,35238,17326,17912,96.7
23003, 동부,065005, 64세,2018,29455,14482,14973,96.7,28746,14161,14585,97.1
23003, 동부,070,65~69세,2018,111908,54736,57172,95.7,109753,53739,56014,95.9
23003, 동부,070001, 65세,2018,25055,12272,12783,96,24479,11993,12486,96.1
23003, 동부,070002, 66세,2018,27102,13364,13738,97.3,26607,13131,13476,97.4
23003, 동부,070003, 67세,2018,18287,8925,9362,95.3,17853,8726,9127,95.6
23003, 동부,070004, 68세,2018,20533,10090,10443,96.6,20189,9937,10252,96.9
23003, 동부,070005, 69세,2018,20931,10085,10846,93,20625,9952,10673,93.2
23003, 동부,075,70~74세,2018,83777,39116,44661,87.6,83037,38833,44204,87.8
23003, 동부,075001, 70세,2018,20112,9800,10312,95,19907,9713,10194,95.3
23003, 동부,075002, 71세,2018,19994,9267,10727,86.4,19821,9195,10626,86.5
23003, 동부,075003, 72세,2018,15241,7094,8147,87.1,15105,7045,8060,87.4
23003, 동부,075004, 73세,2018,14305,6544,7761,84.3,14175,6499,7676,84.7
23003, 동부,075005, 74세,2018,14125,6411,7714,83.1,14029,6381,7648,83.4
23003, 동부,080,75~79세,2018,66484,27610,38874,71,66091,27480,38611,71.2
23003, 동부,080001, 75세,2018,14452,6320,8132,77.7,14375,6296,8079,77.9
23003, 동부,080002, 76세,2018,16318,6966,9352,74.5,16235,6926,9309,74.4
23003, 동부,080003, 77세,2018,12893,5363,7530,71.2,12812,5339,7473,71.4
23003, 동부,080004, 78세,2018,11463,4576,6887,66.4,11384,4552,6832,66.6
23003, 동부,080005, 79세,2018,11358,4385,6973,62.9,11285,4367,6918,63.1
23003, 동부,085,80~84세,2018,41193,14377,26816,53.6,40927,14311,26616,53.8
23003, 동부,085001, 80세,2018,10331,3905,6426,60.8,10253,3891,6362,61.2
23003, 동부,085002, 81세,2018,8808,3158,5650,55.9,8760,3142,5618,55.9
23003, 동부,085003, 82세,2018,8197,2820,5377,52.4,8142,2805,5337,52.6
23003, 동부,085004, 83세,2018,7684,2589,5095,50.8,7639,2574,5065,50.8
23003, 동부,085005, 84세,2018,6173,1905,4268,44.6,6133,1899,4234,44.9
23003, 동부,090,85~89세,2018,19850,5224,14626,35.7,19749,5208,14541,35.8
23003, 동부,090001, 85세,2018,5368,1548,3820,40.5,5340,1547,3793,40.8
23003, 동부,090002, 86세,2018,4617,1269,3348,37.9,4595,1264,3331,37.9
23003, 동부,090003, 87세,2018,3578,931,2647,35.2,3554,928,2626,35.3
23003, 동부,090004, 88세,2018,3369,749,2620,28.6,3349,746,2603,28.7
23003, 동부,090005, 89세,2018,2918,727,2191,33.2,2911,723,2188,33
23003, 동부,095,90~94세,2018,6889,1477,5412,27.3,6862,1472,5390,27.3
23003, 동부,095001, 90세,2018,2225,512,1713,29.9,2218,511,1707,29.9
23003, 동부,095002, 91세,2018,1756,388,1368,28.4,1748,388,1360,28.5
23003, 동부,095003, 92세,2018,1197,247,950,26,1191,244,947,25.8
23003, 동부,095004, 93세,2018,1011,183,828,22.1,1009,182,827,22
23003, 동부,095005, 94세,2018,700,147,553,26.6,696,147,549,26.8
23003, 동부,100,95~99세,2018,1688,393,1295,30.3,1684,390,1294,30.1
23003, 동부,100001, 95세,2018,640,164,476,34.5,639,163,476,34.2
23003, 동부,100002, 96세,2018,431,85,346,24.6,428,83,345,24.1
23003, 동부,100003, 97세,2018,297,65,232,28,297,65,232,28
23003, 동부,100004, 98세,2018,187,41,146,28.1,187,41,146,28.1
23003, 동부,100005, 99세,2018,133,38,95,40,133,38,95,40
23003, 동부,101,100세이상,2018,199,22,177,12.4,198,21,177,11.9
23003, 동부,102,15세미만,2018,376481,193290,183191,105.5,370991,190470,180521,105.5
23003, 동부,103,15~64세,2018,2144009,1096491,1047518,104.7,2066076,1050961,1015115,103.5
23003, 동부,104,65세이상,2018,331988,142955,189033,75.6,328301,141454,186847,75.7
23003, 동부,086,85세이상,2018,28626,7116,21510,33.1,28493,7091,21402,33.1
23003, 동부,126,평균연령,2018,40.7,39.7,41.7,,40.8,39.8,41.7,
23003, 동부,127,중위연령,2018,41.5,40.4,42.7,,41.8,40.8,42.9,
23010, 중구,000,합계,2018,119514,61843,57671,107.2,114960,59421,55539,107
23010, 중구,005,0~4세,2018,4880,2466,2414,102.2,4785,2418,2367,102.2
23010, 중구,005001, 0세,2018,793,404,389,103.9,778,398,380,104.7
23010, 중구,005002, 1세,2018,862,435,427,101.9,841,422,419,100.7
23010, 중구,005003, 2세,2018,1028,502,526,95.4,1005,488,517,94.4
23010, 중구,005004, 3세,2018,1130,593,537,110.4,1109,584,525,111.2
23010, 중구,005005, 4세,2018,1067,532,535,99.4,1052,526,526,100
23010, 중구,010,5~9세,2018,5722,2919,2803,104.1,5641,2875,2766,103.9
23010, 중구,010001, 5세,2018,1144,587,557,105.4,1124,577,547,105.5
23010, 중구,010002, 6세,2018,1219,594,625,95,1203,587,616,95.3
23010, 중구,010003, 7세,2018,1189,617,572,107.9,1173,608,565,107.6
23010, 중구,010004, 8세,2018,1123,585,538,108.7,1110,576,534,107.9
23010, 중구,010005, 9세,2018,1047,536,511,104.9,1031,527,504,104.6
23010, 중구,015,10~14세,2018,5638,2902,2736,106.1,5573,2871,2702,106.3
23010, 중구,015001, 10세,2018,1145,559,586,95.4,1138,556,582,95.5
23010, 중구,015002, 11세,2018,1231,643,588,109.4,1215,635,580,109.5
23010, 중구,015003, 12세,2018,1075,561,514,109.1,1060,554,506,109.5
23010, 중구,015004, 13세,2018,1047,550,497,110.7,1036,543,493,110.1
23010, 중구,015005, 14세,2018,1140,589,551,106.9,1124,583,541,107.8
23010, 중구,020,15~19세,2018,6607,3535,3072,115.1,6499,3483,3016,115.5
23010, 중구,020001, 15세,2018,1154,608,546,111.4,1131,598,533,112.2
23010, 중구,020002, 16세,2018,1246,662,584,113.4,1223,654,569,114.9
23010, 중구,020003, 17세,2018,1551,819,732,111.9,1536,814,722,112.7
23010, 중구,020004, 18세,2018,1660,920,740,124.3,1639,907,732,123.9
23010, 중구,020005, 19세,2018,996,526,470,111.9,970,510,460,110.9
23010, 중구,025,20~24세,2018,6269,3203,3066,104.5,6003,3065,2938,104.3
23010, 중구,025001, 20세,2018,1059,580,479,121.1,1035,567,468,121.2
23010, 중구,025002, 21세,2018,1095,572,523,109.4,1050,548,502,109.2
23010, 중구,025003, 22세,2018,1193,585,608,96.2,1140,557,583,95.5
23010, 중구,025004, 23세,2018,1358,642,716,89.7,1286,612,674,90.8
23010, 중구,025005, 24세,2018,1564,824,740,111.4,1492,781,711,109.8
23010, 중구,030,25~29세,2018,8418,4611,3807,121.1,7876,4301,3575,120.3
23010, 중구,030001, 25세,2018,1730,894,836,106.9,1633,846,787,107.5
23010, 중구,030002, 26세,2018,1753,932,821,113.5,1635,860,775,111
23010, 중구,030003, 27세,2018,1711,954,757,126,1616,894,722,123.8
23010, 중구,030004, 28세,2018,1650,957,693,138.1,1518,888,630,141
23010, 중구,030005, 29세,2018,1574,874,700,124.9,1474,813,661,123
23010, 중구,035,30~34세,2018,8010,4312,3698,116.6,7362,3949,3413,115.7
23010, 중구,035001, 30세,2018,1521,815,706,115.4,1409,754,655,115.1
23010, 중구,035002, 31세,2018,1621,903,718,125.8,1463,811,652,124.4
23010, 중구,035003, 32세,2018,1594,843,751,112.3,1465,775,690,112.3
23010, 중구,035004, 33세,2018,1610,840,770,109.1,1489,774,715,108.3
23010, 중구,035005, 34세,2018,1664,911,753,121,1536,835,701,119.1
23010, 중구,040,35~39세,2018,10610,5703,4907,116.2,10028,5368,4660,115.2
23010, 중구,040001, 35세,2018,1916,1050,866,121.2,1800,980,820,119.5
23010, 중구,040002, 36세,2018,2213,1147,1066,107.6,2074,1068,1006,106.2
23010, 중구,040003, 37세,2018,2156,1164,992,117.3,2043,1102,941,117.1
23010, 중구,040004, 38세,2018,2235,1209,1026,117.8,2131,1144,987,115.9
23010, 중구,040005, 39세,2018,2090,1133,957,118.4,1980,1074,906,118.5
23010, 중구,045,40~44세,2018,10306,5654,4652,121.5,9889,5399,4490,120.2
23010, 중구,045001, 40세,2018,2090,1130,960,117.7,1985,1065,920,115.8
23010, 중구,045002, 41세,2018,2029,1102,927,118.9,1939,1047,892,117.4
23010, 중구,045003, 42세,2018,1998,1089,909,119.8,1935,1055,880,119.9
23010, 중구,045004, 43세,2018,1999,1083,916,118.2,1935,1044,891,117.2
23010, 중구,045005, 44세,2018,2190,1250,940,133,2095,1188,907,131
23010, 중구,050,45~49세,2018,10654,5906,4748,124.4,10234,5679,4555,124.7
23010, 중구,050001, 45세,2018,2194,1174,1020,115.1,2113,1127,986,114.3
23010, 중구,050002, 46세,2018,2156,1179,977,120.7,2065,1130,935,120.9
23010, 중구,050003, 47세,2018,2223,1274,949,134.2,2142,1229,913,134.6
23010, 중구,050004, 48세,2018,2111,1196,915,130.7,2016,1145,871,131.5
23010, 중구,050005, 49세,2018,1970,1083,887,122.1,1898,1048,850,123.3
23010, 중구,055,50~54세,2018,8741,4834,3907,123.7,8389,4660,3729,125
23010, 중구,055001, 50세,2018,2011,1100,911,120.7,1925,1058,867,122
23010, 중구,055002, 51세,2018,1690,978,712,137.4,1638,947,691,137
23010, 중구,055003, 52세,2018,1666,913,753,121.2,1594,877,717,122.3
23010, 중구,055004, 53세,2018,1735,948,787,120.5,1667,923,744,124.1
23010, 중구,055005, 54세,2018,1639,895,744,120.3,1565,855,710,120.4
23010, 중구,060,55~59세,2018,8831,4503,4328,104,8468,4336,4132,104.9
23010, 중구,060001, 55세,2018,1743,895,848,105.5,1652,859,793,108.3
23010, 중구,060002, 56세,2018,1736,937,799,117.3,1660,898,762,117.8
23010, 중구,060003, 57세,2018,1828,903,925,97.6,1773,882,891,99
23010, 중구,060004, 58세,2018,1805,919,886,103.7,1744,893,851,104.9
23010, 중구,060005, 59세,2018,1719,849,870,97.6,1639,804,835,96.3
23010, 중구,065,60~64세,2018,7987,3943,4044,97.5,7704,3812,3892,97.9
23010, 중구,065001, 60세,2018,1726,868,858,101.2,1675,845,830,101.8
23010, 중구,065002, 61세,2018,1616,812,804,101,1554,780,774,100.8
23010, 중구,065003, 62세,2018,1562,779,783,99.5,1497,749,748,100.1
23010, 중구,065004, 63세,2018,1668,795,873,91.1,1612,770,842,91.4
23010, 중구,065005, 64세,2018,1415,689,726,94.9,1366,668,698,95.7
23010, 중구,070,65~69세,2018,5351,2529,2822,89.6,5164,2443,2721,89.8
23010, 중구,070001, 65세,2018,1144,561,583,96.2,1101,540,561,96.3
23010, 중구,070002, 66세,2018,1251,605,646,93.7,1208,581,627,92.7
23010, 중구,070003, 67세,2018,804,377,427,88.3,771,364,407,89.4
23010, 중구,070004, 68세,2018,1033,503,530,94.9,1001,489,512,95.5
23010, 중구,070005, 69세,2018,1119,483,636,75.9,1083,469,614,76.4
23010, 중구,075,70~74세,2018,4528,2164,2364,91.5,4457,2133,2324,91.8
23010, 중구,075001, 70세,2018,1044,508,536,94.8,1025,499,526,94.9
23010, 중구,075002, 71세,2018,1102,525,577,91,1081,512,569,90
23010, 중구,075003, 72세,2018,827,374,453,82.6,817,371,446,83.2
23010, 중구,075004, 73세,2018,764,365,399,91.5,751,363,388,93.6
23010, 중구,075005, 74세,2018,791,392,399,98.2,783,388,395,98.2
23010, 중구,080,75~79세,2018,3482,1512,1970,76.8,3441,1494,1947,76.7
23010, 중구,080001, 75세,2018,753,359,394,91.1,746,356,390,91.3
23010, 중구,080002, 76세,2018,877,371,506,73.3,866,366,500,73.2
23010, 중구,080003, 77세,2018,674,307,367,83.7,664,303,361,83.9
23010, 중구,080004, 78세,2018,576,242,334,72.5,567,236,331,71.3
23010, 중구,080005, 79세,2018,602,233,369,63.1,598,233,365,63.8
23010, 중구,085,80~84세,2018,2001,751,1250,60.1,1978,743,1235,60.2
23010, 중구,085001, 80세,2018,529,205,324,63.3,524,203,321,63.2
23010, 중구,085002, 81세,2018,409,164,245,66.9,402,161,241,66.8
23010, 중구,085003, 82세,2018,381,160,221,72.4,376,158,218,72.5
23010, 중구,085004, 83세,2018,371,127,244,52,367,126,241,52.3
23010, 중구,085005, 84세,2018,311,95,216,44,309,95,214,44.4
23010, 중구,090,85~89세,2018,975,268,707,37.9,968,266,702,37.9
23010, 중구,090001, 85세,2018,237,77,160,48.1,236,77,159,48.4
23010, 중구,090002, 86세,2018,256,71,185,38.4,255,71,184,38.6
23010, 중구,090003, 87세,2018,181,49,132,37.1,179,49,130,37.7
23010, 중구,090004, 88세,2018,155,33,122,27,153,32,121,26.4
23010, 중구,090005, 89세,2018,146,38,108,35.2,145,37,108,34.3
23010, 중구,095,90~94세,2018,391,100,291,34.4,389,98,291,33.7
23010, 중구,095001, 90세,2018,107,27,80,33.8,106,26,80,32.5
23010, 중구,095002, 91세,2018,106,27,79,34.2,106,27,79,34.2
23010, 중구,095003, 92세,2018,70,21,49,42.9,70,21,49,42.9
23010, 중구,095004, 93세,2018,64,13,51,25.5,63,12,51,23.5
23010, 중구,095005, 94세,2018,44,12,32,37.5,44,12,32,37.5
23010, 중구,100,95~99세,2018,104,28,76,36.8,103,28,75,37.3
23010, 중구,100001, 95세,2018,29,9,20,45,29,9,20,45
23010, 중구,100002, 96세,2018,35,6,29,20.7,34,6,28,21.4
23010, 중구,100003, 97세,2018,14,5,9,55.6,14,5,9,55.6
23010, 중구,100004, 98세,2018,16,X,13,23.1,16,X,13,23.1
23010, 중구,100005, 99세,2018,10,5,5,100,10,5,5,100
23010, 중구,101,100세이상,2018,9,X,9,0,9,X,9,0
23010, 중구,102,15세미만,2018,16240,8287,7953,104.2,15999,8164,7835,104.2
23010, 중구,103,15~64세,2018,86433,46204,40229,114.9,82452,44052,38400,114.7
23010, 중구,104,65세이상,2018,16841,7352,9489,77.5,16509,7205,9304,77.4
23010, 중구,086,85세이상,2018,1479,396,1083,36.6,1469,392,1077,36.4
23010, 중구,126,평균연령,2018,41.3,40.4,42.2,,41.3,40.4,42.3,
23010, 중구,127,중위연령,2018,41.7,41.1,42.5,,41.9,41.3,42.6,
23020, 동구,000,합계,2018,65185,32761,32424,101,63981,32090,31891,100.6
23020, 동구,005,0~4세,2018,2209,1176,1033,113.8,2191,1168,1023,114.2
23020, 동구,005001, 0세,2018,360,191,169,113,357,190,167,113.8
23020, 동구,005002, 1세,2018,379,187,192,97.4,374,186,188,98.9
23020, 동구,005003, 2세,2018,480,265,215,123.3,473,260,213,122.1
23020, 동구,005004, 3세,2018,497,268,229,117,497,268,229,117
23020, 동구,005005, 4세,2018,493,265,228,116.2,490,264,226,116.8
23020, 동구,010,5~9세,2018,2617,1328,1289,103,2604,1323,1281,103.3
23020, 동구,010001, 5세,2018,494,243,251,96.8,488,240,248,96.8
23020, 동구,010002, 6세,2018,561,300,261,114.9,560,300,260,115.4
23020, 동구,010003, 7세,2018,531,281,250,112.4,529,279,250,111.6
23020, 동구,010004, 8세,2018,538,268,270,99.3,535,268,267,100.4
23020, 동구,010005, 9세,2018,493,236,257,91.8,492,236,256,92.2
23020, 동구,015,10~14세,2018,2558,1336,1222,109.3,2547,1334,1213,110
23020, 동구,015001, 10세,2018,510,271,239,113.4,510,271,239,113.4
23020, 동구,015002, 11세,2018,587,298,289,103.1,584,298,286,104.2
23020, 동구,015003, 12세,2018,455,241,214,112.6,453,241,212,113.7
23020, 동구,015004, 13세,2018,482,251,231,108.7,479,250,229,109.2
23020, 동구,015005, 14세,2018,524,275,249,110.4,521,274,247,110.9
23020, 동구,020,15~19세,2018,2870,1483,1387,106.9,2849,1471,1378,106.7
23020, 동구,020001, 15세,2018,510,259,251,103.2,510,259,251,103.2
23020, 동구,020002, 16세,2018,533,282,251,112.4,526,278,248,112.1
23020, 동구,020003, 17세,2018,561,304,257,118.3,557,301,256,117.6
23020, 동구,020004, 18세,2018,655,329,326,100.9,655,329,326,100.9
23020, 동구,020005, 19세,2018,611,309,302,102.3,601,304,297,102.4
23020, 동구,025,20~24세,2018,3499,1866,1633,114.3,3401,1798,1603,112.2
23020, 동구,025001, 20세,2018,691,352,339,103.8,680,348,332,104.8
23020, 동구,025002, 21세,2018,719,381,338,112.7,704,371,333,111.4
23020, 동구,025003, 22세,2018,713,376,337,111.6,695,365,330,110.6
23020, 동구,025004, 23세,2018,700,371,329,112.8,672,348,324,107.4
23020, 동구,025005, 24세,2018,676,386,290,133.1,650,366,284,128.9
23020, 동구,030,25~29세,2018,3482,1867,1615,115.6,3337,1767,1570,112.5
23020, 동구,030001, 25세,2018,743,390,353,110.5,710,366,344,106.4
23020, 동구,030002, 26세,2018,733,387,346,111.8,704,366,338,108.3
23020, 동구,030003, 27세,2018,723,380,343,110.8,695,365,330,110.6
23020, 동구,030004, 28세,2018,678,366,312,117.3,649,346,303,114.2
23020, 동구,030005, 29세,2018,605,344,261,131.8,579,324,255,127.1
23020, 동구,035,30~34세,2018,3666,1992,1674,119,3476,1865,1611,115.8
23020, 동구,035001, 30세,2018,671,362,309,117.2,634,336,298,112.8
23020, 동구,035002, 31세,2018,716,401,315,127.3,678,375,303,123.8
23020, 동구,035003, 32세,2018,737,392,345,113.6,703,375,328,114.3
23020, 동구,035004, 33세,2018,776,404,372,108.6,733,374,359,104.2
23020, 동구,035005, 34세,2018,766,433,333,130,728,405,323,125.4
23020, 동구,040,35~39세,2018,5252,2792,2460,113.5,5095,2701,2394,112.8
23020, 동구,040001, 35세,2018,941,499,442,112.9,909,478,431,110.9
23020, 동구,040002, 36세,2018,992,509,483,105.4,952,482,470,102.6
23020, 동구,040003, 37세,2018,1091,583,508,114.8,1067,569,498,114.3
23020, 동구,040004, 38세,2018,1126,594,532,111.7,1094,580,514,112.8
23020, 동구,040005, 39세,2018,1102,607,495,122.6,1073,592,481,123.1
23020, 동구,045,40~44세,2018,4970,2669,2301,116,4860,2612,2248,116.2
23020, 동구,045001, 40세,2018,992,532,460,115.7,962,519,443,117.2
23020, 동구,045002, 41세,2018,938,521,417,124.9,909,505,404,125
23020, 동구,045003, 42세,2018,946,513,433,118.5,923,499,424,117.7
23020, 동구,045004, 43세,2018,1049,566,483,117.2,1033,558,475,117.5
23020, 동구,045005, 44세,2018,1045,537,508,105.7,1033,531,502,105.8
23020, 동구,050,45~49세,2018,5407,2911,2496,116.6,5298,2852,2446,116.6
23020, 동구,050001, 45세,2018,1104,580,524,110.7,1084,569,515,110.5
23020, 동구,050002, 46세,2018,1119,601,518,116,1098,591,507,116.6
23020, 동구,050003, 47세,2018,1103,607,496,122.4,1082,597,485,123.1
23020, 동구,050004, 48세,2018,1049,587,462,127.1,1020,569,451,126.2
23020, 동구,050005, 49세,2018,1032,536,496,108.1,1014,526,488,107.8
23020, 동구,055,50~54세,2018,4893,2583,2310,111.8,4794,2536,2258,112.3
23020, 동구,055001, 50세,2018,1078,581,497,116.9,1051,570,481,118.5
23020, 동구,055002, 51세,2018,951,491,460,106.7,936,484,452,107.1
23020, 동구,055003, 52세,2018,914,495,419,118.1,902,487,415,117.3
23020, 동구,055004, 53세,2018,1026,522,504,103.6,1005,513,492,104.3
23020, 동구,055005, 54세,2018,924,494,430,114.9,900,482,418,115.3
23020, 동구,060,55~59세,2018,5556,2752,2804,98.1,5466,2715,2751,98.7
23020, 동구,060001, 55세,2018,986,513,473,108.5,957,496,461,107.6
23020, 동구,060002, 56세,2018,1091,542,549,98.7,1069,536,533,100.6
23020, 동구,060003, 57세,2018,1122,558,564,98.9,1113,554,559,99.1
23020, 동구,060004, 58세,2018,1236,606,630,96.2,1217,598,619,96.6
23020, 동구,060005, 59세,2018,1121,533,588,90.6,1110,531,579,91.7
23020, 동구,065,60~64세,2018,5362,2626,2736,96,5293,2600,2693,96.5
23020, 동구,065001, 60세,2018,1163,576,587,98.1,1148,568,580,97.9
23020, 동구,065002, 61세,2018,1107,534,573,93.2,1089,528,561,94.1
23020, 동구,065003, 62세,2018,1068,525,543,96.7,1056,522,534,97.8
23020, 동구,065004, 63세,2018,1088,516,572,90.2,1079,514,565,91
23020, 동구,065005, 64세,2018,936,475,461,103,921,468,453,103.3
23020, 동구,070,65~69세,2018,3897,1789,2108,84.9,3854,1769,2085,84.8
23020, 동구,070001, 65세,2018,792,384,408,94.1,783,380,403,94.3
23020, 동구,070002, 66세,2018,925,434,491,88.4,914,428,486,88.1
23020, 동구,070003, 67세,2018,650,274,376,72.9,641,269,372,72.3
23020, 동구,070004, 68세,2018,761,360,401,89.8,756,359,397,90.4
23020, 동구,070005, 69세,2018,769,337,432,78,760,333,427,78
23020, 동구,075,70~74세,2018,3426,1543,1883,81.9,3410,1536,1874,82
23020, 동구,075001, 70세,2018,795,364,431,84.5,790,363,427,85
23020, 동구,075002, 71세,2018,784,344,440,78.2,778,341,437,78
23020, 동구,075003, 72세,2018,643,292,351,83.2,641,290,351,82.6
23020, 동구,075004, 73세,2018,611,291,320,90.9,608,290,318,91.2
23020, 동구,075005, 74세,2018,593,252,341,73.9,593,252,341,73.9
23020, 동구,080,75~79세,2018,2794,1194,1600,74.6,2789,1192,1597,74.6
23020, 동구,080001, 75세,2018,587,250,337,74.2,586,249,337,73.9
23020, 동구,080002, 76세,2018,710,320,390,82.1,710,320,390,82.1
23020, 동구,080003, 77세,2018,561,240,321,74.8,557,239,318,75.2
23020, 동구,080004, 78세,2018,449,199,250,79.6,449,199,250,79.6
23020, 동구,080005, 79세,2018,487,185,302,61.3,487,185,302,61.3
23020, 동구,085,80~84세,2018,1631,564,1067,52.9,1625,562,1063,52.9
23020, 동구,085001, 80세,2018,395,150,245,61.2,395,150,245,61.2
23020, 동구,085002, 81세,2018,360,139,221,62.9,360,139,221,62.9
23020, 동구,085003, 82세,2018,338,116,222,52.3,337,116,221,52.5
23020, 동구,085004, 83세,2018,300,92,208,44.2,297,90,207,43.5
23020, 동구,085005, 84세,2018,238,67,171,39.2,236,67,169,39.6
23020, 동구,090,85~89세,2018,785,218,567,38.4,782,217,565,38.4
23020, 동구,090001, 85세,2018,209,54,155,34.8,208,54,154,35.1
23020, 동구,090002, 86세,2018,205,58,147,39.5,204,57,147,38.8
23020, 동구,090003, 87세,2018,145,42,103,40.8,145,42,103,40.8
23020, 동구,090004, 88세,2018,124,36,88,40.9,123,36,87,41.4
23020, 동구,090005, 89세,2018,102,28,74,37.8,102,28,74,37.8
23020, 동구,095,90~94세,2018,256,56,200,28,255,56,199,28.1
23020, 동구,095001, 90세,2018,86,19,67,28.4,86,19,67,28.4
23020, 동구,095002, 91세,2018,71,19,52,36.5,70,19,51,37.3
23020, 동구,095003, 92세,2018,37,9,28,32.1,37,9,28,32.1
23020, 동구,095004, 93세,2018,28,X,26,7.7,28,X,26,7.7
23020, 동구,095005, 94세,2018,34,7,27,25.9,34,7,27,25.9
23020, 동구,100,95~99세,2018,46,14,32,43.8,46,14,32,43.8
23020, 동구,100001, 95세,2018,20,7,13,53.8,20,7,13,53.8
23020, 동구,100002, 96세,2018,11,X,8,37.5,11,X,8,37.5
23020, 동구,100003, 97세,2018,7,X,5,40,7,X,5,40
23020, 동구,100004, 98세,2018,X,X,X,33.3,X,X,X,33.3
23020, 동구,100005, 99세,2018,X,X,X,33.3,X,X,X,33.3
23020, 동구,101,100세이상,2018,9,X,7,28.6,9,X,7,28.6
23020, 동구,102,15세미만,2018,7384,3840,3544,108.4,7342,3825,3517,108.8
23020, 동구,103,15~64세,2018,44957,23541,21416,109.9,43869,22917,20952,109.4
23020, 동구,104,65세이상,2018,12844,5380,7464,72.1,12770,5348,7422,72.1
23020, 동구,086,85세이상,2018,1096,290,806,36,1092,289,803,36
23020, 동구,126,평균연령,2018,45,43.5,46.6,,45.1,43.6,46.7,
23020, 동구,127,중위연령,2018,46.3,44.8,48.1,,46.5,45,48.3,
23040, 연수구,000,합계,2018,349963,174622,175341,99.6,334732,166555,168177,99
23040, 연수구,005,0~4세,2018,15524,7902,7622,103.7,14653,7439,7214,103.1
23040, 연수구,005001, 0세,2018,2545,1310,1235,106.1,2380,1217,1163,104.6
23040, 연수구,005002, 1세,2018,2843,1415,1428,99.1,2663,1330,1333,99.8
23040, 연수구,005003, 2세,2018,3173,1600,1573,101.7,2992,1494,1498,99.7
23040, 연수구,005004, 3세,2018,3462,1785,1677,106.4,3281,1684,1597,105.4
23040, 연수구,005005, 4세,2018,3501,1792,1709,104.9,3337,1714,1623,105.6
23040, 연수구,010,5~9세,2018,19032,9787,9245,105.9,18428,9476,8952,105.9
23040, 연수구,010001, 5세,2018,3639,1859,1780,104.4,3504,1790,1714,104.4
23040, 연수구,010002, 6세,2018,3877,1961,1916,102.3,3737,1891,1846,102.4
23040, 연수구,010003, 7세,2018,3969,2044,1925,106.2,3845,1984,1861,106.6
23040, 연수구,010004, 8세,2018,3729,1931,1798,107.4,3635,1880,1755,107.1
23040, 연수구,010005, 9세,2018,3818,1992,1826,109.1,3707,1931,1776,108.7
23040, 연수구,015,10~14세,2018,19085,9732,9353,104.1,18612,9492,9120,104.1
23040, 연수구,015001, 10세,2018,3927,1989,1938,102.6,3804,1921,1883,102
23040, 연수구,015002, 11세,2018,4044,2060,1984,103.8,3946,2010,1936,103.8
23040, 연수구,015003, 12세,2018,3645,1850,1795,103.1,3555,1805,1750,103.1
23040, 연수구,015004, 13세,2018,3572,1830,1742,105.1,3490,1788,1702,105.1
23040, 연수구,015005, 14세,2018,3897,2003,1894,105.8,3817,1968,1849,106.4
23040, 연수구,020,15~19세,2018,23043,11720,11323,103.5,22339,11416,10923,104.5
23040, 연수구,020001, 15세,2018,3684,1855,1829,101.4,3627,1825,1802,101.3
23040, 연수구,020002, 16세,2018,3733,1945,1788,108.8,3679,1910,1769,108
23040, 연수구,020003, 17세,2018,4204,2224,1980,112.3,4124,2187,1937,112.9
23040, 연수구,020004, 18세,2018,5216,2644,2572,102.8,5015,2562,2453,104.4
23040, 연수구,020005, 19세,2018,6206,3052,3154,96.8,5894,2932,2962,99
23040, 연수구,025,20~24세,2018,25484,13259,12225,108.5,23824,12403,11421,108.6
23040, 연수구,025001, 20세,2018,5457,2807,2650,105.9,5135,2648,2487,106.5
23040, 연수구,025002, 21세,2018,5070,2655,2415,109.9,4754,2483,2271,109.3
23040, 연수구,025003, 22세,2018,4980,2576,2404,107.2,4654,2408,2246,107.2
23040, 연수구,025004, 23세,2018,4942,2565,2377,107.9,4621,2404,2217,108.4
23040, 연수구,025005, 24세,2018,5035,2656,2379,111.6,4660,2460,2200,111.8
23040, 연수구,030,25~29세,2018,25142,13098,12044,108.8,23059,11995,11064,108.4
23040, 연수구,030001, 25세,2018,5166,2748,2418,113.6,4790,2543,2247,113.2
23040, 연수구,030002, 26세,2018,5283,2706,2577,105,4904,2510,2394,104.8
23040, 연수구,030003, 27세,2018,5081,2654,2427,109.4,4678,2447,2231,109.7
23040, 연수구,030004, 28세,2018,4927,2558,2369,108,4476,2323,2153,107.9
23040, 연수구,030005, 29세,2018,4685,2432,2253,107.9,4211,2172,2039,106.5
23040, 연수구,035,30~34세,2018,22888,11630,11258,103.3,20524,10282,10242,100.4
23040, 연수구,035001, 30세,2018,4467,2321,2146,108.2,4007,2062,1945,106
23040, 연수구,035002, 31세,2018,4383,2212,2171,101.9,3894,1925,1969,97.8
23040, 연수구,035003, 32세,2018,4564,2302,2262,101.8,4040,2012,2028,99.2
23040, 연수구,035004, 33세,2018,4684,2394,2290,104.5,4208,2127,2081,102.2
23040, 연수구,035005, 34세,2018,4790,2401,2389,100.5,4375,2156,2219,97.2
23040, 연수구,040,35~39세,2018,29134,14331,14803,96.8,27251,13259,13992,94.8
23040, 연수구,040001, 35세,2018,5324,2599,2725,95.4,4888,2340,2548,91.8
23040, 연수구,040002, 36세,2018,5807,2872,2935,97.9,5403,2638,2765,95.4
23040, 연수구,040003, 37세,2018,6048,2961,3087,95.9,5695,2750,2945,93.4
23040, 연수구,040004, 38세,2018,6038,2997,3041,98.6,5699,2809,2890,97.2
23040, 연수구,040005, 39세,2018,5917,2902,3015,96.3,5566,2722,2844,95.7
23040, 연수구,045,40~44세,2018,29234,14380,14854,96.8,27811,13571,14240,95.3
23040, 연수구,045001, 40세,2018,5540,2749,2791,98.5,5186,2546,2640,96.4
23040, 연수구,045002, 41세,2018,5611,2750,2861,96.1,5329,2591,2738,94.6
23040, 연수구,045003, 42세,2018,5572,2778,2794,99.4,5295,2618,2677,97.8
23040, 연수구,045004, 43세,2018,6057,2940,3117,94.3,5784,2786,2998,92.9
23040, 연수구,045005, 44세,2018,6454,3163,3291,96.1,6217,3030,3187,95.1
23040, 연수구,050,45~49세,2018,33442,16325,17117,95.4,32285,15715,16570,94.8
23040, 연수구,050001, 45세,2018,6585,3091,3494,88.5,6323,2966,3357,88.4
23040, 연수구,050002, 46세,2018,6599,3250,3349,97,6352,3118,3234,96.4
23040, 연수구,050003, 47세,2018,6948,3470,3478,99.8,6723,3340,3383,98.7
23040, 연수구,050004, 48세,2018,6585,3253,3332,97.6,6362,3134,3228,97.1
23040, 연수구,050005, 49세,2018,6725,3261,3464,94.1,6525,3157,3368,93.7
23040, 연수구,055,50~54세,2018,29641,14536,15105,96.2,28836,14131,14705,96.1
23040, 연수구,055001, 50세,2018,6426,3137,3289,95.4,6207,3025,3182,95.1
23040, 연수구,055002, 51세,2018,5814,2854,2960,96.4,5679,2780,2899,95.9
23040, 연수구,055003, 52세,2018,5727,2788,2939,94.9,5566,2716,2850,95.3
23040, 연수구,055004, 53세,2018,5974,2907,3067,94.8,5827,2834,2993,94.7
23040, 연수구,055005, 54세,2018,5700,2850,2850,100,5557,2776,2781,99.8
23040, 연수구,060,55~59세,2018,29057,14995,14062,106.6,28491,14710,13781,106.7
23040, 연수구,060001, 55세,2018,6061,3095,2966,104.3,5903,3009,2894,104
23040, 연수구,060002, 56세,2018,5976,3032,2944,103,5871,2979,2892,103
23040, 연수구,060003, 57세,2018,6150,3191,2959,107.8,6044,3139,2905,108.1
23040, 연수구,060004, 58세,2018,5847,3039,2808,108.2,5734,2979,2755,108.1
23040, 연수구,060005, 59세,2018,5023,2638,2385,110.6,4939,2604,2335,111.5
23040, 연수구,065,60~64세,2018,18862,9859,9003,109.5,18490,9698,8792,110.3
23040, 연수구,065001, 60세,2018,4579,2445,2134,114.6,4478,2400,2078,115.5
23040, 연수구,065002, 61세,2018,4197,2199,1998,110.1,4121,2159,1962,110
23040, 연수구,065003, 62세,2018,3650,1857,1793,103.6,3581,1838,1743,105.5
23040, 연수구,065004, 63세,2018,3580,1827,1753,104.2,3505,1795,1710,105
23040, 연수구,065005, 64세,2018,2856,1531,1325,115.5,2805,1506,1299,115.9
23040, 연수구,070,65~69세,2018,10111,5063,5048,100.3,9957,5003,4954,101
23040, 연수구,070001, 65세,2018,2356,1168,1188,98.3,2320,1154,1166,99
23040, 연수구,070002, 66세,2018,2579,1346,1233,109.2,2543,1334,1209,110.3
23040, 연수구,070003, 67세,2018,1560,781,779,100.3,1526,766,760,100.8
23040, 연수구,070004, 68세,2018,1762,867,895,96.9,1738,857,881,97.3
23040, 연수구,070005, 69세,2018,1854,901,953,94.5,1830,892,938,95.1
23040, 연수구,075,70~74세,2018,7401,3442,3959,86.9,7330,3413,3917,87.1
23040, 연수구,075001, 70세,2018,1806,850,956,88.9,1784,840,944,89
23040, 연수구,075002, 71세,2018,1779,781,998,78.3,1764,776,988,78.5
23040, 연수구,075003, 72세,2018,1380,669,711,94.1,1364,663,701,94.6
23040, 연수구,075004, 73세,2018,1207,571,636,89.8,1198,566,632,89.6
23040, 연수구,075005, 74세,2018,1229,571,658,86.8,1220,568,652,87.1
23040, 연수구,080,75~79세,2018,6061,2474,3587,69,6040,2467,3573,69
23040, 연수구,080001, 75세,2018,1344,592,752,78.7,1341,591,750,78.8
23040, 연수구,080002, 76세,2018,1429,587,842,69.7,1424,586,838,69.9
23040, 연수구,080003, 77세,2018,1177,506,671,75.4,1174,504,670,75.2
23040, 연수구,080004, 78세,2018,1053,411,642,64,1047,410,637,64.4
23040, 연수구,080005, 79세,2018,1058,378,680,55.6,1054,376,678,55.5
23040, 연수구,085,80~84세,2018,3882,1331,2551,52.2,3874,1330,2544,52.3
23040, 연수구,085001, 80세,2018,979,361,618,58.4,976,361,615,58.7
23040, 연수구,085002, 81세,2018,865,301,564,53.4,862,300,562,53.4
23040, 연수구,085003, 82세,2018,712,235,477,49.3,710,235,475,49.5
23040, 연수구,085004, 83세,2018,728,242,486,49.8,728,242,486,49.8
23040, 연수구,085005, 84세,2018,598,192,406,47.3,598,192,406,47.3
23040, 연수구,090,85~89세,2018,2041,538,1503,35.8,2032,535,1497,35.7
23040, 연수구,090001, 85세,2018,536,147,389,37.8,534,146,388,37.6
23040, 연수구,090002, 86세,2018,492,139,353,39.4,490,139,351,39.6
23040, 연수구,090003, 87세,2018,383,93,290,32.1,380,92,288,31.9
23040, 연수구,090004, 88세,2018,338,81,257,31.5,336,80,256,31.3
23040, 연수구,090005, 89세,2018,292,78,214,36.4,292,78,214,36.4
23040, 연수구,095,90~94세,2018,708,172,536,32.1,705,172,533,32.3
23040, 연수구,095001, 90세,2018,223,62,161,38.5,221,62,159,39
23040, 연수구,095002, 91세,2018,172,50,122,41,171,50,121,41.3
23040, 연수구,095003, 92세,2018,131,28,103,27.2,131,28,103,27.2
23040, 연수구,095004, 93세,2018,112,14,98,14.3,112,14,98,14.3
23040, 연수구,095005, 94세,2018,70,18,52,34.6,70,18,52,34.6
23040, 연수구,100,95~99세,2018,175,45,130,34.6,175,45,130,34.6
23040, 연수구,100001, 95세,2018,64,16,48,33.3,64,16,48,33.3
23040, 연수구,100002, 96세,2018,50,11,39,28.2,50,11,39,28.2
23040, 연수구,100003, 97세,2018,28,8,20,40,28,8,20,40
23040, 연수구,100004, 98세,2018,15,5,10,50,15,5,10,50
23040, 연수구,100005, 99세,2018,18,5,13,38.5,18,5,13,38.5
23040, 연수구,101,100세이상,2018,16,X,13,23.1,16,X,13,23.1
23040, 연수구,102,15세미만,2018,53641,27421,26220,104.6,51693,26407,25286,104.4
23040, 연수구,103,15~64세,2018,265927,134133,131794,101.8,252910,127180,125730,101.2
23040, 연수구,104,65세이상,2018,30395,13068,17327,75.4,30129,12968,17161,75.6
23040, 연수구,086,85세이상,2018,2940,758,2182,34.7,2928,755,2173,34.7
23040, 연수구,126,평균연령,2018,38.4,37.7,39.1,,38.6,37.9,39.3,
23040, 연수구,127,중위연령,2018,39.3,38.6,39.9,,39.8,39.1,40.4,
23050, 남동구,000,합계,2018,537389,269790,267599,100.8,520814,258792,262022,98.8
23050, 남동구,005,0~4세,2018,22496,11580,10916,106.1,22185,11423,10762,106.1
23050, 남동구,005001, 0세,2018,3720,1934,1786,108.3,3668,1909,1759,108.5
23050, 남동구,005002, 1세,2018,4090,2111,1979,106.7,4012,2067,1945,106.3
23050, 남동구,005003, 2세,2018,4684,2418,2266,106.7,4603,2379,2224,107
23050, 남동구,005004, 3세,2018,5038,2542,2496,101.8,4979,2517,2462,102.2
23050, 남동구,005005, 4세,2018,4964,2575,2389,107.8,4923,2551,2372,107.5
23050, 남동구,010,5~9세,2018,26345,13494,12851,105,26162,13396,12766,104.9
23050, 남동구,010001, 5세,2018,5141,2588,2553,101.4,5087,2562,2525,101.5
23050, 남동구,010002, 6세,2018,5510,2826,2684,105.3,5470,2806,2664,105.3
23050, 남동구,010003, 7세,2018,5434,2855,2579,110.7,5400,2831,2569,110.2
23050, 남동구,010004, 8세,2018,5219,2667,2552,104.5,5194,2652,2542,104.3
23050, 남동구,010005, 9세,2018,5041,2558,2483,103,5011,2545,2466,103.2
23050, 남동구,015,10~14세,2018,24400,12463,11937,104.4,24275,12406,11869,104.5
23050, 남동구,015001, 10세,2018,5156,2583,2573,100.4,5123,2566,2557,100.4
23050, 남동구,015002, 11세,2018,5165,2667,2498,106.8,5141,2661,2480,107.3
23050, 남동구,015003, 12세,2018,4745,2476,2269,109.1,4723,2465,2258,109.2
23050, 남동구,015004, 13세,2018,4555,2305,2250,102.4,4532,2294,2238,102.5
23050, 남동구,015005, 14세,2018,4779,2432,2347,103.6,4756,2420,2336,103.6
23050, 남동구,020,15~19세,2018,27014,13818,13196,104.7,26838,13716,13122,104.5
23050, 남동구,020001, 15세,2018,5024,2590,2434,106.4,4999,2579,2420,106.6
23050, 남동구,020002, 16세,2018,5074,2607,2467,105.7,5050,2595,2455,105.7
23050, 남동구,020003, 17세,2018,5921,3006,2915,103.1,5895,2991,2904,103
23050, 남동구,020004, 18세,2018,5917,2954,2963,99.7,5879,2929,2950,99.3
23050, 남동구,020005, 19세,2018,5078,2661,2417,110.1,5015,2622,2393,109.6
23050, 남동구,025,20~24세,2018,33114,17504,15610,112.1,31814,16573,15241,108.7
23050, 남동구,025001, 20세,2018,5742,3131,2611,119.9,5632,3068,2564,119.7
23050, 남동구,025002, 21세,2018,6162,3376,2786,121.2,5969,3253,2716,119.8
23050, 남동구,025003, 22세,2018,6615,3550,3065,115.8,6364,3364,3000,112.1
23050, 남동구,025004, 23세,2018,7166,3621,3545,102.1,6824,3366,3458,97.3
23050, 남동구,025005, 24세,2018,7429,3826,3603,106.2,7025,3522,3503,100.5
23050, 남동구,030,25~29세,2018,39029,20702,18327,113,36292,18669,17623,105.9
23050, 남동구,030001, 25세,2018,8097,4313,3784,114,7659,3981,3678,108.2
23050, 남동구,030002, 26세,2018,8309,4343,3966,109.5,7838,3992,3846,103.8
23050, 남동구,030003, 27세,2018,7877,4216,3661,115.2,7316,3795,3521,107.8
23050, 남동구,030004, 28세,2018,7592,4057,3535,114.8,6958,3581,3377,106
23050, 남동구,030005, 29세,2018,7154,3773,3381,111.6,6521,3320,3201,103.7
23050, 남동구,035,30~34세,2018,37223,19965,17258,115.7,33893,17555,16338,107.4
23050, 남동구,035001, 30세,2018,7304,3913,3391,115.4,6621,3429,3192,107.4
23050, 남동구,035002, 31세,2018,7118,3776,3342,113,6449,3298,3151,104.7
23050, 남동구,035003, 32세,2018,7365,3961,3404,116.4,6687,3479,3208,108.4
23050, 남동구,035004, 33세,2018,7429,4023,3406,118.1,6793,3540,3253,108.8
23050, 남동구,035005, 34세,2018,8007,4292,3715,115.5,7343,3809,3534,107.8
23050, 남동구,040,35~39세,2018,48191,25015,23176,107.9,45620,23106,22514,102.6
23050, 남동구,040001, 35세,2018,8958,4670,4288,108.9,8363,4211,4152,101.4
23050, 남동구,040002, 36세,2018,9805,5104,4701,108.6,9253,4680,4573,102.3
23050, 남동구,040003, 37세,2018,9853,5156,4697,109.8,9379,4822,4557,105.8
23050, 남동구,040004, 38세,2018,10044,5159,4885,105.6,9571,4811,4760,101.1
23050, 남동구,040005, 39세,2018,9531,4926,4605,107,9054,4582,4472,102.5
23050, 남동구,045,40~44세,2018,44023,22923,21100,108.6,42474,21825,20649,105.7
23050, 남동구,045001, 40세,2018,8663,4430,4233,104.7,8310,4167,4143,100.6
23050, 남동구,045002, 41세,2018,8818,4582,4236,108.2,8501,4361,4140,105.3
23050, 남동구,045003, 42세,2018,8321,4423,3898,113.5,8015,4204,3811,110.3
23050, 남동구,045004, 43세,2018,8810,4596,4214,109.1,8520,4398,4122,106.7
23050, 남동구,045005, 44세,2018,9411,4892,4519,108.3,9128,4695,4433,105.9
23050, 남동구,050,45~49세,2018,47834,23976,23858,100.5,46552,23233,23319,99.6
23050, 남동구,050001, 45세,2018,9350,4713,4637,101.6,9082,4548,4534,100.3
23050, 남동구,050002, 46세,2018,9350,4788,4562,105,9107,4657,4450,104.7
23050, 남동구,050003, 47세,2018,9831,4957,4874,101.7,9554,4789,4765,100.5
23050, 남동구,050004, 48세,2018,9640,4832,4808,100.5,9389,4681,4708,99.4
23050, 남동구,050005, 49세,2018,9663,4686,4977,94.2,9420,4558,4862,93.7
23050, 남동구,055,50~54세,2018,44695,21912,22783,96.2,43651,21352,22299,95.8
23050, 남동구,055001, 50세,2018,9677,4707,4970,94.7,9442,4572,4870,93.9
23050, 남동구,055002, 51세,2018,8729,4229,4500,94,8546,4132,4414,93.6
23050, 남동구,055003, 52세,2018,8568,4215,4353,96.8,8379,4110,4269,96.3
23050, 남동구,055004, 53세,2018,9209,4527,4682,96.7,8986,4404,4582,96.1
23050, 남동구,055005, 54세,2018,8512,4234,4278,99,8298,4134,4164,99.3
23050, 남동구,060,55~59세,2018,46275,22927,23348,98.2,45484,22534,22950,98.2
23050, 남동구,060001, 55세,2018,8940,4455,4485,99.3,8723,4350,4373,99.5
23050, 남동구,060002, 56세,2018,9259,4635,4624,100.2,9090,4555,4535,100.4
23050, 남동구,060003, 57세,2018,9941,4926,5015,98.2,9808,4868,4940,98.5
23050, 남동구,060004, 58세,2018,9692,4812,4880,98.6,9537,4730,4807,98.4
23050, 남동구,060005, 59세,2018,8443,4099,4344,94.4,8326,4031,4295,93.9
23050, 남동구,065,60~64세,2018,34600,16853,17747,95,34010,16579,17431,95.1
23050, 남동구,065001, 60세,2018,8093,3969,4124,96.2,7952,3900,4052,96.2
23050, 남동구,065002, 61세,2018,7467,3698,3769,98.1,7329,3630,3699,98.1
23050, 남동구,065003, 62세,2018,6542,3161,3381,93.5,6446,3118,3328,93.7
23050, 남동구,065004, 63세,2018,6829,3336,3493,95.5,6718,3283,3435,95.6
23050, 남동구,065005, 64세,2018,5669,2689,2980,90.2,5565,2648,2917,90.8
23050, 남동구,070,65~69세,2018,21540,10498,11042,95.1,21206,10344,10862,95.2
23050, 남동구,070001, 65세,2018,4878,2346,2532,92.7,4791,2312,2479,93.3
23050, 남동구,070002, 66세,2018,5254,2558,2696,94.9,5161,2511,2650,94.8
23050, 남동구,070003, 67세,2018,3489,1706,1783,95.7,3430,1677,1753,95.7
23050, 남동구,070004, 68세,2018,3963,1938,2025,95.7,3907,1912,1995,95.8
23050, 남동구,070005, 69세,2018,3956,1950,2006,97.2,3917,1932,1985,97.3
23050, 남동구,075,70~74세,2018,15821,7414,8407,88.2,15692,7364,8328,88.4
23050, 남동구,075001, 70세,2018,3815,1843,1972,93.5,3774,1826,1948,93.7
23050, 남동구,075002, 71세,2018,3763,1767,1996,88.5,3739,1757,1982,88.6
23050, 남동구,075003, 72세,2018,2899,1346,1553,86.7,2879,1338,1541,86.8
23050, 남동구,075004, 73세,2018,2656,1217,1439,84.6,2631,1210,1421,85.2
23050, 남동구,075005, 74세,2018,2688,1241,1447,85.8,2669,1233,1436,85.9
23050, 남동구,080,75~79세,2018,12088,4927,7161,68.8,12029,4911,7118,69
23050, 남동구,080001, 75세,2018,2620,1088,1532,71,2606,1084,1522,71.2
23050, 남동구,080002, 76세,2018,3036,1273,1763,72.2,3023,1268,1755,72.3
23050, 남동구,080003, 77세,2018,2309,936,1373,68.2,2291,931,1360,68.5
23050, 남동구,080004, 78세,2018,2092,838,1254,66.8,2082,836,1246,67.1
23050, 남동구,080005, 79세,2018,2031,792,1239,63.9,2027,792,1235,64.1
23050, 남동구,085,80~84세,2018,7343,2588,4755,54.4,7300,2579,4721,54.6
23050, 남동구,085001, 80세,2018,1807,697,1110,62.8,1795,695,1100,63.2
23050, 남동구,085002, 81세,2018,1592,603,989,61,1586,602,984,61.2
23050, 남동구,085003, 82세,2018,1503,497,1006,49.4,1489,494,995,49.6
23050, 남동구,085004, 83세,2018,1334,455,879,51.8,1329,454,875,51.9
23050, 남동구,085005, 84세,2018,1107,336,771,43.6,1101,334,767,43.5
23050, 남동구,090,85~89세,2018,3690,908,2782,32.6,3675,905,2770,32.7
23050, 남동구,090001, 85세,2018,963,291,672,43.3,960,291,669,43.5
23050, 남동구,090002, 86세,2018,843,207,636,32.5,839,205,634,32.3
23050, 남동구,090003, 87세,2018,657,134,523,25.6,654,134,520,25.8
23050, 남동구,090004, 88세,2018,660,136,524,26,656,135,521,25.9
23050, 남동구,090005, 89세,2018,567,140,427,32.8,566,140,426,32.9
23050, 남동구,095,90~94세,2018,1293,253,1040,24.3,1287,252,1035,24.3
23050, 남동구,095001, 90세,2018,422,90,332,27.1,421,90,331,27.2
23050, 남동구,095002, 91세,2018,330,65,265,24.5,327,65,262,24.8
23050, 남동구,095003, 92세,2018,219,42,177,23.7,218,41,177,23.2
23050, 남동구,095004, 93세,2018,194,33,161,20.5,194,33,161,20.5
23050, 남동구,095005, 94세,2018,128,23,105,21.9,127,23,104,22.1
23050, 남동구,100,95~99세,2018,334,66,268,24.6,334,66,268,24.6
23050, 남동구,100001, 95세,2018,130,29,101,28.7,130,29,101,28.7
23050, 남동구,100002, 96세,2018,82,13,69,18.8,82,13,69,18.8
23050, 남동구,100003, 97세,2018,50,10,40,25,50,10,40,25
23050, 남동구,100004, 98세,2018,44,6,38,15.8,44,6,38,15.8
23050, 남동구,100005, 99세,2018,28,8,20,40,28,8,20,40
23050, 남동구,101,100세이상,2018,41,X,37,10.8,41,X,37,10.8
23050, 남동구,102,15세미만,2018,73241,37537,35704,105.1,72622,37225,35397,105.2
23050, 남동구,103,15~64세,2018,401998,205595,196403,104.7,386628,195142,191486,101.9
23050, 남동구,104,65세이상,2018,62150,26658,35492,75.1,61564,26425,35139,75.2
23050, 남동구,086,85세이상,2018,5358,1231,4127,29.8,5337,1227,4110,29.9
23050, 남동구,126,평균연령,2018,40.6,39.5,41.6,,40.6,39.6,41.6,
23050, 남동구,127,중위연령,2018,41.3,40.1,42.5,,41.6,40.6,42.7,
23060, 부평구,000,합계,2018,525014,260408,264606,98.4,506644,251075,255569,98.2
23060, 부평구,005,0~4세,2018,19843,10172,9671,105.2,19044,9765,9279,105.2
23060, 부평구,005001, 0세,2018,3561,1836,1725,106.4,3385,1744,1641,106.3
23060, 부평구,005002, 1세,2018,3679,1944,1735,112,3505,1846,1659,111.3
23060, 부평구,005003, 2세,2018,4163,2102,2061,102,3969,2007,1962,102.3
23060, 부평구,005004, 3세,2018,4259,2158,2101,102.7,4123,2096,2027,103.4
23060, 부평구,005005, 4세,2018,4181,2132,2049,104.1,4062,2072,1990,104.1
23060, 부평구,010,5~9세,2018,20784,10607,10177,104.2,20457,10451,10006,104.4
23060, 부평구,010001, 5세,2018,3981,1999,1982,100.9,3912,1966,1946,101
23060, 부평구,010002, 6세,2018,4355,2203,2152,102.4,4261,2157,2104,102.5
23060, 부평구,010003, 7세,2018,4278,2211,2067,107,4213,2177,2036,106.9
23060, 부평구,010004, 8세,2018,4068,2126,1942,109.5,4016,2105,1911,110.2
23060, 부평구,010005, 9세,2018,4102,2068,2034,101.7,4055,2046,2009,101.8
23060, 부평구,015,10~14세,2018,21217,11037,10180,108.4,21066,10956,10110,108.4
23060, 부평구,015001, 10세,2018,4239,2211,2028,109,4195,2189,2006,109.1
23060, 부평구,015002, 11세,2018,4496,2343,2153,108.8,4469,2329,2140,108.8
23060, 부평구,015003, 12세,2018,4031,2107,1924,109.5,4004,2090,1914,109.2
23060, 부평구,015004, 13세,2018,4039,2075,1964,105.7,4009,2059,1950,105.6
23060, 부평구,015005, 14세,2018,4412,2301,2111,109,4389,2289,2100,109
23060, 부평구,020,15~19세,2018,26358,13666,12692,107.7,26167,13574,12593,107.8
23060, 부평구,020001, 15세,2018,4674,2450,2224,110.2,4655,2442,2213,110.3
23060, 부평구,020002, 16세,2018,4863,2508,2355,106.5,4839,2493,2346,106.3
23060, 부평구,020003, 17세,2018,5523,2860,2663,107.4,5485,2841,2644,107.5
23060, 부평구,020004, 18세,2018,6024,3049,2975,102.5,5983,3031,2952,102.7
23060, 부평구,020005, 19세,2018,5274,2799,2475,113.1,5205,2767,2438,113.5
23060, 부평구,025,20~24세,2018,34198,17884,16314,109.6,33491,17534,15957,109.9
23060, 부평구,025001, 20세,2018,5841,3129,2712,115.4,5750,3082,2668,115.5
23060, 부평구,025002, 21세,2018,6520,3486,3034,114.9,6417,3438,2979,115.4
23060, 부평구,025003, 22세,2018,6720,3512,3208,109.5,6572,3443,3129,110
23060, 부평구,025004, 23세,2018,7395,3867,3528,109.6,7207,3768,3439,109.6
23060, 부평구,025005, 24세,2018,7722,3890,3832,101.5,7545,3803,3742,101.6
23060, 부평구,030,25~29세,2018,39756,20146,19610,102.7,37802,19198,18604,103.2
23060, 부평구,030001, 25세,2018,8103,4046,4057,99.7,7846,3922,3924,99.9
23060, 부평구,030002, 26세,2018,8348,4227,4121,102.6,8020,4064,3956,102.7
23060, 부평구,030003, 27세,2018,8081,4079,4002,101.9,7688,3907,3781,103.3
23060, 부평구,030004, 28세,2018,7669,3882,3787,102.5,7204,3661,3543,103.3
23060, 부평구,030005, 29세,2018,7555,3912,3643,107.4,7044,3644,3400,107.2
23060, 부평구,035,30~34세,2018,37106,19084,18022,105.9,34285,17614,16671,105.7
23060, 부평구,035001, 30세,2018,7350,3678,3672,100.2,6738,3365,3373,99.8
23060, 부평구,035002, 31세,2018,7301,3730,3571,104.5,6696,3425,3271,104.7
23060, 부평구,035003, 32세,2018,7487,3894,3593,108.4,6891,3572,3319,107.6
23060, 부평구,035004, 33세,2018,7319,3789,3530,107.3,6785,3523,3262,108
23060, 부평구,035005, 34세,2018,7649,3993,3656,109.2,7175,3729,3446,108.2
23060, 부평구,040,35~39세,2018,42524,22093,20431,108.1,40599,21008,19591,107.2
23060, 부평구,040001, 35세,2018,8090,4208,3882,108.4,7630,3958,3672,107.8
23060, 부평구,040002, 36세,2018,8907,4535,4372,103.7,8450,4282,4168,102.7
23060, 부평구,040003, 37세,2018,8766,4606,4160,110.7,8410,4420,3990,110.8
23060, 부평구,040004, 38세,2018,8676,4504,4172,108,8349,4316,4033,107
23060, 부평구,040005, 39세,2018,8085,4240,3845,110.3,7760,4032,3728,108.2
23060, 부평구,045,40~44세,2018,38608,19651,18957,103.7,37269,18879,18390,102.7
23060, 부평구,045001, 40세,2018,7443,3817,3626,105.3,7115,3620,3495,103.6
23060, 부평구,045002, 41세,2018,7644,3934,3710,106,7398,3784,3614,104.7
23060, 부평구,045003, 42세,2018,7337,3797,3540,107.3,7061,3639,3422,106.3
23060, 부평구,045004, 43세,2018,7740,3827,3913,97.8,7494,3696,3798,97.3
23060, 부평구,045005, 44세,2018,8444,4276,4168,102.6,8201,4140,4061,101.9
23060, 부평구,050,45~49세,2018,46192,22713,23479,96.7,44475,21813,22662,96.3
23060, 부평구,050001, 45세,2018,8708,4387,4321,101.5,8409,4226,4183,101
23060, 부평구,050002, 46세,2018,8935,4443,4492,98.9,8605,4264,4341,98.2
23060, 부평구,050003, 47세,2018,9377,4614,4763,96.9,9024,4431,4593,96.5
23060, 부평구,050004, 48세,2018,9441,4624,4817,96,9047,4412,4635,95.2
23060, 부평구,050005, 49세,2018,9731,4645,5086,91.3,9390,4480,4910,91.2
23060, 부평구,055,50~54세,2018,47015,22793,24222,94.1,45170,21869,23301,93.9
23060, 부평구,055001, 50세,2018,9861,4604,5257,87.6,9487,4409,5078,86.8
23060, 부평구,055002, 51세,2018,9043,4348,4695,92.6,8738,4187,4551,92
23060, 부평구,055003, 52세,2018,9166,4525,4641,97.5,8839,4365,4474,97.6
23060, 부평구,055004, 53세,2018,9617,4682,4935,94.9,9221,4481,4740,94.5
23060, 부평구,055005, 54세,2018,9328,4634,4694,98.7,8885,4427,4458,99.3
23060, 부평구,060,55~59세,2018,48861,24327,24534,99.2,47062,23451,23611,99.3
23060, 부평구,060001, 55세,2018,9593,4812,4781,100.6,9132,4584,4548,100.8
23060, 부평구,060002, 56세,2018,9778,4834,4944,97.8,9410,4656,4754,97.9
23060, 부평구,060003, 57세,2018,10227,5145,5082,101.2,9986,5033,4953,101.6
23060, 부평구,060004, 58세,2018,10304,5093,5211,97.7,9899,4905,4994,98.2
23060, 부평구,060005, 59세,2018,8959,4443,4516,98.4,8635,4273,4362,98
23060, 부평구,065,60~64세,2018,36789,17946,18843,95.2,35200,17168,18032,95.2
23060, 부평구,065001, 60세,2018,8502,4242,4260,99.6,8151,4058,4093,99.1
23060, 부평구,065002, 61세,2018,8165,3985,4180,95.3,7803,3813,3990,95.6
23060, 부평구,065003, 62세,2018,7093,3466,3627,95.6,6806,3325,3481,95.5
23060, 부평구,065004, 63세,2018,7149,3465,3684,94.1,6822,3310,3512,94.2
23060, 부평구,065005, 64세,2018,5880,2788,3092,90.2,5618,2662,2956,90.1
23060, 부평구,070,65~69세,2018,22332,10922,11410,95.7,21599,10570,11029,95.8
23060, 부평구,070001, 65세,2018,5035,2486,2549,97.5,4830,2387,2443,97.7
23060, 부평구,070002, 66세,2018,5313,2590,2723,95.1,5153,2513,2640,95.2
23060, 부평구,070003, 67세,2018,3827,1893,1934,97.9,3660,1808,1852,97.6
23060, 부평구,070004, 68세,2018,4050,1993,2057,96.9,3944,1945,1999,97.3
23060, 부평구,070005, 69세,2018,4107,1960,2147,91.3,4012,1917,2095,91.5
23060, 부평구,075,70~74세,2018,16313,7589,8724,87,16109,7517,8592,87.5
23060, 부평구,075001, 70세,2018,3989,1968,2021,97.4,3930,1941,1989,97.6
23060, 부평구,075002, 71세,2018,3873,1774,2099,84.5,3824,1757,2067,85
23060, 부평구,075003, 72세,2018,2971,1389,1582,87.8,2936,1377,1559,88.3
23060, 부평구,075004, 73세,2018,2727,1220,1507,81,2694,1211,1483,81.7
23060, 부평구,075005, 74세,2018,2753,1238,1515,81.7,2725,1231,1494,82.4
23060, 부평구,080,75~79세,2018,13229,5465,7764,70.4,13090,5423,7667,70.7
23060, 부평구,080001, 75세,2018,2900,1271,1629,78,2875,1262,1613,78.2
23060, 부평구,080002, 76세,2018,3156,1358,1798,75.5,3132,1347,1785,75.5
23060, 부평구,080003, 77세,2018,2581,1049,1532,68.5,2555,1043,1512,69
23060, 부평구,080004, 78세,2018,2311,916,1395,65.7,2277,907,1370,66.2
23060, 부평구,080005, 79세,2018,2281,871,1410,61.8,2251,864,1387,62.3
23060, 부평구,085,80~84세,2018,8337,2876,5461,52.7,8251,2853,5398,52.9
23060, 부평구,085001, 80세,2018,2090,758,1332,56.9,2061,752,1309,57.4
23060, 부평구,085002, 81세,2018,1788,599,1189,50.4,1774,594,1180,50.3
23060, 부평구,085003, 82세,2018,1665,584,1081,54,1645,577,1068,54
23060, 부평구,085004, 83세,2018,1580,532,1048,50.8,1570,528,1042,50.7
23060, 부평구,085005, 84세,2018,1214,403,811,49.7,1201,402,799,50.3
23060, 부평구,090,85~89세,2018,3868,1077,2791,38.6,3831,1073,2758,38.9
23060, 부평구,090001, 85세,2018,1112,341,771,44.2,1098,341,757,45
23060, 부평구,090002, 86세,2018,890,255,635,40.2,883,255,628,40.6
23060, 부평구,090003, 87세,2018,694,195,499,39.1,684,193,491,39.3
23060, 부평구,090004, 88세,2018,639,138,501,27.5,636,138,498,27.7
23060, 부평구,090005, 89세,2018,533,148,385,38.4,530,146,384,38
23060, 부평구,095,90~94세,2018,1305,271,1034,26.2,1298,270,1028,26.3
23060, 부평구,095001, 90세,2018,437,102,335,30.4,436,102,334,30.5
23060, 부평구,095002, 91세,2018,323,63,260,24.2,323,63,260,24.2
23060, 부평구,095003, 92세,2018,234,48,186,25.8,232,47,185,25.4
23060, 부평구,095004, 93세,2018,175,33,142,23.2,174,33,141,23.4
23060, 부평구,095005, 94세,2018,136,25,111,22.5,133,25,108,23.1
23060, 부평구,100,95~99세,2018,336,86,250,34.4,336,86,250,34.4
23060, 부평구,100001, 95세,2018,128,37,91,40.7,128,37,91,40.7
23060, 부평구,100002, 96세,2018,92,23,69,33.3,92,23,69,33.3
23060, 부평구,100003, 97세,2018,63,12,51,23.5,63,12,51,23.5
23060, 부평구,100004, 98세,2018,37,7,30,23.3,37,7,30,23.3
23060, 부평구,100005, 99세,2018,16,7,9,77.8,16,7,9,77.8
23060, 부평구,101,100세이상,2018,43,X,40,7.5,43,X,40,7.5
23060, 부평구,102,15세미만,2018,61844,31816,30028,106,60567,31172,29395,106
23060, 부평구,103,15~64세,2018,397407,200303,197104,101.6,381520,192108,189412,101.4
23060, 부평구,104,65세이상,2018,65763,28289,37474,75.5,64557,27795,36762,75.6
23060, 부평구,086,85세이상,2018,5552,1437,4115,34.9,5508,1432,4076,35.1
23060, 부평구,126,평균연령,2018,41.7,40.7,42.7,,41.7,40.6,42.8,
23060, 부평구,127,중위연령,2018,42.8,41.4,44.1,,42.8,41.5,44.2,
23070, 계양구,000,합계,2018,307598,152614,154984,98.5,303392,150709,152683,98.7
23070, 계양구,005,0~4세,2018,10215,5154,5061,101.8,10124,5114,5010,102.1
23070, 계양구,005001, 0세,2018,1795,884,911,97,1776,872,904,96.5
23070, 계양구,005002, 1세,2018,1824,913,911,100.2,1809,908,901,100.8
23070, 계양구,005003, 2세,2018,2135,1081,1054,102.6,2116,1075,1041,103.3
23070, 계양구,005004, 3세,2018,2199,1101,1098,100.3,2179,1095,1084,101
23070, 계양구,005005, 4세,2018,2262,1175,1087,108.1,2244,1164,1080,107.8
23070, 계양구,010,5~9세,2018,12345,6300,6045,104.2,12323,6288,6035,104.2
23070, 계양구,010001, 5세,2018,2299,1203,1096,109.8,2293,1201,1092,110
23070, 계양구,010002, 6세,2018,2499,1261,1238,101.9,2493,1258,1235,101.9
23070, 계양구,010003, 7세,2018,2563,1291,1272,101.5,2558,1288,1270,101.4
23070, 계양구,010004, 8세,2018,2523,1284,1239,103.6,2521,1282,1239,103.5
23070, 계양구,010005, 9세,2018,2461,1261,1200,105.1,2458,1259,1199,105
23070, 계양구,015,10~14세,2018,13046,6695,6351,105.4,13017,6680,6337,105.4
23070, 계양구,015001, 10세,2018,2616,1338,1278,104.7,2609,1334,1275,104.6
23070, 계양구,015002, 11세,2018,2787,1433,1354,105.8,2777,1428,1349,105.9
23070, 계양구,015003, 12세,2018,2495,1276,1219,104.7,2490,1273,1217,104.6
23070, 계양구,015004, 13세,2018,2366,1209,1157,104.5,2362,1206,1156,104.3
23070, 계양구,015005, 14세,2018,2782,1439,1343,107.1,2779,1439,1340,107.4
23070, 계양구,020,15~19세,2018,16970,8635,8335,103.6,16892,8607,8285,103.9
23070, 계양구,020001, 15세,2018,2905,1458,1447,100.8,2904,1458,1446,100.8
23070, 계양구,020002, 16세,2018,2959,1563,1396,112,2956,1562,1394,112.1
23070, 계양구,020003, 17세,2018,3488,1831,1657,110.5,3480,1828,1652,110.7
23070, 계양구,020004, 18세,2018,3774,1923,1851,103.9,3753,1914,1839,104.1
23070, 계양구,020005, 19세,2018,3844,1860,1984,93.8,3799,1845,1954,94.4
23070, 계양구,025,20~24세,2018,22455,11587,10868,106.6,22034,11410,10624,107.4
23070, 계양구,025001, 20세,2018,4066,2109,1957,107.8,4014,2088,1926,108.4
23070, 계양구,025002, 21세,2018,4334,2324,2010,115.6,4269,2298,1971,116.6
23070, 계양구,025003, 22세,2018,4506,2341,2165,108.1,4421,2305,2116,108.9
23070, 계양구,025004, 23세,2018,4634,2325,2309,100.7,4521,2283,2238,102
23070, 계양구,025005, 24세,2018,4915,2488,2427,102.5,4809,2436,2373,102.7
23070, 계양구,030,25~29세,2018,23785,12088,11697,103.3,23134,11775,11359,103.7
23070, 계양구,030001, 25세,2018,5105,2599,2506,103.7,4968,2531,2437,103.9
23070, 계양구,030002, 26세,2018,5172,2580,2592,99.5,5039,2514,2525,99.6
23070, 계양구,030003, 27세,2018,4801,2449,2352,104.1,4676,2386,2290,104.2
23070, 계양구,030004, 28세,2018,4514,2349,2165,108.5,4391,2294,2097,109.4
23070, 계양구,030005, 29세,2018,4193,2111,2082,101.4,4060,2050,2010,102
23070, 계양구,035,30~34세,2018,19437,10100,9337,108.2,18771,9779,8992,108.8
23070, 계양구,035001, 30세,2018,3886,2023,1863,108.6,3755,1960,1795,109.2
23070, 계양구,035002, 31세,2018,3829,1955,1874,104.3,3697,1882,1815,103.7
23070, 계양구,035003, 32세,2018,3923,2081,1842,113,3780,2007,1773,113.2
23070, 계양구,035004, 33세,2018,3901,2028,1873,108.3,3764,1969,1795,109.7
23070, 계양구,035005, 34세,2018,3898,2013,1885,106.8,3775,1961,1814,108.1
23070, 계양구,040,35~39세,2018,22914,11689,11225,104.1,22442,11461,10981,104.4
23070, 계양구,040001, 35세,2018,4430,2243,2187,102.6,4314,2191,2123,103.2
23070, 계양구,040002, 36세,2018,4576,2351,2225,105.7,4470,2298,2172,105.8
23070, 계양구,040003, 37세,2018,4598,2397,2201,108.9,4513,2351,2162,108.7
23070, 계양구,040004, 38세,2018,4801,2381,2420,98.4,4715,2344,2371,98.9
23070, 계양구,040005, 39세,2018,4509,2317,2192,105.7,4430,2277,2153,105.8
23070, 계양구,045,40~44세,2018,22210,11222,10988,102.1,21859,11057,10802,102.4
23070, 계양구,045001, 40세,2018,4088,2084,2004,104,4007,2041,1966,103.8
23070, 계양구,045002, 41세,2018,4309,2186,2123,103,4245,2159,2086,103.5
23070, 계양구,045003, 42세,2018,4184,2099,2085,100.7,4113,2068,2045,101.1
23070, 계양구,045004, 43세,2018,4567,2278,2289,99.5,4505,2252,2253,100
23070, 계양구,045005, 44세,2018,5062,2575,2487,103.5,4989,2537,2452,103.5
23070, 계양구,050,45~49세,2018,28419,13704,14715,93.1,28004,13525,14479,93.4
23070, 계양구,050001, 45세,2018,5338,2551,2787,91.5,5253,2510,2743,91.5
23070, 계양구,050002, 46세,2018,5282,2606,2676,97.4,5214,2579,2635,97.9
23070, 계양구,050003, 47세,2018,5833,2826,3007,94,5739,2786,2953,94.3
23070, 계양구,050004, 48세,2018,5826,2818,3008,93.7,5754,2788,2966,94
23070, 계양구,050005, 49세,2018,6140,2903,3237,89.7,6044,2862,3182,89.9
23070, 계양구,055,50~54세,2018,30451,14529,15922,91.3,30127,14393,15734,91.5
23070, 계양구,055001, 50세,2018,6328,2936,3392,86.6,6249,2899,3350,86.5
23070, 계양구,055002, 51세,2018,5994,2808,3186,88.1,5941,2791,3150,88.6
23070, 계양구,055003, 52세,2018,5935,2884,3051,94.5,5884,2861,3023,94.6
23070, 계양구,055004, 53세,2018,6310,3078,3232,95.2,6237,3048,3189,95.6
23070, 계양구,055005, 54세,2018,5884,2823,3061,92.2,5816,2794,3022,92.5
23070, 계양구,060,55~59세,2018,31919,16217,15702,103.3,31638,16085,15553,103.4
23070, 계양구,060001, 55세,2018,6490,3307,3183,103.9,6407,3269,3138,104.2
23070, 계양구,060002, 56세,2018,6578,3314,3264,101.5,6530,3292,3238,101.7
23070, 계양구,060003, 57세,2018,6855,3433,3422,100.3,6816,3415,3401,100.4
23070, 계양구,060004, 58세,2018,6534,3319,3215,103.2,6465,3287,3178,103.4
23070, 계양구,060005, 59세,2018,5462,2844,2618,108.6,5420,2822,2598,108.6
23070, 계양구,065,60~64세,2018,20441,10662,9779,109,20260,10588,9672,109.5
23070, 계양구,065001, 60세,2018,4994,2614,2380,109.8,4955,2598,2357,110.2
23070, 계양구,065002, 61세,2018,4551,2425,2126,114.1,4510,2409,2101,114.7
23070, 계양구,065003, 62세,2018,3952,2041,1911,106.8,3909,2026,1883,107.6
23070, 계양구,065004, 63세,2018,3886,1948,1938,100.5,3863,1943,1920,101.2
23070, 계양구,065005, 64세,2018,3058,1634,1424,114.7,3023,1612,1411,114.2
23070, 계양구,070,65~69세,2018,11071,5614,5457,102.9,10941,5561,5380,103.4
23070, 계양구,070001, 65세,2018,2529,1295,1234,104.9,2496,1280,1216,105.3
23070, 계양구,070002, 66세,2018,2781,1402,1379,101.7,2757,1391,1366,101.8
23070, 계양구,070003, 67세,2018,1804,929,875,106.2,1780,920,860,107
23070, 계양구,070004, 68세,2018,1958,988,970,101.9,1934,976,958,101.9
23070, 계양구,070005, 69세,2018,1999,1000,999,100.1,1974,994,980,101.4
23070, 계양구,075,70~74세,2018,7856,3636,4220,86.2,7814,3618,4196,86.2
23070, 계양구,075001, 70세,2018,1903,973,930,104.6,1892,970,922,105.2
23070, 계양구,075002, 71세,2018,1851,856,995,86,1843,851,992,85.8
23070, 계양구,075003, 72세,2018,1406,644,762,84.5,1392,638,754,84.6
23070, 계양구,075004, 73세,2018,1370,598,772,77.5,1366,596,770,77.4
23070, 계양구,075005, 74세,2018,1326,565,761,74.2,1321,563,758,74.3
23070, 계양구,080,75~79세,2018,6625,2611,4014,65,6595,2601,3994,65.1
23070, 계양구,080001, 75세,2018,1364,569,795,71.6,1356,567,789,71.9
23070, 계양구,080002, 76세,2018,1596,648,948,68.4,1590,645,945,68.3
23070, 계양구,080003, 77세,2018,1340,532,808,65.8,1337,531,806,65.9
23070, 계양구,080004, 78세,2018,1178,442,736,60.1,1174,440,734,59.9
23070, 계양구,080005, 79세,2018,1147,420,727,57.8,1138,418,720,58.1
23070, 계양구,085,80~84세,2018,4374,1430,2944,48.6,4363,1428,2935,48.7
23070, 계양구,085001, 80세,2018,1046,374,672,55.7,1043,374,669,55.9
23070, 계양구,085002, 81세,2018,918,321,597,53.8,914,319,595,53.6
23070, 계양구,085003, 82세,2018,887,265,622,42.6,886,265,621,42.7
23070, 계양구,085004, 83세,2018,840,273,567,48.1,840,273,567,48.1
23070, 계양구,085005, 84세,2018,683,197,486,40.5,680,197,483,40.8
23070, 계양구,090,85~89세,2018,2106,525,1581,33.2,2100,525,1575,33.3
23070, 계양구,090001, 85세,2018,597,160,437,36.6,595,160,435,36.8
23070, 계양구,090002, 86세,2018,464,119,345,34.5,464,119,345,34.5
23070, 계양구,090003, 87세,2018,388,100,288,34.7,386,100,286,35
23070, 계양구,090004, 88세,2018,356,76,280,27.1,354,76,278,27.3
23070, 계양구,090005, 89세,2018,301,70,231,30.3,301,70,231,30.3
23070, 계양구,095,90~94세,2018,764,175,589,29.7,760,174,586,29.7
23070, 계양구,095001, 90세,2018,254,58,196,29.6,252,58,194,29.9
23070, 계양구,095002, 91세,2018,189,43,146,29.5,188,43,145,29.7
23070, 계양구,095003, 92세,2018,140,35,105,33.3,139,34,105,32.4
23070, 계양구,095004, 93세,2018,109,22,87,25.3,109,22,87,25.3
23070, 계양구,095005, 94세,2018,72,17,55,30.9,72,17,55,30.9
23070, 계양구,100,95~99세,2018,176,40,136,29.4,175,39,136,28.7
23070, 계양구,100001, 95세,2018,71,20,51,39.2,71,20,51,39.2
23070, 계양구,100002, 96세,2018,35,6,29,20.7,34,5,29,17.2
23070, 계양구,100003, 97세,2018,36,9,27,33.3,36,9,27,33.3
23070, 계양구,100004, 98세,2018,21,X,17,23.5,21,X,17,23.5
23070, 계양구,100005, 99세,2018,13,X,12,8.3,13,X,12,8.3
23070, 계양구,101,100세이상,2018,19,X,18,5.6,19,X,18,5.6
23070, 계양구,102,15세미만,2018,35606,18149,17457,104,35464,18082,17382,104
23070, 계양구,103,15~64세,2018,239001,120433,118568,101.6,235161,118680,116481,101.9
23070, 계양구,104,65세이상,2018,32991,14032,18959,74,32767,13947,18820,74.1
23070, 계양구,086,85세이상,2018,3065,741,2324,31.9,3054,739,2315,31.9
23070, 계양구,126,평균연령,2018,41.3,40.4,42.1,,41.3,40.5,42.1,
23070, 계양구,127,중위연령,2018,43,41.9,44,,43.1,42,44.2,
23080, 서구,000,합계,2018,532713,271338,261375,103.8,516402,260292,256110,101.6
23080, 서구,005,0~4세,2018,25433,13171,12262,107.4,25124,13014,12110,107.5
23080, 서구,005001, 0세,2018,4182,2177,2005,108.6,4125,2146,1979,108.4
23080, 서구,005002, 1세,2018,4634,2400,2234,107.4,4577,2374,2203,107.8
23080, 서구,005003, 2세,2018,5369,2770,2599,106.6,5305,2735,2570,106.4
23080, 서구,005004, 3세,2018,5709,2962,2747,107.8,5641,2928,2713,107.9
23080, 서구,005005, 4세,2018,5539,2862,2677,106.9,5476,2831,2645,107
23080, 서구,010,5~9세,2018,28919,14959,13960,107.2,28721,14849,13872,107
23080, 서구,010001, 5세,2018,5660,2875,2785,103.2,5612,2854,2758,103.5
23080, 서구,010002, 6세,2018,6090,3214,2876,111.8,6046,3190,2856,111.7
23080, 서구,010003, 7세,2018,6111,3174,2937,108.1,6070,3144,2926,107.5
23080, 서구,010004, 8세,2018,5690,2914,2776,105,5660,2895,2765,104.7
23080, 서구,010005, 9세,2018,5368,2782,2586,107.6,5333,2766,2567,107.8
23080, 서구,015,10~14세,2018,27430,14033,13397,104.7,27308,13973,13335,104.8
23080, 서구,015001, 10세,2018,5681,2886,2795,103.3,5642,2863,2779,103
23080, 서구,015002, 11세,2018,5810,2936,2874,102.2,5780,2921,2859,102.2
23080, 서구,015003, 12세,2018,5342,2755,2587,106.5,5326,2748,2578,106.6
23080, 서구,015004, 13세,2018,5140,2676,2464,108.6,5119,2667,2452,108.8
23080, 서구,015005, 14세,2018,5457,2780,2677,103.8,5441,2774,2667,104
23080, 서구,020,15~19세,2018,28386,14573,13813,105.5,28207,14461,13746,105.2
23080, 서구,020001, 15세,2018,5432,2761,2671,103.4,5417,2750,2667,103.1
23080, 서구,020002, 16세,2018,5482,2829,2653,106.6,5459,2812,2647,106.2
23080, 서구,020003, 17세,2018,6048,3099,2949,105.1,6027,3088,2939,105.1
23080, 서구,020004, 18세,2018,6234,3219,3015,106.8,6193,3202,2991,107.1
23080, 서구,020005, 19세,2018,5190,2665,2525,105.5,5111,2609,2502,104.3
23080, 서구,025,20~24세,2018,33095,17651,15444,114.3,31832,16702,15130,110.4
23080, 서구,025001, 20세,2018,5902,3250,2652,122.5,5800,3184,2616,121.7
23080, 서구,025002, 21세,2018,6505,3530,2975,118.7,6340,3412,2928,116.5
23080, 서구,025003, 22세,2018,6586,3478,3108,111.9,6328,3282,3046,107.7
23080, 서구,025004, 23세,2018,6908,3617,3291,109.9,6558,3348,3210,104.3
23080, 서구,025005, 24세,2018,7194,3776,3418,110.5,6806,3476,3330,104.4
23080, 서구,030,25~29세,2018,37171,19750,17421,113.4,34271,17591,16680,105.5
23080, 서구,030001, 25세,2018,7434,3934,3500,112.4,6974,3585,3389,105.8
23080, 서구,030002, 26세,2018,7875,4154,3721,111.6,7302,3720,3582,103.9
23080, 서구,030003, 27세,2018,7703,4112,3591,114.5,7099,3677,3422,107.5
23080, 서구,030004, 28세,2018,7069,3753,3316,113.2,6448,3304,3144,105.1
23080, 서구,030005, 29세,2018,7090,3797,3293,115.3,6448,3305,3143,105.2
23080, 서구,035,30~34세,2018,38044,19970,18074,110.5,34711,17442,17269,101
23080, 서구,035001, 30세,2018,7055,3700,3355,110.3,6357,3183,3174,100.3
23080, 서구,035002, 31세,2018,7223,3765,3458,108.9,6469,3189,3280,97.2
23080, 서구,035003, 32세,2018,7635,4050,3585,113,6969,3540,3429,103.2
23080, 서구,035004, 33세,2018,7817,4154,3663,113.4,7208,3685,3523,104.6
23080, 서구,035005, 34세,2018,8314,4301,4013,107.2,7708,3845,3863,99.5
23080, 서구,040,35~39세,2018,49641,26022,23619,110.2,47128,24173,22955,105.3
23080, 서구,040001, 35세,2018,9181,4804,4377,109.8,8619,4383,4236,103.5
23080, 서구,040002, 36세,2018,10088,5373,4715,114,9542,4961,4581,108.3
23080, 서구,040003, 37세,2018,10126,5351,4775,112.1,9634,4980,4654,107
23080, 서구,040004, 38세,2018,10422,5407,5015,107.8,9947,5070,4877,104
23080, 서구,040005, 39세,2018,9824,5087,4737,107.4,9386,4779,4607,103.7
23080, 서구,045,40~44세,2018,45936,23614,22322,105.8,44434,22607,21827,103.6
23080, 서구,045001, 40세,2018,8852,4567,4285,106.6,8489,4315,4174,103.4
23080, 서구,045002, 41세,2018,9118,4657,4461,104.4,8795,4432,4363,101.6
23080, 서구,045003, 42세,2018,8778,4480,4298,104.2,8501,4303,4198,102.5
23080, 서구,045004, 43세,2018,9259,4803,4456,107.8,8996,4630,4366,106
23080, 서구,045005, 44세,2018,9929,5107,4822,105.9,9653,4927,4726,104.3
23080, 서구,050,45~49세,2018,49671,25136,24535,102.4,48429,24377,24052,101.4
23080, 서구,050001, 45세,2018,9709,4897,4812,101.8,9468,4738,4730,100.2
23080, 서구,050002, 46세,2018,9787,4982,4805,103.7,9506,4809,4697,102.4
23080, 서구,050003, 47세,2018,10379,5304,5075,104.5,10144,5169,4975,103.9
23080, 서구,050004, 48세,2018,9760,4958,4802,103.2,9499,4802,4697,102.2
23080, 서구,050005, 49세,2018,10036,4995,5041,99.1,9812,4859,4953,98.1
23080, 서구,055,50~54세,2018,46060,23205,22855,101.5,45073,22690,22383,101.4
23080, 서구,055001, 50세,2018,9965,4961,5004,99.1,9756,4841,4915,98.5
23080, 서구,055002, 51세,2018,9062,4486,4576,98,8881,4393,4488,97.9
23080, 서구,055003, 52세,2018,9008,4634,4374,105.9,8815,4530,4285,105.7
23080, 서구,055004, 53세,2018,9420,4760,4660,102.1,9204,4657,4547,102.4
23080, 서구,055005, 54세,2018,8605,4364,4241,102.9,8417,4269,4148,102.9
23080, 서구,060,55~59세,2018,43311,22352,20959,106.6,42616,22010,20606,106.8
23080, 서구,060001, 55세,2018,8836,4525,4311,105,8654,4431,4223,104.9
23080, 서구,060002, 56세,2018,8706,4504,4202,107.2,8553,4422,4131,107
23080, 서구,060003, 57세,2018,9221,4840,4381,110.5,9113,4788,4325,110.7
23080, 서구,060004, 58세,2018,8948,4582,4366,104.9,8810,4520,4290,105.4
23080, 서구,060005, 59세,2018,7600,3901,3699,105.5,7486,3849,3637,105.8
23080, 서구,065,60~64세,2018,30152,15382,14770,104.1,29580,15092,14488,104.2
23080, 서구,065001, 60세,2018,7076,3674,3402,108,6956,3610,3346,107.9
23080, 서구,065002, 61세,2018,6678,3393,3285,103.3,6534,3320,3214,103.3
23080, 서구,065003, 62세,2018,5943,3065,2878,106.5,5848,3014,2834,106.4
23080, 서구,065004, 63세,2018,5796,2921,2875,101.6,5685,2864,2821,101.5
23080, 서구,065005, 64세,2018,4659,2329,2330,100,4557,2284,2273,100.5
23080, 서구,070,65~69세,2018,17526,8778,8748,100.3,17226,8634,8592,100.5
23080, 서구,070001, 65세,2018,4018,1979,2039,97.1,3934,1933,2001,96.6
23080, 서구,070002, 66세,2018,4234,2162,2072,104.3,4171,2128,2043,104.2
23080, 서구,070003, 67세,2018,2906,1435,1471,97.6,2849,1412,1437,98.3
23080, 서구,070004, 68세,2018,3193,1613,1580,102.1,3137,1590,1547,102.8
23080, 서구,070005, 69세,2018,3175,1589,1586,100.2,3135,1571,1564,100.4
23080, 서구,075,70~74세,2018,12263,5830,6433,90.6,12163,5792,6371,90.9
23080, 서구,075001, 70세,2018,2991,1500,1491,100.6,2967,1489,1478,100.7
23080, 서구,075002, 71세,2018,2983,1409,1574,89.5,2956,1399,1557,89.9
23080, 서구,075003, 72세,2018,2172,1015,1157,87.7,2157,1010,1147,88.1
23080, 서구,075004, 73세,2018,2111,966,1145,84.4,2088,957,1131,84.6
23080, 서구,075005, 74세,2018,2006,940,1066,88.2,1995,937,1058,88.6
23080, 서구,080,75~79세,2018,9344,3882,5462,71.1,9299,3862,5437,71
23080, 서구,080001, 75세,2018,2088,937,1151,81.4,2079,934,1145,81.6
23080, 서구,080002, 76세,2018,2298,992,1306,76,2286,985,1301,75.7
23080, 서구,080003, 77세,2018,1768,729,1039,70.2,1759,726,1033,70.3
23080, 서구,080004, 78세,2018,1603,603,1000,60.3,1598,601,997,60.3
23080, 서구,080005, 79세,2018,1587,621,966,64.3,1577,616,961,64.1
23080, 서구,085,80~84세,2018,6062,2025,4037,50.2,6022,2020,4002,50.5
23080, 서구,085001, 80세,2018,1517,565,952,59.3,1501,563,938,60
23080, 서구,085002, 81세,2018,1255,419,836,50.1,1250,418,832,50.2
23080, 서구,085003, 82세,2018,1255,411,844,48.7,1250,411,839,49
23080, 서구,085004, 83세,2018,1123,360,763,47.2,1115,358,757,47.3
23080, 서구,085005, 84세,2018,912,270,642,42.1,906,270,636,42.5
23080, 서구,090,85~89세,2018,2980,751,2229,33.7,2972,750,2222,33.8
23080, 서구,090001, 85세,2018,818,229,589,38.9,817,229,588,38.9
23080, 서구,090002, 86세,2018,682,189,493,38.3,678,188,490,38.4
23080, 서구,090003, 87세,2018,517,130,387,33.6,516,130,386,33.7
23080, 서구,090004, 88세,2018,506,108,398,27.1,504,108,396,27.3
23080, 서구,090005, 89세,2018,457,95,362,26.2,457,95,362,26.2
23080, 서구,095,90~94세,2018,1009,201,808,24.9,1007,201,806,24.9
23080, 서구,095001, 90세,2018,326,73,253,28.9,326,73,253,28.9
23080, 서구,095002, 91세,2018,267,52,215,24.2,266,52,214,24.3
23080, 서구,095003, 92세,2018,161,29,132,22,160,29,131,22.1
23080, 서구,095004, 93세,2018,154,31,123,25.2,154,31,123,25.2
23080, 서구,095005, 94세,2018,101,16,85,18.8,101,16,85,18.8
23080, 서구,100,95~99세,2018,251,52,199,26.1,250,51,199,25.6
23080, 서구,100001, 95세,2018,100,23,77,29.9,99,22,77,28.6
23080, 서구,100002, 96세,2018,62,9,53,17,62,9,53,17
23080, 서구,100003, 97세,2018,45,6,39,15.4,45,6,39,15.4
23080, 서구,100004, 98세,2018,29,11,18,61.1,29,11,18,61.1
23080, 서구,100005, 99세,2018,15,X,12,25,15,X,12,25
23080, 서구,101,100세이상,2018,29,X,28,3.6,29,X,28,3.6
23080, 서구,102,15세미만,2018,81782,42163,39619,106.4,81153,41836,39317,106.4
23080, 서구,103,15~64세,2018,401467,207655,193812,107.1,386281,197145,189136,104.2
23080, 서구,104,65세이상,2018,49464,21520,27944,77,48968,21311,27657,77.1
23080, 서구,086,85세이상,2018,4269,1005,3264,30.8,4258,1003,3255,30.8
23080, 서구,126,평균연령,2018,39,38.2,39.7,,39,38.3,39.7,
23080, 서구,127,중위연령,2018,39.8,39.1,40.6,,40.1,39.6,40.7,
23090, 미추홀구,000,합계,2018,415102,209360,205742,101.8,404443,203951,200492,101.7
23090, 미추홀구,005,0~4세,2018,15504,7891,7613,103.7,15164,7705,7459,103.3
23090, 미추홀구,005001, 0세,2018,2649,1361,1288,105.7,2566,1318,1248,105.6
23090, 미추홀구,005002, 1세,2018,2980,1522,1458,104.4,2901,1475,1426,103.4
23090, 미추홀구,005003, 2세,2018,3235,1633,1602,101.9,3154,1594,1560,102.2
23090, 미추홀구,005004, 3세,2018,3420,1774,1646,107.8,3372,1748,1624,107.6
23090, 미추홀구,005005, 4세,2018,3220,1601,1619,98.9,3171,1570,1601,98.1
23090, 미추홀구,010,5~9세,2018,16128,8352,7776,107.4,15966,8268,7698,107.4
23090, 미추홀구,010001, 5세,2018,3211,1666,1545,107.8,3170,1646,1524,108
23090, 미추홀구,010002, 6세,2018,3441,1789,1652,108.3,3403,1768,1635,108.1
23090, 미추홀구,010003, 7세,2018,3352,1747,1605,108.8,3319,1732,1587,109.1
23090, 미추홀구,010004, 8세,2018,3131,1598,1533,104.2,3099,1582,1517,104.3
23090, 미추홀구,010005, 9세,2018,2993,1552,1441,107.7,2975,1540,1435,107.3
23090, 미추홀구,015,10~14세,2018,15111,7834,7277,107.7,15021,7786,7235,107.6
23090, 미추홀구,015001, 10세,2018,3169,1626,1543,105.4,3150,1616,1534,105.3
23090, 미추홀구,015002, 11세,2018,3199,1704,1495,114,3174,1690,1484,113.9
23090, 미추홀구,015003, 12세,2018,2827,1456,1371,106.2,2808,1443,1365,105.7
23090, 미추홀구,015004, 13세,2018,2828,1450,1378,105.2,2814,1444,1370,105.4
23090, 미추홀구,015005, 14세,2018,3088,1598,1490,107.2,3075,1593,1482,107.5
23090, 미추홀구,020,15~19세,2018,19903,10389,9514,109.2,19406,10111,9295,108.8
23090, 미추홀구,020001, 15세,2018,3284,1712,1572,108.9,3274,1706,1568,108.8
23090, 미추홀구,020002, 16세,2018,3339,1748,1591,109.9,3325,1739,1586,109.6
23090, 미추홀구,020003, 17세,2018,3840,1961,1879,104.4,3800,1937,1863,104
23090, 미추홀구,020004, 18세,2018,4499,2353,2146,109.6,4350,2275,2075,109.6
23090, 미추홀구,020005, 19세,2018,4941,2615,2326,112.4,4657,2454,2203,111.4
23090, 미추홀구,025,20~24세,2018,29252,15463,13789,112.1,27719,14668,13051,112.4
23090, 미추홀구,025001, 20세,2018,5184,2662,2522,105.6,4844,2488,2356,105.6
23090, 미추홀구,025002, 21세,2018,5545,2866,2679,107,5249,2715,2534,107.1
23090, 미추홀구,025003, 22세,2018,6007,3213,2794,115,5675,3042,2633,115.5
23090, 미추홀구,025004, 23세,2018,6168,3311,2857,115.9,5852,3136,2716,115.5
23090, 미추홀구,025005, 24세,2018,6348,3411,2937,116.1,6099,3287,2812,116.9
23090, 미추홀구,030,25~29세,2018,31012,16760,14252,117.6,29627,16067,13560,118.5
23090, 미추홀구,030001, 25세,2018,6480,3507,2973,118,6257,3398,2859,118.9
23090, 미추홀구,030002, 26세,2018,6601,3542,3059,115.8,6335,3397,2938,115.6
23090, 미추홀구,030003, 27세,2018,6278,3422,2856,119.8,5982,3281,2701,121.5
23090, 미추홀구,030004, 28세,2018,5886,3180,2706,117.5,5574,3025,2549,118.7
23090, 미추홀구,030005, 29세,2018,5767,3109,2658,117,5479,2966,2513,118
23090, 미추홀구,035,30~34세,2018,28064,15012,13052,115,26572,14223,12349,115.2
23090, 미추홀구,035001, 30세,2018,5420,2878,2542,113.2,5107,2723,2384,114.2
23090, 미추홀구,035002, 31세,2018,5512,2964,2548,116.3,5190,2790,2400,116.3
23090, 미추홀구,035003, 32세,2018,5566,2993,2573,116.3,5272,2846,2426,117.3
23090, 미추홀구,035004, 33세,2018,5664,3058,2606,117.3,5347,2878,2469,116.6
23090, 미추홀구,035005, 34세,2018,5902,3119,2783,112.1,5656,2986,2670,111.8
23090, 미추홀구,040,35~39세,2018,34239,18369,15870,115.7,33103,17727,15376,115.3
23090, 미추홀구,040001, 35세,2018,6549,3435,3114,110.3,6270,3282,2988,109.8
23090, 미추홀구,040002, 36세,2018,6914,3690,3224,114.5,6644,3540,3104,114
23090, 미추홀구,040003, 37세,2018,7115,3841,3274,117.3,6890,3712,3178,116.8
23090, 미추홀구,040004, 38세,2018,7007,3792,3215,117.9,6806,3668,3138,116.9
23090, 미추홀구,040005, 39세,2018,6654,3611,3043,118.7,6493,3525,2968,118.8
23090, 미추홀구,045,40~44세,2018,30260,16088,14172,113.5,29483,15677,13806,113.6
23090, 미추홀구,045001, 40세,2018,6056,3201,2855,112.1,5866,3109,2757,112.8
23090, 미추홀구,045002, 41세,2018,5839,3128,2711,115.4,5685,3045,2640,115.3
23090, 미추홀구,045003, 42세,2018,5679,2964,2715,109.2,5543,2893,2650,109.2
23090, 미추홀구,045004, 43세,2018,6148,3320,2828,117.4,5996,3232,2764,116.9
23090, 미추홀구,045005, 44세,2018,6538,3475,3063,113.5,6393,3398,2995,113.5
23090, 미추홀구,050,45~49세,2018,34777,17977,16800,107,33992,17577,16415,107.1
23090, 미추홀구,050001, 45세,2018,6800,3537,3263,108.4,6647,3449,3198,107.8
23090, 미추홀구,050002, 46세,2018,6915,3654,3261,112.1,6766,3579,3187,112.3
23090, 미추홀구,050003, 47세,2018,7058,3594,3464,103.8,6893,3512,3381,103.9
23090, 미추홀구,050004, 48세,2018,6906,3508,3398,103.2,6733,3423,3310,103.4
23090, 미추홀구,050005, 49세,2018,7098,3684,3414,107.9,6953,3614,3339,108.2
23090, 미추홀구,055,50~54세,2018,32948,16314,16634,98.1,32248,15988,16260,98.3
23090, 미추홀구,055001, 50세,2018,6969,3478,3491,99.6,6803,3395,3408,99.6
23090, 미추홀구,055002, 51세,2018,6442,3171,3271,96.9,6323,3114,3209,97
23090, 미추홀구,055003, 52세,2018,6249,3121,3128,99.8,6130,3074,3056,100.6
23090, 미추홀구,055004, 53세,2018,6852,3368,3484,96.7,6703,3299,3404,96.9
23090, 미추홀구,055005, 54세,2018,6436,3176,3260,97.4,6289,3106,3183,97.6
23090, 미추홀구,060,55~59세,2018,36101,17713,18388,96.3,35428,17413,18015,96.7
23090, 미추홀구,060001, 55세,2018,6934,3485,3449,101,6748,3406,3342,101.9
23090, 미추홀구,060002, 56세,2018,7068,3480,3588,97,6908,3408,3500,97.4
23090, 미추홀구,060003, 57세,2018,7506,3608,3898,92.6,7418,3570,3848,92.8
23090, 미추홀구,060004, 58세,2018,7551,3668,3883,94.5,7411,3607,3804,94.8
23090, 미추홀구,060005, 59세,2018,7042,3472,3570,97.3,6943,3422,3521,97.2
23090, 미추홀구,065,60~64세,2018,30263,14542,15721,92.5,29677,14286,15391,92.8
23090, 미추홀구,065001, 60세,2018,6681,3224,3457,93.3,6548,3163,3385,93.4
23090, 미추홀구,065002, 61세,2018,6472,3151,3321,94.9,6343,3093,3250,95.2
23090, 미추홀구,065003, 62세,2018,6061,2922,3139,93.1,5941,2870,3071,93.5
23090, 미추홀구,065004, 63세,2018,6067,2898,3169,91.4,5954,2847,3107,91.6
23090, 미추홀구,065005, 64세,2018,4982,2347,2635,89.1,4891,2313,2578,89.7
23090, 미추홀구,070,65~69세,2018,20080,9543,10537,90.6,19806,9415,10391,90.6
23090, 미추홀구,070001, 65세,2018,4303,2053,2250,91.2,4224,2007,2217,90.5
23090, 미추홀구,070002, 66세,2018,4765,2267,2498,90.8,4700,2245,2455,91.4
23090, 미추홀구,070003, 67세,2018,3247,1530,1717,89.1,3196,1510,1686,89.6
23090, 미추홀구,070004, 68세,2018,3813,1828,1985,92.1,3772,1809,1963,92.2
23090, 미추홀구,070005, 69세,2018,3952,1865,2087,89.4,3914,1844,2070,89.1
23090, 미추홀구,075,70~74세,2018,16169,7498,8671,86.5,16062,7460,8602,86.7
23090, 미추홀구,075001, 70세,2018,3769,1794,1975,90.8,3745,1785,1960,91.1
23090, 미추홀구,075002, 71세,2018,3859,1811,2048,88.4,3836,1802,2034,88.6
23090, 미추홀구,075003, 72세,2018,2943,1365,1578,86.5,2919,1358,1561,87
23090, 미추홀구,075004, 73세,2018,2859,1316,1543,85.3,2839,1306,1533,85.2
23090, 미추홀구,075005, 74세,2018,2739,1212,1527,79.4,2723,1209,1514,79.9
23090, 미추홀구,080,75~79세,2018,12861,5545,7316,75.8,12808,5530,7278,76
23090, 미추홀구,080001, 75세,2018,2796,1254,1542,81.3,2786,1253,1533,81.7
23090, 미추홀구,080002, 76세,2018,3216,1417,1799,78.8,3204,1409,1795,78.5
23090, 미추홀구,080003, 77세,2018,2483,1064,1419,75,2475,1062,1413,75.2
23090, 미추홀구,080004, 78세,2018,2201,925,1276,72.5,2190,923,1267,72.8
23090, 미추홀구,080005, 79세,2018,2165,885,1280,69.1,2153,883,1270,69.5
23090, 미추홀구,085,80~84세,2018,7563,2812,4751,59.2,7514,2796,4718,59.3
23090, 미추홀구,085001, 80세,2018,1968,795,1173,67.8,1958,793,1165,68.1
23090, 미추홀구,085002, 81세,2018,1621,612,1009,60.7,1612,609,1003,60.7
23090, 미추홀구,085003, 82세,2018,1456,552,904,61.1,1449,549,900,61
23090, 미추홀구,085004, 83세,2018,1408,508,900,56.4,1393,503,890,56.5
23090, 미추홀구,085005, 84세,2018,1110,345,765,45.1,1102,342,760,45
23090, 미추홀구,090,85~89세,2018,3405,939,2466,38.1,3389,937,2452,38.2
23090, 미추홀구,090001, 85세,2018,896,249,647,38.5,892,249,643,38.7
23090, 미추홀구,090002, 86세,2018,785,231,554,41.7,782,230,552,41.7
23090, 미추홀구,090003, 87세,2018,613,188,425,44.2,610,188,422,44.5
23090, 미추홀구,090004, 88세,2018,591,141,450,31.3,587,141,446,31.6
23090, 미추홀구,090005, 89세,2018,520,130,390,33.3,518,129,389,33.2
23090, 미추홀구,095,90~94세,2018,1163,249,914,27.2,1161,249,912,27.3
23090, 미추홀구,095001, 90세,2018,370,81,289,28,370,81,289,28
23090, 미추홀구,095002, 91세,2018,298,69,229,30.1,297,69,228,30.3
23090, 미추홀구,095003, 92세,2018,205,35,170,20.6,204,35,169,20.7
23090, 미추홀구,095004, 93세,2018,175,35,140,25,175,35,140,25
23090, 미추홀구,095005, 94세,2018,115,29,86,33.7,115,29,86,33.7
23090, 미추홀구,100,95~99세,2018,266,62,204,30.4,265,61,204,29.9
23090, 미추홀구,100001, 95세,2018,98,23,75,30.7,98,23,75,30.7
23090, 미추홀구,100002, 96세,2018,64,14,50,28,63,13,50,26
23090, 미추홀구,100003, 97세,2018,54,13,41,31.7,54,13,41,31.7
23090, 미추홀구,100004, 98세,2018,21,X,17,23.5,21,X,17,23.5
23090, 미추홀구,100005, 99세,2018,29,8,21,38.1,29,8,21,38.1
23090, 미추홀구,101,100세이상,2018,33,8,25,32,32,7,25,28
23090, 미추홀구,102,15세미만,2018,46743,24077,22666,106.2,46151,23759,22392,106.1
23090, 미추홀구,103,15~64세,2018,306819,158627,148192,107,297255,153737,143518,107.1
23090, 미추홀구,104,65세이상,2018,61540,26656,34884,76.4,61037,26455,34582,76.5
23090, 미추홀구,086,85세이상,2018,4867,1258,3609,34.9,4847,1254,3593,34.9
23090, 미추홀구,126,평균연령,2018,42.4,41.2,43.7,,42.6,41.4,43.8,
23090, 미추홀구,127,중위연령,2018,43.1,41.5,44.9,,43.4,41.8,45.1,
23310, 강화군,000,합계,2018,64432,32378,32054,101,63322,31674,31648,100.1
23310, 강화군,005,0~4세,2018,1390,711,679,104.7,1382,705,677,104.1
23310, 강화군,005001, 0세,2018,263,142,121,117.4,262,141,121,116.5
23310, 강화군,005002, 1세,2018,238,122,116,105.2,237,122,115,106.1
23310, 강화군,005003, 2세,2018,268,140,128,109.4,268,140,128,109.4
23310, 강화군,005004, 3세,2018,305,149,156,95.5,303,147,156,94.2
23310, 강화군,005005, 4세,2018,316,158,158,100,312,155,157,98.7
23310, 강화군,010,5~9세,2018,1867,977,890,109.8,1856,971,885,109.7
23310, 강화군,010001, 5세,2018,317,153,164,93.3,314,152,162,93.8
23310, 강화군,010002, 6세,2018,373,196,177,110.7,371,195,176,110.8
23310, 강화군,010003, 7세,2018,400,207,193,107.3,399,206,193,106.7
23310, 강화군,010004, 8세,2018,385,208,177,117.5,382,206,176,117
23310, 강화군,010005, 9세,2018,392,213,179,119,390,212,178,119.1
23310, 강화군,015,10~14세,2018,2039,1015,1024,99.1,2034,1011,1023,98.8
23310, 강화군,015001, 10세,2018,433,194,239,81.2,432,193,239,80.8
23310, 강화군,015002, 11세,2018,397,217,180,120.6,397,217,180,120.6
23310, 강화군,015003, 12세,2018,403,204,199,102.5,402,203,199,102
23310, 강화군,015004, 13세,2018,397,197,200,98.5,397,197,200,98.5
23310, 강화군,015005, 14세,2018,409,203,206,98.5,406,201,205,98
23310, 강화군,020,15~19세,2018,2704,1377,1327,103.8,2696,1373,1323,103.8
23310, 강화군,020001, 15세,2018,515,271,244,111.1,515,271,244,111.1
23310, 강화군,020002, 16세,2018,541,279,262,106.5,538,278,260,106.9
23310, 강화군,020003, 17세,2018,617,278,339,82,617,278,339,82
23310, 강화군,020004, 18세,2018,633,330,303,108.9,633,330,303,108.9
23310, 강화군,020005, 19세,2018,398,219,179,122.3,393,216,177,122
23310, 강화군,025,20~24세,2018,2470,1494,976,153.1,2359,1425,934,152.6
23310, 강화군,025001, 20세,2018,446,278,168,165.5,439,274,165,166.1
23310, 강화군,025002, 21세,2018,491,318,173,183.8,480,311,169,184
23310, 강화군,025003, 22세,2018,475,285,190,150,449,268,181,148.1
23310, 강화군,025004, 23세,2018,505,292,213,137.1,474,275,199,138.2
23310, 강화군,025005, 24세,2018,553,321,232,138.4,517,297,220,135
23310, 강화군,030,25~29세,2018,2684,1583,1101,143.8,2430,1399,1031,135.7
23310, 강화군,030001, 25세,2018,549,311,238,130.7,503,278,225,123.6
23310, 강화군,030002, 26세,2018,532,323,209,154.5,480,287,193,148.7
23310, 강화군,030003, 27세,2018,571,326,245,133.1,525,293,232,126.3
23310, 강화군,030004, 28세,2018,525,326,199,163.8,470,284,186,152.7
23310, 강화군,030005, 29세,2018,507,297,210,141.4,452,257,195,131.8
23310, 강화군,035,30~34세,2018,2303,1273,1030,123.6,2077,1111,966,115
23310, 강화군,035001, 30세,2018,480,270,210,128.6,424,227,197,115.2
23310, 강화군,035002, 31세,2018,440,254,186,136.6,398,226,172,131.4
23310, 강화군,035003, 32세,2018,429,249,180,138.3,380,214,166,128.9
23310, 강화군,035004, 33세,2018,470,248,222,111.7,429,218,211,103.3
23310, 강화군,035005, 34세,2018,484,252,232,108.6,446,226,220,102.7
23310, 강화군,040,35~39세,2018,2908,1560,1348,115.7,2771,1466,1305,112.3
23310, 강화군,040001, 35세,2018,572,331,241,137.3,528,299,229,130.6
23310, 강화군,040002, 36세,2018,593,311,282,110.3,562,290,272,106.6
23310, 강화군,040003, 37세,2018,600,318,282,112.8,581,304,277,109.7
23310, 강화군,040004, 38세,2018,592,319,273,116.8,567,303,264,114.8
23310, 강화군,040005, 39세,2018,551,281,270,104.1,533,270,263,102.7
23310, 강화군,045,40~44세,2018,3290,1790,1500,119.3,3210,1744,1466,119
23310, 강화군,045001, 40세,2018,574,303,271,111.8,556,294,262,112.2
23310, 강화군,045002, 41세,2018,637,350,287,122,626,342,284,120.4
23310, 강화군,045003, 42세,2018,629,336,293,114.7,613,326,287,113.6
23310, 강화군,045004, 43세,2018,683,364,319,114.1,665,353,312,113.1
23310, 강화군,045005, 44세,2018,767,437,330,132.4,750,429,321,133.6
23310, 강화군,050,45~49세,2018,4330,2360,1970,119.8,4259,2326,1933,120.3
23310, 강화군,050001, 45세,2018,839,466,373,124.9,827,458,369,124.1
23310, 강화군,050002, 46세,2018,786,433,353,122.7,773,426,347,122.8
23310, 강화군,050003, 47세,2018,887,485,402,120.6,871,477,394,121.1
23310, 강화군,050004, 48세,2018,869,484,385,125.7,854,478,376,127.1
23310, 강화군,050005, 49세,2018,949,492,457,107.7,934,487,447,108.9
23310, 강화군,055,50~54세,2018,4998,2567,2431,105.6,4921,2528,2393,105.6
23310, 강화군,055001, 50세,2018,970,492,478,102.9,951,483,468,103.2
23310, 강화군,055002, 51세,2018,896,460,436,105.5,886,455,431,105.6
23310, 강화군,055003, 52세,2018,973,511,462,110.6,959,503,456,110.3
23310, 강화군,055004, 53세,2018,1100,571,529,107.9,1083,561,522,107.5
23310, 강화군,055005, 54세,2018,1059,533,526,101.3,1042,526,516,101.9
23310, 강화군,060,55~59세,2018,6916,3408,3508,97.1,6867,3386,3481,97.3
23310, 강화군,060001, 55세,2018,1120,568,552,102.9,1107,562,545,103.1
23310, 강화군,060002, 56세,2018,1332,648,684,94.7,1325,646,679,95.1
23310, 강화군,060003, 57세,2018,1442,717,725,98.9,1440,716,724,98.9
23310, 강화군,060004, 58세,2018,1511,738,773,95.5,1501,732,769,95.2
23310, 강화군,060005, 59세,2018,1511,737,774,95.2,1494,730,764,95.5
23310, 강화군,065,60~64세,2018,6602,3276,3326,98.5,6572,3265,3307,98.7
23310, 강화군,065001, 60세,2018,1394,686,708,96.9,1388,686,702,97.7
23310, 강화군,065002, 61세,2018,1364,693,671,103.3,1360,691,669,103.3
23310, 강화군,065003, 62세,2018,1324,649,675,96.1,1320,647,673,96.1
23310, 강화군,065004, 63세,2018,1362,672,690,97.4,1352,668,684,97.7
23310, 강화군,065005, 64세,2018,1158,576,582,99,1152,573,579,99
23310, 강화군,070,65~69세,2018,5151,2555,2596,98.4,5134,2544,2590,98.2
23310, 강화군,070001, 65세,2018,1151,582,569,102.3,1147,580,567,102.3
23310, 강화군,070002, 66세,2018,1193,581,612,94.9,1187,577,610,94.6
23310, 강화군,070003, 67세,2018,780,375,405,92.6,779,375,404,92.8
23310, 강화군,070004, 68세,2018,994,488,506,96.4,994,488,506,96.4
23310, 강화군,070005, 69세,2018,1033,529,504,105,1027,524,503,104.2
23310, 강화군,075,70~74세,2018,4797,2319,2478,93.6,4785,2314,2471,93.6
23310, 강화군,075001, 70세,2018,1025,516,509,101.4,1023,516,507,101.8
23310, 강화군,075002, 71세,2018,1160,573,587,97.6,1156,571,585,97.6
23310, 강화군,075003, 72세,2018,904,425,479,88.7,902,424,478,88.7
23310, 강화군,075004, 73세,2018,838,406,432,94,834,404,430,94
23310, 강화군,075005, 74세,2018,870,399,471,84.7,870,399,471,84.7
23310, 강화군,080,75~79세,2018,4385,2040,2345,87,4379,2037,2342,87
23310, 강화군,080001, 75세,2018,960,474,486,97.5,960,474,486,97.5
23310, 강화군,080002, 76세,2018,982,453,529,85.6,981,453,528,85.8
23310, 강화군,080003, 77세,2018,884,412,472,87.3,882,410,472,86.9
23310, 강화군,080004, 78세,2018,767,345,422,81.8,765,344,421,81.7
23310, 강화군,080005, 79세,2018,792,356,436,81.7,791,356,435,81.8
23310, 강화군,085,80~84세,2018,3262,1387,1875,74,3258,1385,1873,73.9
23310, 강화군,085001, 80세,2018,752,351,401,87.5,751,350,401,87.3
23310, 강화군,085002, 81세,2018,648,286,362,79,648,286,362,79
23310, 강화군,085003, 82세,2018,696,289,407,71,695,289,406,71.2
23310, 강화군,085004, 83세,2018,647,264,383,68.9,645,263,382,68.8
23310, 강화군,085005, 84세,2018,519,197,322,61.2,519,197,322,61.2
23310, 강화군,090,85~89세,2018,1649,509,1140,44.6,1647,508,1139,44.6
23310, 강화군,090001, 85세,2018,457,163,294,55.4,456,163,293,55.6
23310, 강화군,090002, 86세,2018,420,123,297,41.4,420,123,297,41.4
23310, 강화군,090003, 87세,2018,298,94,204,46.1,297,93,204,45.6
23310, 강화군,090004, 88세,2018,262,73,189,38.6,262,73,189,38.6
23310, 강화군,090005, 89세,2018,212,56,156,35.9,212,56,156,35.9
23310, 강화군,095,90~94세,2018,541,134,407,32.9,539,133,406,32.8
23310, 강화군,095001, 90세,2018,183,47,136,34.6,183,47,136,34.6
23310, 강화군,095002, 91세,2018,119,27,92,29.3,118,26,92,28.3
23310, 강화군,095003, 92세,2018,90,21,69,30.4,89,21,68,30.9
23310, 강화군,095004, 93세,2018,86,20,66,30.3,86,20,66,30.3
23310, 강화군,095005, 94세,2018,63,19,44,43.2,63,19,44,43.2
23310, 강화군,100,95~99세,2018,130,38,92,41.3,130,38,92,41.3
23310, 강화군,100001, 95세,2018,51,16,35,45.7,51,16,35,45.7
23310, 강화군,100002, 96세,2018,24,6,18,33.3,24,6,18,33.3
23310, 강화군,100003, 97세,2018,26,8,18,44.4,26,8,18,44.4
23310, 강화군,100004, 98세,2018,16,6,10,60,16,6,10,60
23310, 강화군,100005, 99세,2018,13,X,11,18.2,13,X,11,18.2
23310, 강화군,101,100세이상,2018,16,5,11,45.5,16,5,11,45.5
23310, 강화군,102,15세미만,2018,5296,2703,2593,104.2,5272,2687,2585,103.9
23310, 강화군,103,15~64세,2018,39205,20688,18517,111.7,38162,20023,18139,110.4
23310, 강화군,104,65세이상,2018,19931,8987,10944,82.1,19888,8964,10924,82.1
23310, 강화군,086,85세이상,2018,2336,686,1650,41.6,2332,684,1648,41.5
23310, 강화군,126,평균연령,2018,51.7,50,53.5,,52,50.4,53.6,
23310, 강화군,127,중위연령,2018,56.1,54,57.7,,56.4,54.6,57.9,
23320, 옹진군,000,합계,2018,19207,10983,8224,133.5,18938,10796,8142,132.6
23320, 옹진군,005,0~4세,2018,542,266,276,96.4,542,266,276,96.4
23320, 옹진군,005001, 0세,2018,91,54,37,145.9,91,54,37,145.9
23320, 옹진군,005002, 1세,2018,97,42,55,76.4,97,42,55,76.4
23320, 옹진군,005003, 2세,2018,125,60,65,92.3,125,60,65,92.3
23320, 옹진군,005004, 3세,2018,116,61,55,110.9,116,61,55,110.9
23320, 옹진군,005005, 4세,2018,113,49,64,76.6,113,49,64,76.6
23320, 옹진군,010,5~9세,2018,575,306,269,113.8,574,306,268,114.2
23320, 옹진군,010001, 5세,2018,128,70,58,120.7,128,70,58,120.7
23320, 옹진군,010002, 6세,2018,115,56,59,94.9,115,56,59,94.9
23320, 옹진군,010003, 7세,2018,112,68,44,154.5,111,68,43,158.1
23320, 옹진군,010004, 8세,2018,116,55,61,90.2,116,55,61,90.2
23320, 옹진군,010005, 9세,2018,104,57,47,121.3,104,57,47,121.3
23320, 옹진군,015,10~14세,2018,509,252,257,98.1,509,252,257,98.1
23320, 옹진군,015001, 10세,2018,105,53,52,101.9,105,53,52,101.9
23320, 옹진군,015002, 11세,2018,115,49,66,74.2,115,49,66,74.2
23320, 옹진군,015003, 12세,2018,91,47,44,106.8,91,47,44,106.8
23320, 옹진군,015004, 13세,2018,86,48,38,126.3,86,48,38,126.3
23320, 옹진군,015005, 14세,2018,112,55,57,96.5,112,55,57,96.5
23320, 옹진군,020,15~19세,2018,522,296,226,131,522,296,226,131
23320, 옹진군,020001, 15세,2018,102,49,53,92.5,102,49,53,92.5
23320, 옹진군,020002, 16세,2018,106,60,46,130.4,106,60,46,130.4
23320, 옹진군,020003, 17세,2018,125,69,56,123.2,125,69,56,123.2
23320, 옹진군,020004, 18세,2018,119,67,52,128.8,119,67,52,128.8
23320, 옹진군,020005, 19세,2018,70,51,19,268.4,70,51,19,268.4
23320, 옹진군,025,20~24세,2018,1191,977,214,456.5,1157,946,211,448.3
23320, 옹진군,025001, 20세,2018,155,131,24,545.8,150,126,24,525
23320, 옹진군,025002, 21세,2018,194,163,31,525.8,189,159,30,530
23320, 옹진군,025003, 22세,2018,259,215,44,488.6,253,210,43,488.4
23320, 옹진군,025004, 23세,2018,271,223,48,464.6,262,214,48,445.8
23320, 옹진군,025005, 24세,2018,312,245,67,365.7,303,237,66,359.1
23320, 옹진군,030,25~29세,2018,1297,935,362,258.3,1240,893,347,257.3
23320, 옹진군,030001, 25세,2018,294,222,72,308.3,279,209,70,298.6
23320, 옹진군,030002, 26세,2018,288,202,86,234.9,273,191,82,232.9
23320, 옹진군,030003, 27세,2018,258,177,81,218.5,252,174,78,223.1
23320, 옹진군,030004, 28세,2018,240,169,71,238,229,162,67,241.8
23320, 옹진군,030005, 29세,2018,217,165,52,317.3,207,157,50,314
23320, 옹진군,035,30~34세,2018,1011,654,357,183.2,958,609,349,174.5
23320, 옹진군,035001, 30세,2018,223,158,65,243.1,212,148,64,231.3
23320, 옹진군,035002, 31세,2018,234,153,81,188.9,223,144,79,182.3
23320, 옹진군,035003, 32세,2018,199,127,72,176.4,191,120,71,169
23320, 옹진군,035004, 33세,2018,173,103,70,147.1,162,92,70,131.4
23320, 옹진군,035005, 34세,2018,182,113,69,163.8,170,105,65,161.5
23320, 옹진군,040,35~39세,2018,1172,710,462,153.7,1140,686,454,151.1
23320, 옹진군,040001, 35세,2018,212,129,83,155.4,204,123,81,151.9
23320, 옹진군,040002, 36세,2018,246,160,86,186,237,154,83,185.5
23320, 옹진군,040003, 37세,2018,227,140,87,160.9,220,134,86,155.8
23320, 옹진군,040004, 38세,2018,257,148,109,135.8,254,146,108,135.2
23320, 옹진군,040005, 39세,2018,230,133,97,137.1,225,129,96,134.4
23320, 옹진군,045,40~44세,2018,1098,715,383,186.7,1074,700,374,187.2
23320, 옹진군,045001, 40세,2018,216,141,75,188,212,138,74,186.5
23320, 옹진군,045002, 41세,2018,212,134,78,171.8,205,130,75,173.3
23320, 옹진군,045003, 42세,2018,195,126,69,182.6,188,122,66,184.8
23320, 옹진군,045004, 43세,2018,226,151,75,201.3,225,150,75,200
23320, 옹진군,045005, 44세,2018,249,163,86,189.5,244,160,84,190.5
23320, 옹진군,050,45~49세,2018,1273,820,453,181,1254,809,445,181.8
23320, 옹진군,050001, 45세,2018,247,161,86,187.2,244,159,85,187.1
23320, 옹진군,050002, 46세,2018,257,173,84,206,254,173,81,213.6
23320, 옹진군,050003, 47세,2018,263,161,102,157.8,258,158,100,158
23320, 옹진군,050004, 48세,2018,262,175,87,201.1,255,170,85,200
23320, 옹진군,050005, 49세,2018,244,150,94,159.6,243,149,94,158.5
23320, 옹진군,055,50~54세,2018,1487,841,646,130.2,1477,838,639,131.1
23320, 옹진군,055001, 50세,2018,266,155,111,139.6,263,154,109,141.3
23320, 옹진군,055002, 51세,2018,295,172,123,139.8,295,172,123,139.8
23320, 옹진군,055003, 52세,2018,285,173,112,154.5,283,172,111,155
23320, 옹진군,055004, 53세,2018,327,167,160,104.4,324,167,157,106.4
23320, 옹진군,055005, 54세,2018,314,174,140,124.3,312,173,139,124.5
23320, 옹진군,060,55~59세,2018,2097,1165,932,125,2086,1162,924,125.8
23320, 옹진군,060001, 55세,2018,369,199,170,117.1,366,199,167,119.2
23320, 옹진군,060002, 56세,2018,410,240,170,141.2,408,239,169,141.4
23320, 옹진군,060003, 57세,2018,474,260,214,121.5,473,260,213,122.1
23320, 옹진군,060004, 58세,2018,415,234,181,129.3,413,233,180,129.4
23320, 옹진군,060005, 59세,2018,429,232,197,117.8,426,231,195,118.5
23320, 옹진군,065,60~64세,2018,1915,1005,910,110.4,1903,999,904,110.5
23320, 옹진군,065001, 60세,2018,389,213,176,121,387,213,174,122.4
23320, 옹진군,065002, 61세,2018,396,220,176,125,396,220,176,125
23320, 옹진군,065003, 62세,2018,392,198,194,102.1,389,195,194,100.5
23320, 옹진군,065004, 63세,2018,425,222,203,109.4,419,220,199,110.6
23320, 옹진군,065005, 64세,2018,313,152,161,94.4,312,151,161,93.8
23320, 옹진군,070,65~69세,2018,1338,708,630,112.4,1330,706,624,113.1
23320, 옹진군,070001, 65세,2018,272,150,122,123,271,150,121,124
23320, 옹진군,070002, 66세,2018,331,165,166,99.4,330,165,165,100
23320, 옹진군,070003, 67세,2018,184,86,98,87.8,182,85,97,87.6
23320, 옹진군,070004, 68세,2018,278,161,117,137.6,276,161,115,140
23320, 옹진군,070005, 69세,2018,273,146,127,115,271,145,126,115.1
23320, 옹진군,075,70~74세,2018,1133,548,585,93.7,1127,544,583,93.3
23320, 옹진군,075001, 70세,2018,214,101,113,89.4,211,100,111,90.1
23320, 옹진군,075002, 71세,2018,299,143,156,91.7,298,142,156,91
23320, 옹진군,075003, 72세,2018,234,113,121,93.4,233,112,121,92.6
23320, 옹진군,075004, 73세,2018,216,106,110,96.4,215,105,110,95.5
23320, 옹진군,075005, 74세,2018,170,85,85,100,170,85,85,100
23320, 옹진군,080,75~79세,2018,890,401,489,82,889,400,489,81.8
23320, 옹진군,080001, 75세,2018,202,93,109,85.3,201,92,109,84.4
23320, 옹진군,080002, 76세,2018,218,100,118,84.7,218,100,118,84.7
23320, 옹진군,080003, 77세,2018,171,76,95,80,171,76,95,80
23320, 옹진군,080004, 78세,2018,154,81,73,111,154,81,73,111
23320, 옹진군,080005, 79세,2018,145,51,94,54.3,145,51,94,54.3
23320, 옹진군,085,80~84세,2018,641,239,402,59.5,640,239,401,59.6
23320, 옹진군,085001, 80세,2018,145,58,87,66.7,145,58,87,66.7
23320, 옹진군,085002, 81세,2018,138,56,82,68.3,138,56,82,68.3
23320, 옹진군,085003, 82세,2018,142,47,95,49.5,141,47,94,50
23320, 옹진군,085004, 83세,2018,108,40,68,58.8,108,40,68,58.8
23320, 옹진군,085005, 84세,2018,108,38,70,54.3,108,38,70,54.3
23320, 옹진군,090,85~89세,2018,340,104,236,44.1,340,104,236,44.1
23320, 옹진군,090001, 85세,2018,91,38,53,71.7,91,38,53,71.7
23320, 옹진군,090002, 86세,2018,78,24,54,44.4,78,24,54,44.4
23320, 옹진군,090003, 87세,2018,69,16,53,30.2,69,16,53,30.2
23320, 옹진군,090004, 88세,2018,52,8,44,18.2,52,8,44,18.2
23320, 옹진군,090005, 89세,2018,50,18,32,56.3,50,18,32,56.3
23320, 옹진군,095,90~94세,2018,141,29,112,25.9,141,29,112,25.9
23320, 옹진군,095001, 90세,2018,40,7,33,21.2,40,7,33,21.2
23320, 옹진군,095002, 91세,2018,39,9,30,30,39,9,30,30
23320, 옹진군,095003, 92세,2018,20,5,15,33.3,20,5,15,33.3
23320, 옹진군,095004, 93세,2018,28,5,23,21.7,28,5,23,21.7
23320, 옹진군,095005, 94세,2018,14,X,11,27.3,14,X,11,27.3
23320, 옹진군,100,95~99세,2018,31,10,21,47.6,31,10,21,47.6
23320, 옹진군,100001, 95세,2018,10,X,7,42.9,10,X,7,42.9
23320, 옹진군,100002, 96세,2018,11,X,9,22.2,11,X,9,22.2
23320, 옹진군,100003, 97세,2018,5,X,X,66.7,5,X,X,66.7
23320, 옹진군,100004, 98세,2018,5,X,X,150,5,X,X,150
23320, 옹진군,100005, 99세,2018,X,X,X,,X,X,X,
23320, 옹진군,101,100세이상,2018,X,X,X,100,X,X,X,100
23320, 옹진군,102,15세미만,2018,1626,824,802,102.7,1625,824,801,102.9
23320, 옹진군,103,15~64세,2018,13063,8118,4945,164.2,12811,7938,4873,162.9
23320, 옹진군,104,65세이상,2018,4518,2041,2477,82.4,4502,2034,2468,82.4
23320, 옹진군,086,85세이상,2018,516,145,371,39.1,516,145,371,39.1
23320, 옹진군,126,평균연령,2018,48.2,45.6,51.7,,48.4,45.8,51.7,
23320, 옹진군,127,중위연령,2018,51.5,47.3,56.2,,51.8,47.7,56.3,
24,광주광역시,000,합계,2018,1490092,741728,748364,99.1,1460259,725127,735132,98.6
24,광주광역시,005,0~4세,2018,59117,30351,28766,105.5,58606,30092,28514,105.5
24,광주광역시,005001, 0세,2018,9570,4964,4606,107.8,9466,4901,4565,107.4
24,광주광역시,005002, 1세,2018,10661,5552,5109,108.7,10543,5501,5042,109.1
24,광주광역시,005003, 2세,2018,12355,6278,6077,103.3,12252,6227,6025,103.4
24,광주광역시,005004, 3세,2018,13078,6759,6319,107,12986,6709,6277,106.9
24,광주광역시,005005, 4세,2018,13453,6798,6655,102.1,13359,6754,6605,102.3
24,광주광역시,010,5~9세,2018,72461,37429,35032,106.8,72122,37270,34852,106.9
24,광주광역시,010001, 5세,2018,13574,7022,6552,107.2,13495,6988,6507,107.4
24,광주광역시,010002, 6세,2018,15256,7923,7333,108,15169,7882,7287,108.2
24,광주광역시,010003, 7세,2018,14922,7703,7219,106.7,14856,7663,7193,106.5
24,광주광역시,010004, 8세,2018,14509,7477,7032,106.3,14448,7449,6999,106.4
24,광주광역시,010005, 9세,2018,14200,7304,6896,105.9,14154,7288,6866,106.1
24,광주광역시,015,10~14세,2018,74979,38907,36072,107.9,74735,38783,35952,107.9
24,광주광역시,015001, 10세,2018,14882,7715,7167,107.6,14829,7689,7140,107.7
24,광주광역시,015002, 11세,2018,15756,8171,7585,107.7,15716,8154,7562,107.8
24,광주광역시,015003, 12세,2018,14504,7548,6956,108.5,14437,7516,6921,108.6
24,광주광역시,015004, 13세,2018,14253,7362,6891,106.8,14213,7340,6873,106.8
24,광주광역시,015005, 14세,2018,15584,8111,7473,108.5,15540,8084,7456,108.4
24,광주광역시,020,15~19세,2018,95991,49482,46509,106.4,94765,48861,45904,106.4
24,광주광역시,020001, 15세,2018,16395,8624,7771,111,16346,8605,7741,111.2
24,광주광역시,020002, 16세,2018,16575,8591,7984,107.6,16527,8564,7963,107.5
24,광주광역시,020003, 17세,2018,19215,9929,9286,106.9,19104,9873,9231,107
24,광주광역시,020004, 18세,2018,21829,11255,10574,106.4,21464,11075,10389,106.6
24,광주광역시,020005, 19세,2018,21977,11083,10894,101.7,21324,10744,10580,101.6
24,광주광역시,025,20~24세,2018,118636,61702,56934,108.4,113013,58534,54479,107.4
24,광주광역시,025001, 20세,2018,23181,11761,11420,103,22282,11287,10995,102.7
24,광주광역시,025002, 21세,2018,23970,12314,11656,105.6,22862,11698,11164,104.8
24,광주광역시,025003, 22세,2018,24229,12560,11669,107.6,23058,11910,11148,106.8
24,광주광역시,025004, 23세,2018,23884,12439,11445,108.7,22703,11768,10935,107.6
24,광주광역시,025005, 24세,2018,23372,12628,10744,117.5,22108,11871,10237,116
24,광주광역시,030,25~29세,2018,100269,52939,47330,111.9,94546,49599,44947,110.3
24,광주광역시,030001, 25세,2018,22443,12052,10391,116,21235,11349,9886,114.8
24,광주광역시,030002, 26세,2018,21849,11528,10321,111.7,20671,10814,9857,109.7
24,광주광역시,030003, 27세,2018,19756,10325,9431,109.5,18636,9692,8944,108.4
24,광주광역시,030004, 28세,2018,18483,9788,8695,112.6,17364,9136,8228,111
24,광주광역시,030005, 29세,2018,17738,9246,8492,108.9,16640,8608,8032,107.2
24,광주광역시,035,30~34세,2018,89671,46229,43442,106.4,85190,43611,41579,104.9
24,광주광역시,035001, 30세,2018,16945,8789,8156,107.8,15963,8214,7749,106
24,광주광역시,035002, 31세,2018,17452,8948,8504,105.2,16436,8351,8085,103.3
24,광주광역시,035003, 32세,2018,17697,9082,8615,105.4,16832,8579,8253,104
24,광주광역시,035004, 33세,2018,17931,9255,8676,106.7,17080,8761,8319,105.3
24,광주광역시,035005, 34세,2018,19646,10155,9491,107,18879,9706,9173,105.8
24,광주광역시,040,35~39세,2018,117599,59291,58308,101.7,114352,57367,56985,100.7
24,광주광역시,040001, 35세,2018,21783,11200,10583,105.8,21048,10762,10286,104.6
24,광주광역시,040002, 36세,2018,24266,12341,11925,103.5,23523,11885,11638,102.1
24,광주광역시,040003, 37세,2018,23358,11812,11546,102.3,22738,11447,11291,101.4
24,광주광역시,040004, 38세,2018,24276,12068,12208,98.9,23671,11720,11951,98.1
24,광주광역시,040005, 39세,2018,23916,11870,12046,98.5,23372,11553,11819,97.7
24,광주광역시,045,40~44세,2018,117521,59064,58457,101,115139,57737,57402,100.6
24,광주광역시,045001, 40세,2018,21883,10969,10914,100.5,21322,10647,10675,99.7
24,광주광역시,045002, 41세,2018,23012,11471,11541,99.4,22542,11195,11347,98.7
24,광주광역시,045003, 42세,2018,22803,11546,11257,102.6,22356,11296,11060,102.1
24,광주광역시,045004, 43세,2018,23360,11687,11673,100.1,22893,11437,11456,99.8
24,광주광역시,045005, 44세,2018,26463,13391,13072,102.4,26026,13162,12864,102.3
24,광주광역시,050,45~49세,2018,133365,66705,66660,100.1,131257,65535,65722,99.7
24,광주광역시,050001, 45세,2018,26104,12918,13186,98,25676,12672,13004,97.4
24,광주광역시,050002, 46세,2018,26546,13284,13262,100.2,26039,12996,13043,99.6
24,광주광역시,050003, 47세,2018,27874,13917,13957,99.7,27452,13680,13772,99.3
24,광주광역시,050004, 48세,2018,26709,13403,13306,100.7,26326,13208,13118,100.7
24,광주광역시,050005, 49세,2018,26132,13183,12949,101.8,25764,12979,12785,101.5
24,광주광역시,055,50~54세,2018,121016,60588,60428,100.3,119357,59776,59581,100.3
24,광주광역시,055001, 50세,2018,27027,13408,13619,98.5,26662,13226,13436,98.4
24,광주광역시,055002, 51세,2018,24322,12119,12203,99.3,24004,11971,12033,99.5
24,광주광역시,055003, 52세,2018,24303,12341,11962,103.2,23973,12178,11795,103.2
24,광주광역시,055004, 53세,2018,23556,11708,11848,98.8,23236,11546,11690,98.8
24,광주광역시,055005, 54세,2018,21808,11012,10796,102,21482,10855,10627,102.1
24,광주광역시,060,55~59세,2018,115081,57147,57934,98.6,113988,56624,57364,98.7
24,광주광역시,060001, 55세,2018,23211,11730,11481,102.2,22924,11606,11318,102.5
24,광주광역시,060002, 56세,2018,22026,11083,10943,101.3,21788,10968,10820,101.4
24,광주광역시,060003, 57세,2018,23508,11655,11853,98.3,23325,11570,11755,98.4
24,광주광역시,060004, 58세,2018,24581,12027,12554,95.8,24359,11913,12446,95.7
24,광주광역시,060005, 59세,2018,21755,10652,11103,95.9,21592,10567,11025,95.8
24,광주광역시,065,60~64세,2018,85764,41772,43992,95,85074,41426,43648,94.9
24,광주광역시,065001, 60세,2018,19488,9473,10015,94.6,19308,9380,9928,94.5
24,광주광역시,065002, 61세,2018,18954,9323,9631,96.8,18820,9257,9563,96.8
24,광주광역시,065003, 62세,2018,16238,8032,8206,97.9,16100,7966,8134,97.9
24,광주광역시,065004, 63세,2018,17219,8246,8973,91.9,17089,8179,8910,91.8
24,광주광역시,065005, 64세,2018,13865,6698,7167,93.5,13757,6644,7113,93.4
24,광주광역시,070,65~69세,2018,60852,28732,32120,89.5,60567,28609,31958,89.5
24,광주광역시,070001, 65세,2018,12362,5846,6516,89.7,12290,5810,6480,89.7
24,광주광역시,070002, 66세,2018,13514,6450,7064,91.3,13437,6417,7020,91.4
24,광주광역시,070003, 67세,2018,11222,5308,5914,89.8,11170,5290,5880,90
24,광주광역시,070004, 68세,2018,11624,5481,6143,89.2,11585,5468,6117,89.4
24,광주광역시,070005, 69세,2018,12130,5647,6483,87.1,12085,5624,6461,87
24,광주광역시,075,70~74세,2018,47800,21911,25889,84.6,47683,21862,25821,84.7
24,광주광역시,075001, 70세,2018,11101,5172,5929,87.2,11072,5159,5913,87.2
24,광주광역시,075002, 71세,2018,11512,5258,6254,84.1,11476,5243,6233,84.1
24,광주광역시,075003, 72세,2018,8757,4087,4670,87.5,8740,4079,4661,87.5
24,광주광역시,075004, 73세,2018,8456,3808,4648,81.9,8437,3801,4636,82
24,광주광역시,075005, 74세,2018,7974,3586,4388,81.7,7958,3580,4378,81.8
24,광주광역시,080,75~79세,2018,39582,16788,22794,73.7,39528,16768,22760,73.7
24,광주광역시,080001, 75세,2018,7947,3528,4419,79.8,7934,3522,4412,79.8
24,광주광역시,080002, 76세,2018,10356,4578,5778,79.2,10346,4575,5771,79.3
24,광주광역시,080003, 77세,2018,7804,3245,4559,71.2,7793,3241,4552,71.2
24,광주광역시,080004, 78세,2018,6879,2744,4135,66.4,6866,2741,4125,66.4
24,광주광역시,080005, 79세,2018,6596,2693,3903,69,6589,2689,3900,68.9
24,광주광역시,085,80~84세,2018,24092,8630,15462,55.8,24057,8618,15439,55.8
24,광주광역시,085001, 80세,2018,5924,2309,3615,63.9,5910,2304,3606,63.9
24,광주광역시,085002, 81세,2018,5367,1989,3378,58.9,5364,1989,3375,58.9
24,광주광역시,085003, 82세,2018,4543,1602,2941,54.5,4537,1600,2937,54.5
24,광주광역시,085004, 83세,2018,4364,1477,2887,51.2,4358,1475,2883,51.2
24,광주광역시,085005, 84세,2018,3894,1253,2641,47.4,3888,1250,2638,47.4
24,광주광역시,090,85~89세,2018,11432,3127,8305,37.7,11420,3121,8299,37.6
24,광주광역시,090001, 85세,2018,3032,923,2109,43.8,3027,921,2106,43.7
24,광주광역시,090002, 86세,2018,2599,767,1832,41.9,2595,764,1831,41.7
24,광주광역시,090003, 87세,2018,2092,530,1562,33.9,2091,530,1561,34
24,광주광역시,090004, 88세,2018,2116,486,1630,29.8,2115,485,1630,29.8
24,광주광역시,090005, 89세,2018,1593,421,1172,35.9,1592,421,1171,36
24,광주광역시,095,90~94세,2018,3783,778,3005,25.9,3780,778,3002,25.9
24,광주광역시,095001, 90세,2018,1259,287,972,29.5,1258,287,971,29.6
24,광주광역시,095002, 91세,2018,953,180,773,23.3,952,180,772,23.3
24,광주광역시,095003, 92세,2018,701,147,554,26.5,701,147,554,26.5
24,광주광역시,095004, 93세,2018,560,100,460,21.7,559,100,459,21.8
24,광주광역시,095005, 94세,2018,310,64,246,26,310,64,246,26
24,광주광역시,100,95~99세,2018,978,148,830,17.8,977,148,829,17.9
24,광주광역시,100001, 95세,2018,408,67,341,19.6,407,67,340,19.7
24,광주광역시,100002, 96세,2018,248,37,211,17.5,248,37,211,17.5
24,광주광역시,100003, 97세,2018,156,19,137,13.9,156,19,137,13.9
24,광주광역시,100004, 98세,2018,102,12,90,13.3,102,12,90,13.3
24,광주광역시,100005, 99세,2018,64,13,51,25.5,64,13,51,25.5
24,광주광역시,101,100세이상,2018,103,8,95,8.4,103,8,95,8.4
24,광주광역시,102,15세미만,2018,206557,106687,99870,106.8,205463,106145,99318,106.9
24,광주광역시,103,15~64세,2018,1094913,554919,539994,102.8,1066681,539070,527611,102.2
24,광주광역시,104,65세이상,2018,188622,80122,108500,73.8,188115,79912,108203,73.9
24,광주광역시,086,85세이상,2018,16296,4061,12235,33.2,16280,4055,12225,33.2
24,광주광역시,126,평균연령,2018,40.1,39,41.2,,40.2,39.1,41.4,
24,광주광역시,127,중위연령,2018,40.7,39.5,41.9,,41.1,39.9,42.2,
24010, 동구,000,합계,2018,99870,49942,49928,100,97653,48758,48895,99.7
24010, 동구,005,0~4세,2018,3029,1596,1433,111.4,3010,1584,1426,111.1
24010, 동구,005001, 0세,2018,535,280,255,109.8,527,275,252,109.1
24010, 동구,005002, 1세,2018,551,301,250,120.4,547,299,248,120.6
24010, 동구,005003, 2세,2018,586,304,282,107.8,584,303,281,107.8
24010, 동구,005004, 3세,2018,675,359,316,113.6,673,357,316,113
24010, 동구,005005, 4세,2018,682,352,330,106.7,679,350,329,106.4
24010, 동구,010,5~9세,2018,3046,1567,1479,105.9,3036,1562,1474,106
24010, 동구,010001, 5세,2018,620,314,306,102.6,617,312,305,102.3
24010, 동구,010002, 6세,2018,664,337,327,103.1,659,335,324,103.4
24010, 동구,010003, 7세,2018,665,329,336,97.9,664,328,336,97.6
24010, 동구,010004, 8세,2018,585,311,274,113.5,585,311,274,113.5
24010, 동구,010005, 9세,2018,512,276,236,116.9,511,276,235,117.4
24010, 동구,015,10~14세,2018,2881,1481,1400,105.8,2875,1478,1397,105.8
24010, 동구,015001, 10세,2018,573,285,288,99,571,283,288,98.3
24010, 동구,015002, 11세,2018,584,303,281,107.8,584,303,281,107.8
24010, 동구,015003, 12세,2018,564,290,274,105.8,562,290,272,106.6
24010, 동구,015004, 13세,2018,517,275,242,113.6,516,275,241,114.1
24010, 동구,015005, 14세,2018,643,328,315,104.1,642,327,315,103.8
24010, 동구,020,15~19세,2018,5626,2967,2659,111.6,5326,2803,2523,111.1
24010, 동구,020001, 15세,2018,680,377,303,124.4,679,377,302,124.8
24010, 동구,020002, 16세,2018,743,382,361,105.8,740,380,360,105.6
24010, 동구,020003, 17세,2018,900,476,424,112.3,877,469,408,115
24010, 동구,020004, 18세,2018,1405,766,639,119.9,1265,682,583,117
24010, 동구,020005, 19세,2018,1898,966,932,103.6,1765,895,870,102.9
24010, 동구,025,20~24세,2018,9575,4953,4622,107.2,8931,4611,4320,106.7
24010, 동구,025001, 20세,2018,1812,857,955,89.7,1673,795,878,90.5
24010, 동구,025002, 21세,2018,1837,919,918,100.1,1680,822,858,95.8
24010, 동구,025003, 22세,2018,1959,1020,939,108.6,1841,958,883,108.5
24010, 동구,025004, 23세,2018,2068,1122,946,118.6,1949,1061,888,119.5
24010, 동구,025005, 24세,2018,1899,1035,864,119.8,1788,975,813,119.9
24010, 동구,030,25~29세,2018,7294,3971,3323,119.5,6905,3760,3145,119.6
24010, 동구,030001, 25세,2018,1717,955,762,125.3,1628,918,710,129.3
24010, 동구,030002, 26세,2018,1606,871,735,118.5,1523,822,701,117.3
24010, 동구,030003, 27세,2018,1408,754,654,115.3,1339,717,622,115.3
24010, 동구,030004, 28세,2018,1247,682,565,120.7,1181,644,537,119.9
24010, 동구,030005, 29세,2018,1316,709,607,116.8,1234,659,575,114.6
24010, 동구,035,30~34세,2018,5845,3083,2762,111.6,5611,2964,2647,112
24010, 동구,035001, 30세,2018,1148,615,533,115.4,1100,586,514,114
24010, 동구,035002, 31세,2018,1203,605,598,101.2,1148,578,570,101.4
24010, 동구,035003, 32세,2018,1135,605,530,114.2,1092,584,508,115
24010, 동구,035004, 33세,2018,1179,636,543,117.1,1132,613,519,118.1
24010, 동구,035005, 34세,2018,1180,622,558,111.5,1139,603,536,112.5
24010, 동구,040,35~39세,2018,6440,3462,2978,116.3,6288,3372,2916,115.6
24010, 동구,040001, 35세,2018,1249,659,590,111.7,1214,637,577,110.4
24010, 동구,040002, 36세,2018,1382,734,648,113.3,1347,712,635,112.1
24010, 동구,040003, 37세,2018,1331,733,598,122.6,1298,715,583,122.6
24010, 동구,040004, 38세,2018,1240,659,581,113.4,1210,641,569,112.7
24010, 동구,040005, 39세,2018,1238,677,561,120.7,1219,667,552,120.8
24010, 동구,045,40~44세,2018,5832,3206,2626,122.1,5711,3132,2579,121.4
24010, 동구,045001, 40세,2018,1143,638,505,126.3,1113,621,492,126.2
24010, 동구,045002, 41세,2018,1167,634,533,118.9,1145,618,527,117.3
24010, 동구,045003, 42세,2018,1125,616,509,121,1107,609,498,122.3
24010, 동구,045004, 43세,2018,1126,627,499,125.7,1096,607,489,124.1
24010, 동구,045005, 44세,2018,1271,691,580,119.1,1250,677,573,118.2
24010, 동구,050,45~49세,2018,6994,3628,3366,107.8,6894,3559,3335,106.7
24010, 동구,050001, 45세,2018,1344,699,645,108.4,1316,678,638,106.3
24010, 동구,050002, 46세,2018,1344,716,628,114,1318,695,623,111.6
24010, 동구,050003, 47세,2018,1484,764,720,106.1,1462,753,709,106.2
24010, 동구,050004, 48세,2018,1431,741,690,107.4,1420,731,689,106.1
24010, 동구,050005, 49세,2018,1391,708,683,103.7,1378,702,676,103.8
24010, 동구,055,50~54세,2018,6981,3520,3461,101.7,6886,3483,3403,102.4
24010, 동구,055001, 50세,2018,1464,743,721,103.1,1443,731,712,102.7
24010, 동구,055002, 51세,2018,1343,692,651,106.3,1318,686,632,108.5
24010, 동구,055003, 52세,2018,1420,724,696,104,1410,722,688,104.9
24010, 동구,055004, 53세,2018,1403,694,709,97.9,1384,686,698,98.3
24010, 동구,055005, 54세,2018,1351,667,684,97.5,1331,658,673,97.8
24010, 동구,060,55~59세,2018,8162,3959,4203,94.2,8093,3932,4161,94.5
24010, 동구,060001, 55세,2018,1560,768,792,97,1536,759,777,97.7
24010, 동구,060002, 56세,2018,1476,724,752,96.3,1461,718,743,96.6
24010, 동구,060003, 57세,2018,1657,801,856,93.6,1648,798,850,93.9
24010, 동구,060004, 58세,2018,1811,857,954,89.8,1799,854,945,90.4
24010, 동구,060005, 59세,2018,1658,809,849,95.3,1649,803,846,94.9
24010, 동구,065,60~64세,2018,7564,3622,3942,91.9,7526,3607,3919,92
24010, 동구,065001, 60세,2018,1627,792,835,94.9,1614,786,828,94.9
24010, 동구,065002, 61세,2018,1585,786,799,98.4,1578,783,795,98.5
24010, 동구,065003, 62세,2018,1430,674,756,89.2,1425,673,752,89.5
24010, 동구,065004, 63세,2018,1573,726,847,85.7,1568,725,843,86
24010, 동구,065005, 64세,2018,1349,644,705,91.3,1341,640,701,91.3
24010, 동구,070,65~69세,2018,6000,2756,3244,85,5984,2750,3234,85
24010, 동구,070001, 65세,2018,1196,552,644,85.7,1190,550,640,85.9
24010, 동구,070002, 66세,2018,1311,609,702,86.8,1306,606,700,86.6
24010, 동구,070003, 67세,2018,1085,495,590,83.9,1083,495,588,84.2
24010, 동구,070004, 68세,2018,1141,518,623,83.1,1139,517,622,83.1
24010, 동구,070005, 69세,2018,1267,582,685,85,1266,582,684,85.1
24010, 동구,075,70~74세,2018,5196,2347,2849,82.4,5183,2341,2842,82.4
24010, 동구,075001, 70세,2018,1139,526,613,85.8,1137,524,613,85.5
24010, 동구,075002, 71세,2018,1241,538,703,76.5,1239,538,701,76.7
24010, 동구,075003, 72세,2018,954,406,548,74.1,950,404,546,74
24010, 동구,075004, 73세,2018,954,425,529,80.3,950,423,527,80.3
24010, 동구,075005, 74세,2018,908,452,456,99.1,907,452,455,99.3
24010, 동구,080,75~79세,2018,4621,2057,2564,80.2,4615,2055,2560,80.3
24010, 동구,080001, 75세,2018,861,386,475,81.3,861,386,475,81.3
24010, 동구,080002, 76세,2018,1211,539,672,80.2,1209,539,670,80.4
24010, 동구,080003, 77세,2018,944,425,519,81.9,943,425,518,82
24010, 동구,080004, 78세,2018,836,370,466,79.4,834,369,465,79.4
24010, 동구,080005, 79세,2018,769,337,432,78,768,336,432,77.8
24010, 동구,085,80~84세,2018,2843,1203,1640,73.4,2839,1202,1637,73.4
24010, 동구,085001, 80세,2018,705,324,381,85,704,324,380,85.3
24010, 동구,085002, 81세,2018,625,272,353,77.1,624,272,352,77.3
24010, 동구,085003, 82세,2018,570,242,328,73.8,569,242,327,74
24010, 동구,085004, 83세,2018,485,189,296,63.9,485,189,296,63.9
24010, 동구,085005, 84세,2018,458,176,282,62.4,457,175,282,62.1
24010, 동구,090,85~89세,2018,1331,426,905,47.1,1330,425,905,47
24010, 동구,090001, 85세,2018,358,131,227,57.7,358,131,227,57.7
24010, 동구,090002, 86세,2018,293,96,197,48.7,293,96,197,48.7
24010, 동구,090003, 87세,2018,239,76,163,46.6,239,76,163,46.6
24010, 동구,090004, 88세,2018,257,70,187,37.4,256,69,187,36.9
24010, 동구,090005, 89세,2018,184,53,131,40.5,184,53,131,40.5
24010, 동구,095,90~94세,2018,481,113,368,30.7,481,113,368,30.7
24010, 동구,095001, 90세,2018,158,44,114,38.6,158,44,114,38.6
24010, 동구,095002, 91세,2018,120,21,99,21.2,120,21,99,21.2
24010, 동구,095003, 92세,2018,92,25,67,37.3,92,25,67,37.3
24010, 동구,095004, 93세,2018,66,15,51,29.4,66,15,51,29.4
24010, 동구,095005, 94세,2018,45,8,37,21.6,45,8,37,21.6
24010, 동구,100,95~99세,2018,117,25,92,27.2,117,25,92,27.2
24010, 동구,100001, 95세,2018,47,10,37,27,47,10,37,27
24010, 동구,100002, 96세,2018,29,X,25,16,29,X,25,16
24010, 동구,100003, 97세,2018,20,X,16,25,20,X,16,25
24010, 동구,100004, 98세,2018,12,5,7,71.4,12,5,7,71.4
24010, 동구,100005, 99세,2018,9,X,7,28.6,9,X,7,28.6
24010, 동구,101,100세이상,2018,12,X,12,0,12,X,12,0
24010, 동구,102,15세미만,2018,8956,4644,4312,107.7,8921,4624,4297,107.6
24010, 동구,103,15~64세,2018,70313,36371,33942,107.2,68171,35223,32948,106.9
24010, 동구,104,65세이상,2018,20601,8927,11674,76.5,20561,8911,11650,76.5
24010, 동구,086,85세이상,2018,1941,564,1377,41,1940,563,1377,40.9
24010, 동구,126,평균연령,2018,44.5,43,46.1,,44.9,43.3,46.4,
24010, 동구,127,중위연령,2018,45.3,43,47.6,,45.9,43.7,48.1,
24020, 서구,000,합계,2018,302189,149109,153080,97.4,299936,148047,151889,97.5
24020, 서구,005,0~4세,2018,10904,5636,5268,107,10861,5613,5248,107
24020, 서구,005001, 0세,2018,1790,926,864,107.2,1782,919,863,106.5
24020, 서구,005002, 1세,2018,2014,1068,946,112.9,2007,1067,940,113.5
24020, 서구,005003, 2세,2018,2288,1175,1113,105.6,2275,1167,1108,105.3
24020, 서구,005004, 3세,2018,2308,1214,1094,111,2299,1209,1090,110.9
24020, 서구,005005, 4세,2018,2504,1253,1251,100.2,2498,1251,1247,100.3
24020, 서구,010,5~9세,2018,13879,7237,6642,109,13861,7226,6635,108.9
24020, 서구,010001, 5세,2018,2589,1354,1235,109.6,2586,1353,1233,109.7
24020, 서구,010002, 6세,2018,2841,1483,1358,109.2,2834,1478,1356,109
24020, 서구,010003, 7세,2018,2914,1512,1402,107.8,2912,1511,1401,107.9
24020, 서구,010004, 8세,2018,2758,1462,1296,112.8,2753,1458,1295,112.6
24020, 서구,010005, 9세,2018,2777,1426,1351,105.6,2776,1426,1350,105.6
24020, 서구,015,10~14세,2018,15249,7975,7274,109.6,15242,7970,7272,109.6
24020, 서구,015001, 10세,2018,2938,1524,1414,107.8,2936,1522,1414,107.6
24020, 서구,015002, 11세,2018,3189,1643,1546,106.3,3188,1643,1545,106.3
24020, 서구,015003, 12세,2018,2960,1604,1356,118.3,2958,1602,1356,118.1
24020, 서구,015004, 13세,2018,2919,1491,1428,104.4,2918,1491,1427,104.5
24020, 서구,015005, 14세,2018,3243,1713,1530,112,3242,1712,1530,111.9
24020, 서구,020,15~19세,2018,18828,9904,8924,111,18777,9879,8898,111
24020, 서구,020001, 15세,2018,3377,1784,1593,112,3374,1783,1591,112.1
24020, 서구,020002, 16세,2018,3560,1920,1640,117.1,3557,1919,1638,117.2
24020, 서구,020003, 17세,2018,3993,2015,1978,101.9,3985,2011,1974,101.9
24020, 서구,020004, 18세,2018,4210,2202,2008,109.7,4201,2199,2002,109.8
24020, 서구,020005, 19세,2018,3688,1983,1705,116.3,3660,1967,1693,116.2
24020, 서구,025,20~24세,2018,22095,11535,10560,109.2,21820,11405,10415,109.5
24020, 서구,025001, 20세,2018,4036,2222,1814,122.5,4014,2211,1803,122.6
24020, 서구,025002, 21세,2018,4414,2407,2007,119.9,4381,2388,1993,119.8
24020, 서구,025003, 22세,2018,4499,2333,2166,107.7,4447,2310,2137,108.1
24020, 서구,025004, 23세,2018,4575,2259,2316,97.5,4486,2222,2264,98.1
24020, 서구,025005, 24세,2018,4571,2314,2257,102.5,4492,2274,2218,102.5
24020, 서구,030,25~29세,2018,20681,10517,10164,103.5,20262,10321,9941,103.8
24020, 서구,030001, 25세,2018,4501,2298,2203,104.3,4414,2255,2159,104.4
24020, 서구,030002, 26세,2018,4479,2170,2309,94,4393,2137,2256,94.7
24020, 서구,030003, 27세,2018,4092,2051,2041,100.5,4005,2015,1990,101.3
24020, 서구,030004, 28세,2018,3875,2079,1796,115.8,3793,2032,1761,115.4
24020, 서구,030005, 29세,2018,3734,1919,1815,105.7,3657,1882,1775,106
24020, 서구,035,30~34세,2018,17894,9045,8849,102.2,17562,8893,8669,102.6
24020, 서구,035001, 30세,2018,3442,1777,1665,106.7,3367,1748,1619,108
24020, 서구,035002, 31세,2018,3445,1725,1720,100.3,3368,1688,1680,100.5
24020, 서구,035003, 32세,2018,3631,1841,1790,102.8,3565,1808,1757,102.9
24020, 서구,035004, 33세,2018,3539,1763,1776,99.3,3485,1740,1745,99.7
24020, 서구,035005, 34세,2018,3837,1939,1898,102.2,3777,1909,1868,102.2
24020, 서구,040,35~39세,2018,23167,11390,11777,96.7,22921,11262,11659,96.6
24020, 서구,040001, 35세,2018,4325,2181,2144,101.7,4273,2151,2122,101.4
24020, 서구,040002, 36세,2018,4769,2399,2370,101.2,4709,2367,2342,101.1
24020, 서구,040003, 37세,2018,4583,2289,2294,99.8,4542,2273,2269,100.2
24020, 서구,040004, 38세,2018,4782,2268,2514,90.2,4740,2246,2494,90.1
24020, 서구,040005, 39세,2018,4708,2253,2455,91.8,4657,2225,2432,91.5
24020, 서구,045,40~44세,2018,24042,11732,12310,95.3,23876,11656,12220,95.4
24020, 서구,045001, 40세,2018,4346,2110,2236,94.4,4312,2093,2219,94.3
24020, 서구,045002, 41세,2018,4639,2272,2367,96,4604,2254,2350,95.9
24020, 서구,045003, 42세,2018,4647,2288,2359,97,4616,2276,2340,97.3
24020, 서구,045004, 43세,2018,4825,2331,2494,93.5,4789,2315,2474,93.6
24020, 서구,045005, 44세,2018,5585,2731,2854,95.7,5555,2718,2837,95.8
24020, 서구,050,45~49세,2018,28714,13992,14722,95,28485,13892,14593,95.2
24020, 서구,050001, 45세,2018,5451,2625,2826,92.9,5413,2607,2806,92.9
24020, 서구,050002, 46세,2018,5663,2681,2982,89.9,5610,2660,2950,90.2
24020, 서구,050003, 47세,2018,5994,2905,3089,94,5941,2884,3057,94.3
24020, 서구,050004, 48세,2018,5787,2884,2903,99.3,5746,2870,2876,99.8
24020, 서구,050005, 49세,2018,5819,2897,2922,99.1,5775,2871,2904,98.9
24020, 서구,055,50~54세,2018,25912,12989,12923,100.5,25736,12899,12837,100.5
24020, 서구,055001, 50세,2018,5908,2967,2941,100.9,5868,2947,2921,100.9
24020, 서구,055002, 51세,2018,5250,2622,2628,99.8,5212,2601,2611,99.6
24020, 서구,055003, 52세,2018,5091,2576,2515,102.4,5059,2558,2501,102.3
24020, 서구,055004, 53세,2018,4971,2484,2487,99.9,4935,2470,2465,100.2
24020, 서구,055005, 54세,2018,4692,2340,2352,99.5,4662,2323,2339,99.3
24020, 서구,060,55~59세,2018,24259,11850,12409,95.5,24137,11799,12338,95.6
24020, 서구,060001, 55세,2018,4937,2443,2494,98,4905,2432,2473,98.3
24020, 서구,060002, 56세,2018,4684,2286,2398,95.3,4662,2275,2387,95.3
24020, 서구,060003, 57세,2018,4902,2405,2497,96.3,4879,2398,2481,96.7
24020, 서구,060004, 58세,2018,5155,2521,2634,95.7,5130,2509,2621,95.7
24020, 서구,060005, 59세,2018,4581,2195,2386,92,4561,2185,2376,92
24020, 서구,065,60~64세,2018,18133,8765,9368,93.6,18043,8723,9320,93.6
24020, 서구,065001, 60세,2018,4080,1910,2170,88,4058,1899,2159,88
24020, 서구,065002, 61세,2018,4084,2021,2063,98,4065,2013,2052,98.1
24020, 서구,065003, 62세,2018,3419,1683,1736,96.9,3403,1675,1728,96.9
24020, 서구,065004, 63세,2018,3699,1782,1917,93,3680,1772,1908,92.9
24020, 서구,065005, 64세,2018,2851,1369,1482,92.4,2837,1364,1473,92.6
24020, 서구,070,65~69세,2018,12758,6061,6697,90.5,12714,6042,6672,90.6
24020, 서구,070001, 65세,2018,2620,1234,1386,89,2612,1230,1382,89
24020, 서구,070002, 66세,2018,2856,1371,1485,92.3,2844,1367,1477,92.6
24020, 서구,070003, 67세,2018,2322,1133,1189,95.3,2309,1128,1181,95.5
24020, 서구,070004, 68세,2018,2447,1142,1305,87.5,2445,1141,1304,87.5
24020, 서구,070005, 69세,2018,2513,1181,1332,88.7,2504,1176,1328,88.6
24020, 서구,075,70~74세,2018,9846,4497,5349,84.1,9832,4489,5343,84
24020, 서구,075001, 70세,2018,2252,1023,1229,83.2,2248,1021,1227,83.2
24020, 서구,075002, 71세,2018,2399,1094,1305,83.8,2394,1091,1303,83.7
24020, 서구,075003, 72세,2018,1792,837,955,87.6,1791,836,955,87.5
24020, 서구,075004, 73세,2018,1783,829,954,86.9,1781,828,953,86.9
24020, 서구,075005, 74세,2018,1620,714,906,78.8,1618,713,905,78.8
24020, 서구,080,75~79세,2018,8003,3453,4550,75.9,7994,3451,4543,76
24020, 서구,080001, 75세,2018,1635,749,886,84.5,1633,749,884,84.7
24020, 서구,080002, 76세,2018,2065,905,1160,78,2065,905,1160,78
24020, 서구,080003, 77세,2018,1557,687,870,79,1555,686,869,78.9
24020, 서구,080004, 78세,2018,1385,569,816,69.7,1382,569,813,70
24020, 서구,080005, 79세,2018,1361,543,818,66.4,1359,542,817,66.3
24020, 서구,085,80~84세,2018,4666,1710,2956,57.8,4658,1707,2951,57.8
24020, 서구,085001, 80세,2018,1160,453,707,64.1,1158,453,705,64.3
24020, 서구,085002, 81세,2018,1040,391,649,60.2,1040,391,649,60.2
24020, 서구,085003, 82세,2018,903,314,589,53.3,902,313,589,53.1
24020, 서구,085004, 83세,2018,835,323,512,63.1,833,322,511,63
24020, 서구,085005, 84세,2018,728,229,499,45.9,725,228,497,45.9
24020, 서구,090,85~89세,2018,2238,650,1588,40.9,2235,649,1586,40.9
24020, 서구,090001, 85세,2018,609,188,421,44.7,607,188,419,44.9
24020, 서구,090002, 86세,2018,514,154,360,42.8,513,153,360,42.5
24020, 서구,090003, 87세,2018,406,116,290,40,406,116,290,40
24020, 서구,090004, 88세,2018,369,84,285,29.5,369,84,285,29.5
24020, 서구,090005, 89세,2018,340,108,232,46.6,340,108,232,46.6
24020, 서구,095,90~94세,2018,719,148,571,25.9,719,148,571,25.9
24020, 서구,095001, 90세,2018,242,58,184,31.5,242,58,184,31.5
24020, 서구,095002, 91세,2018,175,35,140,25,175,35,140,25
24020, 서구,095003, 92세,2018,134,23,111,20.7,134,23,111,20.7
24020, 서구,095004, 93세,2018,103,18,85,21.2,103,18,85,21.2
24020, 서구,095005, 94세,2018,65,14,51,27.5,65,14,51,27.5
24020, 서구,100,95~99세,2018,178,20,158,12.7,177,20,157,12.7
24020, 서구,100001, 95세,2018,86,14,72,19.4,85,14,71,19.7
24020, 서구,100002, 96세,2018,37,X,35,5.7,37,X,35,5.7
24020, 서구,100003, 97세,2018,23,X,23,0,23,X,23,0
24020, 서구,100004, 98세,2018,17,X,15,13.3,17,X,15,13.3
24020, 서구,100005, 99세,2018,15,X,13,15.4,15,X,13,15.4
24020, 서구,101,100세이상,2018,24,X,21,14.3,24,X,21,14.3
24020, 서구,102,15세미만,2018,40032,20848,19184,108.7,39964,20809,19155,108.6
24020, 서구,103,15~64세,2018,223725,111719,112006,99.7,221619,110729,110890,99.9
24020, 서구,104,65세이상,2018,38432,16542,21890,75.6,38353,16509,21844,75.6
24020, 서구,086,85세이상,2018,3159,821,2338,35.1,3155,820,2335,35.1
24020, 서구,126,평균연령,2018,40.7,39.6,41.8,,40.7,39.6,41.8,
24020, 서구,127,중위연령,2018,41.9,40.6,43,,41.9,40.7,43.1,
24030, 남구,000,합계,2018,217345,105079,112266,93.6,215519,104369,111150,93.9
24030, 남구,005,0~4세,2018,7761,3972,3789,104.8,7734,3963,3771,105.1
24030, 남구,005001, 0세,2018,1204,618,586,105.5,1201,618,583,106
24030, 남구,005002, 1세,2018,1352,716,636,112.6,1341,712,629,113.2
24030, 남구,005003, 2세,2018,1537,764,773,98.8,1532,762,770,99
24030, 남구,005004, 3세,2018,1804,915,889,102.9,1801,914,887,103
24030, 남구,005005, 4세,2018,1864,959,905,106,1859,957,902,106.1
24030, 남구,010,5~9세,2018,10073,5154,4919,104.8,10061,5151,4910,104.9
24030, 남구,010001, 5세,2018,1850,937,913,102.6,1842,935,907,103.1
24030, 남구,010002, 6세,2018,2135,1120,1015,110.3,2133,1120,1013,110.6
24030, 남구,010003, 7세,2018,2062,1040,1022,101.8,2061,1039,1022,101.7
24030, 남구,010004, 8세,2018,2052,1046,1006,104,2051,1046,1005,104.1
24030, 남구,010005, 9세,2018,1974,1011,963,105,1974,1011,963,105
24030, 남구,015,10~14세,2018,10532,5354,5178,103.4,10515,5345,5170,103.4
24030, 남구,015001, 10세,2018,2060,1066,994,107.2,2056,1063,993,107
24030, 남구,015002, 11세,2018,2230,1118,1112,100.5,2228,1116,1112,100.4
24030, 남구,015003, 12세,2018,2054,1032,1022,101,2048,1030,1018,101.2
24030, 남구,015004, 13세,2018,2004,1019,985,103.5,2003,1018,985,103.4
24030, 남구,015005, 14세,2018,2184,1119,1065,105.1,2180,1118,1062,105.3
24030, 남구,020,15~19세,2018,13618,6859,6759,101.5,13538,6821,6717,101.5
24030, 남구,020001, 15세,2018,2212,1161,1051,110.5,2207,1160,1047,110.8
24030, 남구,020002, 16세,2018,2400,1221,1179,103.6,2398,1220,1178,103.6
24030, 남구,020003, 17세,2018,2808,1427,1381,103.3,2797,1423,1374,103.6
24030, 남구,020004, 18세,2018,3046,1519,1527,99.5,3024,1509,1515,99.6
24030, 남구,020005, 19세,2018,3152,1531,1621,94.4,3112,1509,1603,94.1
24030, 남구,025,20~24세,2018,16064,8218,7846,104.7,15714,8083,7631,105.9
24030, 남구,025001, 20세,2018,3298,1646,1652,99.6,3228,1619,1609,100.6
24030, 남구,025002, 21세,2018,3142,1602,1540,104,3082,1579,1503,105.1
24030, 남구,025003, 22세,2018,3281,1653,1628,101.5,3185,1606,1579,101.7
24030, 남구,025004, 23세,2018,3246,1635,1611,101.5,3186,1616,1570,102.9
24030, 남구,025005, 24세,2018,3097,1682,1415,118.9,3033,1663,1370,121.4
24030, 남구,030,25~29세,2018,12900,6590,6310,104.4,12647,6506,6141,105.9
24030, 남구,030001, 25세,2018,2952,1559,1393,111.9,2894,1537,1357,113.3
24030, 남구,030002, 26세,2018,2760,1385,1375,100.7,2705,1369,1336,102.5
24030, 남구,030003, 27세,2018,2567,1295,1272,101.8,2525,1282,1243,103.1
24030, 남구,030004, 28세,2018,2383,1176,1207,97.4,2324,1157,1167,99.1
24030, 남구,030005, 29세,2018,2238,1175,1063,110.5,2199,1161,1038,111.8
24030, 남구,035,30~34세,2018,11462,5671,5791,97.9,11225,5591,5634,99.2
24030, 남구,035001, 30세,2018,2124,1061,1063,99.8,2070,1048,1022,102.5
24030, 남구,035002, 31세,2018,2144,1059,1085,97.6,2101,1044,1057,98.8
24030, 남구,035003, 32세,2018,2248,1118,1130,98.9,2196,1096,1100,99.6
24030, 남구,035004, 33세,2018,2363,1152,1211,95.1,2317,1140,1177,96.9
24030, 남구,035005, 34세,2018,2583,1281,1302,98.4,2541,1263,1278,98.8
24030, 남구,040,35~39세,2018,15953,7856,8097,97,15796,7796,8000,97.5
24030, 남구,040001, 35세,2018,2951,1460,1491,97.9,2921,1449,1472,98.4
24030, 남구,040002, 36세,2018,3219,1566,1653,94.7,3191,1556,1635,95.2
24030, 남구,040003, 37세,2018,3285,1612,1673,96.4,3253,1600,1653,96.8
24030, 남구,040004, 38세,2018,3273,1622,1651,98.2,3238,1611,1627,99
24030, 남구,040005, 39세,2018,3225,1596,1629,98,3193,1580,1613,98
24030, 남구,045,40~44세,2018,15931,7898,8033,98.3,15778,7844,7934,98.9
24030, 남구,045001, 40세,2018,3001,1473,1528,96.4,2962,1457,1505,96.8
24030, 남구,045002, 41세,2018,3173,1551,1622,95.6,3146,1544,1602,96.4
24030, 남구,045003, 42세,2018,3117,1567,1550,101.1,3086,1558,1528,102
24030, 남구,045004, 43세,2018,3122,1530,1592,96.1,3097,1521,1576,96.5
24030, 남구,045005, 44세,2018,3518,1777,1741,102.1,3487,1764,1723,102.4
24030, 남구,050,45~49세,2018,18068,8831,9237,95.6,17915,8766,9149,95.8
24030, 남구,050001, 45세,2018,3518,1708,1810,94.4,3485,1692,1793,94.4
24030, 남구,050002, 46세,2018,3662,1841,1821,101.1,3624,1823,1801,101.2
24030, 남구,050003, 47세,2018,3790,1849,1941,95.3,3760,1837,1923,95.5
24030, 남구,050004, 48세,2018,3587,1690,1897,89.1,3561,1684,1877,89.7
24030, 남구,050005, 49세,2018,3511,1743,1768,98.6,3485,1730,1755,98.6
24030, 남구,055,50~54세,2018,17133,8211,8922,92,16959,8128,8831,92
24030, 남구,055001, 50세,2018,3727,1777,1950,91.1,3692,1760,1932,91.1
24030, 남구,055002, 51세,2018,3383,1627,1756,92.7,3353,1613,1740,92.7
24030, 남구,055003, 52세,2018,3466,1688,1778,94.9,3423,1670,1753,95.3
24030, 남구,055004, 53세,2018,3380,1601,1779,90,3350,1585,1765,89.8
24030, 남구,055005, 54세,2018,3177,1518,1659,91.5,3141,1500,1641,91.4
24030, 남구,060,55~59세,2018,18013,8477,9536,88.9,17901,8430,9471,89
24030, 남구,060001, 55세,2018,3460,1678,1782,94.2,3426,1669,1757,95
24030, 남구,060002, 56세,2018,3409,1587,1822,87.1,3393,1580,1813,87.1
24030, 남구,060003, 57세,2018,3678,1707,1971,86.6,3656,1698,1958,86.7
24030, 남구,060004, 58세,2018,3892,1809,2083,86.8,3871,1797,2074,86.6
24030, 남구,060005, 59세,2018,3574,1696,1878,90.3,3555,1686,1869,90.2
24030, 남구,065,60~64세,2018,14996,7070,7926,89.2,14935,7044,7891,89.3
24030, 남구,065001, 60세,2018,3374,1600,1774,90.2,3362,1594,1768,90.2
24030, 남구,065002, 61세,2018,3323,1552,1771,87.6,3309,1549,1760,88
24030, 남구,065003, 62세,2018,2847,1391,1456,95.5,2833,1384,1449,95.5
24030, 남구,065004, 63세,2018,2995,1380,1615,85.4,2983,1375,1608,85.5
24030, 남구,065005, 64세,2018,2457,1147,1310,87.6,2448,1142,1306,87.4
24030, 남구,070,65~69세,2018,11316,5266,6050,87,11292,5255,6037,87
24030, 남구,070001, 65세,2018,2292,1089,1203,90.5,2282,1084,1198,90.5
24030, 남구,070002, 66세,2018,2506,1184,1322,89.6,2500,1181,1319,89.5
24030, 남구,070003, 67세,2018,2068,938,1130,83,2064,937,1127,83.1
24030, 남구,070004, 68세,2018,2148,1002,1146,87.4,2146,1001,1145,87.4
24030, 남구,070005, 69세,2018,2302,1053,1249,84.3,2300,1052,1248,84.3
24030, 남구,075,70~74세,2018,8952,4129,4823,85.6,8944,4125,4819,85.6
24030, 남구,075001, 70세,2018,2089,966,1123,86,2089,966,1123,86
24030, 남구,075002, 71세,2018,2170,988,1182,83.6,2167,987,1180,83.6
24030, 남구,075003, 72세,2018,1604,745,859,86.7,1602,744,858,86.7
24030, 남구,075004, 73세,2018,1568,732,836,87.6,1566,731,835,87.5
24030, 남구,075005, 74세,2018,1521,698,823,84.8,1520,697,823,84.7
24030, 남구,080,75~79세,2018,7273,3195,4078,78.3,7269,3194,4075,78.4
24030, 남구,080001, 75세,2018,1464,667,797,83.7,1463,666,797,83.6
24030, 남구,080002, 76세,2018,1866,870,996,87.3,1866,870,996,87.3
24030, 남구,080003, 77세,2018,1449,599,850,70.5,1448,599,849,70.6
24030, 남구,080004, 78세,2018,1281,529,752,70.3,1279,529,750,70.5
24030, 남구,080005, 79세,2018,1213,530,683,77.6,1213,530,683,77.6
24030, 남구,085,80~84세,2018,4374,1556,2818,55.2,4372,1556,2816,55.3
24030, 남구,085001, 80세,2018,1095,428,667,64.2,1094,428,666,64.3
24030, 남구,085002, 81세,2018,1000,358,642,55.8,1000,358,642,55.8
24030, 남구,085003, 82세,2018,803,297,506,58.7,803,297,506,58.7
24030, 남구,085004, 83세,2018,763,246,517,47.6,762,246,516,47.7
24030, 남구,085005, 84세,2018,713,227,486,46.7,713,227,486,46.7
24030, 남구,090,85~89세,2018,2045,600,1445,41.5,2044,599,1445,41.5
24030, 남구,090001, 85세,2018,549,178,371,48,548,177,371,47.7
24030, 남구,090002, 86세,2018,480,152,328,46.3,480,152,328,46.3
24030, 남구,090003, 87세,2018,353,84,269,31.2,353,84,269,31.2
24030, 남구,090004, 88세,2018,383,108,275,39.3,383,108,275,39.3
24030, 남구,090005, 89세,2018,280,78,202,38.6,280,78,202,38.6
24030, 남구,095,90~94세,2018,676,141,535,26.4,675,141,534,26.4
24030, 남구,095001, 90세,2018,205,44,161,27.3,205,44,161,27.3
24030, 남구,095002, 91세,2018,186,35,151,23.2,186,35,151,23.2
24030, 남구,095003, 92세,2018,129,33,96,34.4,129,33,96,34.4
24030, 남구,095004, 93세,2018,98,17,81,21,97,17,80,21.3
24030, 남구,095005, 94세,2018,58,12,46,26.1,58,12,46,26.1
24030, 남구,100,95~99세,2018,187,30,157,19.1,187,30,157,19.1
24030, 남구,100001, 95세,2018,76,12,64,18.8,76,12,64,18.8
24030, 남구,100002, 96세,2018,45,9,36,25,45,9,36,25
24030, 남구,100003, 97세,2018,29,5,24,20.8,29,5,24,20.8
24030, 남구,100004, 98세,2018,20,X,19,5.3,20,X,19,5.3
24030, 남구,100005, 99세,2018,17,X,14,21.4,17,X,14,21.4
24030, 남구,101,100세이상,2018,18,X,17,5.9,18,X,17,5.9
24030, 남구,102,15세미만,2018,28366,14480,13886,104.3,28310,14459,13851,104.4
24030, 남구,103,15~64세,2018,154138,75681,78457,96.5,152408,75009,77399,96.9
24030, 남구,104,65세이상,2018,34841,14918,19923,74.9,34801,14901,19900,74.9
24030, 남구,086,85세이상,2018,2926,772,2154,35.8,2924,771,2153,35.8
24030, 남구,126,평균연령,2018,42.1,40.9,43.3,,42.2,40.9,43.4,
24030, 남구,127,중위연령,2018,43.3,41.9,44.7,,43.4,42,44.8,
24040, 북구,000,합계,2018,450023,224400,225623,99.5,443928,221455,222473,99.5
24040, 북구,005,0~4세,2018,17504,8945,8559,104.5,17396,8889,8507,104.5
24040, 북구,005001, 0세,2018,2951,1546,1405,110,2926,1528,1398,109.3
24040, 북구,005002, 1세,2018,3200,1662,1538,108.1,3170,1649,1521,108.4
24040, 북구,005003, 2세,2018,3689,1856,1833,101.3,3670,1848,1822,101.4
24040, 북구,005004, 3세,2018,3856,1991,1865,106.8,3838,1982,1856,106.8
24040, 북구,005005, 4세,2018,3808,1890,1918,98.5,3792,1882,1910,98.5
24040, 북구,010,5~9세,2018,19765,10296,9469,108.7,19713,10276,9437,108.9
24040, 북구,010001, 5세,2018,3738,1981,1757,112.7,3731,1980,1751,113.1
24040, 북구,010002, 6세,2018,4196,2159,2037,106,4180,2153,2027,106.2
24040, 북구,010003, 7세,2018,4043,2079,1964,105.9,4027,2069,1958,105.7
24040, 북구,010004, 8세,2018,3909,2006,1903,105.4,3903,2004,1899,105.5
24040, 북구,010005, 9세,2018,3879,2071,1808,114.5,3872,2070,1802,114.9
24040, 북구,015,10~14세,2018,20272,10693,9579,111.6,20253,10686,9567,111.7
24040, 북구,015001, 10세,2018,4022,2115,1907,110.9,4015,2113,1902,111.1
24040, 북구,015002, 11세,2018,4210,2236,1974,113.3,4210,2236,1974,113.3
24040, 북구,015003, 12세,2018,3864,2019,1845,109.4,3859,2018,1841,109.6
24040, 북구,015004, 13세,2018,3887,2054,1833,112.1,3883,2052,1831,112.1
24040, 북구,015005, 14세,2018,4289,2269,2020,112.3,4286,2267,2019,112.3
24040, 북구,020,15~19세,2018,27928,14545,13383,108.7,27698,14434,13264,108.8
24040, 북구,020001, 15세,2018,4631,2451,2180,112.4,4629,2451,2178,112.5
24040, 북구,020002, 16세,2018,4711,2433,2278,106.8,4707,2432,2275,106.9
24040, 북구,020003, 17세,2018,5534,2936,2598,113,5524,2930,2594,113
24040, 북구,020004, 18세,2018,6383,3332,3051,109.2,6319,3306,3013,109.7
24040, 북구,020005, 19세,2018,6669,3393,3276,103.6,6519,3315,3204,103.5
24040, 북구,025,20~24세,2018,37275,19513,17762,109.9,35932,18838,17094,110.2
24040, 북구,025001, 20세,2018,7097,3573,3524,101.4,6876,3459,3417,101.2
24040, 북구,025002, 21세,2018,7505,3840,3665,104.8,7219,3693,3526,104.7
24040, 북구,025003, 22세,2018,7666,4046,3620,111.8,7390,3903,3487,111.9
24040, 북구,025004, 23세,2018,7603,4002,3601,111.1,7351,3879,3472,111.7
24040, 북구,025005, 24세,2018,7404,4052,3352,120.9,7096,3904,3192,122.3
24040, 북구,030,25~29세,2018,31807,16822,14985,112.3,30530,16204,14326,113.1
24040, 북구,030001, 25세,2018,7104,3817,3287,116.1,6825,3685,3140,117.4
24040, 북구,030002, 26세,2018,7042,3779,3263,115.8,6793,3646,3147,115.9
24040, 북구,030003, 27세,2018,6212,3283,2929,112.1,5960,3162,2798,113
24040, 북구,030004, 28세,2018,5894,3112,2782,111.9,5650,2988,2662,112.2
24040, 북구,030005, 29세,2018,5555,2831,2724,103.9,5302,2723,2579,105.6
24040, 북구,035,30~34세,2018,27867,14491,13376,108.3,27026,14078,12948,108.7
24040, 북구,035001, 30세,2018,5476,2829,2647,106.9,5281,2726,2555,106.7
24040, 북구,035002, 31세,2018,5436,2738,2698,101.5,5242,2650,2592,102.2
24040, 북구,035003, 32세,2018,5454,2834,2620,108.2,5278,2745,2533,108.4
24040, 북구,035004, 33세,2018,5501,2900,2601,111.5,5344,2828,2516,112.4
24040, 북구,035005, 34세,2018,6000,3190,2810,113.5,5881,3129,2752,113.7
24040, 북구,040,35~39세,2018,34111,17518,16593,105.6,33540,17239,16301,105.8
24040, 북구,040001, 35세,2018,6551,3433,3118,110.1,6415,3377,3038,111.2
24040, 북구,040002, 36세,2018,7047,3673,3374,108.9,6906,3595,3311,108.6
24040, 북구,040003, 37세,2018,6725,3407,3318,102.7,6625,3357,3268,102.7
24040, 북구,040004, 38세,2018,6952,3555,3397,104.7,6861,3512,3349,104.9
24040, 북구,040005, 39세,2018,6836,3450,3386,101.9,6733,3398,3335,101.9
24040, 북구,045,40~44세,2018,32948,16775,16173,103.7,32569,16604,15965,104
24040, 북구,045001, 40세,2018,6241,3181,3060,104,6160,3139,3021,103.9
24040, 북구,045002, 41세,2018,6314,3141,3173,99,6239,3108,3131,99.3
24040, 북구,045003, 42세,2018,6350,3261,3089,105.6,6277,3227,3050,105.8
24040, 북구,045004, 43세,2018,6538,3324,3214,103.4,6457,3290,3167,103.9
24040, 북구,045005, 44세,2018,7505,3868,3637,106.4,7436,3840,3596,106.8
24040, 북구,050,45~49세,2018,38010,18740,19270,97.2,37614,18548,19066,97.3
24040, 북구,050001, 45세,2018,7221,3571,3650,97.8,7138,3530,3608,97.8
24040, 북구,050002, 46세,2018,7482,3677,3805,96.6,7386,3630,3756,96.6
24040, 북구,050003, 47세,2018,7902,3899,4003,97.4,7825,3857,3968,97.2
24040, 북구,050004, 48세,2018,7744,3786,3958,95.7,7676,3757,3919,95.9
24040, 북구,050005, 49세,2018,7661,3807,3854,98.8,7589,3774,3815,98.9
24040, 북구,055,50~54세,2018,37487,18454,19033,97,37112,18296,18816,97.2
24040, 북구,055001, 50세,2018,8116,3990,4126,96.7,8036,3960,4076,97.2
24040, 북구,055002, 51세,2018,7516,3623,3893,93.1,7446,3595,3851,93.4
24040, 북구,055003, 52세,2018,7523,3795,3728,101.8,7457,3761,3696,101.8
24040, 북구,055004, 53세,2018,7359,3586,3773,95,7279,3556,3723,95.5
24040, 북구,055005, 54세,2018,6973,3460,3513,98.5,6894,3424,3470,98.7
24040, 북구,060,55~59세,2018,37707,18361,19346,94.9,37462,18249,19213,95
24040, 북구,060001, 55세,2018,7382,3609,3773,95.7,7316,3583,3733,96
24040, 북구,060002, 56세,2018,7105,3536,3569,99.1,7039,3503,3536,99.1
24040, 북구,060003, 57세,2018,7764,3766,3998,94.2,7726,3752,3974,94.4
24040, 북구,060004, 58세,2018,8213,3961,4252,93.2,8167,3939,4228,93.2
24040, 북구,060005, 59세,2018,7243,3489,3754,92.9,7214,3472,3742,92.8
24040, 북구,065,60~64세,2018,27964,13643,14321,95.3,27828,13567,14261,95.1
24040, 북구,065001, 60세,2018,6280,3037,3243,93.6,6244,3018,3226,93.6
24040, 북구,065002, 61세,2018,6115,2996,3119,96.1,6098,2984,3114,95.8
24040, 북구,065003, 62세,2018,5325,2655,2670,99.4,5303,2646,2657,99.6
24040, 북구,065004, 63세,2018,5660,2723,2937,92.7,5628,2704,2924,92.5
24040, 북구,065005, 64세,2018,4584,2232,2352,94.9,4555,2215,2340,94.7
24040, 북구,070,65~69세,2018,19769,9480,10289,92.1,19702,9448,10254,92.1
24040, 북구,070001, 65세,2018,3950,1876,2074,90.5,3938,1870,2068,90.4
24040, 북구,070002, 66세,2018,4420,2116,2304,91.8,4403,2107,2296,91.8
24040, 북구,070003, 67세,2018,3691,1799,1892,95.1,3678,1793,1885,95.1
24040, 북구,070004, 68세,2018,3822,1856,1966,94.4,3812,1853,1959,94.6
24040, 북구,070005, 69세,2018,3886,1833,2053,89.3,3871,1825,2046,89.2
24040, 북구,075,70~74세,2018,15144,7030,8114,86.6,15117,7019,8098,86.7
24040, 북구,075001, 70세,2018,3612,1721,1891,91,3606,1719,1887,91.1
24040, 북구,075002, 71세,2018,3592,1697,1895,89.6,3583,1693,1890,89.6
24040, 북구,075003, 72세,2018,2762,1314,1448,90.7,2758,1311,1447,90.6
24040, 북구,075004, 73세,2018,2678,1180,1498,78.8,2675,1179,1496,78.8
24040, 북구,075005, 74세,2018,2500,1118,1382,80.9,2495,1117,1378,81.1
24040, 북구,080,75~79세,2018,12222,5234,6988,74.9,12207,5227,6980,74.9
24040, 북구,080001, 75세,2018,2517,1113,1404,79.3,2515,1112,1403,79.3
24040, 북구,080002, 76세,2018,3262,1484,1778,83.5,3257,1481,1776,83.4
24040, 북구,080003, 77세,2018,2369,982,1387,70.8,2365,981,1384,70.9
24040, 북구,080004, 78세,2018,2075,820,1255,65.3,2073,819,1254,65.3
24040, 북구,080005, 79세,2018,1999,835,1164,71.7,1997,834,1163,71.7
24040, 북구,085,80~84세,2018,7343,2641,4702,56.2,7334,2637,4697,56.1
24040, 북구,085001, 80세,2018,1803,708,1095,64.7,1799,705,1094,64.4
24040, 북구,085002, 81세,2018,1614,617,997,61.9,1613,617,996,61.9
24040, 북구,085003, 82세,2018,1376,487,889,54.8,1375,487,888,54.8
24040, 북구,085004, 83세,2018,1335,430,905,47.5,1333,429,904,47.5
24040, 북구,085005, 84세,2018,1215,399,816,48.9,1214,399,815,49
24040, 북구,090,85~89세,2018,3469,930,2539,36.6,3465,927,2538,36.5
24040, 북구,090001, 85세,2018,922,274,648,42.3,921,273,648,42.1
24040, 북구,090002, 86세,2018,784,234,550,42.5,782,232,550,42.2
24040, 북구,090003, 87세,2018,663,165,498,33.1,662,165,497,33.2
24040, 북구,090004, 88세,2018,646,141,505,27.9,646,141,505,27.9
24040, 북구,090005, 89세,2018,454,116,338,34.3,454,116,338,34.3
24040, 북구,095,90~94세,2018,1115,236,879,26.8,1114,236,878,26.9
24040, 북구,095001, 90세,2018,382,85,297,28.6,382,85,297,28.6
24040, 북구,095002, 91세,2018,293,58,235,24.7,292,58,234,24.8
24040, 북구,095003, 92세,2018,211,44,167,26.3,211,44,167,26.3
24040, 북구,095004, 93세,2018,151,33,118,28,151,33,118,28
24040, 북구,095005, 94세,2018,78,16,62,25.8,78,16,62,25.8
24040, 북구,100,95~99세,2018,287,51,236,21.6,287,51,236,21.6
24040, 북구,100001, 95세,2018,106,22,84,26.2,106,22,84,26.2
24040, 북구,100002, 96세,2018,77,13,64,20.3,77,13,64,20.3
24040, 북구,100003, 97세,2018,53,6,47,12.8,53,6,47,12.8
24040, 북구,100004, 98세,2018,34,X,30,13.3,34,X,30,13.3
24040, 북구,100005, 99세,2018,17,6,11,54.5,17,6,11,54.5
24040, 북구,101,100세이상,2018,29,X,27,7.4,29,X,27,7.4
24040, 북구,102,15세미만,2018,57541,29934,27607,108.4,57362,29851,27511,108.5
24040, 북구,103,15~64세,2018,333104,168862,164242,102.8,327311,166057,161254,103
24040, 북구,104,65세이상,2018,59378,25604,33774,75.8,59255,25547,33708,75.8
24040, 북구,086,85세이상,2018,4900,1219,3681,33.1,4895,1216,3679,33.1
24040, 북구,126,평균연령,2018,40.8,39.6,41.9,,40.9,39.6,42.1,
24040, 북구,127,중위연령,2018,41.4,39.8,42.9,,41.6,40,43.2,
24050, 광산구,000,합계,2018,420665,213198,207467,102.8,403223,202498,200725,100.9
24050, 광산구,005,0~4세,2018,19919,10202,9717,105,19605,10043,9562,105
24050, 광산구,005001, 0세,2018,3090,1594,1496,106.6,3030,1561,1469,106.3
24050, 광산구,005002, 1세,2018,3544,1805,1739,103.8,3478,1774,1704,104.1
24050, 광산구,005003, 2세,2018,4255,2179,2076,105,4191,2147,2044,105
24050, 광산구,005004, 3세,2018,4435,2280,2155,105.8,4375,2247,2128,105.6
24050, 광산구,005005, 4세,2018,4595,2344,2251,104.1,4531,2314,2217,104.4
24050, 광산구,010,5~9세,2018,25698,13175,12523,105.2,25451,13055,12396,105.3
24050, 광산구,010001, 5세,2018,4777,2436,2341,104.1,4719,2408,2311,104.2
24050, 광산구,010002, 6세,2018,5420,2824,2596,108.8,5363,2796,2567,108.9
24050, 광산구,010003, 7세,2018,5238,2743,2495,109.9,5192,2716,2476,109.7
24050, 광산구,010004, 8세,2018,5205,2652,2553,103.9,5156,2630,2526,104.1
24050, 광산구,010005, 9세,2018,5058,2520,2538,99.3,5021,2505,2516,99.6
24050, 광산구,015,10~14세,2018,26045,13404,12641,106,25850,13304,12546,106
24050, 광산구,015001, 10세,2018,5289,2725,2564,106.3,5251,2708,2543,106.5
24050, 광산구,015002, 11세,2018,5543,2871,2672,107.4,5506,2856,2650,107.8
24050, 광산구,015003, 12세,2018,5062,2603,2459,105.9,5010,2576,2434,105.8
24050, 광산구,015004, 13세,2018,4926,2523,2403,105,4893,2504,2389,104.8
24050, 광산구,015005, 14세,2018,5225,2682,2543,105.5,5190,2660,2530,105.1
24050, 광산구,020,15~19세,2018,29991,15207,14784,102.9,29426,14924,14502,102.9
24050, 광산구,020001, 15세,2018,5495,2851,2644,107.8,5457,2834,2623,108
24050, 광산구,020002, 16세,2018,5161,2635,2526,104.3,5125,2613,2512,104
24050, 광산구,020003, 17세,2018,5980,3075,2905,105.9,5921,3040,2881,105.5
24050, 광산구,020004, 18세,2018,6785,3436,3349,102.6,6655,3379,3276,103.1
24050, 광산구,020005, 19세,2018,6570,3210,3360,95.5,6268,3058,3210,95.3
24050, 광산구,025,20~24세,2018,33627,17483,16144,108.3,30616,15597,15019,103.8
24050, 광산구,025001, 20세,2018,6938,3463,3475,99.7,6491,3203,3288,97.4
24050, 광산구,025002, 21세,2018,7072,3546,3526,100.6,6500,3216,3284,97.9
24050, 광산구,025003, 22세,2018,6824,3508,3316,105.8,6195,3133,3062,102.3
24050, 광산구,025004, 23세,2018,6392,3421,2971,115.1,5731,2990,2741,109.1
24050, 광산구,025005, 24세,2018,6401,3545,2856,124.1,5699,3055,2644,115.5
24050, 광산구,030,25~29세,2018,27587,15039,12548,119.9,24202,12808,11394,112.4
24050, 광산구,030001, 25세,2018,6169,3423,2746,124.7,5474,2954,2520,117.2
24050, 광산구,030002, 26세,2018,5962,3323,2639,125.9,5257,2840,2417,117.5
24050, 광산구,030003, 27세,2018,5477,2942,2535,116.1,4807,2516,2291,109.8
24050, 광산구,030004, 28세,2018,5084,2739,2345,116.8,4416,2315,2101,110.2
24050, 광산구,030005, 29세,2018,4895,2612,2283,114.4,4248,2183,2065,105.7
24050, 광산구,035,30~34세,2018,26603,13939,12664,110.1,23766,12085,11681,103.5
24050, 광산구,035001, 30세,2018,4755,2507,2248,111.5,4145,2106,2039,103.3
24050, 광산구,035002, 31세,2018,5224,2821,2403,117.4,4577,2391,2186,109.4
24050, 광산구,035003, 32세,2018,5229,2684,2545,105.5,4701,2346,2355,99.6
24050, 광산구,035004, 33세,2018,5349,2804,2545,110.2,4802,2440,2362,103.3
24050, 광산구,035005, 34세,2018,6046,3123,2923,106.8,5541,2802,2739,102.3
24050, 광산구,040,35~39세,2018,37928,19065,18863,101.1,35807,17698,18109,97.7
24050, 광산구,040001, 35세,2018,6707,3467,3240,107,6225,3148,3077,102.3
24050, 광산구,040002, 36세,2018,7849,3969,3880,102.3,7370,3655,3715,98.4
24050, 광산구,040003, 37세,2018,7434,3771,3663,102.9,7020,3502,3518,99.5
24050, 광산구,040004, 38세,2018,8029,3964,4065,97.5,7622,3710,3912,94.8
24050, 광산구,040005, 39세,2018,7909,3894,4015,97,7570,3683,3887,94.8
24050, 광산구,045,40~44세,2018,38768,19453,19315,100.7,37205,18501,18704,98.9
24050, 광산구,045001, 40세,2018,7152,3567,3585,99.5,6775,3337,3438,97.1
24050, 광산구,045002, 41세,2018,7719,3873,3846,100.7,7408,3671,3737,98.2
24050, 광산구,045003, 42세,2018,7564,3814,3750,101.7,7270,3626,3644,99.5
24050, 광산구,045004, 43세,2018,7749,3875,3874,100,7454,3704,3750,98.8
24050, 광산구,045005, 44세,2018,8584,4324,4260,101.5,8298,4163,4135,100.7
24050, 광산구,050,45~49세,2018,41579,21514,20065,107.2,40349,20770,19579,106.1
24050, 광산구,050001, 45세,2018,8570,4315,4255,101.4,8324,4165,4159,100.1
24050, 광산구,050002, 46세,2018,8395,4369,4026,108.5,8101,4188,3913,107
24050, 광산구,050003, 47세,2018,8704,4500,4204,107,8464,4349,4115,105.7
24050, 광산구,050004, 48세,2018,8160,4302,3858,111.5,7923,4166,3757,110.9
24050, 광산구,050005, 49세,2018,7750,4028,3722,108.2,7537,3902,3635,107.3
24050, 광산구,055,50~54세,2018,33503,17414,16089,108.2,32664,16970,15694,108.1
24050, 광산구,055001, 50세,2018,7812,3931,3881,101.3,7623,3828,3795,100.9
24050, 광산구,055002, 51세,2018,6830,3555,3275,108.5,6675,3476,3199,108.7
24050, 광산구,055003, 52세,2018,6803,3558,3245,109.6,6624,3467,3157,109.8
24050, 광산구,055004, 53세,2018,6443,3343,3100,107.8,6288,3249,3039,106.9
24050, 광산구,055005, 54세,2018,5615,3027,2588,117,5454,2950,2504,117.8
24050, 광산구,060,55~59세,2018,26940,14500,12440,116.6,26395,14214,12181,116.7
24050, 광산구,060001, 55세,2018,5872,3232,2640,122.4,5741,3163,2578,122.7
24050, 광산구,060002, 56세,2018,5352,2950,2402,122.8,5233,2892,2341,123.5
24050, 광산구,060003, 57세,2018,5507,2976,2531,117.6,5416,2924,2492,117.3
24050, 광산구,060004, 58세,2018,5510,2879,2631,109.4,5392,2814,2578,109.2
24050, 광산구,060005, 59세,2018,4699,2463,2236,110.2,4613,2421,2192,110.4
24050, 광산구,065,60~64세,2018,17107,8672,8435,102.8,16742,8485,8257,102.8
24050, 광산구,065001, 60세,2018,4127,2134,1993,107.1,4030,2083,1947,107
24050, 광산구,065002, 61세,2018,3847,1968,1879,104.7,3770,1928,1842,104.7
24050, 광산구,065003, 62세,2018,3217,1629,1588,102.6,3136,1588,1548,102.6
24050, 광산구,065004, 63세,2018,3292,1635,1657,98.7,3230,1603,1627,98.5
24050, 광산구,065005, 64세,2018,2624,1306,1318,99.1,2576,1283,1293,99.2
24050, 광산구,070,65~69세,2018,11009,5169,5840,88.5,10875,5114,5761,88.8
24050, 광산구,070001, 65세,2018,2304,1095,1209,90.6,2268,1076,1192,90.3
24050, 광산구,070002, 66세,2018,2421,1170,1251,93.5,2384,1156,1228,94.1
24050, 광산구,070003, 67세,2018,2056,943,1113,84.7,2036,937,1099,85.3
24050, 광산구,070004, 68세,2018,2066,963,1103,87.3,2043,956,1087,87.9
24050, 광산구,070005, 69세,2018,2162,998,1164,85.7,2144,989,1155,85.6
24050, 광산구,075,70~74세,2018,8662,3908,4754,82.2,8607,3888,4719,82.4
24050, 광산구,075001, 70세,2018,2009,936,1073,87.2,1992,929,1063,87.4
24050, 광산구,075002, 71세,2018,2110,941,1169,80.5,2093,934,1159,80.6
24050, 광산구,075003, 72세,2018,1645,785,860,91.3,1639,784,855,91.7
24050, 광산구,075004, 73세,2018,1473,642,831,77.3,1465,640,825,77.6
24050, 광산구,075005, 74세,2018,1425,604,821,73.6,1418,601,817,73.6
24050, 광산구,080,75~79세,2018,7463,2849,4614,61.7,7443,2841,4602,61.7
24050, 광산구,080001, 75세,2018,1470,613,857,71.5,1462,609,853,71.4
24050, 광산구,080002, 76세,2018,1952,780,1172,66.6,1949,780,1169,66.7
24050, 광산구,080003, 77세,2018,1485,552,933,59.2,1482,550,932,59
24050, 광산구,080004, 78세,2018,1302,456,846,53.9,1298,455,843,54
24050, 광산구,080005, 79세,2018,1254,448,806,55.6,1252,447,805,55.5
24050, 광산구,085,80~84세,2018,4866,1520,3346,45.4,4854,1516,3338,45.4
24050, 광산구,085001, 80세,2018,1161,396,765,51.8,1155,394,761,51.8
24050, 광산구,085002, 81세,2018,1088,351,737,47.6,1087,351,736,47.7
24050, 광산구,085003, 82세,2018,891,262,629,41.7,888,261,627,41.6
24050, 광산구,085004, 83세,2018,946,289,657,44,945,289,656,44.1
24050, 광산구,085005, 84세,2018,780,222,558,39.8,779,221,558,39.6
24050, 광산구,090,85~89세,2018,2349,521,1828,28.5,2346,521,1825,28.5
24050, 광산구,090001, 85세,2018,594,152,442,34.4,593,152,441,34.5
24050, 광산구,090002, 86세,2018,528,131,397,33,527,131,396,33.1
24050, 광산구,090003, 87세,2018,431,89,342,26,431,89,342,26
24050, 광산구,090004, 88세,2018,461,83,378,22,461,83,378,22
24050, 광산구,090005, 89세,2018,335,66,269,24.5,334,66,268,24.6
24050, 광산구,095,90~94세,2018,792,140,652,21.5,791,140,651,21.5
24050, 광산구,095001, 90세,2018,272,56,216,25.9,271,56,215,26
24050, 광산구,095002, 91세,2018,179,31,148,20.9,179,31,148,20.9
24050, 광산구,095003, 92세,2018,135,22,113,19.5,135,22,113,19.5
24050, 광산구,095004, 93세,2018,142,17,125,13.6,142,17,125,13.6
24050, 광산구,095005, 94세,2018,64,14,50,28,64,14,50,28
24050, 광산구,100,95~99세,2018,209,22,187,11.8,209,22,187,11.8
24050, 광산구,100001, 95세,2018,93,9,84,10.7,93,9,84,10.7
24050, 광산구,100002, 96세,2018,60,9,51,17.6,60,9,51,17.6
24050, 광산구,100003, 97세,2018,31,X,27,14.8,31,X,27,14.8
24050, 광산구,100004, 98세,2018,19,X,19,0,19,X,19,0
24050, 광산구,100005, 99세,2018,6,X,6,0,6,X,6,0
24050, 광산구,101,100세이상,2018,20,X,18,11.1,20,X,18,11.1
24050, 광산구,102,15세미만,2018,71662,36781,34881,105.4,70906,36402,34504,105.5
24050, 광산구,103,15~64세,2018,313633,162286,151347,107.2,297172,152052,145120,104.8
24050, 광산구,104,65세이상,2018,35370,14131,21239,66.5,35145,14044,21101,66.6
24050, 광산구,086,85세이상,2018,3370,685,2685,25.5,3366,685,2681,25.6
24050, 광산구,126,평균연령,2018,36.9,36.1,37.8,,37.1,36.3,37.9,
24050, 광산구,127,중위연령,2018,37.8,37.2,38.5,,38.3,37.8,38.8,
25,대전광역시,000,합계,2018,1511214,758035,753179,100.6,1488356,747076,741280,100.8
25,대전광역시,005,0~4세,2018,59396,30594,28802,106.2,58893,30335,28558,106.2
25,대전광역시,005001, 0세,2018,9599,4892,4707,103.9,9489,4827,4662,103.5
25,대전광역시,005002, 1세,2018,11062,5648,5414,104.3,10944,5595,5349,104.6
25,대전광역시,005003, 2세,2018,12480,6529,5951,109.7,12371,6469,5902,109.6
25,대전광역시,005004, 3세,2018,13316,6823,6493,105.1,13223,6779,6444,105.2
25,대전광역시,005005, 4세,2018,12939,6702,6237,107.5,12866,6665,6201,107.5
25,대전광역시,010,5~9세,2018,68890,35427,33463,105.9,68636,35299,33337,105.9
25,대전광역시,010001, 5세,2018,13487,6861,6626,103.5,13421,6827,6594,103.5
25,대전광역시,010002, 6세,2018,14165,7377,6788,108.7,14111,7353,6758,108.8
25,대전광역시,010003, 7세,2018,14320,7349,6971,105.4,14269,7322,6947,105.4
25,대전광역시,010004, 8세,2018,13637,6982,6655,104.9,13599,6963,6636,104.9
25,대전광역시,010005, 9세,2018,13281,6858,6423,106.8,13236,6834,6402,106.7
25,대전광역시,015,10~14세,2018,71056,36792,34264,107.4,70916,36718,34198,107.4
25,대전광역시,015001, 10세,2018,14164,7268,6896,105.4,14128,7248,6880,105.3
25,대전광역시,015002, 11세,2018,14803,7563,7240,104.5,14765,7548,7217,104.6
25,대전광역시,015003, 12세,2018,13605,7063,6542,108,13579,7052,6527,108
25,대전광역시,015004, 13세,2018,13459,7043,6416,109.8,13433,7024,6409,109.6
25,대전광역시,015005, 14세,2018,15025,7855,7170,109.6,15011,7846,7165,109.5
25,대전광역시,020,15~19세,2018,95355,49889,45466,109.7,94176,49284,44892,109.8
25,대전광역시,020001, 15세,2018,15110,7749,7361,105.3,15077,7732,7345,105.3
25,대전광역시,020002, 16세,2018,15500,8216,7284,112.8,15472,8204,7268,112.9
25,대전광역시,020003, 17세,2018,17951,9454,8497,111.3,17878,9409,8469,111.1
25,대전광역시,020004, 18세,2018,21560,11364,10196,111.5,21247,11183,10064,111.1
25,대전광역시,020005, 19세,2018,25234,13106,12128,108.1,24502,12756,11746,108.6
25,대전광역시,025,20~24세,2018,127118,67257,59861,112.4,121799,64753,57046,113.5
25,대전광역시,025001, 20세,2018,24631,12359,12272,100.7,23552,11844,11708,101.2
25,대전광역시,025002, 21세,2018,25075,12403,12672,97.9,23885,11852,12033,98.5
25,대전광역시,025003, 22세,2018,26010,13689,12321,111.1,24903,13145,11758,111.8
25,대전광역시,025004, 23세,2018,26034,14549,11485,126.7,25005,14069,10936,128.6
25,대전광역시,025005, 24세,2018,25368,14257,11111,128.3,24454,13843,10611,130.5
25,대전광역시,030,25~29세,2018,109138,59465,49673,119.7,105447,57750,47697,121.1
25,대전광역시,030001, 25세,2018,24132,13449,10683,125.9,23326,13077,10249,127.6
25,대전광역시,030002, 26세,2018,23553,12768,10785,118.4,22808,12433,10375,119.8
25,대전광역시,030003, 27세,2018,21545,11521,10024,114.9,20841,11181,9660,115.7
25,대전광역시,030004, 28세,2018,20419,11149,9270,120.3,19722,10833,8889,121.9
25,대전광역시,030005, 29세,2018,19489,10578,8911,118.7,18750,10226,8524,120
25,대전광역시,035,30~34세,2018,95251,49924,45327,110.1,92226,48479,43747,110.8
25,대전광역시,035001, 30세,2018,19062,10248,8814,116.3,18368,9915,8453,117.3
25,대전광역시,035002, 31세,2018,18726,9782,8944,109.4,18099,9475,8624,109.9
25,대전광역시,035003, 32세,2018,18987,9959,9028,110.3,18355,9662,8693,111.1
25,대전광역시,035004, 33세,2018,19086,9937,9149,108.6,18538,9683,8855,109.4
25,대전광역시,035005, 34세,2018,19390,9998,9392,106.5,18866,9744,9122,106.8
25,대전광역시,040,35~39세,2018,115195,58223,56972,102.2,112989,57163,55826,102.4
25,대전광역시,040001, 35세,2018,21580,11055,10525,105,21120,10835,10285,105.3
25,대전광역시,040002, 36세,2018,23354,11798,11556,102.1,22867,11566,11301,102.3
25,대전광역시,040003, 37세,2018,23655,11978,11677,102.6,23194,11758,11436,102.8
25,대전광역시,040004, 38세,2018,23928,12047,11881,101.4,23504,11839,11665,101.5
25,대전광역시,040005, 39세,2018,22678,11345,11333,100.1,22304,11165,11139,100.2
25,대전광역시,045,40~44세,2018,114245,56910,57335,99.3,112684,56119,56565,99.2
25,대전광역시,045001, 40세,2018,21571,10755,10816,99.4,21231,10568,10663,99.1
25,대전광역시,045002, 41세,2018,22217,11019,11198,98.4,21893,10855,11038,98.3
25,대전광역시,045003, 42세,2018,21949,10928,11021,99.2,21638,10778,10860,99.2
25,대전광역시,045004, 43세,2018,23085,11499,11586,99.2,22806,11362,11444,99.3
25,대전광역시,045005, 44세,2018,25423,12709,12714,100,25116,12556,12560,100
25,대전광역시,050,45~49세,2018,132763,66216,66547,99.5,131208,65439,65769,99.5
25,대전광역시,050001, 45세,2018,25912,12766,13146,97.1,25623,12613,13010,96.9
25,대전광역시,050002, 46세,2018,25310,12745,12565,101.4,24999,12591,12408,101.5
25,대전광역시,050003, 47세,2018,27739,13884,13855,100.2,27406,13724,13682,100.3
25,대전광역시,050004, 48세,2018,26257,13176,13081,100.7,25932,13019,12913,100.8
25,대전광역시,050005, 49세,2018,27545,13645,13900,98.2,27248,13492,13756,98.1
25,대전광역시,055,50~54세,2018,119473,59413,60060,98.9,118247,58815,59432,99
25,대전광역시,055001, 50세,2018,27296,13412,13884,96.6,27020,13268,13752,96.5
25,대전광역시,055002, 51세,2018,24107,11891,12216,97.3,23866,11780,12086,97.5
25,대전광역시,055003, 52세,2018,22509,11449,11060,103.5,22255,11324,10931,103.6
25,대전광역시,055004, 53세,2018,23669,11740,11929,98.4,23443,11633,11810,98.5
25,대전광역시,055005, 54세,2018,21892,10921,10971,99.5,21663,10810,10853,99.6
25,대전광역시,060,55~59세,2018,120602,59583,61019,97.6,119675,59156,60519,97.7
25,대전광역시,060001, 55세,2018,22395,11330,11065,102.4,22126,11197,10929,102.5
25,대전광역시,060002, 56세,2018,24174,12111,12063,100.4,23993,12032,11961,100.6
25,대전광역시,060003, 57세,2018,26450,13004,13446,96.7,26301,12940,13361,96.8
25,대전광역시,060004, 58세,2018,25355,12283,13072,94,25166,12193,12973,94
25,대전광역시,060005, 59세,2018,22228,10855,11373,95.4,22089,10794,11295,95.6
25,대전광역시,065,60~64세,2018,95516,47003,48513,96.9,94799,46667,48132,97
25,대전광역시,065001, 60세,2018,20734,10264,10470,98,20571,10193,10378,98.2
25,대전광역시,065002, 61세,2018,20495,10270,10225,100.4,20348,10202,10146,100.6
25,대전광역시,065003, 62세,2018,19106,9445,9661,97.8,18962,9382,9580,97.9
25,대전광역시,065004, 63세,2018,19058,9261,9797,94.5,18920,9192,9728,94.5
25,대전광역시,065005, 64세,2018,16123,7763,8360,92.9,15998,7698,8300,92.7
25,대전광역시,070,65~69세,2018,62122,30195,31927,94.6,61807,30050,31757,94.6
25,대전광역시,070001, 65세,2018,13345,6567,6778,96.9,13254,6525,6729,97
25,대전광역시,070002, 66세,2018,14398,7007,7391,94.8,14332,6973,7359,94.8
25,대전광역시,070003, 67세,2018,10720,5220,5500,94.9,10656,5192,5464,95
25,대전광역시,070004, 68세,2018,12068,5810,6258,92.8,12022,5789,6233,92.9
25,대전광역시,070005, 69세,2018,11591,5591,6000,93.2,11543,5571,5972,93.3
25,대전광역시,075,70~74세,2018,45609,21292,24317,87.6,45486,21243,24243,87.6
25,대전광역시,075001, 70세,2018,11046,5287,5759,91.8,11022,5278,5744,91.9
25,대전광역시,075002, 71세,2018,10293,4786,5507,86.9,10261,4770,5491,86.9
25,대전광역시,075003, 72세,2018,8039,3862,4177,92.5,8006,3852,4154,92.7
25,대전광역시,075004, 73세,2018,7994,3682,4312,85.4,7977,3675,4302,85.4
25,대전광역시,075005, 74세,2018,8237,3675,4562,80.6,8220,3668,4552,80.6
25,대전광역시,080,75~79세,2018,38310,16295,22015,74,38238,16268,21970,74
25,대전광역시,080001, 75세,2018,8129,3549,4580,77.5,8116,3543,4573,77.5
25,대전광역시,080002, 76세,2018,9786,4349,5437,80,9775,4346,5429,80.1
25,대전광역시,080003, 77세,2018,7336,3088,4248,72.7,7322,3082,4240,72.7
25,대전광역시,080004, 78세,2018,6412,2657,3755,70.8,6397,2649,3748,70.7
25,대전광역시,080005, 79세,2018,6647,2652,3995,66.4,6628,2648,3980,66.5
25,대전광역시,085,80~84세,2018,24513,9024,15489,58.3,24486,9013,15473,58.2
25,대전광역시,085001, 80세,2018,6035,2413,3622,66.6,6029,2410,3619,66.6
25,대전광역시,085002, 81세,2018,5317,2052,3265,62.8,5311,2049,3262,62.8
25,대전광역시,085003, 82세,2018,4900,1708,3192,53.5,4898,1708,3190,53.5
25,대전광역시,085004, 83세,2018,4428,1559,2869,54.3,4422,1557,2865,54.3
25,대전광역시,085005, 84세,2018,3833,1292,2541,50.8,3826,1289,2537,50.8
25,대전광역시,090,85~89세,2018,11644,3371,8273,40.7,11633,3365,8268,40.7
25,대전광역시,090001, 85세,2018,3209,1030,2179,47.3,3207,1029,2178,47.2
25,대전광역시,090002, 86세,2018,2827,863,1964,43.9,2826,862,1964,43.9
25,대전광역시,090003, 87세,2018,2138,609,1529,39.8,2135,608,1527,39.8
25,대전광역시,090004, 88세,2018,1906,485,1421,34.1,1906,485,1421,34.1
25,대전광역시,090005, 89세,2018,1564,384,1180,32.5,1559,381,1178,32.3
25,대전광역시,095,90~94세,2018,3982,962,3020,31.9,3977,961,3016,31.9
25,대전광역시,095001, 90세,2018,1358,343,1015,33.8,1354,342,1012,33.8
25,대전광역시,095002, 91세,2018,1041,261,780,33.5,1040,261,779,33.5
25,대전광역시,095003, 92세,2018,661,164,497,33,661,164,497,33
25,대전광역시,095004, 93세,2018,545,114,431,26.5,545,114,431,26.5
25,대전광역시,095005, 94세,2018,377,80,297,26.9,377,80,297,26.9
25,대전광역시,100,95~99세,2018,930,185,745,24.8,928,184,744,24.7
25,대전광역시,100001, 95세,2018,369,59,310,19,369,59,310,19
25,대전광역시,100002, 96세,2018,254,61,193,31.6,254,61,193,31.6
25,대전광역시,100003, 97세,2018,154,36,118,30.5,154,36,118,30.5
25,대전광역시,100004, 98세,2018,98,16,82,19.5,96,15,81,18.5
25,대전광역시,100005, 99세,2018,55,13,42,31,55,13,42,31
25,대전광역시,101,100세이상,2018,106,15,91,16.5,106,15,91,16.5
25,대전광역시,102,15세미만,2018,199342,102813,96529,106.5,198445,102352,96093,106.5
25,대전광역시,103,15~64세,2018,1124656,573883,550773,104.2,1103250,563625,539625,104.4
25,대전광역시,104,65세이상,2018,187216,81339,105877,76.8,186661,81099,105562,76.8
25,대전광역시,086,85세이상,2018,16662,4533,12129,37.4,16644,4525,12119,37.3
25,대전광역시,126,평균연령,2018,40.2,39.1,41.3,,40.3,39.2,41.5,
25,대전광역시,127,중위연령,2018,40.7,39.2,42.1,,40.9,39.4,42.3,
25010, 동구,000,합계,2018,237297,119833,117464,102,231744,117144,114600,102.2
25010, 동구,005,0~4세,2018,7770,4027,3743,107.6,7724,3998,3726,107.3
25010, 동구,005001, 0세,2018,1210,630,580,108.6,1199,621,578,107.4
25010, 동구,005002, 1세,2018,1441,732,709,103.2,1430,726,704,103.1
25010, 동구,005003, 2세,2018,1593,842,751,112.1,1586,839,747,112.3
25010, 동구,005004, 3세,2018,1749,904,845,107,1742,900,842,106.9
25010, 동구,005005, 4세,2018,1777,919,858,107.1,1767,912,855,106.7
25010, 동구,010,5~9세,2018,9355,4803,4552,105.5,9327,4785,4542,105.4
25010, 동구,010001, 5세,2018,1828,912,916,99.6,1821,907,914,99.2
25010, 동구,010002, 6세,2018,1906,984,922,106.7,1900,980,920,106.5
25010, 동구,010003, 7세,2018,1956,977,979,99.8,1947,973,974,99.9
25010, 동구,010004, 8세,2018,1859,967,892,108.4,1858,967,891,108.5
25010, 동구,010005, 9세,2018,1806,963,843,114.2,1801,958,843,113.6
25010, 동구,015,10~14세,2018,9679,4956,4723,104.9,9667,4948,4719,104.9
25010, 동구,015001, 10세,2018,2028,1013,1015,99.8,2025,1012,1013,99.9
25010, 동구,015002, 11세,2018,2004,1028,976,105.3,2003,1027,976,105.2
25010, 동구,015003, 12세,2018,1843,936,907,103.2,1840,934,906,103.1
25010, 동구,015004, 13세,2018,1799,964,835,115.4,1795,960,835,115
25010, 동구,015005, 14세,2018,2005,1015,990,102.5,2004,1015,989,102.6
25010, 동구,020,15~19세,2018,15722,8341,7381,113,15161,8051,7110,113.2
25010, 동구,020001, 15세,2018,2001,1040,961,108.2,1997,1039,958,108.5
25010, 동구,020002, 16세,2018,2120,1180,940,125.5,2115,1178,937,125.7
25010, 동구,020003, 17세,2018,2534,1398,1136,123.1,2509,1386,1123,123.4
25010, 동구,020004, 18세,2018,3778,2084,1694,123,3623,2001,1622,123.4
25010, 동구,020005, 19세,2018,5289,2639,2650,99.6,4917,2447,2470,99.1
25010, 동구,025,20~24세,2018,23590,12385,11205,110.5,21520,11364,10156,111.9
25010, 동구,025001, 20세,2018,5042,2226,2816,79,4509,1965,2544,77.2
25010, 동구,025002, 21세,2018,4794,2178,2616,83.3,4230,1909,2321,82.2
25010, 동구,025003, 22세,2018,4900,2636,2264,116.4,4452,2405,2047,117.5
25010, 동구,025004, 23세,2018,4673,2841,1832,155.1,4367,2688,1679,160.1
25010, 동구,025005, 24세,2018,4181,2504,1677,149.3,3962,2397,1565,153.2
25010, 동구,030,25~29세,2018,15118,8545,6573,130,14460,8255,6205,133
25010, 동구,030001, 25세,2018,3624,2165,1459,148.4,3438,2088,1350,154.7
25010, 동구,030002, 26세,2018,3305,1832,1473,124.4,3185,1781,1404,126.9
25010, 동구,030003, 27세,2018,2983,1643,1340,122.6,2863,1589,1274,124.7
25010, 동구,030004, 28세,2018,2693,1532,1161,132,2589,1486,1103,134.7
25010, 동구,030005, 29세,2018,2513,1373,1140,120.4,2385,1311,1074,122.1
25010, 동구,035,30~34세,2018,12552,6738,5814,115.9,12070,6543,5527,118.4
25010, 동구,035001, 30세,2018,2509,1390,1119,124.2,2421,1355,1066,127.1
25010, 동구,035002, 31세,2018,2408,1310,1098,119.3,2300,1261,1039,121.4
25010, 동구,035003, 32세,2018,2531,1339,1192,112.3,2424,1295,1129,114.7
25010, 동구,035004, 33세,2018,2479,1327,1152,115.2,2389,1292,1097,117.8
25010, 동구,035005, 34세,2018,2625,1372,1253,109.5,2536,1340,1196,112
25010, 동구,040,35~39세,2018,16433,8522,7911,107.7,16036,8349,7687,108.6
25010, 동구,040001, 35세,2018,2954,1531,1423,107.6,2871,1495,1376,108.6
25010, 동구,040002, 36세,2018,3360,1746,1614,108.2,3266,1705,1561,109.2
25010, 동구,040003, 37세,2018,3426,1778,1648,107.9,3354,1753,1601,109.5
25010, 동구,040004, 38세,2018,3464,1825,1639,111.3,3387,1791,1596,112.2
25010, 동구,040005, 39세,2018,3229,1642,1587,103.5,3158,1605,1553,103.3
25010, 동구,045,40~44세,2018,16485,8693,7792,111.6,16163,8525,7638,111.6
25010, 동구,045001, 40세,2018,3135,1643,1492,110.1,3067,1608,1459,110.2
25010, 동구,045002, 41세,2018,3129,1611,1518,106.1,3055,1570,1485,105.7
25010, 동구,045003, 42세,2018,3166,1654,1512,109.4,3101,1618,1483,109.1
25010, 동구,045004, 43세,2018,3332,1757,1575,111.6,3279,1733,1546,112.1
25010, 동구,045005, 44세,2018,3723,2028,1695,119.6,3661,1996,1665,119.9
25010, 동구,050,45~49세,2018,18502,9707,8795,110.4,18165,9529,8636,110.3
25010, 동구,050001, 45세,2018,3747,1966,1781,110.4,3687,1931,1756,110
25010, 동구,050002, 46세,2018,3548,1879,1669,112.6,3478,1840,1638,112.3
25010, 동구,050003, 47세,2018,3794,2000,1794,111.5,3709,1956,1753,111.6
25010, 동구,050004, 48세,2018,3566,1871,1695,110.4,3502,1840,1662,110.7
25010, 동구,050005, 49세,2018,3847,1991,1856,107.3,3789,1962,1827,107.4
25010, 동구,055,50~54세,2018,17422,8852,8570,103.3,17167,8722,8445,103.3
25010, 동구,055001, 50세,2018,3796,1900,1896,100.2,3741,1869,1872,99.8
25010, 동구,055002, 51세,2018,3426,1734,1692,102.5,3378,1715,1663,103.1
25010, 동구,055003, 52세,2018,3368,1734,1634,106.1,3313,1702,1611,105.6
25010, 동구,055004, 53세,2018,3570,1810,1760,102.8,3519,1783,1736,102.7
25010, 동구,055005, 54세,2018,3262,1674,1588,105.4,3216,1653,1563,105.8
25010, 동구,060,55~59세,2018,19515,9621,9894,97.2,19346,9539,9807,97.3
25010, 동구,060001, 55세,2018,3402,1752,1650,106.2,3357,1731,1626,106.5
25010, 동구,060002, 56세,2018,3833,1960,1873,104.6,3800,1947,1853,105.1
25010, 동구,060003, 57세,2018,4274,2064,2210,93.4,4242,2047,2195,93.3
25010, 동구,060004, 58세,2018,4301,2085,2216,94.1,4269,2069,2200,94
25010, 동구,060005, 59세,2018,3705,1760,1945,90.5,3678,1745,1933,90.3
25010, 동구,065,60~64세,2018,16822,8252,8570,96.3,16701,8190,8511,96.2
25010, 동구,065001, 60세,2018,3499,1716,1783,96.2,3469,1701,1768,96.2
25010, 동구,065002, 61세,2018,3535,1748,1787,97.8,3519,1737,1782,97.5
25010, 동구,065003, 62세,2018,3461,1702,1759,96.8,3442,1698,1744,97.4
25010, 동구,065004, 63세,2018,3354,1620,1734,93.4,3315,1599,1716,93.2
25010, 동구,065005, 64세,2018,2973,1466,1507,97.3,2956,1455,1501,96.9
25010, 동구,070,65~69세,2018,12026,5678,6348,89.4,11971,5652,6319,89.4
25010, 동구,070001, 65세,2018,2462,1178,1284,91.7,2443,1171,1272,92.1
25010, 동구,070002, 66세,2018,2756,1318,1438,91.7,2743,1312,1431,91.7
25010, 동구,070003, 67세,2018,2096,1022,1074,95.2,2085,1013,1072,94.5
25010, 동구,070004, 68세,2018,2436,1114,1322,84.3,2428,1112,1316,84.5
25010, 동구,070005, 69세,2018,2276,1046,1230,85,2272,1044,1228,85
25010, 동구,075,70~74세,2018,9475,4393,5082,86.4,9455,4385,5070,86.5
25010, 동구,075001, 70세,2018,2206,1062,1144,92.8,2205,1061,1144,92.7
25010, 동구,075002, 71세,2018,2119,950,1169,81.3,2115,949,1166,81.4
25010, 동구,075003, 72세,2018,1647,774,873,88.7,1642,773,869,89
25010, 동구,075004, 73세,2018,1708,793,915,86.7,1704,792,912,86.8
25010, 동구,075005, 74세,2018,1795,814,981,83,1789,810,979,82.7
25010, 동구,080,75~79세,2018,8281,3509,4772,73.5,8270,3502,4768,73.4
25010, 동구,080001, 75세,2018,1818,810,1008,80.4,1812,806,1006,80.1
25010, 동구,080002, 76세,2018,2087,922,1165,79.1,2087,922,1165,79.1
25010, 동구,080003, 77세,2018,1596,666,930,71.6,1592,663,929,71.4
25010, 동구,080004, 78세,2018,1386,559,827,67.6,1386,559,827,67.6
25010, 동구,080005, 79세,2018,1394,552,842,65.6,1393,552,841,65.6
25010, 동구,085,80~84세,2018,5108,1884,3224,58.4,5105,1883,3222,58.4
25010, 동구,085001, 80세,2018,1264,481,783,61.4,1262,480,782,61.4
25010, 동구,085002, 81세,2018,1100,425,675,63,1100,425,675,63
25010, 동구,085003, 82세,2018,1023,355,668,53.1,1023,355,668,53.1
25010, 동구,085004, 83세,2018,923,337,586,57.5,923,337,586,57.5
25010, 동구,085005, 84세,2018,798,286,512,55.9,797,286,511,56
25010, 동구,090,85~89세,2018,2390,695,1695,41,2387,693,1694,40.9
25010, 동구,090001, 85세,2018,649,200,449,44.5,649,200,449,44.5
25010, 동구,090002, 86세,2018,586,181,405,44.7,586,181,405,44.7
25010, 동구,090003, 87세,2018,443,137,306,44.8,442,137,305,44.9
25010, 동구,090004, 88세,2018,397,100,297,33.7,397,100,297,33.7
25010, 동구,090005, 89세,2018,315,77,238,32.4,313,75,238,31.5
25010, 동구,095,90~94세,2018,838,191,647,29.5,837,191,646,29.6
25010, 동구,095001, 90세,2018,287,73,214,34.1,286,73,213,34.3
25010, 동구,095002, 91세,2018,225,47,178,26.4,225,47,178,26.4
25010, 동구,095003, 92세,2018,137,30,107,28,137,30,107,28
25010, 동구,095004, 93세,2018,116,25,91,27.5,116,25,91,27.5
25010, 동구,095005, 94세,2018,73,16,57,28.1,73,16,57,28.1
25010, 동구,100,95~99세,2018,193,38,155,24.5,191,37,154,24
25010, 동구,100001, 95세,2018,67,9,58,15.5,67,9,58,15.5
25010, 동구,100002, 96세,2018,51,9,42,21.4,51,9,42,21.4
25010, 동구,100003, 97세,2018,39,11,28,39.3,39,11,28,39.3
25010, 동구,100004, 98세,2018,22,5,17,29.4,20,X,16,25
25010, 동구,100005, 99세,2018,14,X,10,40,14,X,10,40
25010, 동구,101,100세이상,2018,21,X,18,16.7,21,X,18,16.7
25010, 동구,102,15세미만,2018,26804,13786,13018,105.9,26718,13731,12987,105.7
25010, 동구,103,15~64세,2018,172161,89656,82505,108.7,166789,87067,79722,109.2
25010, 동구,104,65세이상,2018,38332,16391,21941,74.7,38237,16346,21891,74.7
25010, 동구,086,85세이상,2018,3442,927,2515,36.9,3436,924,2512,36.8
25010, 동구,126,평균연령,2018,42.1,40.8,43.5,,42.4,41,43.8,
25010, 동구,127,중위연령,2018,42.7,41,44.4,,43.2,41.4,45,
25020, 중구,000,합계,2018,239284,117939,121345,97.2,237337,117203,120134,97.6
25020, 중구,005,0~4세,2018,7855,4022,3833,104.9,7827,4007,3820,104.9
25020, 중구,005001, 0세,2018,1224,597,627,95.2,1219,597,622,96
25020, 중구,005002, 1세,2018,1436,721,715,100.8,1434,720,714,100.8
25020, 중구,005003, 2세,2018,1643,850,793,107.2,1635,844,791,106.7
25020, 중구,005004, 3세,2018,1795,957,838,114.2,1787,952,835,114
25020, 중구,005005, 4세,2018,1757,897,860,104.3,1752,894,858,104.2
25020, 중구,010,5~9세,2018,9882,5044,4838,104.3,9866,5034,4832,104.2
25020, 중구,010001, 5세,2018,1905,985,920,107.1,1899,981,918,106.9
25020, 중구,010002, 6세,2018,2033,1021,1012,100.9,2030,1020,1010,101
25020, 중구,010003, 7세,2018,2054,1058,996,106.2,2051,1056,995,106.1
25020, 중구,010004, 8세,2018,1977,997,980,101.7,1974,995,979,101.6
25020, 중구,010005, 9세,2018,1913,983,930,105.7,1912,982,930,105.6
25020, 중구,015,10~14세,2018,10575,5444,5131,106.1,10569,5442,5127,106.1
25020, 중구,015001, 10세,2018,2156,1139,1017,112,2154,1138,1016,112
25020, 중구,015002, 11세,2018,2209,1156,1053,109.8,2207,1156,1051,110
25020, 중구,015003, 12세,2018,1988,992,996,99.6,1987,992,995,99.7
25020, 중구,015004, 13세,2018,2031,1019,1012,100.7,2030,1018,1012,100.6
25020, 중구,015005, 14세,2018,2191,1138,1053,108.1,2191,1138,1053,108.1
25020, 중구,020,15~19세,2018,13248,7107,6141,115.7,13213,7090,6123,115.8
25020, 중구,020001, 15세,2018,2368,1242,1126,110.3,2363,1239,1124,110.2
25020, 중구,020002, 16세,2018,2497,1373,1124,122.2,2497,1373,1124,122.2
25020, 중구,020003, 17세,2018,2878,1545,1333,115.9,2871,1540,1331,115.7
25020, 중구,020004, 18세,2018,2942,1571,1371,114.6,2932,1566,1366,114.6
25020, 중구,020005, 19세,2018,2563,1376,1187,115.9,2550,1372,1178,116.5
25020, 중구,025,20~24세,2018,15638,8097,7541,107.4,15490,8051,7439,108.2
25020, 중구,025001, 20세,2018,2731,1485,1246,119.2,2712,1479,1233,120
25020, 중구,025002, 21세,2018,3073,1628,1445,112.7,3058,1623,1435,113.1
25020, 중구,025003, 22세,2018,3240,1679,1561,107.6,3211,1666,1545,107.8
25020, 중구,025004, 23세,2018,3260,1622,1638,99,3217,1611,1606,100.3
25020, 중구,025005, 24세,2018,3334,1683,1651,101.9,3292,1672,1620,103.2
25020, 중구,030,25~29세,2018,15177,7814,7363,106.1,14876,7721,7155,107.9
25020, 중구,030001, 25세,2018,3347,1703,1644,103.6,3295,1682,1613,104.3
25020, 중구,030002, 26세,2018,3254,1646,1608,102.4,3194,1634,1560,104.7
25020, 중구,030003, 27세,2018,3115,1571,1544,101.7,3061,1553,1508,103
25020, 중구,030004, 28세,2018,2816,1488,1328,112,2755,1466,1289,113.7
25020, 중구,030005, 29세,2018,2645,1406,1239,113.5,2571,1386,1185,117
25020, 중구,035,30~34세,2018,12938,6624,6314,104.9,12649,6523,6126,106.5
25020, 중구,035001, 30세,2018,2628,1376,1252,109.9,2555,1350,1205,112
25020, 중구,035002, 31세,2018,2605,1302,1303,99.9,2546,1279,1267,100.9
25020, 중구,035003, 32세,2018,2549,1326,1223,108.4,2488,1305,1183,110.3
25020, 중구,035004, 33세,2018,2508,1244,1264,98.4,2455,1231,1224,100.6
25020, 중구,035005, 34세,2018,2648,1376,1272,108.2,2605,1358,1247,108.9
25020, 중구,040,35~39세,2018,16902,8463,8439,100.3,16677,8390,8287,101.2
25020, 중구,040001, 35세,2018,2966,1509,1457,103.6,2919,1498,1421,105.4
25020, 중구,040002, 36세,2018,3295,1628,1667,97.7,3242,1608,1634,98.4
25020, 중구,040003, 37세,2018,3472,1735,1737,99.9,3426,1716,1710,100.4
25020, 중구,040004, 38세,2018,3628,1815,1813,100.1,3579,1804,1775,101.6
25020, 중구,040005, 39세,2018,3541,1776,1765,100.6,3511,1764,1747,101
25020, 중구,045,40~44세,2018,17553,8876,8677,102.3,17388,8813,8575,102.8
25020, 중구,045001, 40세,2018,3209,1633,1576,103.6,3185,1623,1562,103.9
25020, 중구,045002, 41세,2018,3441,1704,1737,98.1,3398,1687,1711,98.6
25020, 중구,045003, 42세,2018,3342,1684,1658,101.6,3311,1672,1639,102
25020, 중구,045004, 43세,2018,3554,1783,1771,100.7,3520,1771,1749,101.3
25020, 중구,045005, 44세,2018,4007,2072,1935,107.1,3974,2060,1914,107.6
25020, 중구,050,45~49세,2018,21000,10658,10342,103.1,20797,10577,10220,103.5
25020, 중구,050001, 45세,2018,4119,2059,2060,100,4087,2044,2043,100
25020, 중구,050002, 46세,2018,4059,2075,1984,104.6,4018,2060,1958,105.2
25020, 중구,050003, 47세,2018,4306,2200,2106,104.5,4267,2186,2081,105
25020, 중구,050004, 48세,2018,4080,2080,2000,104,4038,2066,1972,104.8
25020, 중구,050005, 49세,2018,4436,2244,2192,102.4,4387,2221,2166,102.5
25020, 중구,055,50~54세,2018,19303,9646,9657,99.9,19151,9573,9578,99.9
25020, 중구,055001, 50세,2018,4292,2088,2204,94.7,4268,2075,2193,94.6
25020, 중구,055002, 51세,2018,3926,1934,1992,97.1,3893,1919,1974,97.2
25020, 중구,055003, 52세,2018,3650,1874,1776,105.5,3616,1857,1759,105.6
25020, 중구,055004, 53세,2018,3830,1901,1929,98.5,3798,1886,1912,98.6
25020, 중구,055005, 54세,2018,3605,1849,1756,105.3,3576,1836,1740,105.5
25020, 중구,060,55~59세,2018,20134,9768,10366,94.2,19992,9713,10279,94.5
25020, 중구,060001, 55세,2018,3586,1759,1827,96.3,3545,1740,1805,96.4
25020, 중구,060002, 56세,2018,4084,2031,2053,98.9,4053,2022,2031,99.6
25020, 중구,060003, 57세,2018,4332,2109,2223,94.9,4308,2102,2206,95.3
25020, 중구,060004, 58세,2018,4287,2022,2265,89.3,4264,2009,2255,89.1
25020, 중구,060005, 59세,2018,3845,1847,1998,92.4,3822,1840,1982,92.8
25020, 중구,065,60~64세,2018,17889,8485,9404,90.2,17741,8424,9317,90.4
25020, 중구,065001, 60세,2018,3715,1785,1930,92.5,3684,1775,1909,93
25020, 중구,065002, 61세,2018,3688,1831,1857,98.6,3663,1822,1841,99
25020, 중구,065003, 62세,2018,3580,1685,1895,88.9,3549,1670,1879,88.9
25020, 중구,065004, 63세,2018,3675,1736,1939,89.5,3646,1724,1922,89.7
25020, 중구,065005, 64세,2018,3231,1448,1783,81.2,3199,1433,1766,81.1
25020, 중구,070,65~69세,2018,12996,6113,6883,88.8,12946,6087,6859,88.7
25020, 중구,070001, 65세,2018,2657,1265,1392,90.9,2639,1256,1383,90.8
25020, 중구,070002, 66세,2018,2971,1403,1568,89.5,2961,1398,1563,89.4
25020, 중구,070003, 67세,2018,2202,1051,1151,91.3,2191,1044,1147,91
25020, 중구,070004, 68세,2018,2551,1157,1394,83,2546,1154,1392,82.9
25020, 중구,070005, 69세,2018,2615,1237,1378,89.8,2609,1235,1374,89.9
25020, 중구,075,70~74세,2018,10442,4864,5578,87.2,10422,4853,5569,87.1
25020, 중구,075001, 70세,2018,2499,1190,1309,90.9,2495,1189,1306,91
25020, 중구,075002, 71세,2018,2304,1060,1244,85.2,2293,1052,1241,84.8
25020, 중구,075003, 72세,2018,1911,914,997,91.7,1907,913,994,91.9
25020, 중구,075004, 73세,2018,1844,841,1003,83.8,1843,840,1003,83.7
25020, 중구,075005, 74세,2018,1884,859,1025,83.8,1884,859,1025,83.8
25020, 중구,080,75~79세,2018,8640,3725,4915,75.8,8632,3722,4910,75.8
25020, 중구,080001, 75세,2018,1819,792,1027,77.1,1819,792,1027,77.1
25020, 중구,080002, 76세,2018,2247,983,1264,77.8,2243,981,1262,77.7
25020, 중구,080003, 77세,2018,1622,694,928,74.8,1621,694,927,74.9
25020, 중구,080004, 78세,2018,1447,609,838,72.7,1447,609,838,72.7
25020, 중구,080005, 79세,2018,1505,647,858,75.4,1502,646,856,75.5
25020, 중구,085,80~84세,2018,5519,2144,3375,63.5,5511,2141,3370,63.5
25020, 중구,085001, 80세,2018,1403,600,803,74.7,1402,600,802,74.8
25020, 중구,085002, 81세,2018,1199,466,733,63.6,1196,465,731,63.6
25020, 중구,085003, 82세,2018,1112,428,684,62.6,1112,428,684,62.6
25020, 중구,085004, 83세,2018,980,370,610,60.7,978,369,609,60.6
25020, 중구,085005, 84세,2018,825,280,545,51.4,823,279,544,51.3
25020, 중구,090,85~89세,2018,2525,782,1743,44.9,2523,780,1743,44.8
25020, 중구,090001, 85세,2018,703,240,463,51.8,703,240,463,51.8
25020, 중구,090002, 86세,2018,611,198,413,47.9,610,197,413,47.7
25020, 중구,090003, 87세,2018,470,151,319,47.3,469,150,319,47
25020, 중구,090004, 88세,2018,419,109,310,35.2,419,109,310,35.2
25020, 중구,090005, 89세,2018,322,84,238,35.3,322,84,238,35.3
25020, 중구,095,90~94세,2018,866,213,653,32.6,865,212,653,32.5
25020, 중구,095001, 90세,2018,279,70,209,33.5,278,69,209,33
25020, 중구,095002, 91세,2018,230,63,167,37.7,230,63,167,37.7
25020, 중구,095003, 92세,2018,142,30,112,26.8,142,30,112,26.8
25020, 중구,095004, 93세,2018,125,32,93,34.4,125,32,93,34.4
25020, 중구,095005, 94세,2018,90,18,72,25,90,18,72,25
25020, 중구,100,95~99세,2018,185,49,136,36,185,49,136,36
25020, 중구,100001, 95세,2018,73,16,57,28.1,73,16,57,28.1
25020, 중구,100002, 96세,2018,54,17,37,45.9,54,17,37,45.9
25020, 중구,100003, 97세,2018,31,11,20,55,31,11,20,55
25020, 중구,100004, 98세,2018,18,X,14,28.6,18,X,14,28.6
25020, 중구,100005, 99세,2018,9,X,8,12.5,9,X,8,12.5
25020, 중구,101,100세이상,2018,17,X,16,6.3,17,X,16,6.3
25020, 중구,102,15세미만,2018,28312,14510,13802,105.1,28262,14483,13779,105.1
25020, 중구,103,15~64세,2018,169782,85538,84244,101.5,167974,84875,83099,102.1
25020, 중구,104,65세이상,2018,41190,17891,23299,76.8,41101,17845,23256,76.7
25020, 중구,086,85세이상,2018,3593,1045,2548,41,3590,1042,2548,40.9
25020, 중구,126,평균연령,2018,43.4,42.2,44.6,,43.5,42.2,44.7,
25020, 중구,127,중위연령,2018,45,43.7,46.2,,45,43.8,46.3,
25030, 서구,000,합계,2018,484492,238128,246364,96.7,480243,236333,243910,96.9
25030, 서구,005,0~4세,2018,19203,9926,9277,107,19144,9891,9253,106.9
25030, 서구,005001, 0세,2018,3176,1627,1549,105,3157,1612,1545,104.3
25030, 서구,005002, 1세,2018,3519,1820,1699,107.1,3511,1816,1695,107.1
25030, 서구,005003, 2세,2018,4075,2163,1912,113.1,4063,2158,1905,113.3
25030, 서구,005004, 3세,2018,4295,2185,2110,103.6,4281,2178,2103,103.6
25030, 서구,005005, 4세,2018,4138,2131,2007,106.2,4132,2127,2005,106.1
25030, 서구,010,5~9세,2018,22422,11522,10900,105.7,22387,11506,10881,105.7
25030, 서구,010001, 5세,2018,4418,2267,2151,105.4,4411,2262,2149,105.3
25030, 서구,010002, 6세,2018,4585,2407,2178,110.5,4576,2404,2172,110.7
25030, 서구,010003, 7세,2018,4643,2347,2296,102.2,4641,2347,2294,102.3
25030, 서구,010004, 8세,2018,4441,2241,2200,101.9,4433,2237,2196,101.9
25030, 서구,010005, 9세,2018,4335,2260,2075,108.9,4326,2256,2070,109
25030, 서구,015,10~14세,2018,23850,12285,11565,106.2,23838,12280,11558,106.2
25030, 서구,015001, 10세,2018,4596,2350,2246,104.6,4593,2350,2243,104.8
25030, 서구,015002, 11세,2018,4890,2497,2393,104.3,4887,2495,2392,104.3
25030, 서구,015003, 12세,2018,4569,2347,2222,105.6,4567,2346,2221,105.6
25030, 서구,015004, 13세,2018,4601,2407,2194,109.7,4598,2405,2193,109.7
25030, 서구,015005, 14세,2018,5194,2684,2510,106.9,5193,2684,2509,107
25030, 서구,020,15~19세,2018,31111,15703,15408,101.9,30986,15639,15347,101.9
25030, 서구,020001, 15세,2018,5245,2619,2626,99.7,5236,2613,2623,99.6
25030, 서구,020002, 16세,2018,5287,2756,2531,108.9,5282,2755,2527,109
25030, 서구,020003, 17세,2018,6043,3132,2911,107.6,6033,3124,2909,107.4
25030, 서구,020004, 18세,2018,7067,3509,3558,98.6,7035,3490,3545,98.4
25030, 서구,020005, 19세,2018,7469,3687,3782,97.5,7400,3657,3743,97.7
25030, 서구,025,20~24세,2018,39716,20102,19614,102.5,38946,19829,19117,103.7
25030, 서구,025001, 20세,2018,7377,3556,3821,93.1,7252,3510,3742,93.8
25030, 서구,025002, 21세,2018,7783,3686,4097,90,7637,3637,4000,90.9
25030, 서구,025003, 22세,2018,8138,4054,4084,99.3,7991,3996,3995,100
25030, 서구,025004, 23세,2018,8190,4438,3752,118.3,8033,4384,3649,120.1
25030, 서구,025005, 24세,2018,8228,4368,3860,113.2,8033,4302,3731,115.3
25030, 서구,030,25~29세,2018,36168,18571,17597,105.5,35442,18304,17138,106.8
25030, 서구,030001, 25세,2018,7758,4065,3693,110.1,7606,4013,3593,111.7
25030, 서구,030002, 26세,2018,7820,4003,3817,104.9,7680,3951,3729,106
25030, 서구,030003, 27세,2018,7131,3560,3571,99.7,6992,3511,3481,100.9
25030, 서구,030004, 28세,2018,6917,3523,3394,103.8,6763,3471,3292,105.4
25030, 서구,030005, 29세,2018,6542,3420,3122,109.5,6401,3358,3043,110.4
25030, 서구,035,30~34세,2018,31785,16194,15591,103.9,31191,15945,15246,104.6
25030, 서구,035001, 30세,2018,6361,3284,3077,106.7,6218,3227,2991,107.9
25030, 서구,035002, 31세,2018,6244,3145,3099,101.5,6122,3093,3029,102.1
25030, 서구,035003, 32세,2018,6332,3285,3047,107.8,6200,3237,2963,109.2
25030, 서구,035004, 33세,2018,6427,3289,3138,104.8,6328,3239,3089,104.9
25030, 서구,035005, 34세,2018,6421,3191,3230,98.8,6323,3149,3174,99.2
25030, 서구,040,35~39세,2018,37470,18681,18789,99.4,37027,18485,18542,99.7
25030, 서구,040001, 35세,2018,7110,3579,3531,101.4,7023,3543,3480,101.8
25030, 서구,040002, 36세,2018,7689,3823,3866,98.9,7585,3777,3808,99.2
25030, 서구,040003, 37세,2018,7513,3778,3735,101.2,7407,3732,3675,101.6
25030, 서구,040004, 38세,2018,7823,3862,3961,97.5,7746,3824,3922,97.5
25030, 서구,040005, 39세,2018,7335,3639,3696,98.5,7266,3609,3657,98.7
25030, 서구,045,40~44세,2018,37166,17788,19378,91.8,36827,17636,19191,91.9
25030, 서구,045001, 40세,2018,6931,3374,3557,94.9,6854,3330,3524,94.5
25030, 서구,045002, 41세,2018,7175,3456,3719,92.9,7110,3429,3681,93.2
25030, 서구,045003, 42세,2018,7134,3390,3744,90.5,7067,3364,3703,90.8
25030, 서구,045004, 43세,2018,7570,3649,3921,93.1,7505,3620,3885,93.2
25030, 서구,045005, 44세,2018,8356,3919,4437,88.3,8291,3893,4398,88.5
25030, 서구,050,45~49세,2018,44245,21424,22821,93.9,43918,21263,22655,93.9
25030, 서구,050001, 45세,2018,8473,4069,4404,92.4,8416,4042,4374,92.4
25030, 서구,050002, 46세,2018,8417,4094,4323,94.7,8348,4061,4287,94.7
25030, 서구,050003, 47세,2018,9427,4554,4873,93.5,9360,4520,4840,93.4
25030, 서구,050004, 48세,2018,8753,4306,4447,96.8,8678,4269,4409,96.8
25030, 서구,050005, 49세,2018,9175,4401,4774,92.2,9116,4371,4745,92.1
25030, 서구,055,50~54세,2018,39108,18899,20209,93.5,38796,18744,20052,93.5
25030, 서구,055001, 50세,2018,9118,4398,4720,93.2,9036,4356,4680,93.1
25030, 서구,055002, 51세,2018,7911,3762,4149,90.7,7853,3735,4118,90.7
25030, 서구,055003, 52세,2018,7268,3569,3699,96.5,7204,3541,3663,96.7
25030, 서구,055004, 53세,2018,7718,3770,3948,95.5,7667,3744,3923,95.4
25030, 서구,055005, 54세,2018,7093,3400,3693,92.1,7036,3368,3668,91.8
25030, 서구,060,55~59세,2018,38720,18888,19832,95.2,38513,18799,19714,95.4
25030, 서구,060001, 55세,2018,7292,3625,3667,98.9,7234,3599,3635,99
25030, 서구,060002, 56세,2018,7730,3835,3895,98.5,7687,3814,3873,98.5
25030, 서구,060003, 57세,2018,8571,4143,4428,93.6,8538,4128,4410,93.6
25030, 서구,060004, 58세,2018,8078,3864,4214,91.7,8029,3844,4185,91.9
25030, 서구,060005, 59세,2018,7049,3421,3628,94.3,7025,3414,3611,94.5
25030, 서구,065,60~64세,2018,29696,14538,15158,95.9,29531,14451,15080,95.8
25030, 서구,065001, 60세,2018,6538,3239,3299,98.2,6501,3217,3284,98
25030, 서구,065002, 61세,2018,6439,3173,3266,97.2,6404,3156,3248,97.2
25030, 서구,065003, 62세,2018,5907,2932,2975,98.6,5869,2916,2953,98.7
25030, 서구,065004, 63세,2018,5881,2824,3057,92.4,5849,2805,3044,92.1
25030, 서구,065005, 64세,2018,4931,2370,2561,92.5,4908,2357,2551,92.4
25030, 서구,070,65~69세,2018,18696,9186,9510,96.6,18614,9153,9461,96.7
25030, 서구,070001, 65세,2018,4112,2036,2076,98.1,4098,2032,2066,98.4
25030, 서구,070002, 66세,2018,4308,2126,2182,97.4,4287,2115,2172,97.4
25030, 서구,070003, 67세,2018,3263,1553,1710,90.8,3244,1547,1697,91.2
25030, 서구,070004, 68세,2018,3644,1802,1842,97.8,3631,1794,1837,97.7
25030, 서구,070005, 69세,2018,3369,1669,1700,98.2,3354,1665,1689,98.6
25030, 서구,075,70~74세,2018,13046,6053,6993,86.6,13021,6048,6973,86.7
25030, 서구,075001, 70세,2018,3203,1499,1704,88,3196,1497,1699,88.1
25030, 서구,075002, 71세,2018,2992,1429,1563,91.4,2989,1429,1560,91.6
25030, 서구,075003, 72세,2018,2345,1114,1231,90.5,2335,1112,1223,90.9
25030, 서구,075004, 73세,2018,2216,1016,1200,84.7,2214,1015,1199,84.7
25030, 서구,075005, 74세,2018,2290,995,1295,76.8,2287,995,1292,77
25030, 서구,080,75~79세,2018,10649,4619,6030,76.6,10633,4615,6018,76.7
25030, 서구,080001, 75세,2018,2193,971,1222,79.5,2192,971,1221,79.5
25030, 서구,080002, 76세,2018,2736,1260,1476,85.4,2735,1260,1475,85.4
25030, 서구,080003, 77세,2018,2039,886,1153,76.8,2033,884,1149,76.9
25030, 서구,080004, 78세,2018,1764,751,1013,74.1,1760,750,1010,74.3
25030, 서구,080005, 79세,2018,1917,751,1166,64.4,1913,750,1163,64.5
25030, 서구,085,80~84세,2018,6794,2500,4294,58.2,6786,2497,4289,58.2
25030, 서구,085001, 80세,2018,1663,647,1016,63.7,1661,646,1015,63.6
25030, 서구,085002, 81세,2018,1458,579,879,65.9,1457,578,879,65.8
25030, 서구,085003, 82세,2018,1338,456,882,51.7,1337,456,881,51.8
25030, 서구,085004, 83세,2018,1235,448,787,56.9,1233,448,785,57.1
25030, 서구,085005, 84세,2018,1100,370,730,50.7,1098,369,729,50.6
25030, 서구,090,85~89세,2018,3221,916,2305,39.7,3218,915,2303,39.7
25030, 서구,090001, 85세,2018,894,296,598,49.5,894,296,598,49.5
25030, 서구,090002, 86세,2018,788,241,547,44.1,788,241,547,44.1
25030, 서구,090003, 87세,2018,573,143,430,33.3,573,143,430,33.3
25030, 서구,090004, 88세,2018,525,133,392,33.9,525,133,392,33.9
25030, 서구,090005, 89세,2018,441,103,338,30.5,438,102,336,30.4
25030, 서구,095,90~94세,2018,1123,276,847,32.6,1122,276,846,32.6
25030, 서구,095001, 90세,2018,386,102,284,35.9,386,102,284,35.9
25030, 서구,095002, 91세,2018,281,78,203,38.4,280,78,202,38.6
25030, 서구,095003, 92세,2018,185,50,135,37,185,50,135,37
25030, 서구,095004, 93세,2018,163,25,138,18.1,163,25,138,18.1
25030, 서구,095005, 94세,2018,108,21,87,24.1,108,21,87,24.1
25030, 서구,100,95~99세,2018,267,52,215,24.2,267,52,215,24.2
25030, 서구,100001, 95세,2018,112,18,94,19.1,112,18,94,19.1
25030, 서구,100002, 96세,2018,76,18,58,31,76,18,58,31
25030, 서구,100003, 97세,2018,31,7,24,29.2,31,7,24,29.2
25030, 서구,100004, 98세,2018,30,X,27,11.1,30,X,27,11.1
25030, 서구,100005, 99세,2018,18,6,12,50,18,6,12,50
25030, 서구,101,100세이상,2018,36,5,31,16.1,36,5,31,16.1
25030, 서구,102,15세미만,2018,65475,33733,31742,106.3,65369,33677,31692,106.3
25030, 서구,103,15~64세,2018,365185,180788,184397,98,361177,179095,182082,98.4
25030, 서구,104,65세이상,2018,53832,23607,30225,78.1,53697,23561,30136,78.2
25030, 서구,086,85세이상,2018,4647,1249,3398,36.8,4643,1248,3395,36.8
25030, 서구,126,평균연령,2018,39.6,38.7,40.5,,39.7,38.7,40.6,
25030, 서구,127,중위연령,2018,40.1,38.9,41.2,,40.2,39,41.4,
25040, 유성구,000,합계,2018,365833,188741,177092,106.6,357732,184527,173205,106.5
25040, 유성구,005,0~4세,2018,18690,9653,9037,106.8,18359,9491,8868,107
25040, 유성구,005001, 0세,2018,3042,1601,1441,111.1,2976,1564,1412,110.8
25040, 유성구,005002, 1세,2018,3581,1805,1776,101.6,3493,1767,1726,102.4
25040, 유성구,005003, 2세,2018,3940,2070,1870,110.7,3866,2028,1838,110.3
25040, 유성구,005004, 3세,2018,4189,2114,2075,101.9,4132,2090,2042,102.4
25040, 유성구,005005, 4세,2018,3938,2063,1875,110,3892,2042,1850,110.4
25040, 유성구,010,5~9세,2018,19942,10276,9666,106.3,19783,10204,9579,106.5
25040, 유성구,010001, 5세,2018,3982,2021,1961,103.1,3942,2004,1938,103.4
25040, 유성구,010002, 6세,2018,4198,2204,1994,110.5,4164,2190,1974,110.9
25040, 유성구,010003, 7세,2018,4155,2185,1970,110.9,4121,2166,1955,110.8
25040, 유성구,010004, 8세,2018,3894,1999,1895,105.5,3870,1988,1882,105.6
25040, 유성구,010005, 9세,2018,3713,1867,1846,101.1,3686,1856,1830,101.4
25040, 유성구,015,10~14세,2018,18870,9869,9001,109.6,18780,9820,8960,109.6
25040, 유성구,015001, 10세,2018,3847,1987,1860,106.8,3825,1974,1851,106.6
25040, 유성구,015002, 11세,2018,4004,1998,2006,99.6,3979,1990,1989,100.1
25040, 유성구,015003, 12세,2018,3673,1972,1701,115.9,3656,1965,1691,116.2
25040, 유성구,015004, 13세,2018,3512,1877,1635,114.8,3497,1865,1632,114.3
25040, 유성구,015005, 14세,2018,3834,2035,1799,113.1,3823,2026,1797,112.7
25040, 유성구,020,15~19세,2018,23955,12985,10970,118.4,23564,12779,10785,118.5
25040, 유성구,020001, 15세,2018,3690,1938,1752,110.6,3680,1933,1747,110.6
25040, 유성구,020002, 16세,2018,3758,1990,1768,112.6,3744,1983,1761,112.6
25040, 유성구,020003, 17세,2018,4255,2223,2032,109.4,4229,2206,2023,109
25040, 유성구,020004, 18세,2018,5354,2933,2421,121.1,5248,2865,2383,120.2
25040, 유성구,020005, 19세,2018,6898,3901,2997,130.2,6663,3792,2871,132.1
25040, 유성구,025,20~24세,2018,32694,18496,14198,130.3,30827,17572,13255,132.6
25040, 유성구,025001, 20세,2018,6460,3563,2897,123,6142,3399,2743,123.9
25040, 유성구,025002, 21세,2018,6275,3337,2938,113.6,5905,3153,2752,114.6
25040, 유성구,025003, 22세,2018,6582,3660,2922,125.3,6189,3460,2729,126.8
25040, 유성구,025004, 23세,2018,6736,3934,2802,140.4,6302,3724,2578,144.5
25040, 유성구,025005, 24세,2018,6641,4002,2639,151.6,6289,3836,2453,156.4
25040, 유성구,030,25~29세,2018,30240,17453,12787,136.5,28753,16671,12082,138
25040, 유성구,030001, 25세,2018,6534,3857,2677,144.1,6215,3693,2522,146.4
25040, 유성구,030002, 26세,2018,6416,3743,2673,140,6099,3583,2516,142.4
25040, 유성구,030003, 27세,2018,5918,3376,2542,132.8,5626,3214,2412,133.3
25040, 유성구,030004, 28세,2018,5670,3266,2404,135.9,5395,3125,2270,137.7
25040, 유성구,030005, 29세,2018,5702,3211,2491,128.9,5418,3056,2362,129.4
25040, 유성구,035,30~34세,2018,27855,14900,12955,115,26680,14245,12435,114.6
25040, 유성구,035001, 30세,2018,5481,3042,2439,124.7,5199,2882,2317,124.4
25040, 유성구,035002, 31세,2018,5498,2924,2574,113.6,5249,2785,2464,113
25040, 유성구,035003, 32세,2018,5536,2940,2596,113.3,5296,2807,2489,112.8
25040, 유성구,035004, 33세,2018,5685,3015,2670,112.9,5476,2904,2572,112.9
25040, 유성구,035005, 34세,2018,5655,2979,2676,111.3,5460,2867,2593,110.6
25040, 유성구,040,35~39세,2018,32006,16044,15962,100.5,31232,15627,15605,100.1
25040, 유성구,040001, 35세,2018,6266,3211,3055,105.1,6098,3119,2979,104.7
25040, 유성구,040002, 36세,2018,6591,3340,3251,102.7,6428,3257,3171,102.7
25040, 유성구,040003, 37세,2018,6645,3309,3336,99.2,6488,3221,3267,98.6
25040, 유성구,040004, 38세,2018,6478,3257,3221,101.1,6329,3171,3158,100.4
25040, 유성구,040005, 39세,2018,6026,2927,3099,94.4,5889,2859,3030,94.4
25040, 유성구,045,40~44세,2018,29797,14796,15001,98.6,29305,14521,14784,98.2
25040, 유성구,045001, 40세,2018,5897,2874,3023,95.1,5785,2810,2975,94.5
25040, 유성구,045002, 41세,2018,5934,2952,2982,99,5833,2896,2937,98.6
25040, 유성구,045003, 42세,2018,5763,2913,2850,102.2,5669,2865,2804,102.2
25040, 유성구,045004, 43세,2018,5931,2971,2960,100.4,5848,2920,2928,99.7
25040, 유성구,045005, 44세,2018,6272,3086,3186,96.9,6170,3030,3140,96.5
25040, 유성구,050,45~49세,2018,32005,15841,16164,98,31572,15606,15966,97.7
25040, 유성구,050001, 45세,2018,6399,3071,3328,92.3,6309,3018,3291,91.7
25040, 유성구,050002, 46세,2018,6270,3163,3107,101.8,6191,3118,3073,101.5
25040, 유성구,050003, 47세,2018,6631,3354,3277,102.3,6540,3308,3232,102.4
25040, 유성구,050004, 48세,2018,6370,3154,3216,98.1,6271,3106,3165,98.1
25040, 유성구,050005, 49세,2018,6335,3099,3236,95.8,6261,3056,3205,95.4
25040, 유성구,055,50~54세,2018,27032,13612,13420,101.4,26712,13450,13262,101.4
25040, 유성구,055001, 50세,2018,6297,3150,3147,100.1,6225,3109,3116,99.8
25040, 유성구,055002, 51세,2018,5531,2780,2751,101.1,5462,2746,2716,101.1
25040, 유성구,055003, 52세,2018,5082,2649,2433,108.9,5016,2616,2400,109
25040, 유성구,055004, 53세,2018,5249,2583,2666,96.9,5192,2558,2634,97.1
25040, 유성구,055005, 54세,2018,4873,2450,2423,101.1,4817,2421,2396,101
25040, 유성구,060,55~59세,2018,25413,12838,12575,102.1,25157,12714,12443,102.2
25040, 유성구,060001, 55세,2018,5065,2626,2439,107.7,4984,2580,2404,107.3
25040, 유성구,060002, 56세,2018,5123,2590,2533,102.3,5072,2566,2506,102.4
25040, 유성구,060003, 57세,2018,5507,2760,2747,100.5,5475,2746,2729,100.6
25040, 유성구,060004, 58세,2018,5143,2533,2610,97,5095,2511,2584,97.2
25040, 유성구,060005, 59세,2018,4575,2329,2246,103.7,4531,2311,2220,104.1
25040, 유성구,065,60~64세,2018,18069,9218,8851,104.1,17887,9133,8754,104.3
25040, 유성구,065001, 60세,2018,4116,2043,2073,98.6,4074,2029,2045,99.2
25040, 유성구,065002, 61세,2018,3975,2071,1904,108.8,3931,2053,1878,109.3
25040, 유성구,065003, 62세,2018,3552,1816,1736,104.6,3514,1795,1719,104.4
25040, 유성구,065004, 63세,2018,3553,1809,1744,103.7,3526,1796,1730,103.8
25040, 유성구,065005, 64세,2018,2873,1479,1394,106.1,2842,1460,1382,105.6
25040, 유성구,070,65~69세,2018,10145,5178,4967,104.2,10068,5140,4928,104.3
25040, 유성구,070001, 65세,2018,2385,1252,1133,110.5,2362,1238,1124,110.1
25040, 유성구,070002, 66세,2018,2408,1216,1192,102,2394,1208,1186,101.9
25040, 유성구,070003, 67세,2018,1698,844,854,98.8,1683,840,843,99.6
25040, 유성구,070004, 68세,2018,1871,948,923,102.7,1859,943,916,102.9
25040, 유성구,070005, 69세,2018,1783,918,865,106.1,1770,911,859,106.1
25040, 유성구,075,70~74세,2018,6684,3188,3496,91.2,6653,3174,3479,91.2
25040, 유성구,075001, 70세,2018,1677,838,839,99.9,1669,834,835,99.9
25040, 유성구,075002, 71세,2018,1472,708,764,92.7,1467,705,762,92.5
25040, 유성구,075003, 72세,2018,1134,554,580,95.5,1127,550,577,95.3
25040, 유성구,075004, 73세,2018,1185,543,642,84.6,1181,542,639,84.8
25040, 유성구,075005, 74세,2018,1216,545,671,81.2,1209,543,666,81.5
25040, 유성구,080,75~79세,2018,5532,2278,3254,70,5507,2269,3238,70.1
25040, 유성구,080001, 75세,2018,1136,472,664,71.1,1131,470,661,71.1
25040, 유성구,080002, 76세,2018,1391,614,777,79,1386,613,773,79.3
25040, 유성구,080003, 77세,2018,1082,426,656,64.9,1080,425,655,64.9
25040, 유성구,080004, 78세,2018,966,395,571,69.2,958,391,567,69
25040, 유성구,080005, 79세,2018,957,371,586,63.3,952,370,582,63.6
25040, 유성구,085,80~84세,2018,3895,1306,2589,50.4,3888,1302,2586,50.3
25040, 유성구,085001, 80세,2018,903,341,562,60.7,902,340,562,60.5
25040, 유성구,085002, 81세,2018,834,312,522,59.8,833,311,522,59.6
25040, 유성구,085003, 82세,2018,811,253,558,45.3,810,253,557,45.4
25040, 유성구,085004, 83세,2018,712,202,510,39.6,710,201,509,39.5
25040, 유성구,085005, 84세,2018,635,198,437,45.3,633,197,436,45.2
25040, 유성구,090,85~89세,2018,2080,584,1496,39,2077,583,1494,39
25040, 유성구,090001, 85세,2018,556,161,395,40.8,554,160,394,40.6
25040, 유성구,090002, 86세,2018,507,149,358,41.6,507,149,358,41.6
25040, 유성구,090003, 87세,2018,378,102,276,37,377,102,275,37.1
25040, 유성구,090004, 88세,2018,348,92,256,35.9,348,92,256,35.9
25040, 유성구,090005, 89세,2018,291,80,211,37.9,291,80,211,37.9
25040, 유성구,095,90~94세,2018,739,192,547,35.1,738,192,546,35.2
25040, 유성구,095001, 90세,2018,258,69,189,36.5,257,69,188,36.7
25040, 유성구,095002, 91세,2018,188,43,145,29.7,188,43,145,29.7
25040, 유성구,095003, 92세,2018,121,36,85,42.4,121,36,85,42.4
25040, 유성구,095004, 93세,2018,104,26,78,33.3,104,26,78,33.3
25040, 유성구,095005, 94세,2018,68,18,50,36,68,18,50,36
25040, 유성구,100,95~99세,2018,173,32,141,22.7,173,32,141,22.7
25040, 유성구,100001, 95세,2018,73,13,60,21.7,73,13,60,21.7
25040, 유성구,100002, 96세,2018,44,10,34,29.4,44,10,34,29.4
25040, 유성구,100003, 97세,2018,27,X,23,17.4,27,X,23,17.4
25040, 유성구,100004, 98세,2018,17,X,14,21.4,17,X,14,21.4
25040, 유성구,100005, 99세,2018,12,X,10,20,12,X,10,20
25040, 유성구,101,100세이상,2018,17,X,15,13.3,17,X,15,13.3
25040, 유성구,102,15세미만,2018,57502,29798,27704,107.6,56922,29515,27407,107.7
25040, 유성구,103,15~64세,2018,279066,146183,132883,110,271689,142318,129371,110
25040, 유성구,104,65세이상,2018,29265,12760,16505,77.3,29121,12694,16427,77.3
25040, 유성구,086,85세이상,2018,3009,810,2199,36.8,3005,809,2196,36.8
25040, 유성구,126,평균연령,2018,36.9,35.9,38,,37,36,38.1,
25040, 유성구,127,중위연령,2018,36.7,35.2,38.1,,36.9,35.5,38.4,
25050, 대덕구,000,합계,2018,184308,93394,90914,102.7,181300,91869,89431,102.7
25050, 대덕구,005,0~4세,2018,5878,2966,2912,101.9,5839,2948,2891,102
25050, 대덕구,005001, 0세,2018,947,437,510,85.7,938,433,505,85.7
25050, 대덕구,005002, 1세,2018,1085,570,515,110.7,1076,566,510,111
25050, 대덕구,005003, 2세,2018,1229,604,625,96.6,1221,600,621,96.6
25050, 대덕구,005004, 3세,2018,1288,663,625,106.1,1281,659,622,105.9
25050, 대덕구,005005, 4세,2018,1329,692,637,108.6,1323,690,633,109
25050, 대덕구,010,5~9세,2018,7289,3782,3507,107.8,7273,3770,3503,107.6
25050, 대덕구,010001, 5세,2018,1354,676,678,99.7,1348,673,675,99.7
25050, 대덕구,010002, 6세,2018,1443,761,682,111.6,1441,759,682,111.3
25050, 대덕구,010003, 7세,2018,1512,782,730,107.1,1509,780,729,107
25050, 대덕구,010004, 8세,2018,1466,778,688,113.1,1464,776,688,112.8
25050, 대덕구,010005, 9세,2018,1514,785,729,107.7,1511,782,729,107.3
25050, 대덕구,015,10~14세,2018,8082,4238,3844,110.2,8062,4228,3834,110.3
25050, 대덕구,015001, 10세,2018,1537,779,758,102.8,1531,774,757,102.2
25050, 대덕구,015002, 11세,2018,1696,884,812,108.9,1689,880,809,108.8
25050, 대덕구,015003, 12세,2018,1532,816,716,114,1529,815,714,114.1
25050, 대덕구,015004, 13세,2018,1516,776,740,104.9,1513,776,737,105.3
25050, 대덕구,015005, 14세,2018,1801,983,818,120.2,1800,983,817,120.3
25050, 대덕구,020,15~19세,2018,11319,5753,5566,103.4,11252,5725,5527,103.6
25050, 대덕구,020001, 15세,2018,1806,910,896,101.6,1801,908,893,101.7
25050, 대덕구,020002, 16세,2018,1838,917,921,99.6,1834,915,919,99.6
25050, 대덕구,020003, 17세,2018,2241,1156,1085,106.5,2236,1153,1083,106.5
25050, 대덕구,020004, 18세,2018,2419,1267,1152,110,2409,1261,1148,109.8
25050, 대덕구,020005, 19세,2018,3015,1503,1512,99.4,2972,1488,1484,100.3
25050, 대덕구,025,20~24세,2018,15480,8177,7303,112,15016,7937,7079,112.1
25050, 대덕구,025001, 20세,2018,3021,1529,1492,102.5,2937,1491,1446,103.1
25050, 대덕구,025002, 21세,2018,3150,1574,1576,99.9,3055,1530,1525,100.3
25050, 대덕구,025003, 22세,2018,3150,1660,1490,111.4,3060,1618,1442,112.2
25050, 대덕구,025004, 23세,2018,3175,1714,1461,117.3,3086,1662,1424,116.7
25050, 대덕구,025005, 24세,2018,2984,1700,1284,132.4,2878,1636,1242,131.7
25050, 대덕구,030,25~29세,2018,12435,7082,5353,132.3,11916,6799,5117,132.9
25050, 대덕구,030001, 25세,2018,2869,1659,1210,137.1,2772,1601,1171,136.7
25050, 대덕구,030002, 26세,2018,2758,1544,1214,127.2,2650,1484,1166,127.3
25050, 대덕구,030003, 27세,2018,2398,1371,1027,133.5,2299,1314,985,133.4
25050, 대덕구,030004, 28세,2018,2323,1340,983,136.3,2220,1285,935,137.4
25050, 대덕구,030005, 29세,2018,2087,1168,919,127.1,1975,1115,860,129.7
25050, 대덕구,035,30~34세,2018,10121,5468,4653,117.5,9636,5223,4413,118.4
25050, 대덕구,035001, 30세,2018,2083,1156,927,124.7,1975,1101,874,126
25050, 대덕구,035002, 31세,2018,1971,1101,870,126.6,1882,1057,825,128.1
25050, 대덕구,035003, 32세,2018,2039,1069,970,110.2,1947,1018,929,109.6
25050, 대덕구,035004, 33세,2018,1987,1062,925,114.8,1890,1017,873,116.5
25050, 대덕구,035005, 34세,2018,2041,1080,961,112.4,1942,1030,912,112.9
25050, 대덕구,040,35~39세,2018,12384,6513,5871,110.9,12017,6312,5705,110.6
25050, 대덕구,040001, 35세,2018,2284,1225,1059,115.7,2209,1180,1029,114.7
25050, 대덕구,040002, 36세,2018,2419,1261,1158,108.9,2346,1219,1127,108.2
25050, 대덕구,040003, 37세,2018,2599,1378,1221,112.9,2519,1336,1183,112.9
25050, 대덕구,040004, 38세,2018,2535,1288,1247,103.3,2463,1249,1214,102.9
25050, 대덕구,040005, 39세,2018,2547,1361,1186,114.8,2480,1328,1152,115.3
25050, 대덕구,045,40~44세,2018,13244,6757,6487,104.2,13001,6624,6377,103.9
25050, 대덕구,045001, 40세,2018,2399,1231,1168,105.4,2340,1197,1143,104.7
25050, 대덕구,045002, 41세,2018,2538,1296,1242,104.3,2497,1273,1224,104
25050, 대덕구,045003, 42세,2018,2544,1287,1257,102.4,2490,1259,1231,102.3
25050, 대덕구,045004, 43세,2018,2698,1339,1359,98.5,2654,1318,1336,98.7
25050, 대덕구,045005, 44세,2018,3065,1604,1461,109.8,3020,1577,1443,109.3
25050, 대덕구,050,45~49세,2018,17011,8586,8425,101.9,16756,8464,8292,102.1
25050, 대덕구,050001, 45세,2018,3174,1601,1573,101.8,3124,1578,1546,102.1
25050, 대덕구,050002, 46세,2018,3016,1534,1482,103.5,2964,1512,1452,104.1
25050, 대덕구,050003, 47세,2018,3581,1776,1805,98.4,3530,1754,1776,98.8
25050, 대덕구,050004, 48세,2018,3488,1765,1723,102.4,3443,1738,1705,101.9
25050, 대덕구,050005, 49세,2018,3752,1910,1842,103.7,3695,1882,1813,103.8
25050, 대덕구,055,50~54세,2018,16608,8404,8204,102.4,16421,8326,8095,102.9
25050, 대덕구,055001, 50세,2018,3793,1876,1917,97.9,3750,1859,1891,98.3
25050, 대덕구,055002, 51세,2018,3313,1681,1632,103,3280,1665,1615,103.1
25050, 대덕구,055003, 52세,2018,3141,1623,1518,106.9,3106,1608,1498,107.3
25050, 대덕구,055004, 53세,2018,3302,1676,1626,103.1,3267,1662,1605,103.6
25050, 대덕구,055005, 54세,2018,3059,1548,1511,102.4,3018,1532,1486,103.1
25050, 대덕구,060,55~59세,2018,16820,8468,8352,101.4,16667,8391,8276,101.4
25050, 대덕구,060001, 55세,2018,3050,1568,1482,105.8,3006,1547,1459,106
25050, 대덕구,060002, 56세,2018,3404,1695,1709,99.2,3381,1683,1698,99.1
25050, 대덕구,060003, 57세,2018,3766,1928,1838,104.9,3738,1917,1821,105.3
25050, 대덕구,060004, 58세,2018,3546,1779,1767,100.7,3509,1760,1749,100.6
25050, 대덕구,060005, 59세,2018,3054,1498,1556,96.3,3033,1484,1549,95.8
25050, 대덕구,065,60~64세,2018,13040,6510,6530,99.7,12939,6469,6470,100
25050, 대덕구,065001, 60세,2018,2866,1481,1385,106.9,2843,1471,1372,107.2
25050, 대덕구,065002, 61세,2018,2858,1447,1411,102.6,2831,1434,1397,102.6
25050, 대덕구,065003, 62세,2018,2606,1310,1296,101.1,2588,1303,1285,101.4
25050, 대덕구,065004, 63세,2018,2595,1272,1323,96.1,2584,1268,1316,96.4
25050, 대덕구,065005, 64세,2018,2115,1000,1115,89.7,2093,993,1100,90.3
25050, 대덕구,070,65~69세,2018,8259,4040,4219,95.8,8208,4018,4190,95.9
25050, 대덕구,070001, 65세,2018,1729,836,893,93.6,1712,828,884,93.7
25050, 대덕구,070002, 66세,2018,1955,944,1011,93.4,1947,940,1007,93.3
25050, 대덕구,070003, 67세,2018,1461,750,711,105.5,1453,748,705,106.1
25050, 대덕구,070004, 68세,2018,1566,789,777,101.5,1558,786,772,101.8
25050, 대덕구,070005, 69세,2018,1548,721,827,87.2,1538,716,822,87.1
25050, 대덕구,075,70~74세,2018,5962,2794,3168,88.2,5935,2783,3152,88.3
25050, 대덕구,075001, 70세,2018,1461,698,763,91.5,1457,697,760,91.7
25050, 대덕구,075002, 71세,2018,1406,639,767,83.3,1397,635,762,83.3
25050, 대덕구,075003, 72세,2018,1002,506,496,102,995,504,491,102.6
25050, 대덕구,075004, 73세,2018,1041,489,552,88.6,1035,486,549,88.5
25050, 대덕구,075005, 74세,2018,1052,462,590,78.3,1051,461,590,78.1
25050, 대덕구,080,75~79세,2018,5208,2164,3044,71.1,5196,2160,3036,71.1
25050, 대덕구,080001, 75세,2018,1163,504,659,76.5,1162,504,658,76.6
25050, 대덕구,080002, 76세,2018,1325,570,755,75.5,1324,570,754,75.6
25050, 대덕구,080003, 77세,2018,997,416,581,71.6,996,416,580,71.7
25050, 대덕구,080004, 78세,2018,849,343,506,67.8,846,340,506,67.2
25050, 대덕구,080005, 79세,2018,874,331,543,61,868,330,538,61.3
25050, 대덕구,085,80~84세,2018,3197,1190,2007,59.3,3196,1190,2006,59.3
25050, 대덕구,085001, 80세,2018,802,344,458,75.1,802,344,458,75.1
25050, 대덕구,085002, 81세,2018,726,270,456,59.2,725,270,455,59.3
25050, 대덕구,085003, 82세,2018,616,216,400,54,616,216,400,54
25050, 대덕구,085004, 83세,2018,578,202,376,53.7,578,202,376,53.7
25050, 대덕구,085005, 84세,2018,475,158,317,49.8,475,158,317,49.8
25050, 대덕구,090,85~89세,2018,1428,394,1034,38.1,1428,394,1034,38.1
25050, 대덕구,090001, 85세,2018,407,133,274,48.5,407,133,274,48.5
25050, 대덕구,090002, 86세,2018,335,94,241,39,335,94,241,39
25050, 대덕구,090003, 87세,2018,274,76,198,38.4,274,76,198,38.4
25050, 대덕구,090004, 88세,2018,217,51,166,30.7,217,51,166,30.7
25050, 대덕구,090005, 89세,2018,195,40,155,25.8,195,40,155,25.8
25050, 대덕구,095,90~94세,2018,416,90,326,27.6,415,90,325,27.7
25050, 대덕구,095001, 90세,2018,148,29,119,24.4,147,29,118,24.6
25050, 대덕구,095002, 91세,2018,117,30,87,34.5,117,30,87,34.5
25050, 대덕구,095003, 92세,2018,76,18,58,31,76,18,58,31
25050, 대덕구,095004, 93세,2018,37,6,31,19.4,37,6,31,19.4
25050, 대덕구,095005, 94세,2018,38,7,31,22.6,38,7,31,22.6
25050, 대덕구,100,95~99세,2018,112,14,98,14.3,112,14,98,14.3
25050, 대덕구,100001, 95세,2018,44,X,41,7.3,44,X,41,7.3
25050, 대덕구,100002, 96세,2018,29,7,22,31.8,29,7,22,31.8
25050, 대덕구,100003, 97세,2018,26,X,23,13,26,X,23,13
25050, 대덕구,100004, 98세,2018,11,X,10,10,11,X,10,10
25050, 대덕구,100005, 99세,2018,X,X,X,0,X,X,X,0
25050, 대덕구,101,100세이상,2018,15,X,11,36.4,15,X,11,36.4
25050, 대덕구,102,15세미만,2018,21249,10986,10263,107,21174,10946,10228,107
25050, 대덕구,103,15~64세,2018,138462,71718,66744,107.5,135621,70270,65351,107.5
25050, 대덕구,104,65세이상,2018,24597,10690,13907,76.9,24505,10653,13852,76.9
25050, 대덕구,086,85세이상,2018,1971,502,1469,34.2,1970,502,1468,34.2
25050, 대덕구,126,평균연령,2018,41.8,40.7,42.9,,41.9,40.8,43,
25050, 대덕구,127,중위연령,2018,43.6,42.1,45,,43.9,42.4,45.2,
26,울산광역시,000,합계,2018,1150116,595795,554321,107.5,1122954,579263,543691,106.5
26,울산광역시,005,0~4세,2018,51327,26424,24903,106.1,50870,26198,24672,106.2
26,울산광역시,005001, 0세,2018,8317,4268,4049,105.4,8242,4232,4010,105.5
26,울산광역시,005002, 1세,2018,9465,4907,4558,107.7,9362,4857,4505,107.8
26,울산광역시,005003, 2세,2018,10866,5603,5263,106.5,10774,5562,5212,106.7
26,울산광역시,005004, 3세,2018,11361,5886,5475,107.5,11271,5840,5431,107.5
26,울산광역시,005005, 4세,2018,11318,5760,5558,103.6,11221,5707,5514,103.5
26,울산광역시,010,5~9세,2018,57107,29557,27550,107.3,56852,29429,27423,107.3
26,울산광역시,010001, 5세,2018,11246,5724,5522,103.7,11188,5698,5490,103.8
26,울산광역시,010002, 6세,2018,12008,6186,5822,106.3,11948,6155,5793,106.2
26,울산광역시,010003, 7세,2018,11726,6070,5656,107.3,11680,6044,5636,107.2
26,울산광역시,010004, 8세,2018,11315,5937,5378,110.4,11267,5920,5347,110.7
26,울산광역시,010005, 9세,2018,10812,5640,5172,109,10769,5612,5157,108.8
26,울산광역시,015,10~14세,2018,54425,28504,25921,110,54249,28412,25837,110
26,울산광역시,015001, 10세,2018,11371,5864,5507,106.5,11329,5833,5496,106.1
26,울산광역시,015002, 11세,2018,11500,6044,5456,110.8,11460,6022,5438,110.7
26,울산광역시,015003, 12세,2018,10370,5380,4990,107.8,10342,5371,4971,108
26,울산광역시,015004, 13세,2018,10190,5382,4808,111.9,10155,5366,4789,112
26,울산광역시,015005, 14세,2018,10994,5834,5160,113.1,10963,5820,5143,113.2
26,울산광역시,020,15~19세,2018,63055,34433,28622,120.3,62598,34181,28417,120.3
26,울산광역시,020001, 15세,2018,11335,6038,5297,114,11317,6034,5283,114.2
26,울산광역시,020002, 16세,2018,11764,6184,5580,110.8,11725,6168,5557,111
26,울산광역시,020003, 17세,2018,13708,7328,6380,114.9,13661,7301,6360,114.8
26,울산광역시,020004, 18세,2018,14779,7997,6782,117.9,14668,7930,6738,117.7
26,울산광역시,020005, 19세,2018,11469,6886,4583,150.3,11227,6748,4479,150.7
26,울산광역시,025,20~24세,2018,73066,42595,30471,139.8,70594,41104,29490,139.4
26,울산광역시,025001, 20세,2018,13137,8046,5091,158,12804,7849,4955,158.4
26,울산광역시,025002, 21세,2018,14488,8687,5801,149.8,14047,8401,5646,148.8
26,울산광역시,025003, 22세,2018,14616,8432,6184,136.4,14148,8169,5979,136.6
26,울산광역시,025004, 23세,2018,15279,8579,6700,128,14708,8244,6464,127.5
26,울산광역시,025005, 24세,2018,15546,8851,6695,132.2,14887,8441,6446,130.9
26,울산광역시,030,25~29세,2018,76961,43594,33367,130.7,72681,40823,31858,128.1
26,울산광역시,030001, 25세,2018,15883,9061,6822,132.8,15169,8620,6549,131.6
26,울산광역시,030002, 26세,2018,16021,9159,6862,133.5,15234,8637,6597,130.9
26,울산광역시,030003, 27세,2018,15473,8601,6872,125.2,14560,8013,6547,122.4
26,울산광역시,030004, 28세,2018,14867,8451,6416,131.7,13899,7813,6086,128.4
26,울산광역시,030005, 29세,2018,14717,8322,6395,130.1,13819,7740,6079,127.3
26,울산광역시,035,30~34세,2018,74711,40707,34004,119.7,70161,37714,32447,116.2
26,울산광역시,035001, 30세,2018,14193,8016,6177,129.8,13219,7386,5833,126.6
26,울산광역시,035002, 31세,2018,14452,7910,6542,120.9,13492,7298,6194,117.8
26,울산광역시,035003, 32세,2018,14770,8016,6754,118.7,13831,7393,6438,114.8
26,울산광역시,035004, 33세,2018,15084,8106,6978,116.2,14210,7520,6690,112.4
26,울산광역시,035005, 34세,2018,16212,8659,7553,114.6,15409,8117,7292,111.3
26,울산광역시,040,35~39세,2018,96923,50903,46020,110.6,93593,48690,44903,108.4
26,울산광역시,040001, 35세,2018,18064,9503,8561,111,17274,8957,8317,107.7
26,울산광역시,040002, 36세,2018,19602,10178,9424,108,18908,9733,9175,106.1
26,울산광역시,040003, 37세,2018,19818,10590,9228,114.8,19146,10117,9029,112.1
26,울산광역시,040004, 38세,2018,20565,10736,9829,109.2,19976,10368,9608,107.9
26,울산광역시,040005, 39세,2018,18874,9896,8978,110.2,18289,9515,8774,108.4
26,울산광역시,045,40~44세,2018,89675,46287,43388,106.7,87248,44780,42468,105.4
26,울산광역시,045001, 40세,2018,17435,9211,8224,112,16889,8894,7995,111.2
26,울산광역시,045002, 41세,2018,17868,9305,8563,108.7,17386,8993,8393,107.1
26,울산광역시,045003, 42세,2018,16895,8841,8054,109.8,16431,8535,7896,108.1
26,울산광역시,045004, 43세,2018,18065,9189,8876,103.5,17593,8902,8691,102.4
26,울산광역시,045005, 44세,2018,19412,9741,9671,100.7,18949,9456,9493,99.6
26,울산광역시,050,45~49세,2018,105641,52547,53094,99,102977,50978,51999,98
26,울산광역시,050001, 45세,2018,19985,9961,10024,99.4,19523,9680,9843,98.3
26,울산광역시,050002, 46세,2018,20178,10078,10100,99.8,19654,9769,9885,98.8
26,울산광역시,050003, 47세,2018,21894,10927,10967,99.6,21298,10582,10716,98.7
26,울산광역시,050004, 48세,2018,21462,10593,10869,97.5,20908,10259,10649,96.3
26,울산광역시,050005, 49세,2018,22122,10988,11134,98.7,21594,10688,10906,98
26,울산광역시,055,50~54세,2018,106434,54185,52249,103.7,103971,52781,51190,103.1
26,울산광역시,055001, 50세,2018,22598,11176,11422,97.8,22045,10853,11192,97
26,울산광역시,055002, 51세,2018,21262,10447,10815,96.6,20846,10225,10621,96.3
26,울산광역시,055003, 52세,2018,21427,11244,10183,110.4,20930,10947,9983,109.7
26,울산광역시,055004, 53세,2018,21515,11156,10359,107.7,21016,10874,10142,107.2
26,울산광역시,055005, 54세,2018,19632,10162,9470,107.3,19134,9882,9252,106.8
26,울산광역시,060,55~59세,2018,103394,53366,50028,106.7,101628,52383,49245,106.4
26,울산광역시,060001, 55세,2018,20399,10682,9717,109.9,19879,10392,9487,109.5
26,울산광역시,060002, 56세,2018,20874,10932,9942,110,20501,10734,9767,109.9
26,울산광역시,060003, 57세,2018,22370,11471,10899,105.2,22106,11318,10788,104.9
26,울산광역시,060004, 58세,2018,20923,10606,10317,102.8,20572,10409,10163,102.4
26,울산광역시,060005, 59세,2018,18828,9675,9153,105.7,18570,9530,9040,105.4
26,울산광역시,065,60~64세,2018,75971,38500,37471,102.7,74954,37945,37009,102.5
26,울산광역시,065001, 60세,2018,17464,8992,8472,106.1,17227,8861,8366,105.9
26,울산광역시,065002, 61세,2018,16521,8392,8129,103.2,16297,8262,8035,102.8
26,울산광역시,065003, 62세,2018,15029,7565,7464,101.4,14832,7462,7370,101.2
26,울산광역시,065004, 63세,2018,14770,7345,7425,98.9,14577,7243,7334,98.8
26,울산광역시,065005, 64세,2018,12187,6206,5981,103.8,12021,6117,5904,103.6
26,울산광역시,070,65~69세,2018,46875,23702,23173,102.3,46401,23480,22921,102.4
26,울산광역시,070001, 65세,2018,10885,5449,5436,100.2,10762,5390,5372,100.3
26,울산광역시,070002, 66세,2018,10973,5557,5416,102.6,10864,5504,5360,102.7
26,울산광역시,070003, 67세,2018,8521,4341,4180,103.9,8418,4293,4125,104.1
26,울산광역시,070004, 68세,2018,8361,4230,4131,102.4,8293,4199,4094,102.6
26,울산광역시,070005, 69세,2018,8135,4125,4010,102.9,8064,4094,3970,103.1
26,울산광역시,075,70~74세,2018,29859,14549,15310,95,29695,14481,15214,95.2
26,울산광역시,075001, 70세,2018,7944,3976,3968,100.2,7900,3953,3947,100.2
26,울산광역시,075002, 71세,2018,7105,3534,3571,99,7059,3515,3544,99.2
26,울산광역시,075003, 72세,2018,4904,2430,2474,98.2,4878,2422,2456,98.6
26,울산광역시,075004, 73세,2018,4914,2354,2560,92,4889,2345,2544,92.2
26,울산광역시,075005, 74세,2018,4992,2255,2737,82.4,4969,2246,2723,82.5
26,울산광역시,080,75~79세,2018,22972,9794,13178,74.3,22860,9756,13104,74.5
26,울산광역시,080001, 75세,2018,5326,2389,2937,81.3,5301,2378,2923,81.4
26,울산광역시,080002, 76세,2018,5648,2493,3155,79,5623,2485,3138,79.2
26,울산광역시,080003, 77세,2018,4212,1786,2426,73.6,4191,1778,2413,73.7
26,울산광역시,080004, 78세,2018,4001,1599,2402,66.6,3979,1593,2386,66.8
26,울산광역시,080005, 79세,2018,3785,1527,2258,67.6,3766,1522,2244,67.8
26,울산광역시,085,80~84세,2018,13216,4299,8917,48.2,13151,4285,8866,48.3
26,울산광역시,085001, 80세,2018,3278,1162,2116,54.9,3267,1158,2109,54.9
26,울산광역시,085002, 81세,2018,2899,965,1934,49.9,2878,962,1916,50.2
26,울산광역시,085003, 82세,2018,2598,813,1785,45.5,2585,808,1777,45.5
26,울산광역시,085004, 83세,2018,2362,728,1634,44.6,2351,726,1625,44.7
26,울산광역시,085005, 84세,2018,2079,631,1448,43.6,2070,631,1439,43.8
26,울산광역시,090,85~89세,2018,6067,1496,4571,32.7,6039,1492,4547,32.8
26,울산광역시,090001, 85세,2018,1744,498,1246,40,1738,498,1240,40.2
26,울산광역시,090002, 86세,2018,1447,365,1082,33.7,1442,364,1078,33.8
26,울산광역시,090003, 87세,2018,1125,250,875,28.6,1119,248,871,28.5
26,울산광역시,090004, 88세,2018,933,201,732,27.5,926,201,725,27.7
26,울산광역시,090005, 89세,2018,818,182,636,28.6,814,181,633,28.6
26,울산광역시,095,90~94세,2018,1966,288,1678,17.2,1962,286,1676,17.1
26,울산광역시,095001, 90세,2018,635,105,530,19.8,634,104,530,19.6
26,울산광역시,095002, 91세,2018,500,78,422,18.5,498,77,421,18.3
26,울산광역시,095003, 92세,2018,345,44,301,14.6,344,44,300,14.7
26,울산광역시,095004, 93세,2018,293,36,257,14,293,36,257,14
26,울산광역시,095005, 94세,2018,193,25,168,14.9,193,25,168,14.9
26,울산광역시,100,95~99세,2018,430,64,366,17.5,429,64,365,17.5
26,울산광역시,100001, 95세,2018,177,31,146,21.2,177,31,146,21.2
26,울산광역시,100002, 96세,2018,110,11,99,11.1,109,11,98,11.2
26,울산광역시,100003, 97세,2018,68,10,58,17.2,68,10,58,17.2
26,울산광역시,100004, 98세,2018,49,9,40,22.5,49,9,40,22.5
26,울산광역시,100005, 99세,2018,26,X,23,13,26,X,23,13
26,울산광역시,101,100세이상,2018,41,X,40,2.5,41,X,40,2.5
26,울산광역시,102,15세미만,2018,162859,84485,78374,107.8,161971,84039,77932,107.8
26,울산광역시,103,15~64세,2018,865831,457117,408714,111.8,840405,441379,399026,110.6
26,울산광역시,104,65세이상,2018,121426,54193,67233,80.6,120578,53845,66733,80.7
26,울산광역시,086,85세이상,2018,8504,1849,6655,27.8,8471,1843,6628,27.8
26,울산광역시,126,평균연령,2018,40.2,39.2,41.3,,40.2,39.2,41.3,
26,울산광역시,127,중위연령,2018,41.6,40.1,43.2,,41.7,40.3,43.3,
26004, 읍부,000,합계,2018,170611,89508,81103,110.4,163796,85151,78645,108.3
26004, 읍부,005,0~4세,2018,7582,3901,3681,106,7438,3832,3606,106.3
26004, 읍부,005001, 0세,2018,1257,648,609,106.4,1236,641,595,107.7
26004, 읍부,005002, 1세,2018,1378,735,643,114.3,1343,717,626,114.5
26004, 읍부,005003, 2세,2018,1508,756,752,100.5,1482,745,737,101.1
26004, 읍부,005004, 3세,2018,1706,884,822,107.5,1675,866,809,107
26004, 읍부,005005, 4세,2018,1733,878,855,102.7,1702,863,839,102.9
26004, 읍부,010,5~9세,2018,9282,4683,4599,101.8,9200,4640,4560,101.8
26004, 읍부,010001, 5세,2018,1747,872,875,99.7,1732,864,868,99.5
26004, 읍부,010002, 6세,2018,1959,975,984,99.1,1937,964,973,99.1
26004, 읍부,010003, 7세,2018,1923,982,941,104.4,1910,975,935,104.3
26004, 읍부,010004, 8세,2018,1884,962,922,104.3,1871,957,914,104.7
26004, 읍부,010005, 9세,2018,1769,892,877,101.7,1750,880,870,101.1
26004, 읍부,015,10~14세,2018,9555,4977,4578,108.7,9498,4946,4552,108.7
26004, 읍부,015001, 10세,2018,1958,1009,949,106.3,1939,995,944,105.4
26004, 읍부,015002, 11세,2018,1969,1038,931,111.5,1959,1032,927,111.3
26004, 읍부,015003, 12세,2018,1829,972,857,113.4,1816,967,849,113.9
26004, 읍부,015004, 13세,2018,1859,953,906,105.2,1849,951,898,105.9
26004, 읍부,015005, 14세,2018,1940,1005,935,107.5,1935,1001,934,107.2
26004, 읍부,020,15~19세,2018,10231,5574,4657,119.7,10116,5504,4612,119.3
26004, 읍부,020001, 15세,2018,1939,983,956,102.8,1931,980,951,103
26004, 읍부,020002, 16세,2018,1917,970,947,102.4,1907,966,941,102.7
26004, 읍부,020003, 17세,2018,2154,1108,1046,105.9,2140,1099,1041,105.6
26004, 읍부,020004, 18세,2018,2272,1293,979,132.1,2235,1269,966,131.4
26004, 읍부,020005, 19세,2018,1949,1220,729,167.4,1903,1190,713,166.9
26004, 읍부,025,20~24세,2018,11633,7000,4633,151.1,11121,6655,4466,149
26004, 읍부,025001, 20세,2018,2110,1356,754,179.8,2036,1305,731,178.5
26004, 읍부,025002, 21세,2018,2283,1378,905,152.3,2185,1317,868,151.7
26004, 읍부,025003, 22세,2018,2255,1319,936,140.9,2152,1247,905,137.8
26004, 읍부,025004, 23세,2018,2489,1450,1039,139.6,2376,1375,1001,137.4
26004, 읍부,025005, 24세,2018,2496,1497,999,149.8,2372,1411,961,146.8
26004, 읍부,030,25~29세,2018,10747,6349,4398,144.4,9880,5767,4113,140.2
26004, 읍부,030001, 25세,2018,2347,1431,916,156.2,2217,1346,871,154.5
26004, 읍부,030002, 26세,2018,2339,1384,955,144.9,2178,1278,900,142
26004, 읍부,030003, 27세,2018,2184,1279,905,141.3,2007,1157,850,136.1
26004, 읍부,030004, 28세,2018,1957,1140,817,139.5,1754,1004,750,133.9
26004, 읍부,030005, 29세,2018,1920,1115,805,138.5,1724,982,742,132.3
26004, 읍부,035,30~34세,2018,9841,5364,4477,119.8,8766,4606,4160,110.7
26004, 읍부,035001, 30세,2018,1760,985,775,127.1,1526,828,698,118.6
26004, 읍부,035002, 31세,2018,1956,1091,865,126.1,1726,929,797,116.6
26004, 읍부,035003, 32세,2018,1943,1061,882,120.3,1711,897,814,110.2
26004, 읍부,035004, 33세,2018,1988,1077,911,118.2,1758,909,849,107.1
26004, 읍부,035005, 34세,2018,2194,1150,1044,110.2,2045,1043,1002,104.1
26004, 읍부,040,35~39세,2018,13748,7175,6573,109.2,12961,6621,6340,104.4
26004, 읍부,040001, 35세,2018,2420,1311,1109,118.2,2231,1166,1065,109.5
26004, 읍부,040002, 36세,2018,2709,1400,1309,107,2549,1296,1253,103.4
26004, 읍부,040003, 37세,2018,2823,1537,1286,119.5,2657,1417,1240,114.3
26004, 읍부,040004, 38세,2018,2950,1460,1490,98,2817,1367,1450,94.3
26004, 읍부,040005, 39세,2018,2846,1467,1379,106.4,2707,1375,1332,103.2
26004, 읍부,045,40~44세,2018,14848,7530,7318,102.9,14189,7098,7091,100.1
26004, 읍부,045001, 40세,2018,2635,1355,1280,105.9,2491,1264,1227,103
26004, 읍부,045002, 41세,2018,2880,1439,1441,99.9,2777,1373,1404,97.8
26004, 읍부,045003, 42세,2018,2908,1504,1404,107.1,2767,1404,1363,103
26004, 읍부,045004, 43세,2018,3059,1529,1530,99.9,2923,1443,1480,97.5
26004, 읍부,045005, 44세,2018,3366,1703,1663,102.4,3231,1614,1617,99.8
26004, 읍부,050,45~49세,2018,17655,9043,8612,105,16868,8572,8296,103.3
26004, 읍부,050001, 45세,2018,3415,1704,1711,99.6,3275,1612,1663,96.9
26004, 읍부,050002, 46세,2018,3423,1746,1677,104.1,3278,1664,1614,103.1
26004, 읍부,050003, 47세,2018,3789,1948,1841,105.8,3613,1839,1774,103.7
26004, 읍부,050004, 48세,2018,3490,1778,1712,103.9,3322,1684,1638,102.8
26004, 읍부,050005, 49세,2018,3538,1867,1671,111.7,3380,1773,1607,110.3
26004, 읍부,055,50~54세,2018,15806,8481,7325,115.8,15045,8017,7028,114.1
26004, 읍부,055001, 50세,2018,3519,1877,1642,114.3,3360,1777,1583,112.3
26004, 읍부,055002, 51세,2018,3263,1700,1563,108.8,3128,1625,1503,108.1
26004, 읍부,055003, 52세,2018,3144,1691,1453,116.4,3000,1604,1396,114.9
26004, 읍부,055004, 53세,2018,3111,1700,1411,120.5,2950,1601,1349,118.7
26004, 읍부,055005, 54세,2018,2769,1513,1256,120.5,2607,1410,1197,117.8
26004, 읍부,060,55~59세,2018,13595,7376,6219,118.6,13072,7065,6007,117.6
26004, 읍부,060001, 55세,2018,2820,1557,1263,123.3,2661,1466,1195,122.7
26004, 읍부,060002, 56세,2018,2734,1488,1246,119.4,2618,1417,1201,118
26004, 읍부,060003, 57세,2018,2952,1581,1371,115.3,2879,1532,1347,113.7
26004, 읍부,060004, 58세,2018,2684,1469,1215,120.9,2586,1412,1174,120.3
26004, 읍부,060005, 59세,2018,2405,1281,1124,114,2328,1238,1090,113.6
26004, 읍부,065,60~64세,2018,9704,5030,4674,107.6,9439,4874,4565,106.8
26004, 읍부,065001, 60세,2018,2264,1170,1094,106.9,2198,1128,1070,105.4
26004, 읍부,065002, 61세,2018,2090,1110,980,113.3,2035,1077,958,112.4
26004, 읍부,065003, 62세,2018,1914,989,925,106.9,1850,951,899,105.8
26004, 읍부,065004, 63세,2018,1920,961,959,100.2,1881,940,941,99.9
26004, 읍부,065005, 64세,2018,1516,800,716,111.7,1475,778,697,111.6
26004, 읍부,070,65~69세,2018,5803,2908,2895,100.4,5708,2862,2846,100.6
26004, 읍부,070001, 65세,2018,1331,678,653,103.8,1309,666,643,103.6
26004, 읍부,070002, 66세,2018,1348,679,669,101.5,1324,667,657,101.5
26004, 읍부,070003, 67세,2018,1060,537,523,102.7,1045,531,514,103.3
26004, 읍부,070004, 68세,2018,1042,528,514,102.7,1022,517,505,102.4
26004, 읍부,070005, 69세,2018,1022,486,536,90.7,1008,481,527,91.3
26004, 읍부,075,70~74세,2018,3855,1851,2004,92.4,3822,1836,1986,92.4
26004, 읍부,075001, 70세,2018,1005,503,502,100.2,994,499,495,100.8
26004, 읍부,075002, 71세,2018,944,485,459,105.7,933,479,454,105.5
26004, 읍부,075003, 72세,2018,613,293,320,91.6,611,293,318,92.1
26004, 읍부,075004, 73세,2018,614,285,329,86.6,609,283,326,86.8
26004, 읍부,075005, 74세,2018,679,285,394,72.3,675,282,393,71.8
26004, 읍부,080,75~79세,2018,3369,1332,2037,65.4,3339,1325,2014,65.8
26004, 읍부,080001, 75세,2018,756,329,427,77,748,328,420,78.1
26004, 읍부,080002, 76세,2018,811,342,469,72.9,803,340,463,73.4
26004, 읍부,080003, 77세,2018,632,236,396,59.6,630,235,395,59.5
26004, 읍부,080004, 78세,2018,588,213,375,56.8,580,211,369,57.2
26004, 읍부,080005, 79세,2018,582,212,370,57.3,578,211,367,57.5
26004, 읍부,085,80~84세,2018,2040,662,1378,48,2026,661,1365,48.4
26004, 읍부,085001, 80세,2018,535,201,334,60.2,531,201,330,60.9
26004, 읍부,085002, 81세,2018,425,129,296,43.6,419,129,290,44.5
26004, 읍부,085003, 82세,2018,375,122,253,48.2,374,122,252,48.4
26004, 읍부,085004, 83세,2018,378,119,259,45.9,376,118,258,45.7
26004, 읍부,085005, 84세,2018,327,91,236,38.6,326,91,235,38.7
26004, 읍부,090,85~89세,2018,943,216,727,29.7,936,215,721,29.8
26004, 읍부,090001, 85세,2018,243,71,172,41.3,241,71,170,41.8
26004, 읍부,090002, 86세,2018,223,47,176,26.7,221,47,174,27
26004, 읍부,090003, 87세,2018,194,40,154,26,193,39,154,25.3
26004, 읍부,090004, 88세,2018,149,28,121,23.1,147,28,119,23.5
26004, 읍부,090005, 89세,2018,134,30,104,28.8,134,30,104,28.8
26004, 읍부,095,90~94세,2018,292,46,246,18.7,290,45,245,18.4
26004, 읍부,095001, 90세,2018,98,20,78,25.6,97,19,78,24.4
26004, 읍부,095002, 91세,2018,80,8,72,11.1,79,8,71,11.3
26004, 읍부,095003, 92세,2018,50,7,43,16.3,50,7,43,16.3
26004, 읍부,095004, 93세,2018,37,6,31,19.4,37,6,31,19.4
26004, 읍부,095005, 94세,2018,27,5,22,22.7,27,5,22,22.7
26004, 읍부,100,95~99세,2018,72,10,62,16.1,72,10,62,16.1
26004, 읍부,100001, 95세,2018,31,5,26,19.2,31,5,26,19.2
26004, 읍부,100002, 96세,2018,17,X,16,6.3,17,X,16,6.3
26004, 읍부,100003, 97세,2018,13,X,10,30,13,X,10,30
26004, 읍부,100004, 98세,2018,6,X,5,20,6,X,5,20
26004, 읍부,100005, 99세,2018,5,X,5,0,5,X,5,0
26004, 읍부,101,100세이상,2018,10,X,10,0,10,X,10,0
26004, 읍부,102,15세미만,2018,26419,13561,12858,105.5,26136,13418,12718,105.5
26004, 읍부,103,15~64세,2018,127808,68922,58886,117,121457,64779,56678,114.3
26004, 읍부,104,65세이상,2018,16384,7025,9359,75.1,16203,6954,9249,75.2
26004, 읍부,086,85세이상,2018,1317,272,1045,26,1308,270,1038,26
26004, 읍부,126,평균연령,2018,39.2,38.3,40.2,,39.2,38.2,40.2,
26004, 읍부,127,중위연령,2018,41,39.8,42.2,,41.2,40,42.2,
26005, 면부,000,합계,2018,54223,28658,25565,112.1,51182,26184,24998,104.7
26005, 면부,005,0~4세,2018,1557,847,710,119.3,1545,841,704,119.5
26005, 면부,005001, 0세,2018,307,176,131,134.4,305,176,129,136.4
26005, 면부,005002, 1세,2018,298,152,146,104.1,294,150,144,104.2
26005, 면부,005003, 2세,2018,325,174,151,115.2,323,173,150,115.3
26005, 면부,005004, 3세,2018,316,169,147,115,315,169,146,115.8
26005, 면부,005005, 4세,2018,311,176,135,130.4,308,173,135,128.1
26005, 면부,010,5~9세,2018,1421,734,687,106.8,1411,731,680,107.5
26005, 면부,010001, 5세,2018,282,134,148,90.5,280,134,146,91.8
26005, 면부,010002, 6세,2018,284,147,137,107.3,281,146,135,108.1
26005, 면부,010003, 7세,2018,302,164,138,118.8,301,163,138,118.1
26005, 면부,010004, 8세,2018,266,141,125,112.8,263,140,123,113.8
26005, 면부,010005, 9세,2018,287,148,139,106.5,286,148,138,107.2
26005, 면부,015,10~14세,2018,1452,778,674,115.4,1448,774,674,114.8
26005, 면부,015001, 10세,2018,287,149,138,108,287,149,138,108
26005, 면부,015002, 11세,2018,325,170,155,109.7,325,170,155,109.7
26005, 면부,015003, 12세,2018,261,129,132,97.7,261,129,132,97.7
26005, 면부,015004, 13세,2018,266,157,109,144,263,154,109,141.3
26005, 면부,015005, 14세,2018,313,173,140,123.6,312,172,140,122.9
26005, 면부,020,15~19세,2018,2202,1214,988,122.9,2177,1196,981,121.9
26005, 면부,020001, 15세,2018,340,182,158,115.2,338,181,157,115.3
26005, 면부,020002, 16세,2018,441,228,213,107,439,227,212,107.1
26005, 면부,020003, 17세,2018,425,257,168,153,421,254,167,152.1
26005, 면부,020004, 18세,2018,509,268,241,111.2,507,266,241,110.4
26005, 면부,020005, 19세,2018,487,279,208,134.1,472,268,204,131.4
26005, 면부,025,20~24세,2018,3093,1829,1264,144.7,2764,1534,1230,124.7
26005, 면부,025001, 20세,2018,545,304,241,126.1,518,280,238,117.6
26005, 면부,025002, 21세,2018,617,335,282,118.8,572,292,280,104.3
26005, 면부,025003, 22세,2018,597,348,249,139.8,531,293,238,123.1
26005, 면부,025004, 23세,2018,674,410,264,155.3,594,340,254,133.9
26005, 면부,025005, 24세,2018,660,432,228,189.5,549,329,220,149.5
26005, 면부,030,25~29세,2018,3547,2312,1235,187.2,2738,1621,1117,145.1
26005, 면부,030001, 25세,2018,712,471,241,195.4,570,345,225,153.3
26005, 면부,030002, 26세,2018,751,482,269,179.2,588,337,251,134.3
26005, 면부,030003, 27세,2018,705,455,250,182,540,315,225,140
26005, 면부,030004, 28세,2018,699,451,248,181.9,518,297,221,134.4
26005, 면부,030005, 29세,2018,680,453,227,199.6,522,327,195,167.7
26005, 면부,035,30~34세,2018,3327,2117,1210,175,2602,1487,1115,133.4
26005, 면부,035001, 30세,2018,664,444,220,201.8,520,316,204,154.9
26005, 면부,035002, 31세,2018,658,404,254,159.1,497,271,226,119.9
26005, 면부,035003, 32세,2018,663,413,250,165.2,529,298,231,129
26005, 면부,035004, 33세,2018,682,444,238,186.6,538,318,220,144.5
26005, 면부,035005, 34세,2018,660,412,248,166.1,518,284,234,121.4
26005, 면부,040,35~39세,2018,3521,2116,1405,150.6,3059,1735,1324,131
26005, 면부,040001, 35세,2018,673,414,259,159.8,552,310,242,128.1
26005, 면부,040002, 36세,2018,739,434,305,142.3,636,350,286,122.4
26005, 면부,040003, 37세,2018,761,452,309,146.3,658,364,294,123.8
26005, 면부,040004, 38세,2018,724,445,279,159.5,649,386,263,146.8
26005, 면부,040005, 39세,2018,624,371,253,146.6,564,325,239,136
26005, 면부,045,40~44세,2018,3131,1798,1333,134.9,2897,1616,1281,126.2
26005, 면부,045001, 40세,2018,594,364,230,158.3,529,312,217,143.8
26005, 면부,045002, 41세,2018,629,381,248,153.6,576,337,239,141
26005, 면부,045003, 42세,2018,598,346,252,137.3,548,309,239,129.3
26005, 면부,045004, 43세,2018,667,350,317,110.4,627,319,308,103.6
26005, 면부,045005, 44세,2018,643,357,286,124.8,617,339,278,121.9
26005, 면부,050,45~49세,2018,3980,2130,1850,115.1,3814,2020,1794,112.6
26005, 면부,050001, 45세,2018,727,398,329,121,698,376,322,116.8
26005, 면부,050002, 46세,2018,726,403,323,124.8,686,374,312,119.9
26005, 면부,050003, 47세,2018,841,441,400,110.3,803,417,386,108
26005, 면부,050004, 48세,2018,824,455,369,123.3,793,432,361,119.7
26005, 면부,050005, 49세,2018,862,433,429,100.9,834,421,413,101.9
26005, 면부,055,50~54세,2018,4730,2411,2319,104,4609,2340,2269,103.1
26005, 면부,055001, 50세,2018,946,446,500,89.2,921,433,488,88.7
26005, 면부,055002, 51세,2018,873,434,439,98.9,852,423,429,98.6
26005, 면부,055003, 52세,2018,934,507,427,118.7,901,486,415,117.1
26005, 면부,055004, 53세,2018,973,532,441,120.6,951,519,432,120.1
26005, 면부,055005, 54세,2018,1004,492,512,96.1,984,479,505,94.9
26005, 면부,060,55~59세,2018,5603,2872,2731,105.2,5534,2831,2703,104.7
26005, 면부,060001, 55세,2018,1025,535,490,109.2,1004,525,479,109.6
26005, 면부,060002, 56세,2018,1117,587,530,110.8,1101,575,526,109.3
26005, 면부,060003, 57세,2018,1181,598,583,102.6,1170,591,579,102.1
26005, 면부,060004, 58세,2018,1160,583,577,101,1150,578,572,101
26005, 면부,060005, 59세,2018,1120,569,551,103.3,1109,562,547,102.7
26005, 면부,065,60~64세,2018,5045,2575,2470,104.3,5007,2554,2453,104.1
26005, 면부,065001, 60세,2018,1105,564,541,104.3,1095,558,537,103.9
26005, 면부,065002, 61세,2018,1078,546,532,102.6,1072,542,530,102.3
26005, 면부,065003, 62세,2018,1021,537,484,111,1013,534,479,111.5
26005, 면부,065004, 63세,2018,968,470,498,94.4,961,467,494,94.5
26005, 면부,065005, 64세,2018,873,458,415,110.4,866,453,413,109.7
26005, 면부,070,65~69세,2018,3621,1770,1851,95.6,3598,1756,1842,95.3
26005, 면부,070001, 65세,2018,806,374,432,86.6,800,370,430,86
26005, 면부,070002, 66세,2018,808,374,434,86.2,802,369,433,85.2
26005, 면부,070003, 67세,2018,657,333,324,102.8,650,328,322,101.9
26005, 면부,070004, 68세,2018,688,356,332,107.2,686,356,330,107.9
26005, 면부,070005, 69세,2018,662,333,329,101.2,660,333,327,101.8
26005, 면부,075,70~74세,2018,2666,1298,1368,94.9,2660,1296,1364,95
26005, 면부,075001, 70세,2018,660,337,323,104.3,657,336,321,104.7
26005, 면부,075002, 71세,2018,591,304,287,105.9,591,304,287,105.9
26005, 면부,075003, 72세,2018,455,225,230,97.8,454,225,229,98.3
26005, 면부,075004, 73세,2018,502,235,267,88,500,234,266,88
26005, 면부,075005, 74세,2018,458,197,261,75.5,458,197,261,75.5
26005, 면부,080,75~79세,2018,2440,995,1445,68.9,2435,993,1442,68.9
26005, 면부,080001, 75세,2018,523,223,300,74.3,523,223,300,74.3
26005, 면부,080002, 76세,2018,579,238,341,69.8,578,237,341,69.5
26005, 면부,080003, 77세,2018,459,189,270,70,457,189,268,70.5
26005, 면부,080004, 78세,2018,454,184,270,68.1,453,184,269,68.4
26005, 면부,080005, 79세,2018,425,161,264,61,424,160,264,60.6
26005, 면부,085,80~84세,2018,1650,555,1095,50.7,1647,552,1095,50.4
26005, 면부,085001, 80세,2018,382,130,252,51.6,380,128,252,50.8
26005, 면부,085002, 81세,2018,360,132,228,57.9,360,132,228,57.9
26005, 면부,085003, 82세,2018,314,109,205,53.2,314,109,205,53.2
26005, 면부,085004, 83세,2018,304,95,209,45.5,303,94,209,45
26005, 면부,085005, 84세,2018,290,89,201,44.3,290,89,201,44.3
26005, 면부,090,85~89세,2018,864,229,635,36.1,864,229,635,36.1
26005, 면부,090001, 85세,2018,238,59,179,33,238,59,179,33
26005, 면부,090002, 86세,2018,226,66,160,41.3,226,66,160,41.3
26005, 면부,090003, 87세,2018,162,48,114,42.1,162,48,114,42.1
26005, 면부,090004, 88세,2018,123,28,95,29.5,123,28,95,29.5
26005, 면부,090005, 89세,2018,115,28,87,32.2,115,28,87,32.2
26005, 면부,095,90~94세,2018,317,65,252,25.8,317,65,252,25.8
26005, 면부,095001, 90세,2018,106,25,81,30.9,106,25,81,30.9
26005, 면부,095002, 91세,2018,74,22,52,42.3,74,22,52,42.3
26005, 면부,095003, 92세,2018,59,10,49,20.4,59,10,49,20.4
26005, 면부,095004, 93세,2018,46,6,40,15,46,6,40,15
26005, 면부,095005, 94세,2018,32,X,30,6.7,32,X,30,6.7
26005, 면부,100,95~99세,2018,49,13,36,36.1,49,13,36,36.1
26005, 면부,100001, 95세,2018,25,8,17,47.1,25,8,17,47.1
26005, 면부,100002, 96세,2018,11,X,8,37.5,11,X,8,37.5
26005, 면부,100003, 97세,2018,9,X,8,12.5,9,X,8,12.5
26005, 면부,100004, 98세,2018,X,X,X,0,X,X,X,0
26005, 면부,100005, 99세,2018,X,X,X,50,X,X,X,50
26005, 면부,101,100세이상,2018,7,X,7,0,7,X,7,0
26005, 면부,102,15세미만,2018,4430,2359,2071,113.9,4404,2346,2058,114
26005, 면부,103,15~64세,2018,38179,21374,16805,127.2,35201,18934,16267,116.4
26005, 면부,104,65세이상,2018,11614,4925,6689,73.6,11577,4904,6673,73.5
26005, 면부,086,85세이상,2018,1237,307,930,33,1237,307,930,33
26005, 면부,126,평균연령,2018,47.2,44.8,49.8,,48,45.9,50.1,
26005, 면부,127,중위연령,2018,49.9,46.5,53.1,,51.3,48.9,53.6,
26003, 동부,000,합계,2018,925282,477629,447653,106.7,907976,467928,440048,106.3
26003, 동부,005,0~4세,2018,42188,21676,20512,105.7,41887,21525,20362,105.7
26003, 동부,005001, 0세,2018,6753,3444,3309,104.1,6701,3415,3286,103.9
26003, 동부,005002, 1세,2018,7789,4020,3769,106.7,7725,3990,3735,106.8
26003, 동부,005003, 2세,2018,9033,4673,4360,107.2,8969,4644,4325,107.4
26003, 동부,005004, 3세,2018,9339,4833,4506,107.3,9281,4805,4476,107.4
26003, 동부,005005, 4세,2018,9274,4706,4568,103,9211,4671,4540,102.9
26003, 동부,010,5~9세,2018,46404,24140,22264,108.4,46241,24058,22183,108.5
26003, 동부,010001, 5세,2018,9217,4718,4499,104.9,9176,4700,4476,105
26003, 동부,010002, 6세,2018,9765,5064,4701,107.7,9730,5045,4685,107.7
26003, 동부,010003, 7세,2018,9501,4924,4577,107.6,9469,4906,4563,107.5
26003, 동부,010004, 8세,2018,9165,4834,4331,111.6,9133,4823,4310,111.9
26003, 동부,010005, 9세,2018,8756,4600,4156,110.7,8733,4584,4149,110.5
26003, 동부,015,10~14세,2018,43418,22749,20669,110.1,43303,22692,20611,110.1
26003, 동부,015001, 10세,2018,9126,4706,4420,106.5,9103,4689,4414,106.2
26003, 동부,015002, 11세,2018,9206,4836,4370,110.7,9176,4820,4356,110.7
26003, 동부,015003, 12세,2018,8280,4279,4001,106.9,8265,4275,3990,107.1
26003, 동부,015004, 13세,2018,8065,4272,3793,112.6,8043,4261,3782,112.7
26003, 동부,015005, 14세,2018,8741,4656,4085,114,8716,4647,4069,114.2
26003, 동부,020,15~19세,2018,50622,27645,22977,120.3,50305,27481,22824,120.4
26003, 동부,020001, 15세,2018,9056,4873,4183,116.5,9048,4873,4175,116.7
26003, 동부,020002, 16세,2018,9406,4986,4420,112.8,9379,4975,4404,113
26003, 동부,020003, 17세,2018,11129,5963,5166,115.4,11100,5948,5152,115.5
26003, 동부,020004, 18세,2018,11998,6436,5562,115.7,11926,6395,5531,115.6
26003, 동부,020005, 19세,2018,9033,5387,3646,147.8,8852,5290,3562,148.5
26003, 동부,025,20~24세,2018,58340,33766,24574,137.4,56709,32915,23794,138.3
26003, 동부,025001, 20세,2018,10482,6386,4096,155.9,10250,6264,3986,157.2
26003, 동부,025002, 21세,2018,11588,6974,4614,151.1,11290,6792,4498,151
26003, 동부,025003, 22세,2018,11764,6765,4999,135.3,11465,6629,4836,137.1
26003, 동부,025004, 23세,2018,12116,6719,5397,124.5,11738,6529,5209,125.3
26003, 동부,025005, 24세,2018,12390,6922,5468,126.6,11966,6701,5265,127.3
26003, 동부,030,25~29세,2018,62667,34933,27734,126,60063,33435,26628,125.6
26003, 동부,030001, 25세,2018,12824,7159,5665,126.4,12382,6929,5453,127.1
26003, 동부,030002, 26세,2018,12931,7293,5638,129.4,12468,7022,5446,128.9
26003, 동부,030003, 27세,2018,12584,6867,5717,120.1,12013,6541,5472,119.5
26003, 동부,030004, 28세,2018,12211,6860,5351,128.2,11627,6512,5115,127.3
26003, 동부,030005, 29세,2018,12117,6754,5363,125.9,11573,6431,5142,125.1
26003, 동부,035,30~34세,2018,61543,33226,28317,117.3,58793,31621,27172,116.4
26003, 동부,035001, 30세,2018,11769,6587,5182,127.1,11173,6242,4931,126.6
26003, 동부,035002, 31세,2018,11838,6415,5423,118.3,11269,6098,5171,117.9
26003, 동부,035003, 32세,2018,12164,6542,5622,116.4,11591,6198,5393,114.9
26003, 동부,035004, 33세,2018,12414,6585,5829,113,11914,6293,5621,112
26003, 동부,035005, 34세,2018,13358,7097,6261,113.4,12846,6790,6056,112.1
26003, 동부,040,35~39세,2018,79654,41612,38042,109.4,77573,40334,37239,108.3
26003, 동부,040001, 35세,2018,14971,7778,7193,108.1,14491,7481,7010,106.7
26003, 동부,040002, 36세,2018,16154,8344,7810,106.8,15723,8087,7636,105.9
26003, 동부,040003, 37세,2018,16234,8601,7633,112.7,15831,8336,7495,111.2
26003, 동부,040004, 38세,2018,16891,8831,8060,109.6,16510,8615,7895,109.1
26003, 동부,040005, 39세,2018,15404,8058,7346,109.7,15018,7815,7203,108.5
26003, 동부,045,40~44세,2018,71696,36959,34737,106.4,70162,36066,34096,105.8
26003, 동부,045001, 40세,2018,14206,7492,6714,111.6,13869,7318,6551,111.7
26003, 동부,045002, 41세,2018,14359,7485,6874,108.9,14033,7283,6750,107.9
26003, 동부,045003, 42세,2018,13389,6991,6398,109.3,13116,6822,6294,108.4
26003, 동부,045004, 43세,2018,14339,7310,7029,104,14043,7140,6903,103.4
26003, 동부,045005, 44세,2018,15403,7681,7722,99.5,15101,7503,7598,98.7
26003, 동부,050,45~49세,2018,84006,41374,42632,97,82295,40386,41909,96.4
26003, 동부,050001, 45세,2018,15843,7859,7984,98.4,15550,7692,7858,97.9
26003, 동부,050002, 46세,2018,16029,7929,8100,97.9,15690,7731,7959,97.1
26003, 동부,050003, 47세,2018,17264,8538,8726,97.8,16882,8326,8556,97.3
26003, 동부,050004, 48세,2018,17148,8360,8788,95.1,16793,8143,8650,94.1
26003, 동부,050005, 49세,2018,17722,8688,9034,96.2,17380,8494,8886,95.6
26003, 동부,055,50~54세,2018,85898,43293,42605,101.6,84317,42424,41893,101.3
26003, 동부,055001, 50세,2018,18133,8853,9280,95.4,17764,8643,9121,94.8
26003, 동부,055002, 51세,2018,17126,8313,8813,94.3,16866,8177,8689,94.1
26003, 동부,055003, 52세,2018,17349,9046,8303,108.9,17029,8857,8172,108.4
26003, 동부,055004, 53세,2018,17431,8924,8507,104.9,17115,8754,8361,104.7
26003, 동부,055005, 54세,2018,15859,8157,7702,105.9,15543,7993,7550,105.9
26003, 동부,060,55~59세,2018,84196,43118,41078,105,83022,42487,40535,104.8
26003, 동부,060001, 55세,2018,16554,8590,7964,107.9,16214,8401,7813,107.5
26003, 동부,060002, 56세,2018,17023,8857,8166,108.5,16782,8742,8040,108.7
26003, 동부,060003, 57세,2018,18237,9292,8945,103.9,18057,9195,8862,103.8
26003, 동부,060004, 58세,2018,17079,8554,8525,100.3,16836,8419,8417,100
26003, 동부,060005, 59세,2018,15303,7825,7478,104.6,15133,7730,7403,104.4
26003, 동부,065,60~64세,2018,61222,30895,30327,101.9,60508,30517,29991,101.8
26003, 동부,065001, 60세,2018,14095,7258,6837,106.2,13934,7175,6759,106.2
26003, 동부,065002, 61세,2018,13353,6736,6617,101.8,13190,6643,6547,101.5
26003, 동부,065003, 62세,2018,12094,6039,6055,99.7,11969,5977,5992,99.7
26003, 동부,065004, 63세,2018,11882,5914,5968,99.1,11735,5836,5899,98.9
26003, 동부,065005, 64세,2018,9798,4948,4850,102,9680,4886,4794,101.9
26003, 동부,070,65~69세,2018,37451,19024,18427,103.2,37095,18862,18233,103.4
26003, 동부,070001, 65세,2018,8748,4397,4351,101.1,8653,4354,4299,101.3
26003, 동부,070002, 66세,2018,8817,4504,4313,104.4,8738,4468,4270,104.6
26003, 동부,070003, 67세,2018,6804,3471,3333,104.1,6723,3434,3289,104.4
26003, 동부,070004, 68세,2018,6631,3346,3285,101.9,6585,3326,3259,102.1
26003, 동부,070005, 69세,2018,6451,3306,3145,105.1,6396,3280,3116,105.3
26003, 동부,075,70~74세,2018,23338,11400,11938,95.5,23213,11349,11864,95.7
26003, 동부,075001, 70세,2018,6279,3136,3143,99.8,6249,3118,3131,99.6
26003, 동부,075002, 71세,2018,5570,2745,2825,97.2,5535,2732,2803,97.5
26003, 동부,075003, 72세,2018,3836,1912,1924,99.4,3813,1904,1909,99.7
26003, 동부,075004, 73세,2018,3798,1834,1964,93.4,3780,1828,1952,93.6
26003, 동부,075005, 74세,2018,3855,1773,2082,85.2,3836,1767,2069,85.4
26003, 동부,080,75~79세,2018,17163,7467,9696,77,17086,7438,9648,77.1
26003, 동부,080001, 75세,2018,4047,1837,2210,83.1,4030,1827,2203,82.9
26003, 동부,080002, 76세,2018,4258,1913,2345,81.6,4242,1908,2334,81.7
26003, 동부,080003, 77세,2018,3121,1361,1760,77.3,3104,1354,1750,77.4
26003, 동부,080004, 78세,2018,2959,1202,1757,68.4,2946,1198,1748,68.5
26003, 동부,080005, 79세,2018,2778,1154,1624,71.1,2764,1151,1613,71.4
26003, 동부,085,80~84세,2018,9526,3082,6444,47.8,9478,3072,6406,48
26003, 동부,085001, 80세,2018,2361,831,1530,54.3,2356,829,1527,54.3
26003, 동부,085002, 81세,2018,2114,704,1410,49.9,2099,701,1398,50.1
26003, 동부,085003, 82세,2018,1909,582,1327,43.9,1897,577,1320,43.7
26003, 동부,085004, 83세,2018,1680,514,1166,44.1,1672,514,1158,44.4
26003, 동부,085005, 84세,2018,1462,451,1011,44.6,1454,451,1003,45
26003, 동부,090,85~89세,2018,4260,1051,3209,32.8,4239,1048,3191,32.8
26003, 동부,090001, 85세,2018,1263,368,895,41.1,1259,368,891,41.3
26003, 동부,090002, 86세,2018,998,252,746,33.8,995,251,744,33.7
26003, 동부,090003, 87세,2018,769,162,607,26.7,764,161,603,26.7
26003, 동부,090004, 88세,2018,661,145,516,28.1,656,145,511,28.4
26003, 동부,090005, 89세,2018,569,124,445,27.9,565,123,442,27.8
26003, 동부,095,90~94세,2018,1357,177,1180,15,1355,176,1179,14.9
26003, 동부,095001, 90세,2018,431,60,371,16.2,431,60,371,16.2
26003, 동부,095002, 91세,2018,346,48,298,16.1,345,47,298,15.8
26003, 동부,095003, 92세,2018,236,27,209,12.9,235,27,208,13
26003, 동부,095004, 93세,2018,210,24,186,12.9,210,24,186,12.9
26003, 동부,095005, 94세,2018,134,18,116,15.5,134,18,116,15.5
26003, 동부,100,95~99세,2018,309,41,268,15.3,308,41,267,15.4
26003, 동부,100001, 95세,2018,121,18,103,17.5,121,18,103,17.5
26003, 동부,100002, 96세,2018,82,7,75,9.3,81,7,74,9.5
26003, 동부,100003, 97세,2018,46,6,40,15,46,6,40,15
26003, 동부,100004, 98세,2018,42,8,34,23.5,42,8,34,23.5
26003, 동부,100005, 99세,2018,18,X,16,12.5,18,X,16,12.5
26003, 동부,101,100세이상,2018,24,X,23,4.3,24,X,23,4.3
26003, 동부,102,15세미만,2018,132010,68565,63445,108.1,131431,68275,63156,108.1
26003, 동부,103,15~64세,2018,699844,366821,333023,110.1,683747,357666,326081,109.7
26003, 동부,104,65세이상,2018,93428,42243,51185,82.5,92798,41987,50811,82.6
26003, 동부,086,85세이상,2018,5950,1270,4680,27.1,5926,1266,4660,27.2
26003, 동부,126,평균연령,2018,40,39,41,,40,39,41,
26003, 동부,127,중위연령,2018,41.3,39.9,42.8,,41.4,40,42.9,
26010, 중구,000,합계,2018,227054,115519,111535,103.6,224067,114211,109856,104
26010, 중구,005,0~4세,2018,9249,4797,4452,107.7,9179,4758,4421,107.6
26010, 중구,005001, 0세,2018,1467,774,693,111.7,1452,765,687,111.4
26010, 중구,005002, 1세,2018,1713,888,825,107.6,1705,886,819,108.2
26010, 중구,005003, 2세,2018,1968,1021,947,107.8,1954,1016,938,108.3
26010, 중구,005004, 3세,2018,2001,1046,955,109.5,1986,1035,951,108.8
26010, 중구,005005, 4세,2018,2100,1068,1032,103.5,2082,1056,1026,102.9
26010, 중구,010,5~9세,2018,10629,5640,4989,113,10599,5626,4973,113.1
26010, 중구,010001, 5세,2018,2112,1096,1016,107.9,2100,1093,1007,108.5
26010, 중구,010002, 6세,2018,2210,1201,1009,119,2205,1197,1008,118.8
26010, 중구,010003, 7세,2018,2224,1155,1069,108,2222,1153,1069,107.9
26010, 중구,010004, 8세,2018,2094,1114,980,113.7,2091,1113,978,113.8
26010, 중구,010005, 9세,2018,1989,1074,915,117.4,1981,1070,911,117.5
26010, 중구,015,10~14세,2018,9827,5204,4623,112.6,9807,5195,4612,112.6
26010, 중구,015001, 10세,2018,2044,1057,987,107.1,2042,1055,987,106.9
26010, 중구,015002, 11세,2018,2102,1114,988,112.8,2096,1110,986,112.6
26010, 중구,015003, 12세,2018,1852,976,876,111.4,1849,976,873,111.8
26010, 중구,015004, 13세,2018,1835,982,853,115.1,1831,981,850,115.4
26010, 중구,015005, 14세,2018,1994,1075,919,117,1989,1073,916,117.1
26010, 중구,020,15~19세,2018,11610,6330,5280,119.9,11568,6314,5254,120.2
26010, 중구,020001, 15세,2018,2126,1127,999,112.8,2123,1127,996,113.2
26010, 중구,020002, 16세,2018,2145,1108,1037,106.8,2135,1103,1032,106.9
26010, 중구,020003, 17세,2018,2585,1380,1205,114.5,2577,1377,1200,114.8
26010, 중구,020004, 18세,2018,2803,1500,1303,115.1,2799,1499,1300,115.3
26010, 중구,020005, 19세,2018,1951,1215,736,165.1,1934,1208,726,166.4
26010, 중구,025,20~24세,2018,13863,8038,5825,138,13673,7988,5685,140.5
26010, 중구,025001, 20세,2018,2501,1548,953,162.4,2483,1544,939,164.4
26010, 중구,025002, 21세,2018,2700,1658,1042,159.1,2671,1651,1020,161.9
26010, 중구,025003, 22세,2018,2798,1637,1161,141,2765,1627,1138,143
26010, 중구,025004, 23세,2018,2889,1567,1322,118.5,2833,1556,1277,121.8
26010, 중구,025005, 24세,2018,2975,1628,1347,120.9,2921,1610,1311,122.8
26010, 중구,030,25~29세,2018,14548,7927,6621,119.7,14228,7839,6389,122.7
26010, 중구,030001, 25세,2018,3061,1675,1386,120.9,3007,1666,1341,124.2
26010, 중구,030002, 26세,2018,2941,1625,1316,123.5,2893,1614,1279,126.2
26010, 중구,030003, 27세,2018,2987,1599,1388,115.2,2917,1574,1343,117.2
26010, 중구,030004, 28세,2018,2835,1549,1286,120.5,2755,1520,1235,123.1
26010, 중구,030005, 29세,2018,2724,1479,1245,118.8,2656,1465,1191,123
26010, 중구,035,30~34세,2018,13357,6991,6366,109.8,12963,6834,6129,111.5
26010, 중구,035001, 30세,2018,2622,1404,1218,115.3,2544,1375,1169,117.6
26010, 중구,035002, 31세,2018,2536,1336,1200,111.3,2449,1303,1146,113.7
26010, 중구,035003, 32세,2018,2614,1404,1210,116,2528,1363,1165,117
26010, 중구,035004, 33세,2018,2674,1337,1337,100,2610,1312,1298,101.1
26010, 중구,035005, 34세,2018,2911,1510,1401,107.8,2832,1481,1351,109.6
26010, 중구,040,35~39세,2018,17916,9228,8688,106.2,17602,9079,8523,106.5
26010, 중구,040001, 35세,2018,3304,1706,1598,106.8,3243,1677,1566,107.1
26010, 중구,040002, 36세,2018,3611,1824,1787,102.1,3544,1794,1750,102.5
26010, 중구,040003, 37세,2018,3559,1843,1716,107.4,3503,1817,1686,107.8
26010, 중구,040004, 38세,2018,3843,1985,1858,106.8,3784,1960,1824,107.5
26010, 중구,040005, 39세,2018,3599,1870,1729,108.2,3528,1831,1697,107.9
26010, 중구,045,40~44세,2018,16601,8529,8072,105.7,16343,8417,7926,106.2
26010, 중구,045001, 40세,2018,3252,1706,1546,110.3,3179,1686,1493,112.9
26010, 중구,045002, 41세,2018,3283,1713,1570,109.1,3236,1690,1546,109.3
26010, 중구,045003, 42세,2018,3066,1569,1497,104.8,3030,1553,1477,105.1
26010, 중구,045004, 43세,2018,3343,1701,1642,103.6,3295,1678,1617,103.8
26010, 중구,045005, 44세,2018,3657,1840,1817,101.3,3603,1810,1793,100.9
26010, 중구,050,45~49세,2018,20401,9943,10458,95.1,20080,9785,10295,95
26010, 중구,050001, 45세,2018,3838,1908,1930,98.9,3787,1887,1900,99.3
26010, 중구,050002, 46세,2018,3937,1939,1998,97,3877,1908,1969,96.9
26010, 중구,050003, 47세,2018,4214,2076,2138,97.1,4135,2041,2094,97.5
26010, 중구,050004, 48세,2018,4090,1962,2128,92.2,4021,1917,2104,91.1
26010, 중구,050005, 49세,2018,4322,2058,2264,90.9,4260,2032,2228,91.2
26010, 중구,055,50~54세,2018,21568,10769,10799,99.7,21195,10575,10620,99.6
26010, 중구,055001, 50세,2018,4456,2156,2300,93.7,4381,2115,2266,93.3
26010, 중구,055002, 51세,2018,4245,2083,2162,96.3,4184,2052,2132,96.2
26010, 중구,055003, 52세,2018,4281,2189,2092,104.6,4203,2145,2058,104.2
26010, 중구,055004, 53세,2018,4445,2221,2224,99.9,4367,2178,2189,99.5
26010, 중구,055005, 54세,2018,4141,2120,2021,104.9,4060,2085,1975,105.6
26010, 중구,060,55~59세,2018,21844,10981,10863,101.1,21566,10836,10730,101
26010, 중구,060001, 55세,2018,4139,2079,2060,100.9,4061,2041,2020,101
26010, 중구,060002, 56세,2018,4416,2300,2116,108.7,4356,2265,2091,108.3
26010, 중구,060003, 57세,2018,4816,2426,2390,101.5,4771,2404,2367,101.6
26010, 중구,060004, 58세,2018,4408,2146,2262,94.9,4354,2122,2232,95.1
26010, 중구,060005, 59세,2018,4065,2030,2035,99.8,4024,2004,2020,99.2
26010, 중구,065,60~64세,2018,17055,8357,8698,96.1,16857,8255,8602,96
26010, 중구,065001, 60세,2018,3816,1932,1884,102.5,3770,1911,1859,102.8
26010, 중구,065002, 61세,2018,3658,1833,1825,100.4,3617,1812,1805,100.4
26010, 중구,065003, 62세,2018,3426,1644,1782,92.3,3382,1621,1761,92
26010, 중구,065004, 63세,2018,3340,1556,1784,87.2,3302,1532,1770,86.6
26010, 중구,065005, 64세,2018,2815,1392,1423,97.8,2786,1379,1407,98
26010, 중구,070,65~69세,2018,11245,5579,5666,98.5,11135,5531,5604,98.7
26010, 중구,070001, 65세,2018,2590,1255,1335,94,2563,1243,1320,94.2
26010, 중구,070002, 66세,2018,2607,1282,1325,96.8,2582,1271,1311,96.9
26010, 중구,070003, 67세,2018,2070,1043,1027,101.6,2046,1034,1012,102.2
26010, 중구,070004, 68세,2018,1945,961,984,97.7,1931,954,977,97.6
26010, 중구,070005, 69세,2018,2033,1038,995,104.3,2013,1029,984,104.6
26010, 중구,075,70~74세,2018,7215,3369,3846,87.6,7184,3354,3830,87.6
26010, 중구,075001, 70세,2018,1850,871,979,89,1842,865,977,88.5
26010, 중구,075002, 71세,2018,1733,809,924,87.6,1719,803,916,87.7
26010, 중구,075003, 72세,2018,1118,557,561,99.3,1116,556,560,99.3
26010, 중구,075004, 73세,2018,1223,588,635,92.6,1220,587,633,92.7
26010, 중구,075005, 74세,2018,1291,544,747,72.8,1287,543,744,73
26010, 중구,080,75~79세,2018,5541,2413,3128,77.1,5526,2405,3121,77.1
26010, 중구,080001, 75세,2018,1303,602,701,85.9,1296,598,698,85.7
26010, 중구,080002, 76세,2018,1359,598,761,78.6,1358,598,760,78.7
26010, 중구,080003, 77세,2018,1014,444,570,77.9,1011,441,570,77.4
26010, 중구,080004, 78세,2018,967,397,570,69.6,966,396,570,69.5
26010, 중구,080005, 79세,2018,898,372,526,70.7,895,372,523,71.1
26010, 중구,085,80~84세,2018,2901,1023,1878,54.5,2890,1021,1869,54.6
26010, 중구,085001, 80세,2018,745,279,466,59.9,744,279,465,60
26010, 중구,085002, 81세,2018,638,230,408,56.4,638,230,408,56.4
26010, 중구,085003, 82세,2018,636,210,426,49.3,631,208,423,49.2
26010, 중구,085004, 83세,2018,493,170,323,52.6,490,170,320,53.1
26010, 중구,085005, 84세,2018,389,134,255,52.5,387,134,253,53
26010, 중구,090,85~89세,2018,1265,345,920,37.5,1255,343,912,37.6
26010, 중구,090001, 85세,2018,395,124,271,45.8,393,124,269,46.1
26010, 중구,090002, 86세,2018,297,79,218,36.2,294,78,216,36.1
26010, 중구,090003, 87세,2018,239,58,181,32,237,58,179,32.4
26010, 중구,090004, 88세,2018,169,43,126,34.1,168,43,125,34.4
26010, 중구,090005, 89세,2018,165,41,124,33.1,163,40,123,32.5
26010, 중구,095,90~94세,2018,348,45,303,14.9,347,45,302,14.9
26010, 중구,095001, 90세,2018,123,16,107,15,123,16,107,15
26010, 중구,095002, 91세,2018,89,14,75,18.7,89,14,75,18.7
26010, 중구,095003, 92세,2018,59,7,52,13.5,58,7,51,13.7
26010, 중구,095004, 93세,2018,49,6,43,14,49,6,43,14
26010, 중구,095005, 94세,2018,28,X,26,7.7,28,X,26,7.7
26010, 중구,100,95~99세,2018,67,10,57,17.5,66,10,56,17.9
26010, 중구,100001, 95세,2018,27,5,22,22.7,27,5,22,22.7
26010, 중구,100002, 96세,2018,17,X,17,0,16,X,16,0
26010, 중구,100003, 97세,2018,6,X,X,50,6,X,X,50
26010, 중구,100004, 98세,2018,10,X,7,42.9,10,X,7,42.9
26010, 중구,100005, 99세,2018,7,X,7,0,7,X,7,0
26010, 중구,101,100세이상,2018,X,X,X,33.3,X,X,X,33.3
26010, 중구,102,15세미만,2018,29705,15641,14064,111.2,29585,15579,14006,111.2
26010, 중구,103,15~64세,2018,168763,87093,81670,106.6,166075,85922,80153,107.2
26010, 중구,104,65세이상,2018,28586,12785,15801,80.9,28407,12710,15697,81
26010, 중구,086,85세이상,2018,1684,401,1283,31.3,1672,399,1273,31.3
26010, 중구,126,평균연령,2018,41.7,40.5,43,,41.7,40.5,43,
26010, 중구,127,중위연령,2018,43.9,42.1,45.4,,43.9,42.1,45.5,
26020, 남구,000,합계,2018,327561,167350,160211,104.5,320765,163780,156985,104.3
26020, 남구,005,0~4세,2018,12249,6285,5964,105.4,12123,6221,5902,105.4
26020, 남구,005001, 0세,2018,2023,998,1025,97.4,2006,988,1018,97.1
26020, 남구,005002, 1세,2018,2285,1171,1114,105.1,2252,1152,1100,104.7
26020, 남구,005003, 2세,2018,2591,1356,1235,109.8,2565,1344,1221,110.1
26020, 남구,005004, 3세,2018,2748,1423,1325,107.4,2722,1413,1309,107.9
26020, 남구,005005, 4세,2018,2602,1337,1265,105.7,2578,1324,1254,105.6
26020, 남구,010,5~9세,2018,13760,7111,6649,106.9,13695,7075,6620,106.9
26020, 남구,010001, 5세,2018,2659,1334,1325,100.7,2645,1327,1318,100.7
26020, 남구,010002, 6세,2018,2861,1460,1401,104.2,2853,1457,1396,104.4
26020, 남구,010003, 7세,2018,2804,1478,1326,111.5,2789,1469,1320,111.3
26020, 남구,010004, 8세,2018,2706,1435,1271,112.9,2690,1428,1262,113.2
26020, 남구,010005, 9세,2018,2730,1404,1326,105.9,2718,1394,1324,105.3
26020, 남구,015,10~14세,2018,14587,7698,6889,111.7,14536,7678,6858,112
26020, 남구,015001, 10세,2018,2913,1499,1414,106,2900,1490,1410,105.7
26020, 남구,015002, 11세,2018,2930,1582,1348,117.4,2914,1576,1338,117.8
26020, 남구,015003, 12세,2018,2759,1415,1344,105.3,2754,1414,1340,105.5
26020, 남구,015004, 13세,2018,2762,1480,1282,115.4,2751,1476,1275,115.8
26020, 남구,015005, 14세,2018,3223,1722,1501,114.7,3217,1722,1495,115.2
26020, 남구,020,15~19세,2018,18542,10069,8473,118.8,18369,9975,8394,118.8
26020, 남구,020001, 15세,2018,3141,1692,1449,116.8,3137,1692,1445,117.1
26020, 남구,020002, 16세,2018,3210,1691,1519,111.3,3200,1687,1513,111.5
26020, 남구,020003, 17세,2018,3982,2121,1861,114,3969,2114,1855,114
26020, 남구,020004, 18세,2018,4354,2327,2027,114.8,4314,2303,2011,114.5
26020, 남구,020005, 19세,2018,3855,2238,1617,138.4,3749,2179,1570,138.8
26020, 남구,025,20~24세,2018,23374,13409,9965,134.6,22584,13018,9566,136.1
26020, 남구,025001, 20세,2018,4103,2435,1668,146,3971,2373,1598,148.5
26020, 남구,025002, 21세,2018,4684,2800,1884,148.6,4519,2692,1827,147.3
26020, 남구,025003, 22세,2018,4744,2641,2103,125.6,4598,2578,2020,127.6
26020, 남구,025004, 23세,2018,4915,2775,2140,129.7,4743,2694,2049,131.5
26020, 남구,025005, 24세,2018,4928,2758,2170,127.1,4753,2681,2072,129.4
26020, 남구,030,25~29세,2018,23707,13126,10581,124.1,22763,12639,10124,124.8
26020, 남구,030001, 25세,2018,5088,2825,2263,124.8,4919,2750,2169,126.8
26020, 남구,030002, 26세,2018,5085,2895,2190,132.2,4918,2811,2107,133.4
26020, 남구,030003, 27세,2018,4673,2562,2111,121.4,4477,2466,2011,122.6
26020, 남구,030004, 28세,2018,4469,2480,1989,124.7,4257,2363,1894,124.8
26020, 남구,030005, 29세,2018,4392,2364,2028,116.6,4192,2249,1943,115.7
26020, 남구,035,30~34세,2018,20722,11098,9624,115.3,19854,10658,9196,115.9
26020, 남구,035001, 30세,2018,4141,2298,1843,124.7,3936,2201,1735,126.9
26020, 남구,035002, 31세,2018,4107,2201,1906,115.5,3916,2101,1815,115.8
26020, 남구,035003, 32세,2018,4074,2172,1902,114.2,3893,2078,1815,114.5
26020, 남구,035004, 33세,2018,4156,2203,1953,112.8,4006,2134,1872,114
26020, 남구,035005, 34세,2018,4244,2224,2020,110.1,4103,2144,1959,109.4
26020, 남구,040,35~39세,2018,24902,12732,12170,104.6,24200,12362,11838,104.4
26020, 남구,040001, 35세,2018,4585,2386,2199,108.5,4426,2301,2125,108.3
26020, 남구,040002, 36세,2018,5090,2586,2504,103.3,4955,2524,2431,103.8
26020, 남구,040003, 37세,2018,5137,2705,2432,111.2,5011,2634,2377,110.8
26020, 남구,040004, 38세,2018,5257,2662,2595,102.6,5119,2593,2526,102.7
26020, 남구,040005, 39세,2018,4833,2393,2440,98.1,4689,2310,2379,97.1
26020, 남구,045,40~44세,2018,24093,11783,12310,95.7,23539,11476,12063,95.1
26020, 남구,045001, 40세,2018,4526,2336,2190,106.7,4409,2273,2136,106.4
26020, 남구,045002, 41세,2018,4669,2331,2338,99.7,4548,2260,2288,98.8
26020, 남구,045003, 42세,2018,4490,2199,2291,96,4382,2138,2244,95.3
26020, 남구,045004, 43세,2018,4860,2324,2536,91.6,4766,2278,2488,91.6
26020, 남구,045005, 44세,2018,5548,2593,2955,87.7,5434,2527,2907,86.9
26020, 남구,050,45~49세,2018,32046,15367,16679,92.1,31352,14978,16374,91.5
26020, 남구,050001, 45세,2018,5851,2748,3103,88.6,5740,2681,3059,87.6
26020, 남구,050002, 46세,2018,6018,2861,3157,90.6,5889,2786,3103,89.8
26020, 남구,050003, 47세,2018,6663,3187,3476,91.7,6502,3101,3401,91.2
26020, 남구,050004, 48세,2018,6740,3277,3463,94.6,6598,3196,3402,93.9
26020, 남구,050005, 49세,2018,6774,3294,3480,94.7,6623,3214,3409,94.3
26020, 남구,055,50~54세,2018,32341,16264,16077,101.2,31651,15885,15766,100.8
26020, 남구,055001, 50세,2018,6974,3423,3551,96.4,6812,3332,3480,95.7
26020, 남구,055002, 51세,2018,6462,3087,3375,91.5,6361,3035,3326,91.3
26020, 남구,055003, 52세,2018,6511,3388,3123,108.5,6374,3313,3061,108.2
26020, 남구,055004, 53세,2018,6547,3405,3142,108.4,6402,3323,3079,107.9
26020, 남구,055005, 54세,2018,5847,2961,2886,102.6,5702,2882,2820,102.2
26020, 남구,060,55~59세,2018,30862,15716,15146,103.8,30311,15410,14901,103.4
26020, 남구,060001, 55세,2018,6236,3214,3022,106.4,6074,3123,2951,105.8
26020, 남구,060002, 56세,2018,6271,3213,3058,105.1,6153,3158,2995,105.4
26020, 남구,060003, 57세,2018,6594,3420,3174,107.8,6516,3377,3139,107.6
26020, 남구,060004, 58세,2018,6180,3083,3097,99.5,6075,3019,3056,98.8
26020, 남구,060005, 59세,2018,5581,2786,2795,99.7,5493,2733,2760,99
26020, 남구,065,60~64세,2018,22483,11386,11097,102.6,22158,11207,10951,102.3
26020, 남구,065001, 60세,2018,5080,2555,2525,101.2,5012,2520,2492,101.1
26020, 남구,065002, 61세,2018,4908,2486,2422,102.6,4830,2440,2390,102.1
26020, 남구,065003, 62세,2018,4419,2219,2200,100.9,4368,2196,2172,101.1
26020, 남구,065004, 63세,2018,4404,2250,2154,104.5,4337,2210,2127,103.9
26020, 남구,065005, 64세,2018,3672,1876,1796,104.5,3611,1841,1770,104
26020, 남구,070,65~69세,2018,13591,6862,6729,102,13441,6788,6653,102
26020, 남구,070001, 65세,2018,3232,1626,1606,101.2,3188,1605,1583,101.4
26020, 남구,070002, 66세,2018,3160,1597,1563,102.2,3129,1582,1547,102.3
26020, 남구,070003, 67세,2018,2469,1236,1233,100.2,2428,1214,1214,100
26020, 남구,070004, 68세,2018,2449,1238,1211,102.2,2436,1232,1204,102.3
26020, 남구,070005, 69세,2018,2281,1165,1116,104.4,2260,1155,1105,104.5
26020, 남구,075,70~74세,2018,8483,4168,4315,96.6,8438,4151,4287,96.8
26020, 남구,075001, 70세,2018,2381,1210,1171,103.3,2372,1206,1166,103.4
26020, 남구,075002, 71세,2018,1957,1001,956,104.7,1947,996,951,104.7
26020, 남구,075003, 72세,2018,1420,671,749,89.6,1408,666,742,89.8
26020, 남구,075004, 73세,2018,1341,645,696,92.7,1336,644,692,93.1
26020, 남구,075005, 74세,2018,1384,641,743,86.3,1375,639,736,86.8
26020, 남구,080,75~79세,2018,6163,2706,3457,78.3,6127,2694,3433,78.5
26020, 남구,080001, 75세,2018,1415,638,777,82.1,1410,635,775,81.9
26020, 남구,080002, 76세,2018,1518,692,826,83.8,1509,688,821,83.8
26020, 남구,080003, 77세,2018,1146,516,630,81.9,1136,513,623,82.3
26020, 남구,080004, 78세,2018,1059,433,626,69.2,1054,432,622,69.5
26020, 남구,080005, 79세,2018,1025,427,598,71.4,1018,426,592,72
26020, 남구,085,80~84세,2018,3480,1125,2355,47.8,3456,1121,2335,48
26020, 남구,085001, 80세,2018,810,285,525,54.3,808,284,524,54.2
26020, 남구,085002, 81세,2018,794,269,525,51.2,783,267,516,51.7
26020, 남구,085003, 82세,2018,668,203,465,43.7,666,202,464,43.5
26020, 남구,085004, 83세,2018,629,187,442,42.3,625,187,438,42.7
26020, 남구,085005, 84세,2018,579,181,398,45.5,574,181,393,46.1
26020, 남구,090,85~89세,2018,1529,369,1160,31.8,1522,369,1153,32
26020, 남구,090001, 85세,2018,441,113,328,34.5,440,113,327,34.6
26020, 남구,090002, 86세,2018,347,101,246,41.1,347,101,246,41.1
26020, 남구,090003, 87세,2018,284,57,227,25.1,283,57,226,25.2
26020, 남구,090004, 88세,2018,244,54,190,28.4,241,54,187,28.9
26020, 남구,090005, 89세,2018,213,44,169,26,211,44,167,26.3
26020, 남구,095,90~94세,2018,530,64,466,13.7,529,63,466,13.5
26020, 남구,095001, 90세,2018,159,18,141,12.8,159,18,141,12.8
26020, 남구,095002, 91세,2018,130,17,113,15,129,16,113,14.2
26020, 남구,095003, 92세,2018,97,11,86,12.8,97,11,86,12.8
26020, 남구,095004, 93세,2018,84,8,76,10.5,84,8,76,10.5
26020, 남구,095005, 94세,2018,60,10,50,20,60,10,50,20
26020, 남구,100,95~99세,2018,109,12,97,12.4,109,12,97,12.4
26020, 남구,100001, 95세,2018,44,6,38,15.8,44,6,38,15.8
26020, 남구,100002, 96세,2018,26,X,24,8.3,26,X,24,8.3
26020, 남구,100003, 97세,2018,18,X,17,5.9,18,X,17,5.9
26020, 남구,100004, 98세,2018,16,X,14,14.3,16,X,14,14.3
26020, 남구,100005, 99세,2018,5,X,X,25,5,X,X,25
26020, 남구,101,100세이상,2018,8,X,8,0,8,X,8,0
26020, 남구,102,15세미만,2018,40596,21094,19502,108.2,40354,20974,19380,108.2
26020, 남구,103,15~64세,2018,253072,130950,122122,107.2,246781,127608,119173,107.1
26020, 남구,104,65세이상,2018,33893,15306,18587,82.3,33630,15198,18432,82.5
26020, 남구,086,85세이상,2018,2176,445,1731,25.7,2168,444,1724,25.8
26020, 남구,126,평균연령,2018,40.7,39.7,41.8,,40.7,39.7,41.8,
26020, 남구,127,중위연령,2018,42.6,40.9,44.1,,42.8,41,44.3,
26030, 동구,000,합계,2018,166992,88798,78194,113.6,162639,85926,76713,112
26030, 동구,005,0~4세,2018,8651,4388,4263,102.9,8586,4363,4223,103.3
26030, 동구,005001, 0세,2018,1335,687,648,106,1322,681,641,106.2
26030, 동구,005002, 1세,2018,1652,862,790,109.1,1639,859,780,110.1
26030, 동구,005003, 2세,2018,1855,936,919,101.8,1841,929,912,101.9
26030, 동구,005004, 3세,2018,1853,952,901,105.7,1841,947,894,105.9
26030, 동구,005005, 4세,2018,1956,951,1005,94.6,1943,947,996,95.1
26030, 동구,010,5~9세,2018,9115,4736,4379,108.2,9064,4711,4353,108.2
26030, 동구,010001, 5세,2018,1825,943,882,106.9,1814,937,877,106.8
26030, 동구,010002, 6세,2018,1975,1013,962,105.3,1958,1004,954,105.2
26030, 동구,010003, 7세,2018,1856,971,885,109.7,1845,964,881,109.4
26030, 동구,010004, 8세,2018,1831,971,860,112.9,1822,970,852,113.8
26030, 동구,010005, 9세,2018,1628,838,790,106.1,1625,836,789,106
26030, 동구,015,10~14세,2018,7724,4095,3629,112.8,7689,4072,3617,112.6
26030, 동구,015001, 10세,2018,1637,873,764,114.3,1630,868,762,113.9
26030, 동구,015002, 11세,2018,1697,861,836,103,1692,857,835,102.6
26030, 동구,015003, 12세,2018,1517,828,689,120.2,1511,825,686,120.3
26030, 동구,015004, 13세,2018,1407,746,661,112.9,1401,741,660,112.3
26030, 동구,015005, 14세,2018,1466,787,679,115.9,1455,781,674,115.9
26030, 동구,020,15~19세,2018,8660,4664,3996,116.7,8586,4623,3963,116.7
26030, 동구,020001, 15세,2018,1579,849,730,116.3,1579,849,730,116.3
26030, 동구,020002, 16세,2018,1603,835,768,108.7,1599,834,765,109
26030, 동구,020003, 17세,2018,1895,1020,875,116.6,1892,1018,874,116.5
26030, 동구,020004, 18세,2018,2162,1144,1018,112.4,2139,1129,1010,111.8
26030, 동구,020005, 19세,2018,1421,816,605,134.9,1377,793,584,135.8
26030, 동구,025,20~24세,2018,8926,5191,3735,139,8574,4969,3605,137.8
26030, 동구,025001, 20세,2018,1640,984,656,150,1591,947,644,147
26030, 동구,025002, 21세,2018,1773,1034,739,139.9,1712,996,716,139.1
26030, 동구,025003, 22세,2018,1808,1071,737,145.3,1737,1035,702,147.4
26030, 동구,025004, 23세,2018,1839,1045,794,131.6,1764,993,771,128.8
26030, 동구,025005, 24세,2018,1866,1057,809,130.7,1770,998,772,129.3
26030, 동구,030,25~29세,2018,11060,6355,4705,135.1,10351,5851,4500,130
26030, 동구,030001, 25세,2018,2008,1131,877,129,1891,1053,838,125.7
26030, 동구,030002, 26세,2018,2212,1249,963,129.7,2079,1153,926,124.5
26030, 동구,030003, 27세,2018,2245,1249,996,125.4,2093,1138,955,119.2
26030, 동구,030004, 28세,2018,2245,1316,929,141.7,2093,1211,882,137.3
26030, 동구,030005, 29세,2018,2350,1410,940,150,2195,1296,899,144.2
26030, 동구,035,30~34세,2018,13182,7609,5573,136.5,12343,7013,5330,131.6
26030, 동구,035001, 30세,2018,2389,1449,940,154.1,2211,1321,890,148.4
26030, 동구,035002, 31세,2018,2521,1465,1056,138.7,2366,1362,1004,135.7
26030, 동구,035003, 32세,2018,2670,1489,1181,126.1,2490,1360,1130,120.4
26030, 동구,035004, 33세,2018,2693,1538,1155,133.2,2541,1425,1116,127.7
26030, 동구,035005, 34세,2018,2909,1668,1241,134.4,2735,1545,1190,129.8
26030, 동구,040,35~39세,2018,16660,9395,7265,129.3,16026,8932,7094,125.9
26030, 동구,040001, 35세,2018,3349,1846,1503,122.8,3191,1739,1452,119.8
26030, 동구,040002, 36세,2018,3456,1935,1521,127.2,3306,1822,1484,122.8
26030, 동구,040003, 37세,2018,3342,1908,1434,133.1,3217,1812,1405,129
26030, 동구,040004, 38세,2018,3494,1989,1505,132.2,3393,1914,1479,129.4
26030, 동구,040005, 39세,2018,3019,1717,1302,131.9,2919,1645,1274,129.1
26030, 동구,045,40~44세,2018,13381,7433,5948,125,12945,7145,5800,123.2
26030, 동구,045001, 40세,2018,2886,1573,1313,119.8,2799,1520,1279,118.8
26030, 동구,045002, 41세,2018,2710,1479,1231,120.1,2614,1410,1204,117.1
26030, 동구,045003, 42세,2018,2540,1454,1086,133.9,2465,1399,1066,131.2
26030, 동구,045004, 43세,2018,2621,1454,1167,124.6,2527,1393,1134,122.8
26030, 동구,045005, 44세,2018,2624,1473,1151,128,2540,1423,1117,127.4
26030, 동구,050,45~49세,2018,13096,7019,6077,115.5,12685,6741,5944,113.4
26030, 동구,050001, 45세,2018,2660,1437,1223,117.5,2583,1388,1195,116.2
26030, 동구,050002, 46세,2018,2501,1402,1099,127.6,2414,1341,1073,125
26030, 동구,050003, 47세,2018,2711,1459,1252,116.5,2621,1396,1225,114
26030, 동구,050004, 48세,2018,2578,1313,1265,103.8,2494,1259,1235,101.9
26030, 동구,050005, 49세,2018,2646,1408,1238,113.7,2573,1357,1216,111.6
26030, 동구,055,50~54세,2018,12826,6407,6419,99.8,12513,6224,6289,99
26030, 동구,055001, 50세,2018,2661,1332,1329,100.2,2578,1280,1298,98.6
26030, 동구,055002, 51세,2018,2508,1221,1287,94.9,2456,1194,1262,94.6
26030, 동구,055003, 52세,2018,2574,1349,1225,110.1,2511,1308,1203,108.7
26030, 동구,055004, 53세,2018,2654,1290,1364,94.6,2596,1259,1337,94.2
26030, 동구,055005, 54세,2018,2429,1215,1214,100.1,2372,1183,1189,99.5
26030, 동구,060,55~59세,2018,15345,7519,7826,96.1,15124,7395,7729,95.7
26030, 동구,060001, 55세,2018,2748,1359,1389,97.8,2678,1316,1362,96.6
26030, 동구,060002, 56세,2018,2891,1423,1468,96.9,2853,1406,1447,97.2
26030, 동구,060003, 57세,2018,3283,1528,1755,87.1,3247,1510,1737,86.9
26030, 동구,060004, 58세,2018,3369,1623,1746,93,3319,1589,1730,91.8
26030, 동구,060005, 59세,2018,3054,1586,1468,108,3027,1574,1453,108.3
26030, 동구,065,60~64세,2018,12022,6153,5869,104.8,11918,6093,5825,104.6
26030, 동구,065001, 60세,2018,2873,1543,1330,116,2845,1526,1319,115.7
26030, 동구,065002, 61세,2018,2664,1312,1352,97,2640,1296,1344,96.4
26030, 동구,065003, 62세,2018,2362,1213,1149,105.6,2344,1202,1142,105.3
26030, 동구,065004, 63세,2018,2297,1160,1137,102,2278,1152,1126,102.3
26030, 동구,065005, 64세,2018,1826,925,901,102.7,1811,917,894,102.6
26030, 동구,070,65~69세,2018,7191,3808,3383,112.6,7138,3785,3353,112.9
26030, 동구,070001, 65세,2018,1688,862,826,104.4,1673,857,816,105
26030, 동구,070002, 66세,2018,1750,952,798,119.3,1738,946,792,119.4
26030, 동구,070003, 67세,2018,1286,686,600,114.3,1283,685,598,114.5
26030, 동구,070004, 68세,2018,1264,666,598,111.4,1249,660,589,112.1
26030, 동구,070005, 69세,2018,1203,642,561,114.4,1195,637,558,114.2
26030, 동구,075,70~74세,2018,4106,2187,1919,114,4074,2177,1897,114.8
26030, 동구,075001, 70세,2018,1149,627,522,120.1,1141,623,518,120.3
26030, 동구,075002, 71세,2018,997,538,459,117.2,990,537,453,118.5
26030, 동구,075003, 72세,2018,733,403,330,122.1,727,402,325,123.7
26030, 동구,075004, 73세,2018,641,325,316,102.8,634,323,311,103.9
26030, 동구,075005, 74세,2018,586,294,292,100.7,582,292,290,100.7
26030, 동구,080,75~79세,2018,2707,1235,1472,83.9,2691,1229,1462,84.1
26030, 동구,080001, 75세,2018,682,329,353,93.2,681,328,353,92.9
26030, 동구,080002, 76세,2018,671,308,363,84.8,667,307,360,85.3
26030, 동구,080003, 77세,2018,480,216,264,81.8,477,215,262,82.1
26030, 동구,080004, 78세,2018,455,195,260,75,450,193,257,75.1
26030, 동구,080005, 79세,2018,419,187,232,80.6,416,186,230,80.9
26030, 동구,085,80~84세,2018,1392,423,969,43.7,1387,423,964,43.9
26030, 동구,085001, 80세,2018,371,123,248,49.6,370,123,247,49.8
26030, 동구,085002, 81세,2018,284,91,193,47.2,283,91,192,47.4
26030, 동구,085003, 82세,2018,274,77,197,39.1,272,77,195,39.5
26030, 동구,085004, 83세,2018,253,74,179,41.3,252,74,178,41.6
26030, 동구,085005, 84세,2018,210,58,152,38.2,210,58,152,38.2
26030, 동구,090,85~89세,2018,656,149,507,29.4,653,148,505,29.3
26030, 동구,090001, 85세,2018,183,54,129,41.9,182,54,128,42.2
26030, 동구,090002, 86세,2018,154,29,125,23.2,154,29,125,23.2
26030, 동구,090003, 87세,2018,122,25,97,25.8,120,24,96,25
26030, 동구,090004, 88세,2018,109,19,90,21.1,109,19,90,21.1
26030, 동구,090005, 89세,2018,88,22,66,33.3,88,22,66,33.3
26030, 동구,095,90~94세,2018,227,23,204,11.3,227,23,204,11.3
26030, 동구,095001, 90세,2018,64,7,57,12.3,64,7,57,12.3
26030, 동구,095002, 91세,2018,58,6,52,11.5,58,6,52,11.5
26030, 동구,095003, 92세,2018,36,5,31,16.1,36,5,31,16.1
26030, 동구,095004, 93세,2018,49,X,45,8.9,49,X,45,8.9
26030, 동구,095005, 94세,2018,20,X,19,5.3,20,X,19,5.3
26030, 동구,100,95~99세,2018,60,9,51,17.6,60,9,51,17.6
26030, 동구,100001, 95세,2018,23,X,19,21.1,23,X,19,21.1
26030, 동구,100002, 96세,2018,16,X,14,14.3,16,X,14,14.3
26030, 동구,100003, 97세,2018,10,X,9,11.1,10,X,9,11.1
26030, 동구,100004, 98세,2018,9,X,7,28.6,9,X,7,28.6
26030, 동구,100005, 99세,2018,X,X,X,0,X,X,X,0
26030, 동구,101,100세이상,2018,5,X,5,0,5,X,5,0
26030, 동구,102,15세미만,2018,25490,13219,12271,107.7,25339,13146,12193,107.8
26030, 동구,103,15~64세,2018,125158,67745,57413,118,121065,64986,56079,115.9
26030, 동구,104,65세이상,2018,16344,7834,8510,92.1,16235,7794,8441,92.3
26030, 동구,086,85세이상,2018,948,181,767,23.6,945,180,765,23.5
26030, 동구,126,평균연령,2018,39.4,38.7,40.3,,39.5,38.7,40.3,
26030, 동구,127,중위연령,2018,39.8,38.8,41.2,,40,39,41.3,
26040, 북구,000,합계,2018,203675,105962,97713,108.4,200505,104011,96494,107.8
26040, 북구,005,0~4세,2018,12039,6206,5833,106.4,11999,6183,5816,106.3
26040, 북구,005001, 0세,2018,1928,985,943,104.5,1921,981,940,104.4
26040, 북구,005002, 1세,2018,2139,1099,1040,105.7,2129,1093,1036,105.5
26040, 북구,005003, 2세,2018,2619,1360,1259,108,2609,1355,1254,108.1
26040, 북구,005004, 3세,2018,2737,1412,1325,106.6,2732,1410,1322,106.7
26040, 북구,005005, 4세,2018,2616,1350,1266,106.6,2608,1344,1264,106.3
26040, 북구,010,5~9세,2018,12900,6653,6247,106.5,12883,6646,6237,106.6
26040, 북구,010001, 5세,2018,2621,1345,1276,105.4,2617,1343,1274,105.4
26040, 북구,010002, 6세,2018,2719,1390,1329,104.6,2714,1387,1327,104.5
26040, 북구,010003, 7세,2018,2617,1320,1297,101.8,2613,1320,1293,102.1
26040, 북구,010004, 8세,2018,2534,1314,1220,107.7,2530,1312,1218,107.7
26040, 북구,010005, 9세,2018,2409,1284,1125,114.1,2409,1284,1125,114.1
26040, 북구,015,10~14세,2018,11280,5752,5528,104.1,11271,5747,5524,104
26040, 북구,015001, 10세,2018,2532,1277,1255,101.8,2531,1276,1255,101.7
26040, 북구,015002, 11세,2018,2477,1279,1198,106.8,2474,1277,1197,106.7
26040, 북구,015003, 12세,2018,2152,1060,1092,97.1,2151,1060,1091,97.2
26040, 북구,015004, 13세,2018,2061,1064,997,106.7,2060,1063,997,106.6
26040, 북구,015005, 14세,2018,2058,1072,986,108.7,2055,1071,984,108.8
26040, 북구,020,15~19세,2018,11810,6582,5228,125.9,11782,6569,5213,126
26040, 북구,020001, 15세,2018,2210,1205,1005,119.9,2209,1205,1004,120
26040, 북구,020002, 16세,2018,2448,1352,1096,123.4,2445,1351,1094,123.5
26040, 북구,020003, 17세,2018,2667,1442,1225,117.7,2662,1439,1223,117.7
26040, 북구,020004, 18세,2018,2679,1465,1214,120.7,2674,1464,1210,121
26040, 북구,020005, 19세,2018,1806,1118,688,162.5,1792,1110,682,162.8
26040, 북구,025,20~24세,2018,12177,7128,5049,141.2,11878,6940,4938,140.5
26040, 북구,025001, 20세,2018,2238,1419,819,173.3,2205,1400,805,173.9
26040, 북구,025002, 21세,2018,2431,1482,949,156.2,2388,1453,935,155.4
26040, 북구,025003, 22세,2018,2414,1416,998,141.9,2365,1389,976,142.3
26040, 북구,025004, 23세,2018,2473,1332,1141,116.7,2398,1286,1112,115.6
26040, 북구,025005, 24세,2018,2621,1479,1142,129.5,2522,1412,1110,127.2
26040, 북구,030,25~29세,2018,13352,7525,5827,129.1,12721,7106,5615,126.6
26040, 북구,030001, 25세,2018,2667,1528,1139,134.2,2565,1460,1105,132.1
26040, 북구,030002, 26세,2018,2693,1524,1169,130.4,2578,1444,1134,127.3
26040, 북구,030003, 27세,2018,2679,1457,1222,119.2,2526,1363,1163,117.2
26040, 북구,030004, 28세,2018,2662,1515,1147,132.1,2522,1418,1104,128.4
26040, 북구,030005, 29세,2018,2651,1501,1150,130.5,2530,1421,1109,128.1
26040, 북구,035,30~34세,2018,14282,7528,6754,111.5,13633,7116,6517,109.2
26040, 북구,035001, 30세,2018,2617,1436,1181,121.6,2482,1345,1137,118.3
26040, 북구,035002, 31세,2018,2674,1413,1261,112.1,2538,1332,1206,110.4
26040, 북구,035003, 32세,2018,2806,1477,1329,111.1,2680,1397,1283,108.9
26040, 북구,035004, 33세,2018,2891,1507,1384,108.9,2757,1422,1335,106.5
26040, 북구,035005, 34세,2018,3294,1695,1599,106,3176,1620,1556,104.1
26040, 북구,040,35~39세,2018,20176,10257,9919,103.4,19745,9961,9784,101.8
26040, 북구,040001, 35세,2018,3733,1840,1893,97.2,3631,1764,1867,94.5
26040, 북구,040002, 36세,2018,3997,1999,1998,100.1,3918,1947,1971,98.8
26040, 북구,040003, 37세,2018,4196,2145,2051,104.6,4100,2073,2027,102.3
26040, 북구,040004, 38세,2018,4297,2195,2102,104.4,4214,2148,2066,104
26040, 북구,040005, 39세,2018,3953,2078,1875,110.8,3882,2029,1853,109.5
26040, 북구,045,40~44세,2018,17621,9214,8407,109.6,17335,9028,8307,108.7
26040, 북구,045001, 40세,2018,3542,1877,1665,112.7,3482,1839,1643,111.9
26040, 북구,045002, 41세,2018,3697,1962,1735,113.1,3635,1923,1712,112.3
26040, 북구,045003, 42세,2018,3293,1769,1524,116.1,3239,1732,1507,114.9
26040, 북구,045004, 43세,2018,3515,1831,1684,108.7,3455,1791,1664,107.6
26040, 북구,045005, 44세,2018,3574,1775,1799,98.7,3524,1743,1781,97.9
26040, 북구,050,45~49세,2018,18463,9045,9418,96,18178,8882,9296,95.5
26040, 북구,050001, 45세,2018,3494,1766,1728,102.2,3440,1736,1704,101.9
26040, 북구,050002, 46세,2018,3573,1727,1846,93.6,3510,1696,1814,93.5
26040, 북구,050003, 47세,2018,3676,1816,1860,97.6,3624,1788,1836,97.4
26040, 북구,050004, 48세,2018,3740,1808,1932,93.6,3680,1771,1909,92.8
26040, 북구,050005, 49세,2018,3980,1928,2052,94,3924,1891,2033,93
26040, 북구,055,50~54세,2018,19163,9853,9310,105.8,18958,9740,9218,105.7
26040, 북구,055001, 50세,2018,4042,1942,2100,92.5,3993,1916,2077,92.2
26040, 북구,055002, 51세,2018,3911,1922,1989,96.6,3865,1896,1969,96.3
26040, 북구,055003, 52세,2018,3983,2120,1863,113.8,3941,2091,1850,113
26040, 북구,055004, 53세,2018,3785,2008,1777,113,3750,1994,1756,113.6
26040, 북구,055005, 54세,2018,3442,1861,1581,117.7,3409,1843,1566,117.7
26040, 북구,060,55~59세,2018,16145,8902,7243,122.9,16021,8846,7175,123.3
26040, 북구,060001, 55세,2018,3431,1938,1493,129.8,3401,1921,1480,129.8
26040, 북구,060002, 56세,2018,3445,1921,1524,126,3420,1913,1507,126.9
26040, 북구,060003, 57세,2018,3544,1918,1626,118,3523,1904,1619,117.6
26040, 북구,060004, 58세,2018,3122,1702,1420,119.9,3088,1689,1399,120.7
26040, 북구,060005, 59세,2018,2603,1423,1180,120.6,2589,1419,1170,121.3
26040, 북구,065,60~64세,2018,9662,4999,4663,107.2,9575,4962,4613,107.6
26040, 북구,065001, 60세,2018,2326,1228,1098,111.8,2307,1218,1089,111.8
26040, 북구,065002, 61세,2018,2123,1105,1018,108.5,2103,1095,1008,108.6
26040, 북구,065003, 62세,2018,1887,963,924,104.2,1875,958,917,104.5
26040, 북구,065004, 63세,2018,1841,948,893,106.2,1818,942,876,107.5
26040, 북구,065005, 64세,2018,1485,755,730,103.4,1472,749,723,103.6
26040, 북구,070,65~69세,2018,5424,2775,2649,104.8,5381,2758,2623,105.1
26040, 북구,070001, 65세,2018,1238,654,584,112,1229,649,580,111.9
26040, 북구,070002, 66세,2018,1300,673,627,107.3,1289,669,620,107.9
26040, 북구,070003, 67세,2018,979,506,473,107,966,501,465,107.7
26040, 북구,070004, 68세,2018,973,481,492,97.8,969,480,489,98.2
26040, 북구,070005, 69세,2018,934,461,473,97.5,928,459,469,97.9
26040, 북구,075,70~74세,2018,3534,1676,1858,90.2,3517,1667,1850,90.1
26040, 북구,075001, 70세,2018,899,428,471,90.9,894,424,470,90.2
26040, 북구,075002, 71세,2018,883,397,486,81.7,879,396,483,82
26040, 북구,075003, 72세,2018,565,281,284,98.9,562,280,282,99.3
26040, 북구,075004, 73세,2018,593,276,317,87.1,590,274,316,86.7
26040, 북구,075005, 74세,2018,594,294,300,98,592,293,299,98
26040, 북구,080,75~79세,2018,2752,1113,1639,67.9,2742,1110,1632,68
26040, 북구,080001, 75세,2018,647,268,379,70.7,643,266,377,70.6
26040, 북구,080002, 76세,2018,710,315,395,79.7,708,315,393,80.2
26040, 북구,080003, 77세,2018,481,185,296,62.5,480,185,295,62.7
26040, 북구,080004, 78세,2018,478,177,301,58.8,476,177,299,59.2
26040, 북구,080005, 79세,2018,436,168,268,62.7,435,167,268,62.3
26040, 북구,085,80~84세,2018,1753,511,1242,41.1,1745,507,1238,41
26040, 북구,085001, 80세,2018,435,144,291,49.5,434,143,291,49.1
26040, 북구,085002, 81세,2018,398,114,284,40.1,395,113,282,40.1
26040, 북구,085003, 82세,2018,331,92,239,38.5,328,90,238,37.8
26040, 북구,085004, 83세,2018,305,83,222,37.4,305,83,222,37.4
26040, 북구,085005, 84세,2018,284,78,206,37.9,283,78,205,38
26040, 북구,090,85~89세,2018,810,188,622,30.2,809,188,621,30.3
26040, 북구,090001, 85세,2018,244,77,167,46.1,244,77,167,46.1
26040, 북구,090002, 86세,2018,200,43,157,27.4,200,43,157,27.4
26040, 북구,090003, 87세,2018,124,22,102,21.6,124,22,102,21.6
26040, 북구,090004, 88세,2018,139,29,110,26.4,138,29,109,26.6
26040, 북구,090005, 89세,2018,103,17,86,19.8,103,17,86,19.8
26040, 북구,095,90~94세,2018,252,45,207,21.7,252,45,207,21.7
26040, 북구,095001, 90세,2018,85,19,66,28.8,85,19,66,28.8
26040, 북구,095002, 91세,2018,69,11,58,19,69,11,58,19
26040, 북구,095003, 92세,2018,44,X,40,10,44,X,40,10
26040, 북구,095004, 93세,2018,28,6,22,27.3,28,6,22,27.3
26040, 북구,095005, 94세,2018,26,5,21,23.8,26,5,21,23.8
26040, 북구,100,95~99세,2018,73,10,63,15.9,73,10,63,15.9
26040, 북구,100001, 95세,2018,27,X,24,12.5,27,X,24,12.5
26040, 북구,100002, 96세,2018,23,X,20,15,23,X,20,15
26040, 북구,100003, 97세,2018,12,X,10,20,12,X,10,20
26040, 북구,100004, 98세,2018,7,X,6,16.7,7,X,6,16.7
26040, 북구,100005, 99세,2018,X,X,X,33.3,X,X,X,33.3
26040, 북구,101,100세이상,2018,7,X,7,0,7,X,7,0
26040, 북구,102,15세미만,2018,36219,18611,17608,105.7,36153,18576,17577,105.7
26040, 북구,103,15~64세,2018,152851,81033,71818,112.8,149826,79150,70676,112
26040, 북구,104,65세이상,2018,14605,6318,8287,76.2,14526,6285,8241,76.3
26040, 북구,086,85세이상,2018,1142,243,899,27,1141,243,898,27.1
26040, 북구,126,평균연령,2018,37.2,36.5,38,,37.2,36.5,38,
26040, 북구,127,중위연령,2018,38.5,37.8,39.2,,38.6,38,39.2,
26310, 울주군,000,합계,2018,224834,118166,106668,110.8,214978,111335,103643,107.4
26310, 울주군,005,0~4세,2018,9139,4748,4391,108.1,8983,4673,4310,108.4
26310, 울주군,005001, 0세,2018,1564,824,740,111.4,1541,817,724,112.8
26310, 울주군,005002, 1세,2018,1676,887,789,112.4,1637,867,770,112.6
26310, 울주군,005003, 2세,2018,1833,930,903,103,1805,918,887,103.5
26310, 울주군,005004, 3세,2018,2022,1053,969,108.7,1990,1035,955,108.4
26310, 울주군,005005, 4세,2018,2044,1054,990,106.5,2010,1036,974,106.4
26310, 울주군,010,5~9세,2018,10703,5417,5286,102.5,10611,5371,5240,102.5
26310, 울주군,010001, 5세,2018,2029,1006,1023,98.3,2012,998,1014,98.4
26310, 울주군,010002, 6세,2018,2243,1122,1121,100.1,2218,1110,1108,100.2
26310, 울주군,010003, 7세,2018,2225,1146,1079,106.2,2211,1138,1073,106.1
26310, 울주군,010004, 8세,2018,2150,1103,1047,105.3,2134,1097,1037,105.8
26310, 울주군,010005, 9세,2018,2056,1040,1016,102.4,2036,1028,1008,102
26310, 울주군,015,10~14세,2018,11007,5755,5252,109.6,10946,5720,5226,109.5
26310, 울주군,015001, 10세,2018,2245,1158,1087,106.5,2226,1144,1082,105.7
26310, 울주군,015002, 11세,2018,2294,1208,1086,111.2,2284,1202,1082,111.1
26310, 울주군,015003, 12세,2018,2090,1101,989,111.3,2077,1096,981,111.7
26310, 울주군,015004, 13세,2018,2125,1110,1015,109.4,2112,1105,1007,109.7
26310, 울주군,015005, 14세,2018,2253,1178,1075,109.6,2247,1173,1074,109.2
26310, 울주군,020,15~19세,2018,12433,6788,5645,120.2,12293,6700,5593,119.8
26310, 울주군,020001, 15세,2018,2279,1165,1114,104.6,2269,1161,1108,104.8
26310, 울주군,020002, 16세,2018,2358,1198,1160,103.3,2346,1193,1153,103.5
26310, 울주군,020003, 17세,2018,2579,1365,1214,112.4,2561,1353,1208,112
26310, 울주군,020004, 18세,2018,2781,1561,1220,128,2742,1535,1207,127.2
26310, 울주군,020005, 19세,2018,2436,1499,937,160,2375,1458,917,159
26310, 울주군,025,20~24세,2018,14726,8829,5897,149.7,13885,8189,5696,143.8
26310, 울주군,025001, 20세,2018,2655,1660,995,166.8,2554,1585,969,163.6
26310, 울주군,025002, 21세,2018,2900,1713,1187,144.3,2757,1609,1148,140.2
26310, 울주군,025003, 22세,2018,2852,1667,1185,140.7,2683,1540,1143,134.7
26310, 울주군,025004, 23세,2018,3163,1860,1303,142.7,2970,1715,1255,136.7
26310, 울주군,025005, 24세,2018,3156,1929,1227,157.2,2921,1740,1181,147.3
26310, 울주군,030,25~29세,2018,14294,8661,5633,153.8,12618,7388,5230,141.3
26310, 울주군,030001, 25세,2018,3059,1902,1157,164.4,2787,1691,1096,154.3
26310, 울주군,030002, 26세,2018,3090,1866,1224,152.5,2766,1615,1151,140.3
26310, 울주군,030003, 27세,2018,2889,1734,1155,150.1,2547,1472,1075,136.9
26310, 울주군,030004, 28세,2018,2656,1591,1065,149.4,2272,1301,971,134
26310, 울주군,030005, 29세,2018,2600,1568,1032,151.9,2246,1309,937,139.7
26310, 울주군,035,30~34세,2018,13168,7481,5687,131.5,11368,6093,5275,115.5
26310, 울주군,035001, 30세,2018,2424,1429,995,143.6,2046,1144,902,126.8
26310, 울주군,035002, 31세,2018,2614,1495,1119,133.6,2223,1200,1023,117.3
26310, 울주군,035003, 32세,2018,2606,1474,1132,130.2,2240,1195,1045,114.4
26310, 울주군,035004, 33세,2018,2670,1521,1149,132.4,2296,1227,1069,114.8
26310, 울주군,035005, 34세,2018,2854,1562,1292,120.9,2563,1327,1236,107.4
26310, 울주군,040,35~39세,2018,17269,9291,7978,116.5,16020,8356,7664,109
26310, 울주군,040001, 35세,2018,3093,1725,1368,126.1,2783,1476,1307,112.9
26310, 울주군,040002, 36세,2018,3448,1834,1614,113.6,3185,1646,1539,107
26310, 울주군,040003, 37세,2018,3584,1989,1595,124.7,3315,1781,1534,116.1
26310, 울주군,040004, 38세,2018,3674,1905,1769,107.7,3466,1753,1713,102.3
26310, 울주군,040005, 39세,2018,3470,1838,1632,112.6,3271,1700,1571,108.2
26310, 울주군,045,40~44세,2018,17979,9328,8651,107.8,17086,8714,8372,104.1
26310, 울주군,045001, 40세,2018,3229,1719,1510,113.8,3020,1576,1444,109.1
26310, 울주군,045002, 41세,2018,3509,1820,1689,107.8,3353,1710,1643,104.1
26310, 울주군,045003, 42세,2018,3506,1850,1656,111.7,3315,1713,1602,106.9
26310, 울주군,045004, 43세,2018,3726,1879,1847,101.7,3550,1762,1788,98.5
26310, 울주군,045005, 44세,2018,4009,2060,1949,105.7,3848,1953,1895,103.1
26310, 울주군,050,45~49세,2018,21635,11173,10462,106.8,20682,10592,10090,105
26310, 울주군,050001, 45세,2018,4142,2102,2040,103,3973,1988,1985,100.2
26310, 울주군,050002, 46세,2018,4149,2149,2000,107.5,3964,2038,1926,105.8
26310, 울주군,050003, 47세,2018,4630,2389,2241,106.6,4416,2256,2160,104.4
26310, 울주군,050004, 48세,2018,4314,2233,2081,107.3,4115,2116,1999,105.9
26310, 울주군,050005, 49세,2018,4400,2300,2100,109.5,4214,2194,2020,108.6
26310, 울주군,055,50~54세,2018,20536,10892,9644,112.9,19654,10357,9297,111.4
26310, 울주군,055001, 50세,2018,4465,2323,2142,108.5,4281,2210,2071,106.7
26310, 울주군,055002, 51세,2018,4136,2134,2002,106.6,3980,2048,1932,106
26310, 울주군,055003, 52세,2018,4078,2198,1880,116.9,3901,2090,1811,115.4
26310, 울주군,055004, 53세,2018,4084,2232,1852,120.5,3901,2120,1781,119
26310, 울주군,055005, 54세,2018,3773,2005,1768,113.4,3591,1889,1702,111
26310, 울주군,060,55~59세,2018,19198,10248,8950,114.5,18606,9896,8710,113.6
26310, 울주군,060001, 55세,2018,3845,2092,1753,119.3,3665,1991,1674,118.9
26310, 울주군,060002, 56세,2018,3851,2075,1776,116.8,3719,1992,1727,115.3
26310, 울주군,060003, 57세,2018,4133,2179,1954,111.5,4049,2123,1926,110.2
26310, 울주군,060004, 58세,2018,3844,2052,1792,114.5,3736,1990,1746,114
26310, 울주군,060005, 59세,2018,3525,1850,1675,110.4,3437,1800,1637,110
26310, 울주군,065,60~64세,2018,14749,7605,7144,106.5,14446,7428,7018,105.8
26310, 울주군,065001, 60세,2018,3369,1734,1635,106.1,3293,1686,1607,104.9
26310, 울주군,065002, 61세,2018,3168,1656,1512,109.5,3107,1619,1488,108.8
26310, 울주군,065003, 62세,2018,2935,1526,1409,108.3,2863,1485,1378,107.8
26310, 울주군,065004, 63세,2018,2888,1431,1457,98.2,2842,1407,1435,98
26310, 울주군,065005, 64세,2018,2389,1258,1131,111.2,2341,1231,1110,110.9
26310, 울주군,070,65~69세,2018,9424,4678,4746,98.6,9306,4618,4688,98.5
26310, 울주군,070001, 65세,2018,2137,1052,1085,97,2109,1036,1073,96.6
26310, 울주군,070002, 66세,2018,2156,1053,1103,95.5,2126,1036,1090,95
26310, 울주군,070003, 67세,2018,1717,870,847,102.7,1695,859,836,102.8
26310, 울주군,070004, 68세,2018,1730,884,846,104.5,1708,873,835,104.6
26310, 울주군,070005, 69세,2018,1684,819,865,94.7,1668,814,854,95.3
26310, 울주군,075,70~74세,2018,6521,3149,3372,93.4,6482,3132,3350,93.5
26310, 울주군,075001, 70세,2018,1665,840,825,101.8,1651,835,816,102.3
26310, 울주군,075002, 71세,2018,1535,789,746,105.8,1524,783,741,105.7
26310, 울주군,075003, 72세,2018,1068,518,550,94.2,1065,518,547,94.7
26310, 울주군,075004, 73세,2018,1116,520,596,87.2,1109,517,592,87.3
26310, 울주군,075005, 74세,2018,1137,482,655,73.6,1133,479,654,73.2
26310, 울주군,080,75~79세,2018,5809,2327,3482,66.8,5774,2318,3456,67.1
26310, 울주군,080001, 75세,2018,1279,552,727,75.9,1271,551,720,76.5
26310, 울주군,080002, 76세,2018,1390,580,810,71.6,1381,577,804,71.8
26310, 울주군,080003, 77세,2018,1091,425,666,63.8,1087,424,663,64
26310, 울주군,080004, 78세,2018,1042,397,645,61.6,1033,395,638,61.9
26310, 울주군,080005, 79세,2018,1007,373,634,58.8,1002,371,631,58.8
26310, 울주군,085,80~84세,2018,3690,1217,2473,49.2,3673,1213,2460,49.3
26310, 울주군,085001, 80세,2018,917,331,586,56.5,911,329,582,56.5
26310, 울주군,085002, 81세,2018,785,261,524,49.8,779,261,518,50.4
26310, 울주군,085003, 82세,2018,689,231,458,50.4,688,231,457,50.5
26310, 울주군,085004, 83세,2018,682,214,468,45.7,679,212,467,45.4
26310, 울주군,085005, 84세,2018,617,180,437,41.2,616,180,436,41.3
26310, 울주군,090,85~89세,2018,1807,445,1362,32.7,1800,444,1356,32.7
26310, 울주군,090001, 85세,2018,481,130,351,37,479,130,349,37.2
26310, 울주군,090002, 86세,2018,449,113,336,33.6,447,113,334,33.8
26310, 울주군,090003, 87세,2018,356,88,268,32.8,355,87,268,32.5
26310, 울주군,090004, 88세,2018,272,56,216,25.9,270,56,214,26.2
26310, 울주군,090005, 89세,2018,249,58,191,30.4,249,58,191,30.4
26310, 울주군,095,90~94세,2018,609,111,498,22.3,607,110,497,22.1
26310, 울주군,095001, 90세,2018,204,45,159,28.3,203,44,159,27.7
26310, 울주군,095002, 91세,2018,154,30,124,24.2,153,30,123,24.4
26310, 울주군,095003, 92세,2018,109,17,92,18.5,109,17,92,18.5
26310, 울주군,095004, 93세,2018,83,12,71,16.9,83,12,71,16.9
26310, 울주군,095005, 94세,2018,59,7,52,13.5,59,7,52,13.5
26310, 울주군,100,95~99세,2018,121,23,98,23.5,121,23,98,23.5
26310, 울주군,100001, 95세,2018,56,13,43,30.2,56,13,43,30.2
26310, 울주군,100002, 96세,2018,28,X,24,16.7,28,X,24,16.7
26310, 울주군,100003, 97세,2018,22,X,18,22.2,22,X,18,22.2
26310, 울주군,100004, 98세,2018,7,X,6,16.7,7,X,6,16.7
26310, 울주군,100005, 99세,2018,8,X,7,14.3,8,X,7,14.3
26310, 울주군,101,100세이상,2018,17,X,17,0,17,X,17,0
26310, 울주군,102,15세미만,2018,30849,15920,14929,106.6,30540,15764,14776,106.7
26310, 울주군,103,15~64세,2018,165987,90296,75691,119.3,156658,83713,72945,114.8
26310, 울주군,104,65세이상,2018,27998,11950,16048,74.5,27780,11858,15922,74.5
26310, 울주군,086,85세이상,2018,2554,579,1975,29.3,2545,577,1968,29.3
26310, 울주군,126,평균연령,2018,41.1,39.9,42.5,,41.3,40,42.6,
26310, 울주군,127,중위연령,2018,42.8,41.2,44.4,,43.3,41.9,44.6,
29,세종특별자치시,000,합계,2018,312374,157289,155085,101.4,305888,153402,152486,100.6
29,세종특별자치시,005,0~4세,2018,20864,10702,10162,105.3,20778,10654,10124,105.2
29,세종특별자치시,005001, 0세,2018,3691,1871,1820,102.8,3673,1862,1811,102.8
29,세종특별자치시,005002, 1세,2018,3972,2040,1932,105.6,3955,2030,1925,105.5
29,세종특별자치시,005003, 2세,2018,4409,2294,2115,108.5,4391,2285,2106,108.5
29,세종특별자치시,005004, 3세,2018,4446,2282,2164,105.5,4430,2275,2155,105.6
29,세종특별자치시,005005, 4세,2018,4346,2215,2131,103.9,4329,2202,2127,103.5
29,세종특별자치시,010,5~9세,2018,22684,11625,11059,105.1,22632,11597,11035,105.1
29,세종특별자치시,010001, 5세,2018,4488,2282,2206,103.4,4475,2277,2198,103.6
29,세종특별자치시,010002, 6세,2018,4712,2417,2295,105.3,4702,2411,2291,105.2
29,세종특별자치시,010003, 7세,2018,4721,2440,2281,107,4711,2433,2278,106.8
29,세종특별자치시,010004, 8세,2018,4442,2276,2166,105.1,4430,2269,2161,105
29,세종특별자치시,010005, 9세,2018,4321,2210,2111,104.7,4314,2207,2107,104.7
29,세종특별자치시,015,10~14세,2018,19613,9751,9862,98.9,19579,9744,9835,99.1
29,세종특별자치시,015001, 10세,2018,4415,2197,2218,99.1,4410,2197,2213,99.3
29,세종특별자치시,015002, 11세,2018,4174,2042,2132,95.8,4163,2039,2124,96
29,세종특별자치시,015003, 12세,2018,3901,1986,1915,103.7,3890,1985,1905,104.2
29,세종특별자치시,015004, 13세,2018,3503,1742,1761,98.9,3500,1742,1758,99.1
29,세종특별자치시,015005, 14세,2018,3620,1784,1836,97.2,3616,1781,1835,97.1
29,세종특별자치시,020,15~19세,2018,17348,8818,8530,103.4,17017,8623,8394,102.7
29,세종특별자치시,020001, 15세,2018,3363,1659,1704,97.4,3357,1658,1699,97.6
29,세종특별자치시,020002, 16세,2018,3176,1621,1555,104.2,3170,1619,1551,104.4
29,세종특별자치시,020003, 17세,2018,3187,1582,1605,98.6,3162,1567,1595,98.2
29,세종특별자치시,020004, 18세,2018,3554,1838,1716,107.1,3418,1754,1664,105.4
29,세종특별자치시,020005, 19세,2018,4068,2118,1950,108.6,3910,2025,1885,107.4
29,세종특별자치시,025,20~24세,2018,19692,10629,9063,117.3,18767,10094,8673,116.4
29,세종특별자치시,025001, 20세,2018,3925,2026,1899,106.7,3736,1925,1811,106.3
29,세종특별자치시,025002, 21세,2018,3710,1903,1807,105.3,3547,1810,1737,104.2
29,세종특별자치시,025003, 22세,2018,3902,2051,1851,110.8,3716,1946,1770,109.9
29,세종특별자치시,025004, 23세,2018,4111,2298,1813,126.8,3917,2177,1740,125.1
29,세종특별자치시,025005, 24세,2018,4044,2351,1693,138.9,3851,2236,1615,138.5
29,세종특별자치시,030,25~29세,2018,18783,9804,8979,109.2,17656,9069,8587,105.6
29,세종특별자치시,030001, 25세,2018,3762,2197,1565,140.4,3527,2038,1489,136.9
29,세종특별자치시,030002, 26세,2018,3765,1954,1811,107.9,3545,1825,1720,106.1
29,세종특별자치시,030003, 27세,2018,3752,1923,1829,105.1,3514,1762,1752,100.6
29,세종특별자치시,030004, 28세,2018,3635,1832,1803,101.6,3423,1689,1734,97.4
29,세종특별자치시,030005, 29세,2018,3869,1898,1971,96.3,3647,1755,1892,92.8
29,세종특별자치시,035,30~34세,2018,23853,11766,12087,97.3,22828,11097,11731,94.6
29,세종특별자치시,035001, 30세,2018,4148,2076,2072,100.2,3936,1928,2008,96
29,세종특별자치시,035002, 31세,2018,4483,2136,2347,91,4267,1988,2279,87.2
29,세종특별자치시,035003, 32세,2018,4708,2316,2392,96.8,4489,2183,2306,94.7
29,세종특별자치시,035004, 33세,2018,5052,2529,2523,100.2,4833,2387,2446,97.6
29,세종특별자치시,035005, 34세,2018,5462,2709,2753,98.4,5303,2611,2692,97
29,세종특별자치시,040,35~39세,2018,33736,16443,17293,95.1,32963,15978,16985,94.1
29,세종특별자치시,040001, 35세,2018,6106,2900,3206,90.5,5937,2804,3133,89.5
29,세종특별자치시,040002, 36세,2018,7019,3422,3597,95.1,6852,3318,3534,93.9
29,세종특별자치시,040003, 37세,2018,6915,3357,3558,94.4,6776,3268,3508,93.2
29,세종특별자치시,040004, 38세,2018,6922,3430,3492,98.2,6778,3348,3430,97.6
29,세종특별자치시,040005, 39세,2018,6774,3334,3440,96.9,6620,3240,3380,95.9
29,세종특별자치시,045,40~44세,2018,30228,15349,14879,103.2,29664,15016,14648,102.5
29,세종특별자치시,045001, 40세,2018,6033,2996,3037,98.6,5902,2918,2984,97.8
29,세종특별자치시,045002, 41세,2018,6229,3147,3082,102.1,6122,3084,3038,101.5
29,세종특별자치시,045003, 42세,2018,5829,2922,2907,100.5,5721,2861,2860,100
29,세종특별자치시,045004, 43세,2018,5928,3049,2879,105.9,5822,2988,2834,105.4
29,세종특별자치시,045005, 44세,2018,6209,3235,2974,108.8,6097,3165,2932,107.9
29,세종특별자치시,050,45~49세,2018,26319,14220,12099,117.5,25846,13937,11909,117
29,세종특별자치시,050001, 45세,2018,5811,3073,2738,112.2,5726,3019,2707,111.5
29,세종특별자치시,050002, 46세,2018,5353,2962,2391,123.9,5258,2901,2357,123.1
29,세종특별자치시,050003, 47세,2018,5584,2969,2615,113.5,5481,2911,2570,113.3
29,세종특별자치시,050004, 48세,2018,4828,2659,2169,122.6,4734,2602,2132,122
29,세종특별자치시,050005, 49세,2018,4743,2557,2186,117,4647,2504,2143,116.8
29,세종특별자치시,055,50~54세,2018,19174,9962,9212,108.1,18779,9743,9036,107.8
29,세종특별자치시,055001, 50세,2018,4522,2347,2175,107.9,4441,2307,2134,108.1
29,세종특별자치시,055002, 51세,2018,3889,2010,1879,107,3814,1969,1845,106.7
29,세종특별자치시,055003, 52세,2018,3555,1857,1698,109.4,3483,1819,1664,109.3
29,세종특별자치시,055004, 53세,2018,3796,1949,1847,105.5,3715,1897,1818,104.3
29,세종특별자치시,055005, 54세,2018,3412,1799,1613,111.5,3326,1751,1575,111.2
29,세종특별자치시,060,55~59세,2018,18027,9172,8855,103.6,17695,9004,8691,103.6
29,세종특별자치시,060001, 55세,2018,3507,1825,1682,108.5,3407,1773,1634,108.5
29,세종특별자치시,060002, 56세,2018,3609,1883,1726,109.1,3543,1854,1689,109.8
29,세종특별자치시,060003, 57세,2018,3955,1978,1977,100.1,3913,1960,1953,100.4
29,세종특별자치시,060004, 58세,2018,3690,1865,1825,102.2,3623,1823,1800,101.3
29,세종특별자치시,060005, 59세,2018,3266,1621,1645,98.5,3209,1594,1615,98.7
29,세종특별자치시,065,60~64세,2018,14202,7068,7134,99.1,13979,6946,7033,98.8
29,세종특별자치시,065001, 60세,2018,3078,1537,1541,99.7,3030,1508,1522,99.1
29,세종특별자치시,065002, 61세,2018,3026,1508,1518,99.3,2967,1476,1491,99
29,세종특별자치시,065003, 62세,2018,2819,1424,1395,102.1,2780,1400,1380,101.4
29,세종특별자치시,065004, 63세,2018,2886,1440,1446,99.6,2842,1421,1421,100
29,세종특별자치시,065005, 64세,2018,2393,1159,1234,93.9,2360,1141,1219,93.6
29,세종특별자치시,070,65~69세,2018,9251,4513,4738,95.3,9159,4456,4703,94.7
29,세종특별자치시,070001, 65세,2018,1951,970,981,98.9,1921,949,972,97.6
29,세종특별자치시,070002, 66세,2018,2163,1050,1113,94.3,2144,1038,1106,93.9
29,세종특별자치시,070003, 67세,2018,1572,750,822,91.2,1560,744,816,91.2
29,세종특별자치시,070004, 68세,2018,1823,917,906,101.2,1804,907,897,101.1
29,세종특별자치시,070005, 69세,2018,1742,826,916,90.2,1730,818,912,89.7
29,세종특별자치시,075,70~74세,2018,6377,2987,3390,88.1,6350,2971,3379,87.9
29,세종특별자치시,075001, 70세,2018,1516,754,762,99,1509,752,757,99.3
29,세종특별자치시,075002, 71세,2018,1475,697,778,89.6,1464,689,775,88.9
29,세종특별자치시,075003, 72세,2018,1141,536,605,88.6,1137,532,605,87.9
29,세종특별자치시,075004, 73세,2018,1097,511,586,87.2,1095,511,584,87.5
29,세종특별자치시,075005, 74세,2018,1148,489,659,74.2,1145,487,658,74
29,세종특별자치시,080,75~79세,2018,5710,2402,3308,72.6,5697,2398,3299,72.7
29,세종특별자치시,080001, 75세,2018,1129,503,626,80.4,1123,503,620,81.1
29,세종특별자치시,080002, 76세,2018,1445,631,814,77.5,1443,630,813,77.5
29,세종특별자치시,080003, 77세,2018,1136,467,669,69.8,1134,466,668,69.8
29,세종특별자치시,080004, 78세,2018,997,405,592,68.4,995,404,591,68.4
29,세종특별자치시,080005, 79세,2018,1003,396,607,65.2,1002,395,607,65.1
29,세종특별자치시,085,80~84세,2018,3835,1407,2428,57.9,3823,1405,2418,58.1
29,세종특별자치시,085001, 80세,2018,920,362,558,64.9,917,362,555,65.2
29,세종특별자치시,085002, 81세,2018,786,292,494,59.1,783,292,491,59.5
29,세종특별자치시,085003, 82세,2018,785,285,500,57,783,283,500,56.6
29,세종특별자치시,085004, 83세,2018,709,251,458,54.8,708,251,457,54.9
29,세종특별자치시,085005, 84세,2018,635,217,418,51.9,632,217,415,52.3
29,세종특별자치시,090,85~89세,2018,1918,505,1413,35.7,1916,504,1412,35.7
29,세종특별자치시,090001, 85세,2018,537,144,393,36.6,536,143,393,36.4
29,세종특별자치시,090002, 86세,2018,436,108,328,32.9,435,108,327,33
29,세종특별자치시,090003, 87세,2018,358,100,258,38.8,358,100,258,38.8
29,세종특별자치시,090004, 88세,2018,304,85,219,38.8,304,85,219,38.8
29,세종특별자치시,090005, 89세,2018,283,68,215,31.6,283,68,215,31.6
29,세종특별자치시,095,90~94세,2018,619,141,478,29.5,619,141,478,29.5
29,세종특별자치시,095001, 90세,2018,204,47,157,29.9,204,47,157,29.9
29,세종특별자치시,095002, 91세,2018,164,41,123,33.3,164,41,123,33.3
29,세종특별자치시,095003, 92세,2018,105,27,78,34.6,105,27,78,34.6
29,세종특별자치시,095004, 93세,2018,86,17,69,24.6,86,17,69,24.6
29,세종특별자치시,095005, 94세,2018,60,9,51,17.6,60,9,51,17.6
29,세종특별자치시,100,95~99세,2018,120,24,96,25,120,24,96,25
29,세종특별자치시,100001, 95세,2018,48,9,39,23.1,48,9,39,23.1
29,세종특별자치시,100002, 96세,2018,40,9,31,29,40,9,31,29
29,세종특별자치시,100003, 97세,2018,19,X,15,26.7,19,X,15,26.7
29,세종특별자치시,100004, 98세,2018,9,X,8,12.5,9,X,8,12.5
29,세종특별자치시,100005, 99세,2018,X,X,X,33.3,X,X,X,33.3
29,세종특별자치시,101,100세이상,2018,21,X,20,5,21,X,20,5
29,세종특별자치시,102,15세미만,2018,63161,32078,31083,103.2,62989,31995,30994,103.2
29,세종특별자치시,103,15~64세,2018,221362,113231,108131,104.7,215194,109507,105687,103.6
29,세종특별자치시,104,65세이상,2018,27851,11980,15871,75.5,27705,11900,15805,75.3
29,세종특별자치시,086,85세이상,2018,2678,671,2007,33.4,2676,670,2006,33.4
29,세종특별자치시,126,평균연령,2018,36.2,35.6,36.9,,36.2,35.6,36.9,
29,세종특별자치시,127,중위연령,2018,37,36.8,37.3,,37.1,36.9,37.3,
29004, 읍부,000,합계,2018,50660,26604,24056,110.6,48780,25577,23203,110.2
29004, 읍부,005,0~4세,2018,1766,942,824,114.3,1733,918,815,112.6
29004, 읍부,005001, 0세,2018,278,144,134,107.5,268,139,129,107.8
29004, 읍부,005002, 1세,2018,331,168,163,103.1,326,163,163,100
29004, 읍부,005003, 2세,2018,364,193,171,112.9,358,188,170,110.6
29004, 읍부,005004, 3세,2018,391,231,160,144.4,388,229,159,144
29004, 읍부,005005, 4세,2018,402,206,196,105.1,393,199,194,102.6
29004, 읍부,010,5~9세,2018,2214,1120,1094,102.4,2193,1112,1081,102.9
29004, 읍부,010001, 5세,2018,392,192,200,96,384,190,194,97.9
29004, 읍부,010002, 6세,2018,453,232,221,105,448,231,217,106.5
29004, 읍부,010003, 7세,2018,443,235,208,113,441,233,208,112
29004, 읍부,010004, 8세,2018,493,244,249,98,490,241,249,96.8
29004, 읍부,010005, 9세,2018,433,217,216,100.5,430,217,213,101.9
29004, 읍부,015,10~14세,2018,2133,1078,1055,102.2,2124,1077,1047,102.9
29004, 읍부,015001, 10세,2018,501,256,245,104.5,499,256,243,105.3
29004, 읍부,015002, 11세,2018,446,217,229,94.8,442,216,226,95.6
29004, 읍부,015003, 12세,2018,388,201,187,107.5,385,201,184,109.2
29004, 읍부,015004, 13세,2018,384,193,191,101,384,193,191,101
29004, 읍부,015005, 14세,2018,414,211,203,103.9,414,211,203,103.9
29004, 읍부,020,15~19세,2018,4006,2184,1822,119.9,3817,2078,1739,119.5
29004, 읍부,020001, 15세,2018,435,238,197,120.8,432,238,194,122.7
29004, 읍부,020002, 16세,2018,480,273,207,131.9,478,272,206,132
29004, 읍부,020003, 17세,2018,457,249,208,119.7,443,239,204,117.2
29004, 읍부,020004, 18세,2018,891,493,398,123.9,793,433,360,120.3
29004, 읍부,020005, 19세,2018,1743,931,812,114.7,1671,896,775,115.6
29004, 읍부,025,20~24세,2018,6871,3714,3157,117.6,6615,3593,3022,118.9
29004, 읍부,025001, 20세,2018,1482,693,789,87.8,1403,653,750,87.1
29004, 읍부,025002, 21세,2018,1286,585,701,83.5,1236,558,678,82.3
29004, 읍부,025003, 22세,2018,1411,742,669,110.9,1361,718,643,111.7
29004, 읍부,025004, 23세,2018,1410,829,581,142.7,1374,812,562,144.5
29004, 읍부,025005, 24세,2018,1282,865,417,207.4,1241,852,389,219
29004, 읍부,030,25~29세,2018,3957,2513,1444,174,3707,2380,1327,179.4
29004, 읍부,030001, 25세,2018,1139,803,336,239,1090,778,312,249.4
29004, 읍부,030002, 26세,2018,876,561,315,178.1,834,541,293,184.6
29004, 읍부,030003, 27세,2018,758,479,279,171.7,696,442,254,174
29004, 읍부,030004, 28세,2018,618,356,262,135.9,571,330,241,136.9
29004, 읍부,030005, 29세,2018,566,314,252,124.6,516,289,227,127.3
29004, 읍부,035,30~34세,2018,2797,1539,1258,122.3,2562,1405,1157,121.4
29004, 읍부,035001, 30세,2018,546,322,224,143.8,498,291,207,140.6
29004, 읍부,035002, 31세,2018,548,300,248,121,496,268,228,117.5
29004, 읍부,035003, 32세,2018,558,285,273,104.4,502,257,245,104.9
29004, 읍부,035004, 33세,2018,575,311,264,117.8,531,285,246,115.9
29004, 읍부,035005, 34세,2018,570,321,249,128.9,535,304,231,131.6
29004, 읍부,040,35~39세,2018,3436,1766,1670,105.7,3309,1696,1613,105.1
29004, 읍부,040001, 35세,2018,601,298,303,98.3,573,284,289,98.3
29004, 읍부,040002, 36세,2018,729,387,342,113.2,699,370,329,112.5
29004, 읍부,040003, 37세,2018,717,379,338,112.1,693,365,328,111.3
29004, 읍부,040004, 38세,2018,714,371,343,108.2,694,359,335,107.2
29004, 읍부,040005, 39세,2018,675,331,344,96.2,650,318,332,95.8
29004, 읍부,045,40~44세,2018,3529,1884,1645,114.5,3382,1802,1580,114.1
29004, 읍부,045001, 40세,2018,668,349,319,109.4,636,333,303,109.9
29004, 읍부,045002, 41세,2018,711,377,334,112.9,683,362,321,112.8
29004, 읍부,045003, 42세,2018,702,362,340,106.5,667,342,325,105.2
29004, 읍부,045004, 43세,2018,667,357,310,115.2,642,344,298,115.4
29004, 읍부,045005, 44세,2018,781,439,342,128.4,754,421,333,126.4
29004, 읍부,050,45~49세,2018,3899,2141,1758,121.8,3742,2047,1695,120.8
29004, 읍부,050001, 45세,2018,792,429,363,118.2,764,412,352,117
29004, 읍부,050002, 46세,2018,782,436,346,126,752,417,335,124.5
29004, 읍부,050003, 47세,2018,813,439,374,117.4,776,416,360,115.6
29004, 읍부,050004, 48세,2018,718,397,321,123.7,692,383,309,123.9
29004, 읍부,050005, 49세,2018,794,440,354,124.3,758,419,339,123.6
29004, 읍부,055,50~54세,2018,3393,1783,1610,110.7,3220,1691,1529,110.6
29004, 읍부,055001, 50세,2018,747,399,348,114.7,712,384,328,117.1
29004, 읍부,055002, 51세,2018,685,345,340,101.5,649,328,321,102.2
29004, 읍부,055003, 52세,2018,630,328,302,108.6,598,312,286,109.1
29004, 읍부,055004, 53세,2018,697,351,346,101.4,664,330,334,98.8
29004, 읍부,055005, 54세,2018,634,360,274,131.4,597,337,260,129.6
29004, 읍부,060,55~59세,2018,3435,1774,1661,106.8,3298,1697,1601,106
29004, 읍부,060001, 55세,2018,662,345,317,108.8,621,321,300,107
29004, 읍부,060002, 56세,2018,684,356,328,108.5,654,343,311,110.3
29004, 읍부,060003, 57세,2018,750,393,357,110.1,733,386,347,111.2
29004, 읍부,060004, 58세,2018,737,384,353,108.8,712,365,347,105.2
29004, 읍부,060005, 59세,2018,602,296,306,96.7,578,282,296,95.3
29004, 읍부,065,60~64세,2018,2817,1408,1409,99.9,2729,1357,1372,98.9
29004, 읍부,065001, 60세,2018,575,291,284,102.5,554,278,276,100.7
29004, 읍부,065002, 61세,2018,615,298,317,94,592,286,306,93.5
29004, 읍부,065003, 62세,2018,540,295,245,120.4,525,286,239,119.7
29004, 읍부,065004, 63세,2018,607,300,307,97.7,590,289,301,96
29004, 읍부,065005, 64세,2018,480,224,256,87.5,468,218,250,87.2
29004, 읍부,070,65~69세,2018,1990,965,1025,94.1,1948,937,1011,92.7
29004, 읍부,070001, 65세,2018,422,209,213,98.1,409,200,209,95.7
29004, 읍부,070002, 66세,2018,464,246,218,112.8,453,238,215,110.7
29004, 읍부,070003, 67세,2018,329,146,183,79.8,324,142,182,78
29004, 읍부,070004, 68세,2018,397,191,206,92.7,389,188,201,93.5
29004, 읍부,070005, 69세,2018,378,173,205,84.4,373,169,204,82.8
29004, 읍부,075,70~74세,2018,1489,658,831,79.2,1481,653,828,78.9
29004, 읍부,075001, 70세,2018,344,175,169,103.6,341,174,167,104.2
29004, 읍부,075002, 71세,2018,330,156,174,89.7,327,154,173,89
29004, 읍부,075003, 72세,2018,275,112,163,68.7,274,111,163,68.1
29004, 읍부,075004, 73세,2018,263,112,151,74.2,263,112,151,74.2
29004, 읍부,075005, 74세,2018,277,103,174,59.2,276,102,174,58.6
29004, 읍부,080,75~79세,2018,1428,616,812,75.9,1424,615,809,76
29004, 읍부,080001, 75세,2018,293,126,167,75.4,291,126,165,76.4
29004, 읍부,080002, 76세,2018,329,151,178,84.8,328,150,178,84.3
29004, 읍부,080003, 77세,2018,309,132,177,74.6,308,132,176,75
29004, 읍부,080004, 78세,2018,234,105,129,81.4,234,105,129,81.4
29004, 읍부,080005, 79세,2018,263,102,161,63.4,263,102,161,63.4
29004, 읍부,085,80~84세,2018,876,355,521,68.1,872,355,517,68.7
29004, 읍부,085001, 80세,2018,215,96,119,80.7,214,96,118,81.4
29004, 읍부,085002, 81세,2018,169,75,94,79.8,168,75,93,80.6
29004, 읍부,085003, 82세,2018,192,76,116,65.5,192,76,116,65.5
29004, 읍부,085004, 83세,2018,175,64,111,57.7,174,64,110,58.2
29004, 읍부,085005, 84세,2018,125,44,81,54.3,124,44,80,55
29004, 읍부,090,85~89세,2018,433,121,312,38.8,433,121,312,38.8
29004, 읍부,090001, 85세,2018,104,27,77,35.1,104,27,77,35.1
29004, 읍부,090002, 86세,2018,96,26,70,37.1,96,26,70,37.1
29004, 읍부,090003, 87세,2018,82,27,55,49.1,82,27,55,49.1
29004, 읍부,090004, 88세,2018,77,22,55,40,77,22,55,40
29004, 읍부,090005, 89세,2018,74,19,55,34.5,74,19,55,34.5
29004, 읍부,095,90~94세,2018,155,35,120,29.2,155,35,120,29.2
29004, 읍부,095001, 90세,2018,44,7,37,18.9,44,7,37,18.9
29004, 읍부,095002, 91세,2018,42,16,26,61.5,42,16,26,61.5
29004, 읍부,095003, 92세,2018,27,6,21,28.6,27,6,21,28.6
29004, 읍부,095004, 93세,2018,25,X,21,19,25,X,21,19
29004, 읍부,095005, 94세,2018,17,X,15,13.3,17,X,15,13.3
29004, 읍부,100,95~99세,2018,28,7,21,33.3,28,7,21,33.3
29004, 읍부,100001, 95세,2018,9,X,7,28.6,9,X,7,28.6
29004, 읍부,100002, 96세,2018,12,X,8,50,12,X,8,50
29004, 읍부,100003, 97세,2018,X,X,X,50,X,X,X,50
29004, 읍부,100004, 98세,2018,X,X,X,0,X,X,X,0
29004, 읍부,100005, 99세,2018,X,X,X,0,X,X,X,0
29004, 읍부,101,100세이상,2018,8,X,7,14.3,8,X,7,14.3
29004, 읍부,102,15세미만,2018,6113,3140,2973,105.6,6050,3107,2943,105.6
29004, 읍부,103,15~64세,2018,38140,20706,17434,118.8,36381,19746,16635,118.7
29004, 읍부,104,65세이상,2018,6407,2758,3649,75.6,6349,2724,3625,75.1
29004, 읍부,086,85세이상,2018,624,164,460,35.7,624,164,460,35.7
29004, 읍부,126,평균연령,2018,38.9,37.7,40.2,,39,37.7,40.4,
29004, 읍부,127,중위연령,2018,37.4,35.7,39.1,,37.5,35.8,39.4,
29005, 면부,000,합계,2018,52239,28344,23895,118.6,48999,26056,22943,113.6
29005, 면부,005,0~4세,2018,1057,547,510,107.3,1045,539,506,106.5
29005, 면부,005001, 0세,2018,230,114,116,98.3,225,110,115,95.7
29005, 면부,005002, 1세,2018,187,100,87,114.9,184,98,86,114
29005, 면부,005003, 2세,2018,221,118,103,114.6,219,117,102,114.7
29005, 면부,005004, 3세,2018,220,118,102,115.7,220,118,102,115.7
29005, 면부,005005, 4세,2018,199,97,102,95.1,197,96,101,95
29005, 면부,010,5~9세,2018,1091,551,540,102,1082,545,537,101.5
29005, 면부,010001, 5세,2018,222,118,104,113.5,221,118,103,114.6
29005, 면부,010002, 6세,2018,222,113,109,103.7,219,110,109,100.9
29005, 면부,010003, 7세,2018,205,93,112,83,203,91,112,81.3
29005, 면부,010004, 8세,2018,219,116,103,112.6,217,116,101,114.9
29005, 면부,010005, 9세,2018,223,111,112,99.1,222,110,112,98.2
29005, 면부,015,10~14세,2018,1167,585,582,100.5,1157,582,575,101.2
29005, 면부,015001, 10세,2018,262,131,131,100,262,131,131,100
29005, 면부,015002, 11세,2018,221,113,108,104.6,216,112,104,107.7
29005, 면부,015003, 12세,2018,229,115,114,100.9,226,115,111,103.6
29005, 면부,015004, 13세,2018,210,110,100,110,210,110,100,110
29005, 면부,015005, 14세,2018,245,116,129,89.9,243,114,129,88.4
29005, 면부,020,15~19세,2018,2432,1273,1159,109.8,2318,1196,1122,106.6
29005, 면부,020001, 15세,2018,245,127,118,107.6,243,127,116,109.5
29005, 면부,020002, 16세,2018,234,130,104,125,232,129,103,125.2
29005, 면부,020003, 17세,2018,358,211,147,143.5,353,209,144,145.1
29005, 면부,020004, 18세,2018,497,269,228,118,466,250,216,115.7
29005, 면부,020005, 19세,2018,1098,536,562,95.4,1024,481,543,88.6
29005, 면부,025,20~24세,2018,5509,3061,2448,125,4967,2685,2282,117.7
29005, 면부,025001, 20세,2018,1113,517,596,86.7,1011,460,551,83.5
29005, 면부,025002, 21세,2018,984,446,538,82.9,889,384,505,76
29005, 면부,025003, 22세,2018,1080,569,511,111.4,973,493,480,102.7
29005, 면부,025004, 23세,2018,1221,773,448,172.5,1100,682,418,163.2
29005, 면부,025005, 24세,2018,1111,756,355,213,994,666,328,203
29005, 면부,030,25~29세,2018,3941,2645,1296,204.1,3285,2134,1151,185.4
29005, 면부,030001, 25세,2018,907,633,274,231,766,514,252,204
29005, 면부,030002, 26세,2018,818,525,293,179.2,689,433,256,169.1
29005, 면부,030003, 27세,2018,819,557,262,212.6,687,456,231,197.4
29005, 면부,030004, 28세,2018,744,513,231,222.1,615,412,203,203
29005, 면부,030005, 29세,2018,653,417,236,176.7,528,319,209,152.6
29005, 면부,035,30~34세,2018,2890,1886,1004,187.8,2357,1472,885,166.3
29005, 면부,035001, 30세,2018,624,429,195,220,514,344,170,202.4
29005, 면부,035002, 31세,2018,603,385,218,176.6,490,294,196,150
29005, 면부,035003, 32세,2018,544,364,180,202.2,440,283,157,180.3
29005, 면부,035004, 33세,2018,563,362,201,180.1,444,268,176,152.3
29005, 면부,035005, 34세,2018,556,346,210,164.8,469,283,186,152.2
29005, 면부,040,35~39세,2018,2867,1778,1089,163.3,2420,1462,958,152.6
29005, 면부,040001, 35세,2018,523,312,211,147.9,437,251,186,134.9
29005, 면부,040002, 36세,2018,621,379,242,156.6,529,311,218,142.7
29005, 면부,040003, 37세,2018,579,363,216,168.1,492,296,196,151
29005, 면부,040004, 38세,2018,578,354,224,158,486,296,190,155.8
29005, 면부,040005, 39세,2018,566,370,196,188.8,476,308,168,183.3
29005, 면부,045,40~44세,2018,2858,1827,1031,177.2,2586,1636,950,172.2
29005, 면부,045001, 40세,2018,524,353,171,206.4,455,303,152,199.3
29005, 면부,045002, 41세,2018,569,368,201,183.1,520,332,188,176.6
29005, 면부,045003, 42세,2018,537,323,214,150.9,491,296,195,151.8
29005, 면부,045004, 43세,2018,577,366,211,173.5,522,329,193,170.5
29005, 면부,045005, 44세,2018,651,417,234,178.2,598,376,222,169.4
29005, 면부,050,45~49세,2018,3479,2109,1370,153.9,3247,1965,1282,153.3
29005, 면부,050001, 45세,2018,634,378,256,147.7,593,351,242,145
29005, 면부,050002, 46세,2018,580,361,219,164.8,534,331,203,163.1
29005, 면부,050003, 47세,2018,742,451,291,155,691,421,270,155.9
29005, 면부,050004, 48세,2018,754,459,295,155.6,703,425,278,152.9
29005, 면부,050005, 49세,2018,769,460,309,148.9,726,437,289,151.2
29005, 면부,055,50~54세,2018,3887,2168,1719,126.1,3721,2060,1661,124
29005, 면부,055001, 50세,2018,756,412,344,119.8,724,392,332,118.1
29005, 면부,055002, 51세,2018,740,403,337,119.6,714,386,328,117.7
29005, 면부,055003, 52세,2018,706,401,305,131.5,672,381,291,130.9
29005, 면부,055004, 53세,2018,898,532,366,145.4,859,503,356,141.3
29005, 면부,055005, 54세,2018,787,420,367,114.4,752,398,354,112.4
29005, 면부,060,55~59세,2018,4829,2588,2241,115.5,4700,2524,2176,116
29005, 면부,060001, 55세,2018,854,463,391,118.4,816,439,377,116.4
29005, 면부,060002, 56세,2018,950,520,430,120.9,922,508,414,122.7
29005, 면부,060003, 57세,2018,1046,542,504,107.5,1029,535,494,108.3
29005, 면부,060004, 58세,2018,1027,563,464,121.3,1004,551,453,121.6
29005, 면부,060005, 59세,2018,952,500,452,110.6,929,491,438,112.1
29005, 면부,065,60~64세,2018,4422,2309,2113,109.3,4347,2265,2082,108.8
29005, 면부,065001, 60세,2018,878,466,412,113.1,864,456,408,111.8
29005, 면부,065002, 61세,2018,882,448,434,103.2,862,438,424,103.3
29005, 면부,065003, 62세,2018,902,469,433,108.3,889,459,430,106.7
29005, 면부,065004, 63세,2018,944,496,448,110.7,931,491,440,111.6
29005, 면부,065005, 64세,2018,816,430,386,111.4,801,421,380,110.8
29005, 면부,070,65~69세,2018,3235,1652,1583,104.4,3211,1636,1575,103.9
29005, 면부,070001, 65세,2018,626,324,302,107.3,620,319,301,106
29005, 면부,070002, 66세,2018,744,360,384,93.8,741,357,384,93
29005, 면부,070003, 67세,2018,554,291,263,110.6,549,290,259,112
29005, 면부,070004, 68세,2018,654,353,301,117.3,647,348,299,116.4
29005, 면부,070005, 69세,2018,657,324,333,97.3,654,322,332,97
29005, 면부,075,70~74세,2018,2463,1146,1317,87,2450,1139,1311,86.9
29005, 면부,075001, 70세,2018,557,266,291,91.4,555,266,289,92
29005, 면부,075002, 71세,2018,526,258,268,96.3,519,253,266,95.1
29005, 면부,075003, 72세,2018,451,213,238,89.5,449,211,238,88.7
29005, 면부,075004, 73세,2018,435,205,230,89.1,433,205,228,89.9
29005, 면부,075005, 74세,2018,494,204,290,70.3,494,204,290,70.3
29005, 면부,080,75~79세,2018,2699,1105,1594,69.3,2697,1103,1594,69.2
29005, 면부,080001, 75세,2018,473,203,270,75.2,473,203,270,75.2
29005, 면부,080002, 76세,2018,685,296,389,76.1,685,296,389,76.1
29005, 면부,080003, 77세,2018,519,199,320,62.2,519,199,320,62.2
29005, 면부,080004, 78세,2018,517,201,316,63.6,516,200,316,63.3
29005, 면부,080005, 79세,2018,505,206,299,68.9,504,205,299,68.6
29005, 면부,085,80~84세,2018,2018,758,1260,60.2,2015,758,1257,60.3
29005, 면부,085001, 80세,2018,467,185,282,65.6,466,185,281,65.8
29005, 면부,085002, 81세,2018,436,160,276,58,434,160,274,58.4
29005, 면부,085003, 82세,2018,403,146,257,56.8,403,146,257,56.8
29005, 면부,085004, 83세,2018,361,142,219,64.8,361,142,219,64.8
29005, 면부,085005, 84세,2018,351,125,226,55.3,351,125,226,55.3
29005, 면부,090,85~89세,2018,1018,279,739,37.8,1017,278,739,37.6
29005, 면부,090001, 85세,2018,314,90,224,40.2,313,89,224,39.7
29005, 면부,090002, 86세,2018,232,58,174,33.3,232,58,174,33.3
29005, 면부,090003, 87세,2018,187,54,133,40.6,187,54,133,40.6
29005, 면부,090004, 88세,2018,143,44,99,44.4,143,44,99,44.4
29005, 면부,090005, 89세,2018,142,33,109,30.3,142,33,109,30.3
29005, 면부,095,90~94세,2018,301,67,234,28.6,301,67,234,28.6
29005, 면부,095001, 90세,2018,99,25,74,33.8,99,25,74,33.8
29005, 면부,095002, 91세,2018,85,17,68,25,85,17,68,25
29005, 면부,095003, 92세,2018,51,14,37,37.8,51,14,37,37.8
29005, 면부,095004, 93세,2018,41,8,33,24.2,41,8,33,24.2
29005, 면부,095005, 94세,2018,25,X,22,13.6,25,X,22,13.6
29005, 면부,100,95~99세,2018,65,10,55,18.2,65,10,55,18.2
29005, 면부,100001, 95세,2018,27,X,23,17.4,27,X,23,17.4
29005, 면부,100002, 96세,2018,22,X,19,15.8,22,X,19,15.8
29005, 면부,100003, 97세,2018,11,X,10,10,11,X,10,10
29005, 면부,100004, 98세,2018,X,X,X,100,X,X,X,100
29005, 면부,100005, 99세,2018,X,X,X,50,X,X,X,50
29005, 면부,101,100세이상,2018,11,X,11,0,11,X,11,0
29005, 면부,102,15세미만,2018,3315,1683,1632,103.1,3284,1666,1618,103
29005, 면부,103,15~64세,2018,37114,21644,15470,139.9,33948,19399,14549,133.3
29005, 면부,104,65세이상,2018,11810,5017,6793,73.9,11767,4991,6776,73.7
29005, 면부,086,85세이상,2018,1395,356,1039,34.3,1394,355,1039,34.2
29005, 면부,126,평균연령,2018,46.8,44.6,49.4,,47.6,45.5,49.9,
29005, 면부,127,중위연령,2018,48.5,45,52.8,,50,47.2,53.8,
29003, 동부,000,합계,2018,209475,102341,107134,95.5,208109,101769,106340,95.7
29003, 동부,005,0~4세,2018,18041,9213,8828,104.4,18000,9197,8803,104.5
29003, 동부,005001, 0세,2018,3183,1613,1570,102.7,3180,1613,1567,102.9
29003, 동부,005002, 1세,2018,3454,1772,1682,105.4,3445,1769,1676,105.5
29003, 동부,005003, 2세,2018,3824,1983,1841,107.7,3814,1980,1834,108
29003, 동부,005004, 3세,2018,3835,1933,1902,101.6,3822,1928,1894,101.8
29003, 동부,005005, 4세,2018,3745,1912,1833,104.3,3739,1907,1832,104.1
29003, 동부,010,5~9세,2018,19379,9954,9425,105.6,19357,9940,9417,105.6
29003, 동부,010001, 5세,2018,3874,1972,1902,103.7,3870,1969,1901,103.6
29003, 동부,010002, 6세,2018,4037,2072,1965,105.4,4035,2070,1965,105.3
29003, 동부,010003, 7세,2018,4073,2112,1961,107.7,4067,2109,1958,107.7
29003, 동부,010004, 8세,2018,3730,1916,1814,105.6,3723,1912,1811,105.6
29003, 동부,010005, 9세,2018,3665,1882,1783,105.6,3662,1880,1782,105.5
29003, 동부,015,10~14세,2018,16313,8088,8225,98.3,16298,8085,8213,98.4
29003, 동부,015001, 10세,2018,3652,1810,1842,98.3,3649,1810,1839,98.4
29003, 동부,015002, 11세,2018,3507,1712,1795,95.4,3505,1711,1794,95.4
29003, 동부,015003, 12세,2018,3284,1670,1614,103.5,3279,1669,1610,103.7
29003, 동부,015004, 13세,2018,2909,1439,1470,97.9,2906,1439,1467,98.1
29003, 동부,015005, 14세,2018,2961,1457,1504,96.9,2959,1456,1503,96.9
29003, 동부,020,15~19세,2018,10910,5361,5549,96.6,10882,5349,5533,96.7
29003, 동부,020001, 15세,2018,2683,1294,1389,93.2,2682,1293,1389,93.1
29003, 동부,020002, 16세,2018,2462,1218,1244,97.9,2460,1218,1242,98.1
29003, 동부,020003, 17세,2018,2372,1122,1250,89.8,2366,1119,1247,89.7
29003, 동부,020004, 18세,2018,2166,1076,1090,98.7,2159,1071,1088,98.4
29003, 동부,020005, 19세,2018,1227,651,576,113,1215,648,567,114.3
29003, 동부,025,20~24세,2018,7312,3854,3458,111.5,7185,3816,3369,113.3
29003, 동부,025001, 20세,2018,1330,816,514,158.8,1322,812,510,159.2
29003, 동부,025002, 21세,2018,1440,872,568,153.5,1422,868,554,156.7
29003, 동부,025003, 22세,2018,1411,740,671,110.3,1382,735,647,113.6
29003, 동부,025004, 23세,2018,1480,696,784,88.8,1443,683,760,89.9
29003, 동부,025005, 24세,2018,1651,730,921,79.3,1616,718,898,80
29003, 동부,030,25~29세,2018,10885,4646,6239,74.5,10664,4555,6109,74.6
29003, 동부,030001, 25세,2018,1716,761,955,79.7,1671,746,925,80.6
29003, 동부,030002, 26세,2018,2071,868,1203,72.2,2022,851,1171,72.7
29003, 동부,030003, 27세,2018,2175,887,1288,68.9,2131,864,1267,68.2
29003, 동부,030004, 28세,2018,2273,963,1310,73.5,2237,947,1290,73.4
29003, 동부,030005, 29세,2018,2650,1167,1483,78.7,2603,1147,1456,78.8
29003, 동부,035,30~34세,2018,18166,8341,9825,84.9,17909,8220,9689,84.8
29003, 동부,035001, 30세,2018,2978,1325,1653,80.2,2924,1293,1631,79.3
29003, 동부,035002, 31세,2018,3332,1451,1881,77.1,3281,1426,1855,76.9
29003, 동부,035003, 32세,2018,3606,1667,1939,86,3547,1643,1904,86.3
29003, 동부,035004, 33세,2018,3914,1856,2058,90.2,3858,1834,2024,90.6
29003, 동부,035005, 34세,2018,4336,2042,2294,89,4299,2024,2275,89
29003, 동부,040,35~39세,2018,27433,12899,14534,88.8,27234,12820,14414,88.9
29003, 동부,040001, 35세,2018,4982,2290,2692,85.1,4927,2269,2658,85.4
29003, 동부,040002, 36세,2018,5669,2656,3013,88.2,5624,2637,2987,88.3
29003, 동부,040003, 37세,2018,5619,2615,3004,87.1,5591,2607,2984,87.4
29003, 동부,040004, 38세,2018,5630,2705,2925,92.5,5598,2693,2905,92.7
29003, 동부,040005, 39세,2018,5533,2633,2900,90.8,5494,2614,2880,90.8
29003, 동부,045,40~44세,2018,23841,11638,12203,95.4,23696,11578,12118,95.5
29003, 동부,045001, 40세,2018,4841,2294,2547,90.1,4811,2282,2529,90.2
29003, 동부,045002, 41세,2018,4949,2402,2547,94.3,4919,2390,2529,94.5
29003, 동부,045003, 42세,2018,4590,2237,2353,95.1,4563,2223,2340,95
29003, 동부,045004, 43세,2018,4684,2326,2358,98.6,4658,2315,2343,98.8
29003, 동부,045005, 44세,2018,4777,2379,2398,99.2,4745,2368,2377,99.6
29003, 동부,050,45~49세,2018,18941,9970,8971,111.1,18857,9925,8932,111.1
29003, 동부,050001, 45세,2018,4385,2266,2119,106.9,4369,2256,2113,106.8
29003, 동부,050002, 46세,2018,3991,2165,1826,118.6,3972,2153,1819,118.4
29003, 동부,050003, 47세,2018,4029,2079,1950,106.6,4014,2074,1940,106.9
29003, 동부,050004, 48세,2018,3356,1803,1553,116.1,3339,1794,1545,116.1
29003, 동부,050005, 49세,2018,3180,1657,1523,108.8,3163,1648,1515,108.8
29003, 동부,055,50~54세,2018,11894,6011,5883,102.2,11838,5992,5846,102.5
29003, 동부,055001, 50세,2018,3019,1536,1483,103.6,3005,1531,1474,103.9
29003, 동부,055002, 51세,2018,2464,1262,1202,105,2451,1255,1196,104.9
29003, 동부,055003, 52세,2018,2219,1128,1091,103.4,2213,1126,1087,103.6
29003, 동부,055004, 53세,2018,2201,1066,1135,93.9,2192,1064,1128,94.3
29003, 동부,055005, 54세,2018,1991,1019,972,104.8,1977,1016,961,105.7
29003, 동부,060,55~59세,2018,9763,4810,4953,97.1,9697,4783,4914,97.3
29003, 동부,060001, 55세,2018,1991,1017,974,104.4,1970,1013,957,105.9
29003, 동부,060002, 56세,2018,1975,1007,968,104,1967,1003,964,104
29003, 동부,060003, 57세,2018,2159,1043,1116,93.5,2151,1039,1112,93.4
29003, 동부,060004, 58세,2018,1926,918,1008,91.1,1907,907,1000,90.7
29003, 동부,060005, 59세,2018,1712,825,887,93,1702,821,881,93.2
29003, 동부,065,60~64세,2018,6963,3351,3612,92.8,6903,3324,3579,92.9
29003, 동부,065001, 60세,2018,1625,780,845,92.3,1612,774,838,92.4
29003, 동부,065002, 61세,2018,1529,762,767,99.3,1513,752,761,98.8
29003, 동부,065003, 62세,2018,1377,660,717,92.1,1366,655,711,92.1
29003, 동부,065004, 63세,2018,1335,644,691,93.2,1321,641,680,94.3
29003, 동부,065005, 64세,2018,1097,505,592,85.3,1091,502,589,85.2
29003, 동부,070,65~69세,2018,4026,1896,2130,89,4000,1883,2117,88.9
29003, 동부,070001, 65세,2018,903,437,466,93.8,892,430,462,93.1
29003, 동부,070002, 66세,2018,955,444,511,86.9,950,443,507,87.4
29003, 동부,070003, 67세,2018,689,313,376,83.2,687,312,375,83.2
29003, 동부,070004, 68세,2018,772,373,399,93.5,768,371,397,93.5
29003, 동부,070005, 69세,2018,707,329,378,87,703,327,376,87
29003, 동부,075,70~74세,2018,2425,1183,1242,95.2,2419,1179,1240,95.1
29003, 동부,075001, 70세,2018,615,313,302,103.6,613,312,301,103.7
29003, 동부,075002, 71세,2018,619,283,336,84.2,618,282,336,83.9
29003, 동부,075003, 72세,2018,415,211,204,103.4,414,210,204,102.9
29003, 동부,075004, 73세,2018,399,194,205,94.6,399,194,205,94.6
29003, 동부,075005, 74세,2018,377,182,195,93.3,375,181,194,93.3
29003, 동부,080,75~79세,2018,1583,681,902,75.5,1576,680,896,75.9
29003, 동부,080001, 75세,2018,363,174,189,92.1,359,174,185,94.1
29003, 동부,080002, 76세,2018,431,184,247,74.5,430,184,246,74.8
29003, 동부,080003, 77세,2018,308,136,172,79.1,307,135,172,78.5
29003, 동부,080004, 78세,2018,246,99,147,67.3,245,99,146,67.8
29003, 동부,080005, 79세,2018,235,88,147,59.9,235,88,147,59.9
29003, 동부,085,80~84세,2018,941,294,647,45.4,936,292,644,45.3
29003, 동부,085001, 80세,2018,238,81,157,51.6,237,81,156,51.9
29003, 동부,085002, 81세,2018,181,57,124,46,181,57,124,46
29003, 동부,085003, 82세,2018,190,63,127,49.6,188,61,127,48
29003, 동부,085004, 83세,2018,173,45,128,35.2,173,45,128,35.2
29003, 동부,085005, 84세,2018,159,48,111,43.2,157,48,109,44
29003, 동부,090,85~89세,2018,467,105,362,29,466,105,361,29.1
29003, 동부,090001, 85세,2018,119,27,92,29.3,119,27,92,29.3
29003, 동부,090002, 86세,2018,108,24,84,28.6,107,24,83,28.9
29003, 동부,090003, 87세,2018,89,19,70,27.1,89,19,70,27.1
29003, 동부,090004, 88세,2018,84,19,65,29.2,84,19,65,29.2
29003, 동부,090005, 89세,2018,67,16,51,31.4,67,16,51,31.4
29003, 동부,095,90~94세,2018,163,39,124,31.5,163,39,124,31.5
29003, 동부,095001, 90세,2018,61,15,46,32.6,61,15,46,32.6
29003, 동부,095002, 91세,2018,37,8,29,27.6,37,8,29,27.6
29003, 동부,095003, 92세,2018,27,7,20,35,27,7,20,35
29003, 동부,095004, 93세,2018,20,5,15,33.3,20,5,15,33.3
29003, 동부,095005, 94세,2018,18,X,14,28.6,18,X,14,28.6
29003, 동부,100,95~99세,2018,27,7,20,35,27,7,20,35
29003, 동부,100001, 95세,2018,12,X,9,33.3,12,X,9,33.3
29003, 동부,100002, 96세,2018,6,X,X,50,6,X,X,50
29003, 동부,100003, 97세,2018,5,X,X,66.7,5,X,X,66.7
29003, 동부,100004, 98세,2018,X,X,X,0,X,X,X,0
29003, 동부,100005, 99세,2018,X,X,X,,X,X,X,
29003, 동부,101,100세이상,2018,X,X,X,0,X,X,X,0
29003, 동부,102,15세미만,2018,53733,27255,26478,102.9,53655,27222,26433,103
29003, 동부,103,15~64세,2018,146108,70881,75227,94.2,144865,70362,74503,94.4
29003, 동부,104,65세이상,2018,9634,4205,5429,77.5,9589,4185,5404,77.4
29003, 동부,086,85세이상,2018,659,151,508,29.7,658,151,507,29.8
29003, 동부,126,평균연령,2018,32.9,32.6,33.3,,32.9,32.5,33.3,
29003, 동부,127,중위연령,2018,35.7,35.7,35.7,,35.8,35.8,35.8,
29010, 세종시,000,합계,2018,312374,157289,155085,101.4,305888,153402,152486,100.6
29010, 세종시,005,0~4세,2018,20864,10702,10162,105.3,20778,10654,10124,105.2
29010, 세종시,005001, 0세,2018,3691,1871,1820,102.8,3673,1862,1811,102.8
29010, 세종시,005002, 1세,2018,3972,2040,1932,105.6,3955,2030,1925,105.5
29010, 세종시,005003, 2세,2018,4409,2294,2115,108.5,4391,2285,2106,108.5
29010, 세종시,005004, 3세,2018,4446,2282,2164,105.5,4430,2275,2155,105.6
29010, 세종시,005005, 4세,2018,4346,2215,2131,103.9,4329,2202,2127,103.5
29010, 세종시,010,5~9세,2018,22684,11625,11059,105.1,22632,11597,11035,105.1
29010, 세종시,010001, 5세,2018,4488,2282,2206,103.4,4475,2277,2198,103.6
29010, 세종시,010002, 6세,2018,4712,2417,2295,105.3,4702,2411,2291,105.2
29010, 세종시,010003, 7세,2018,4721,2440,2281,107,4711,2433,2278,106.8
29010, 세종시,010004, 8세,2018,4442,2276,2166,105.1,4430,2269,2161,105
29010, 세종시,010005, 9세,2018,4321,2210,2111,104.7,4314,2207,2107,104.7
29010, 세종시,015,10~14세,2018,19613,9751,9862,98.9,19579,9744,9835,99.1
29010, 세종시,015001, 10세,2018,4415,2197,2218,99.1,4410,2197,2213,99.3
29010, 세종시,015002, 11세,2018,4174,2042,2132,95.8,4163,2039,2124,96
29010, 세종시,015003, 12세,2018,3901,1986,1915,103.7,3890,1985,1905,104.2
29010, 세종시,015004, 13세,2018,3503,1742,1761,98.9,3500,1742,1758,99.1
29010, 세종시,015005, 14세,2018,3620,1784,1836,97.2,3616,1781,1835,97.1
29010, 세종시,020,15~19세,2018,17348,8818,8530,103.4,17017,8623,8394,102.7
29010, 세종시,020001, 15세,2018,3363,1659,1704,97.4,3357,1658,1699,97.6
29010, 세종시,020002, 16세,2018,3176,1621,1555,104.2,3170,1619,1551,104.4
29010, 세종시,020003, 17세,2018,3187,1582,1605,98.6,3162,1567,1595,98.2
29010, 세종시,020004, 18세,2018,3554,1838,1716,107.1,3418,1754,1664,105.4
29010, 세종시,020005, 19세,2018,4068,2118,1950,108.6,3910,2025,1885,107.4
29010, 세종시,025,20~24세,2018,19692,10629,9063,117.3,18767,10094,8673,116.4
29010, 세종시,025001, 20세,2018,3925,2026,1899,106.7,3736,1925,1811,106.3
29010, 세종시,025002, 21세,2018,3710,1903,1807,105.3,3547,1810,1737,104.2
29010, 세종시,025003, 22세,2018,3902,2051,1851,110.8,3716,1946,1770,109.9
29010, 세종시,025004, 23세,2018,4111,2298,1813,126.8,3917,2177,1740,125.1
29010, 세종시,025005, 24세,2018,4044,2351,1693,138.9,3851,2236,1615,138.5
29010, 세종시,030,25~29세,2018,18783,9804,8979,109.2,17656,9069,8587,105.6
29010, 세종시,030001, 25세,2018,3762,2197,1565,140.4,3527,2038,1489,136.9
29010, 세종시,030002, 26세,2018,3765,1954,1811,107.9,3545,1825,1720,106.1
29010, 세종시,030003, 27세,2018,3752,1923,1829,105.1,3514,1762,1752,100.6
29010, 세종시,030004, 28세,2018,3635,1832,1803,101.6,3423,1689,1734,97.4
29010, 세종시,030005, 29세,2018,3869,1898,1971,96.3,3647,1755,1892,92.8
29010, 세종시,035,30~34세,2018,23853,11766,12087,97.3,22828,11097,11731,94.6
29010, 세종시,035001, 30세,2018,4148,2076,2072,100.2,3936,1928,2008,96
29010, 세종시,035002, 31세,2018,4483,2136,2347,91,4267,1988,2279,87.2
29010, 세종시,035003, 32세,2018,4708,2316,2392,96.8,4489,2183,2306,94.7
29010, 세종시,035004, 33세,2018,5052,2529,2523,100.2,4833,2387,2446,97.6
29010, 세종시,035005, 34세,2018,5462,2709,2753,98.4,5303,2611,2692,97
29010, 세종시,040,35~39세,2018,33736,16443,17293,95.1,32963,15978,16985,94.1
29010, 세종시,040001, 35세,2018,6106,2900,3206,90.5,5937,2804,3133,89.5
29010, 세종시,040002, 36세,2018,7019,3422,3597,95.1,6852,3318,3534,93.9
29010, 세종시,040003, 37세,2018,6915,3357,3558,94.4,6776,3268,3508,93.2
29010, 세종시,040004, 38세,2018,6922,3430,3492,98.2,6778,3348,3430,97.6
29010, 세종시,040005, 39세,2018,6774,3334,3440,96.9,6620,3240,3380,95.9
29010, 세종시,045,40~44세,2018,30228,15349,14879,103.2,29664,15016,14648,102.5
29010, 세종시,045001, 40세,2018,6033,2996,3037,98.6,5902,2918,2984,97.8
29010, 세종시,045002, 41세,2018,6229,3147,3082,102.1,6122,3084,3038,101.5
29010, 세종시,045003, 42세,2018,5829,2922,2907,100.5,5721,2861,2860,100
29010, 세종시,045004, 43세,2018,5928,3049,2879,105.9,5822,2988,2834,105.4
29010, 세종시,045005, 44세,2018,6209,3235,2974,108.8,6097,3165,2932,107.9
29010, 세종시,050,45~49세,2018,26319,14220,12099,117.5,25846,13937,11909,117
29010, 세종시,050001, 45세,2018,5811,3073,2738,112.2,5726,3019,2707,111.5
29010, 세종시,050002, 46세,2018,5353,2962,2391,123.9,5258,2901,2357,123.1
29010, 세종시,050003, 47세,2018,5584,2969,2615,113.5,5481,2911,2570,113.3
29010, 세종시,050004, 48세,2018,4828,2659,2169,122.6,4734,2602,2132,122
29010, 세종시,050005, 49세,2018,4743,2557,2186,117,4647,2504,2143,116.8
29010, 세종시,055,50~54세,2018,19174,9962,9212,108.1,18779,9743,9036,107.8
29010, 세종시,055001, 50세,2018,4522,2347,2175,107.9,4441,2307,2134,108.1
29010, 세종시,055002, 51세,2018,3889,2010,1879,107,3814,1969,1845,106.7
29010, 세종시,055003, 52세,2018,3555,1857,1698,109.4,3483,1819,1664,109.3
29010, 세종시,055004, 53세,2018,3796,1949,1847,105.5,3715,1897,1818,104.3
29010, 세종시,055005, 54세,2018,3412,1799,1613,111.5,3326,1751,1575,111.2
29010, 세종시,060,55~59세,2018,18027,9172,8855,103.6,17695,9004,8691,103.6
29010, 세종시,060001, 55세,2018,3507,1825,1682,108.5,3407,1773,1634,108.5
29010, 세종시,060002, 56세,2018,3609,1883,1726,109.1,3543,1854,1689,109.8
29010, 세종시,060003, 57세,2018,3955,1978,1977,100.1,3913,1960,1953,100.4
29010, 세종시,060004, 58세,2018,3690,1865,1825,102.2,3623,1823,1800,101.3
29010, 세종시,060005, 59세,2018,3266,1621,1645,98.5,3209,1594,1615,98.7
29010, 세종시,065,60~64세,2018,14202,7068,7134,99.1,13979,6946,7033,98.8
29010, 세종시,065001, 60세,2018,3078,1537,1541,99.7,3030,1508,1522,99.1
29010, 세종시,065002, 61세,2018,3026,1508,1518,99.3,2967,1476,1491,99
29010, 세종시,065003, 62세,2018,2819,1424,1395,102.1,2780,1400,1380,101.4
29010, 세종시,065004, 63세,2018,2886,1440,1446,99.6,2842,1421,1421,100
29010, 세종시,065005, 64세,2018,2393,1159,1234,93.9,2360,1141,1219,93.6
29010, 세종시,070,65~69세,2018,9251,4513,4738,95.3,9159,4456,4703,94.7
29010, 세종시,070001, 65세,2018,1951,970,981,98.9,1921,949,972,97.6
29010, 세종시,070002, 66세,2018,2163,1050,1113,94.3,2144,1038,1106,93.9
29010, 세종시,070003, 67세,2018,1572,750,822,91.2,1560,744,816,91.2
29010, 세종시,070004, 68세,2018,1823,917,906,101.2,1804,907,897,101.1
29010, 세종시,070005, 69세,2018,1742,826,916,90.2,1730,818,912,89.7
29010, 세종시,075,70~74세,2018,6377,2987,3390,88.1,6350,2971,3379,87.9
29010, 세종시,075001, 70세,2018,1516,754,762,99,1509,752,757,99.3
29010, 세종시,075002, 71세,2018,1475,697,778,89.6,1464,689,775,88.9
29010, 세종시,075003, 72세,2018,1141,536,605,88.6,1137,532,605,87.9
29010, 세종시,075004, 73세,2018,1097,511,586,87.2,1095,511,584,87.5
29010, 세종시,075005, 74세,2018,1148,489,659,74.2,1145,487,658,74
29010, 세종시,080,75~79세,2018,5710,2402,3308,72.6,5697,2398,3299,72.7
29010, 세종시,080001, 75세,2018,1129,503,626,80.4,1123,503,620,81.1
29010, 세종시,080002, 76세,2018,1445,631,814,77.5,1443,630,813,77.5
29010, 세종시,080003, 77세,2018,1136,467,669,69.8,1134,466,668,69.8
29010, 세종시,080004, 78세,2018,997,405,592,68.4,995,404,591,68.4
29010, 세종시,080005, 79세,2018,1003,396,607,65.2,1002,395,607,65.1
29010, 세종시,085,80~84세,2018,3835,1407,2428,57.9,3823,1405,2418,58.1
29010, 세종시,085001, 80세,2018,920,362,558,64.9,917,362,555,65.2
29010, 세종시,085002, 81세,2018,786,292,494,59.1,783,292,491,59.5
29010, 세종시,085003, 82세,2018,785,285,500,57,783,283,500,56.6
29010, 세종시,085004, 83세,2018,709,251,458,54.8,708,251,457,54.9
29010, 세종시,085005, 84세,2018,635,217,418,51.9,632,217,415,52.3
29010, 세종시,090,85~89세,2018,1918,505,1413,35.7,1916,504,1412,35.7
29010, 세종시,090001, 85세,2018,537,144,393,36.6,536,143,393,36.4
29010, 세종시,090002, 86세,2018,436,108,328,32.9,435,108,327,33
29010, 세종시,090003, 87세,2018,358,100,258,38.8,358,100,258,38.8
29010, 세종시,090004, 88세,2018,304,85,219,38.8,304,85,219,38.8
29010, 세종시,090005, 89세,2018,283,68,215,31.6,283,68,215,31.6
29010, 세종시,095,90~94세,2018,619,141,478,29.5,619,141,478,29.5
29010, 세종시,095001, 90세,2018,204,47,157,29.9,204,47,157,29.9
29010, 세종시,095002, 91세,2018,164,41,123,33.3,164,41,123,33.3
29010, 세종시,095003, 92세,2018,105,27,78,34.6,105,27,78,34.6
29010, 세종시,095004, 93세,2018,86,17,69,24.6,86,17,69,24.6
29010, 세종시,095005, 94세,2018,60,9,51,17.6,60,9,51,17.6
29010, 세종시,100,95~99세,2018,120,24,96,25,120,24,96,25
29010, 세종시,100001, 95세,2018,48,9,39,23.1,48,9,39,23.1
29010, 세종시,100002, 96세,2018,40,9,31,29,40,9,31,29
29010, 세종시,100003, 97세,2018,19,X,15,26.7,19,X,15,26.7
29010, 세종시,100004, 98세,2018,9,X,8,12.5,9,X,8,12.5
29010, 세종시,100005, 99세,2018,X,X,X,33.3,X,X,X,33.3
29010, 세종시,101,100세이상,2018,21,X,20,5,21,X,20,5
29010, 세종시,102,15세미만,2018,63161,32078,31083,103.2,62989,31995,30994,103.2
29010, 세종시,103,15~64세,2018,221362,113231,108131,104.7,215194,109507,105687,103.6
29010, 세종시,104,65세이상,2018,27851,11980,15871,75.5,27705,11900,15805,75.3
29010, 세종시,086,85세이상,2018,2678,671,2007,33.4,2676,670,2006,33.4
29010, 세종시,126,평균연령,2018,36.2,35.6,36.9,,36.2,35.6,36.9,
29010, 세종시,127,중위연령,2018,37,36.8,37.3,,37.1,36.9,37.3,
31,경기도,000,합계,2018,13103188,6635106,6468082,102.6,12544991,6301846,6243145,100.9
31,경기도,005,0~4세,2018,563208,288581,274627,105.1,550307,281968,268339,105.1
31,경기도,005001, 0세,2018,93179,47737,45442,105.1,90522,46373,44149,105
31,경기도,005002, 1세,2018,103107,53102,50005,106.2,100276,51668,48608,106.3
31,경기도,005003, 2세,2018,118341,60488,57853,104.6,115398,58967,56431,104.5
31,경기도,005004, 3세,2018,124930,64083,60847,105.3,122626,62865,59761,105.2
31,경기도,005005, 4세,2018,123651,63171,60480,104.4,121485,62095,59390,104.6
31,경기도,010,5~9세,2018,643029,329984,313045,105.4,635978,326438,309540,105.5
31,경기도,010001, 5세,2018,124370,63587,60783,104.6,122537,62712,59825,104.8
31,경기도,010002, 6세,2018,135297,69472,65825,105.5,133659,68651,65008,105.6
31,경기도,010003, 7세,2018,132361,67792,64569,105,131056,67117,63939,105
31,경기도,010004, 8세,2018,127305,65493,61812,106,126165,64905,61260,106
31,경기도,010005, 9세,2018,123696,63640,60056,106,122561,63053,59508,106
31,경기도,015,10~14세,2018,625920,321256,304664,105.4,622001,319321,302680,105.5
31,경기도,015001, 10세,2018,130089,66806,63283,105.6,129113,66303,62810,105.6
31,경기도,015002, 11세,2018,131799,67582,64217,105.2,130905,67145,63760,105.3
31,경기도,015003, 12세,2018,120152,61749,58403,105.7,119403,61382,58021,105.8
31,경기도,015004, 13세,2018,117109,59954,57155,104.9,116483,59655,56828,105
31,경기도,015005, 14세,2018,126771,65165,61606,105.8,126097,64836,61261,105.8
31,경기도,020,15~19세,2018,711806,367865,343941,107,704181,363915,340266,107
31,경기도,020001, 15세,2018,127334,65684,61650,106.5,126771,65400,61371,106.6
31,경기도,020002, 16세,2018,129862,67151,62711,107.1,129200,66822,62378,107.1
31,경기도,020003, 17세,2018,146804,75645,71159,106.3,145970,75203,70767,106.3
31,경기도,020004, 18세,2018,158173,81534,76639,106.4,156432,80658,75774,106.4
31,경기도,020005, 19세,2018,149633,77851,71782,108.5,145808,75832,69976,108.4
31,경기도,025,20~24세,2018,847682,452265,395417,114.4,801875,422273,379602,111.2
31,경기도,025001, 20세,2018,157211,83284,73927,112.7,151571,80081,71490,112
31,경기도,025002, 21세,2018,163633,87813,75820,115.8,156693,83485,73208,114
31,경기도,025003, 22세,2018,169197,90965,78232,116.3,160001,84904,75097,113.1
31,경기도,025004, 23세,2018,175914,93468,82446,113.4,164722,85889,78833,109
31,경기도,025005, 24세,2018,181727,96735,84992,113.8,168888,87914,80974,108.6
31,경기도,030,25~29세,2018,919599,496998,422601,117.6,834485,439555,394930,111.3
31,경기도,030001, 25세,2018,187781,100920,86861,116.2,172979,90733,82246,110.3
31,경기도,030002, 26세,2018,194084,105137,88947,118.2,177840,93981,83859,112.1
31,경기도,030003, 27세,2018,185038,99972,85066,117.5,168347,88657,79690,111.3
31,경기도,030004, 28세,2018,177767,96174,81593,117.9,159056,83754,75302,111.2
31,경기도,030005, 29세,2018,174929,94795,80134,118.3,156263,82430,73833,111.6
31,경기도,035,30~34세,2018,899207,476558,422649,112.8,807838,416973,390865,106.7
31,경기도,035001, 30세,2018,173126,92663,80463,115.2,153968,80220,73748,108.8
31,경기도,035002, 31세,2018,174678,92947,81731,113.7,155164,80165,74999,106.9
31,경기도,035003, 32세,2018,178220,94593,83627,113.1,159492,82489,77003,107.1
31,경기도,035004, 33세,2018,182717,96346,86371,111.5,165290,84986,80304,105.8
31,경기도,035005, 34세,2018,190466,100009,90457,110.6,173924,89113,84811,105.1
31,경기도,040,35~39세,2018,1131739,585920,545819,107.3,1063315,541625,521690,103.8
31,경기도,040001, 35세,2018,210379,109822,100557,109.2,194977,99768,95209,104.8
31,경기도,040002, 36세,2018,229388,119208,110180,108.2,213977,109265,104712,104.3
31,경기도,040003, 37세,2018,231697,120429,111268,108.2,218677,111980,106697,105
31,경기도,040004, 38세,2018,235811,121256,114555,105.8,223421,113225,110196,102.7
31,경기도,040005, 39세,2018,224464,115205,109259,105.4,212263,107387,104876,102.4
31,경기도,045,40~44세,2018,1079663,553658,526005,105.3,1032478,524350,508128,103.2
31,경기도,045001, 40세,2018,205734,105880,99854,106,194960,99036,95924,103.2
31,경기도,045002, 41세,2018,212614,108873,103741,104.9,202951,102744,100207,102.5
31,경기도,045003, 42세,2018,208857,107869,100988,106.8,199428,101907,97521,104.5
31,경기도,045004, 43세,2018,217324,110864,106460,104.1,208752,105671,103081,102.5
31,경기도,045005, 44세,2018,235134,120172,114962,104.5,226387,114992,111395,103.2
31,경기도,050,45~49세,2018,1214041,616974,597067,103.3,1164537,589178,575359,102.4
31,경기도,050001, 45세,2018,236838,119990,116848,102.7,227614,114664,112950,101.5
31,경기도,050002, 46세,2018,239512,123216,116296,106,229644,117443,112201,104.7
31,경기도,050003, 47세,2018,251966,128440,123526,104,241690,122699,118991,103.1
31,경기도,050004, 48세,2018,242004,122931,119073,103.2,231599,117207,114392,102.5
31,경기도,050005, 49세,2018,243721,122397,121324,100.9,233990,117165,116825,100.3
31,경기도,055,50~54세,2018,1091113,551060,540053,102,1045208,526870,518338,101.6
31,경기도,055001, 50세,2018,238726,118783,119943,99,229059,113550,115509,98.3
31,경기도,055002, 51세,2018,216507,107801,108706,99.2,208480,103540,104940,98.7
31,경기도,055003, 52세,2018,212378,108950,103428,105.3,203448,104317,99131,105.2
31,경기도,055004, 53세,2018,219197,111134,108063,102.8,209364,105988,103376,102.5
31,경기도,055005, 54세,2018,204305,104392,99913,104.5,194857,99475,95382,104.3
31,경기도,060,55~59세,2018,1056744,536539,520205,103.1,1016820,516779,500041,103.3
31,경기도,060001, 55세,2018,213078,109482,103596,105.7,201677,103759,97918,106
31,경기도,060002, 56세,2018,212038,108582,103456,105,203439,104333,99106,105.3
31,경기도,060003, 57세,2018,222305,111824,110481,101.2,216755,109150,107605,101.4
31,경기도,060004, 58세,2018,217322,109542,107780,101.6,209248,105534,103714,101.8
31,경기도,060005, 59세,2018,192001,97109,94892,102.3,185701,94003,91698,102.5
31,경기도,065,60~64세,2018,789566,394929,394637,100.1,758875,379729,379146,100.2
31,경기도,065001, 60세,2018,181008,92100,88908,103.6,173964,88603,85361,103.8
31,경기도,065002, 61세,2018,170918,85859,85059,100.9,163669,82279,81390,101.1
31,경기도,065003, 62세,2018,154386,77238,77148,100.1,148378,74251,74127,100.2
31,경기도,065004, 63세,2018,154591,76107,78484,97,149007,73326,75681,96.9
31,경기도,065005, 64세,2018,128663,63625,65038,97.8,123857,61270,62587,97.9
31,경기도,070,65~69세,2018,493540,239025,254515,93.9,479507,232391,247116,94
31,경기도,070001, 65세,2018,111260,54539,56721,96.2,107281,52606,54675,96.2
31,경기도,070002, 66세,2018,119746,58733,61013,96.3,116447,57155,59292,96.4
31,경기도,070003, 67세,2018,81264,39213,42051,93.3,78554,37925,40629,93.3
31,경기도,070004, 68세,2018,90369,43064,47305,91,88196,42065,46131,91.2
31,경기도,070005, 69세,2018,90901,43476,47425,91.7,89029,42640,46389,91.9
31,경기도,075,70~74세,2018,382794,176951,205843,86,378409,175157,203252,86.2
31,경기도,075001, 70세,2018,88928,42230,46698,90.4,87688,41682,46006,90.6
31,경기도,075002, 71세,2018,89979,41970,48009,87.4,88887,41495,47392,87.6
31,경기도,075003, 72세,2018,69886,32455,37431,86.7,69063,32150,36913,87.1
31,경기도,075004, 73세,2018,67565,30922,36643,84.4,66918,30667,36251,84.6
31,경기도,075005, 74세,2018,66436,29374,37062,79.3,65853,29163,36690,79.5
31,경기도,080,75~79세,2018,316153,134673,181480,74.2,313834,133966,179868,74.5
31,경기도,080001, 75세,2018,66702,29122,37580,77.5,66199,28974,37225,77.8
31,경기도,080002, 76세,2018,76319,33359,42960,77.7,75779,33179,42600,77.9
31,경기도,080003, 77세,2018,62386,26717,35669,74.9,61902,26560,35342,75.2
31,경기도,080004, 78세,2018,56027,23332,32695,71.4,55612,23208,32404,71.6
31,경기도,080005, 79세,2018,54719,22143,32576,68,54342,22045,32297,68.3
31,경기도,085,80~84세,2018,201839,74832,127007,58.9,200422,74450,125972,59.1
31,경기도,085001, 80세,2018,49381,19546,29835,65.5,48976,19423,29553,65.7
31,경기도,085002, 81세,2018,44657,17254,27403,63,44356,17167,27189,63.1
31,경기도,085003, 82세,2018,40017,14756,25261,58.4,39730,14687,25043,58.6
31,경기도,085004, 83세,2018,37114,12905,24209,53.3,36889,12846,24043,53.4
31,경기도,085005, 84세,2018,30670,10371,20299,51.1,30471,10327,20144,51.3
31,경기도,090,85~89세,2018,94115,27654,66461,41.6,93617,27550,66067,41.7
31,경기도,090001, 85세,2018,25638,8217,17421,47.2,25493,8182,17311,47.3
31,경기도,090002, 86세,2018,22310,6852,15458,44.3,22197,6827,15370,44.4
31,경기도,090003, 87세,2018,17032,4910,12122,40.5,16939,4895,12044,40.6
31,경기도,090004, 88세,2018,15867,4179,11688,35.8,15790,4163,11627,35.8
31,경기도,090005, 89세,2018,13268,3496,9772,35.8,13198,3483,9715,35.9
31,경기도,095,90~94세,2018,32367,7338,25029,29.3,32263,7315,24948,29.3
31,경기도,095001, 90세,2018,10557,2539,8018,31.7,10519,2527,7992,31.6
31,경기도,095002, 91세,2018,8164,1838,6326,29.1,8137,1832,6305,29.1
31,경기도,095003, 92세,2018,5691,1247,4444,28.1,5670,1243,4427,28.1
31,경기도,095004, 93세,2018,4667,933,3734,25,4657,933,3724,25.1
31,경기도,095005, 94세,2018,3288,781,2507,31.2,3280,780,2500,31.2
31,경기도,100,95~99세,2018,8070,1891,6179,30.6,8051,1889,6162,30.7
31,경기도,100001, 95세,2018,3055,754,2301,32.8,3044,753,2291,32.9
31,경기도,100002, 96세,2018,2161,480,1681,28.6,2156,479,1677,28.6
31,경기도,100003, 97세,2018,1330,299,1031,29,1330,299,1031,29
31,경기도,100004, 98세,2018,935,209,726,28.8,932,209,723,28.9
31,경기도,100005, 99세,2018,589,149,440,33.9,589,149,440,33.9
31,경기도,101,100세이상,2018,993,155,838,18.5,990,154,836,18.4
31,경기도,102,15세미만,2018,1832157,939821,892336,105.3,1808286,927727,880559,105.4
31,경기도,103,15~64세,2018,9741160,5032766,4708394,106.9,9229612,4721247,4508365,104.7
31,경기도,104,65세이상,2018,1529871,662519,867352,76.4,1507093,652872,854221,76.4
31,경기도,086,85세이상,2018,135545,37038,98507,37.6,134921,36908,98013,37.7
31,경기도,126,평균연령,2018,40.3,39.3,41.2,,40.3,39.4,41.2,
31,경기도,127,중위연령,2018,41,40,42.1,,41.3,40.4,42.2,
31004, 읍부,000,합계,2018,1425450,741872,683578,108.5,1344687,688086,656601,104.8
31004, 읍부,005,0~4세,2018,63192,32366,30826,105,61928,31729,30199,105.1
31004, 읍부,005001, 0세,2018,10334,5267,5067,103.9,10086,5142,4944,104
31004, 읍부,005002, 1세,2018,11464,5787,5677,101.9,11181,5657,5524,102.4
31004, 읍부,005003, 2세,2018,13333,6868,6465,106.2,13032,6713,6319,106.2
31004, 읍부,005004, 3세,2018,14045,7282,6763,107.7,13821,7153,6668,107.3
31004, 읍부,005005, 4세,2018,14016,7162,6854,104.5,13808,7064,6744,104.7
31004, 읍부,010,5~9세,2018,74537,38074,36463,104.4,73749,37672,36077,104.4
31004, 읍부,010001, 5세,2018,14261,7313,6948,105.3,14067,7224,6843,105.6
31004, 읍부,010002, 6세,2018,15623,7974,7649,104.2,15431,7877,7554,104.3
31004, 읍부,010003, 7세,2018,15443,7884,7559,104.3,15300,7803,7497,104.1
31004, 읍부,010004, 8세,2018,14882,7600,7282,104.4,14760,7539,7221,104.4
31004, 읍부,010005, 9세,2018,14328,7303,7025,104,14191,7229,6962,103.8
31004, 읍부,015,10~14세,2018,72007,37219,34788,107,71515,36987,34528,107.1
31004, 읍부,015001, 10세,2018,15240,7854,7386,106.3,15124,7793,7331,106.3
31004, 읍부,015002, 11세,2018,15185,7780,7405,105.1,15067,7728,7339,105.3
31004, 읍부,015003, 12세,2018,13922,7159,6763,105.9,13837,7115,6722,105.8
31004, 읍부,015004, 13세,2018,13500,7055,6445,109.5,13409,7017,6392,109.8
31004, 읍부,015005, 14세,2018,14160,7371,6789,108.6,14078,7334,6744,108.7
31004, 읍부,020,15~19세,2018,77391,39974,37417,106.8,76385,39436,36949,106.7
31004, 읍부,020001, 15세,2018,13856,7185,6671,107.7,13782,7147,6635,107.7
31004, 읍부,020002, 16세,2018,14631,7542,7089,106.4,14553,7505,7048,106.5
31004, 읍부,020003, 17세,2018,15760,8096,7664,105.6,15673,8051,7622,105.6
31004, 읍부,020004, 18세,2018,17063,8845,8218,107.6,16835,8729,8106,107.7
31004, 읍부,020005, 19세,2018,16081,8306,7775,106.8,15542,8004,7538,106.2
31004, 읍부,025,20~24세,2018,86551,48269,38282,126.1,77932,42074,35858,117.3
31004, 읍부,025001, 20세,2018,16422,8891,7531,118.1,15561,8386,7175,116.9
31004, 읍부,025002, 21세,2018,16811,9280,7531,123.2,15527,8429,7098,118.8
31004, 읍부,025003, 22세,2018,17157,9586,7571,126.6,15409,8309,7100,117
31004, 읍부,025004, 23세,2018,17874,10050,7824,128.5,15724,8441,7283,115.9
31004, 읍부,025005, 24세,2018,18287,10462,7825,133.7,15711,8509,7202,118.1
31004, 읍부,030,25~29세,2018,94267,54672,39595,138.1,78292,42762,35530,120.4
31004, 읍부,030001, 25세,2018,18779,10776,8003,134.6,15886,8591,7295,117.8
31004, 읍부,030002, 26세,2018,19745,11483,8262,139,16594,9092,7502,121.2
31004, 읍부,030003, 27세,2018,18798,10956,7842,139.7,15665,8619,7046,122.3
31004, 읍부,030004, 28세,2018,18631,10788,7843,137.5,15181,8266,6915,119.5
31004, 읍부,030005, 29세,2018,18314,10669,7645,139.6,14966,8194,6772,121
31004, 읍부,035,30~34세,2018,96835,54120,42715,126.7,81501,43091,38410,112.2
31004, 읍부,035001, 30세,2018,18147,10318,7829,131.8,14900,7974,6926,115.1
31004, 읍부,035002, 31세,2018,18710,10568,8142,129.8,15415,8202,7213,113.7
31004, 읍부,035003, 32세,2018,19167,10693,8474,126.2,16087,8500,7587,112
31004, 읍부,035004, 33세,2018,19834,10937,8897,122.9,16883,8813,8070,109.2
31004, 읍부,035005, 34세,2018,20977,11604,9373,123.8,18216,9602,8614,111.5
31004, 읍부,040,35~39세,2018,126341,67831,58510,115.9,114991,59860,55131,108.6
31004, 읍부,040001, 35세,2018,23156,12626,10530,119.9,20487,10719,9768,109.7
31004, 읍부,040002, 36세,2018,25536,13698,11838,115.7,22996,11917,11079,107.6
31004, 읍부,040003, 37세,2018,25911,14183,11728,120.9,23654,12583,11071,113.7
31004, 읍부,040004, 38세,2018,26505,14060,12445,113,24496,12661,11835,107
31004, 읍부,040005, 39세,2018,25233,13264,11969,110.8,23358,11980,11378,105.3
31004, 읍부,045,40~44세,2018,121308,64297,57011,112.8,114330,59654,54676,109.1
31004, 읍부,045001, 40세,2018,23470,12356,11114,111.2,21721,11151,10570,105.5
31004, 읍부,045002, 41세,2018,24060,12743,11317,112.6,22556,11722,10834,108.2
31004, 읍부,045003, 42세,2018,23512,12485,11027,113.2,22167,11593,10574,109.6
31004, 읍부,045004, 43세,2018,24330,12870,11460,112.3,23134,12098,11036,109.6
31004, 읍부,045005, 44세,2018,25936,13843,12093,114.5,24752,13090,11662,112.2
31004, 읍부,050,45~49세,2018,128876,68939,59937,115,122805,65371,57434,113.8
31004, 읍부,050001, 45세,2018,25966,13827,12139,113.9,24776,13112,11664,112.4
31004, 읍부,050002, 46세,2018,25880,14065,11815,119,24649,13340,11309,118
31004, 읍부,050003, 47세,2018,26696,14367,12329,116.5,25451,13613,11838,115
31004, 읍부,050004, 48세,2018,25137,13405,11732,114.3,23855,12679,11176,113.4
31004, 읍부,050005, 49세,2018,25197,13275,11922,111.3,24074,12627,11447,110.3
31004, 읍부,055,50~54세,2018,112292,59397,52895,112.3,107438,56746,50692,111.9
31004, 읍부,055001, 50세,2018,24559,12799,11760,108.8,23493,12216,11277,108.3
31004, 읍부,055002, 51세,2018,22235,11640,10595,109.9,21387,11175,10212,109.4
31004, 읍부,055003, 52세,2018,22234,12006,10228,117.4,21275,11476,9799,117.1
31004, 읍부,055004, 53세,2018,22296,11824,10472,112.9,21292,11293,9999,112.9
31004, 읍부,055005, 54세,2018,20968,11128,9840,113.1,19991,10586,9405,112.6
31004, 읍부,060,55~59세,2018,108882,56397,52485,107.5,105240,54523,50717,107.5
31004, 읍부,060001, 55세,2018,21696,11509,10187,113,20688,10976,9712,113
31004, 읍부,060002, 56세,2018,21796,11525,10271,112.2,20997,11106,9891,112.3
31004, 읍부,060003, 57세,2018,23074,11887,11187,106.3,22494,11606,10888,106.6
31004, 읍부,060004, 58세,2018,22130,11316,10814,104.6,21422,10946,10476,104.5
31004, 읍부,060005, 59세,2018,20186,10160,10026,101.3,19639,9889,9750,101.4
31004, 읍부,065,60~64세,2018,85465,42791,42674,100.3,82946,41498,41448,100.1
31004, 읍부,065001, 60세,2018,19475,9935,9540,104.1,18866,9615,9251,103.9
31004, 읍부,065002, 61세,2018,18014,9070,8944,101.4,17429,8772,8657,101.3
31004, 읍부,065003, 62세,2018,16949,8528,8421,101.3,16436,8268,8168,101.2
31004, 읍부,065004, 63세,2018,16746,8194,8552,95.8,16301,7949,8352,95.2
31004, 읍부,065005, 64세,2018,14281,7064,7217,97.9,13914,6894,7020,98.2
31004, 읍부,070,65~69세,2018,55599,26961,28638,94.1,54520,26420,28100,94
31004, 읍부,070001, 65세,2018,12286,6092,6194,98.4,11963,5921,6042,98
31004, 읍부,070002, 66세,2018,13565,6686,6879,97.2,13342,6585,6757,97.5
31004, 읍부,070003, 67세,2018,9140,4435,4705,94.3,8938,4326,4612,93.8
31004, 읍부,070004, 68세,2018,10095,4815,5280,91.2,9912,4728,5184,91.2
31004, 읍부,070005, 69세,2018,10513,4933,5580,88.4,10365,4860,5505,88.3
31004, 읍부,075,70~74세,2018,44612,20993,23619,88.9,44196,20804,23392,88.9
31004, 읍부,075001, 70세,2018,10307,4944,5363,92.2,10177,4886,5291,92.3
31004, 읍부,075002, 71세,2018,10424,5005,5419,92.4,10321,4955,5366,92.3
31004, 읍부,075003, 72세,2018,8170,3855,4315,89.3,8106,3827,4279,89.4
31004, 읍부,075004, 73세,2018,8043,3752,4291,87.4,7988,3729,4259,87.6
31004, 읍부,075005, 74세,2018,7668,3437,4231,81.2,7604,3407,4197,81.2
31004, 읍부,080,75~79세,2018,37645,16108,21537,74.8,37440,16045,21395,75
31004, 읍부,080001, 75세,2018,7842,3448,4394,78.5,7793,3430,4363,78.6
31004, 읍부,080002, 76세,2018,9084,3994,5090,78.5,9026,3975,5051,78.7
31004, 읍부,080003, 77세,2018,7489,3213,4276,75.1,7452,3199,4253,75.2
31004, 읍부,080004, 78세,2018,6683,2802,3881,72.2,6649,2796,3853,72.6
31004, 읍부,080005, 79세,2018,6547,2651,3896,68,6520,2645,3875,68.3
31004, 읍부,085,80~84세,2018,24217,9201,15016,61.3,24096,9167,14929,61.4
31004, 읍부,085001, 80세,2018,5911,2332,3579,65.2,5882,2325,3557,65.4
31004, 읍부,085002, 81세,2018,5293,2124,3169,67,5261,2113,3148,67.1
31004, 읍부,085003, 82세,2018,4832,1808,3024,59.8,4815,1806,3009,60
31004, 읍부,085004, 83세,2018,4497,1616,2881,56.1,4468,1605,2863,56.1
31004, 읍부,085005, 84세,2018,3684,1321,2363,55.9,3670,1318,2352,56
31004, 읍부,090,85~89세,2018,10764,3201,7563,42.3,10725,3190,7535,42.3
31004, 읍부,090001, 85세,2018,2980,979,2001,48.9,2967,974,1993,48.9
31004, 읍부,090002, 86세,2018,2580,782,1798,43.5,2574,781,1793,43.6
31004, 읍부,090003, 87세,2018,1883,544,1339,40.6,1873,543,1330,40.8
31004, 읍부,090004, 88세,2018,1793,500,1293,38.7,1788,497,1291,38.5
31004, 읍부,090005, 89세,2018,1528,396,1132,35,1523,395,1128,35
31004, 읍부,095,90~94세,2018,3624,797,2827,28.2,3615,793,2822,28.1
31004, 읍부,095001, 90세,2018,1170,264,906,29.1,1166,261,905,28.8
31004, 읍부,095002, 91세,2018,880,181,699,25.9,877,181,696,26
31004, 읍부,095003, 92세,2018,675,163,512,31.8,673,162,511,31.7
31004, 읍부,095004, 93세,2018,523,99,424,23.3,523,99,424,23.3
31004, 읍부,095005, 94세,2018,376,90,286,31.5,376,90,286,31.5
31004, 읍부,100,95~99세,2018,930,244,686,35.6,928,243,685,35.5
31004, 읍부,100001, 95세,2018,337,93,244,38.1,336,93,243,38.3
31004, 읍부,100002, 96세,2018,253,65,188,34.6,252,64,188,34
31004, 읍부,100003, 97세,2018,170,46,124,37.1,170,46,124,37.1
31004, 읍부,100004, 98세,2018,102,22,80,27.5,102,22,80,27.5
31004, 읍부,100005, 99세,2018,68,18,50,36,68,18,50,36
31004, 읍부,101,100세이상,2018,115,21,94,22.3,115,21,94,22.3
31004, 읍부,102,15세미만,2018,209736,107659,102077,105.5,207192,106388,100804,105.5
31004, 읍부,103,15~64세,2018,1038208,556687,481521,115.6,961860,505015,456845,110.5
31004, 읍부,104,65세이상,2018,177506,77526,99980,77.5,175635,76683,98952,77.5
31004, 읍부,086,85세이상,2018,15433,4263,11170,38.2,15383,4247,11136,38.1
31004, 읍부,126,평균연령,2018,40.3,39.3,41.3,,40.5,39.7,41.4,
31004, 읍부,127,중위연령,2018,40.9,39.9,42.1,,41.6,40.9,42.4,
31005, 면부,000,합계,2018,829967,456511,373456,122.2,738161,386393,351768,109.8
31005, 면부,005,0~4세,2018,20817,10728,10089,106.3,20328,10473,9855,106.3
31005, 면부,005001, 0세,2018,3386,1701,1685,100.9,3299,1655,1644,100.7
31005, 면부,005002, 1세,2018,4028,2031,1997,101.7,3919,1976,1943,101.7
31005, 면부,005003, 2세,2018,4311,2268,2043,111,4194,2203,1991,110.6
31005, 면부,005004, 3세,2018,4580,2360,2220,106.3,4495,2320,2175,106.7
31005, 면부,005005, 4세,2018,4512,2368,2144,110.4,4421,2319,2102,110.3
31005, 면부,010,5~9세,2018,24545,12711,11834,107.4,24224,12563,11661,107.7
31005, 면부,010001, 5세,2018,4585,2372,2213,107.2,4519,2344,2175,107.8
31005, 면부,010002, 6세,2018,5048,2558,2490,102.7,4978,2527,2451,103.1
31005, 면부,010003, 7세,2018,5161,2705,2456,110.1,5087,2669,2418,110.4
31005, 면부,010004, 8세,2018,4894,2559,2335,109.6,4838,2534,2304,110
31005, 면부,010005, 9세,2018,4857,2517,2340,107.6,4802,2489,2313,107.6
31005, 면부,015,10~14세,2018,23896,12528,11368,110.2,23682,12424,11258,110.4
31005, 면부,015001, 10세,2018,4977,2574,2403,107.1,4922,2547,2375,107.2
31005, 면부,015002, 11세,2018,4954,2521,2433,103.6,4908,2496,2412,103.5
31005, 면부,015003, 12세,2018,4599,2425,2174,111.5,4561,2410,2151,112
31005, 면부,015004, 13세,2018,4491,2402,2089,115,4451,2382,2069,115.1
31005, 면부,015005, 14세,2018,4875,2606,2269,114.9,4840,2589,2251,115
31005, 면부,020,15~19세,2018,37634,19811,17823,111.2,36871,19308,17563,109.9
31005, 면부,020001, 15세,2018,5151,2677,2474,108.2,5119,2660,2459,108.2
31005, 면부,020002, 16세,2018,5813,3142,2671,117.6,5759,3110,2649,117.4
31005, 면부,020003, 17세,2018,7073,3597,3476,103.5,6986,3540,3446,102.7
31005, 면부,020004, 18세,2018,8886,4521,4365,103.6,8691,4394,4297,102.3
31005, 면부,020005, 19세,2018,10711,5874,4837,121.4,10316,5604,4712,118.9
31005, 면부,025,20~24세,2018,54097,32398,21699,149.3,42822,23424,19398,120.8
31005, 면부,025001, 20세,2018,9629,5250,4379,119.9,8790,4646,4144,112.1
31005, 면부,025002, 21세,2018,9691,5486,4205,130.5,8248,4374,3874,112.9
31005, 면부,025003, 22세,2018,10554,6410,4144,154.7,8165,4500,3665,122.8
31005, 면부,025004, 23세,2018,11673,7324,4349,168.4,8619,4844,3775,128.3
31005, 면부,025005, 24세,2018,12550,7928,4622,171.5,9000,5060,3940,128.4
31005, 면부,030,25~29세,2018,67057,44763,22294,200.8,44268,26396,17872,147.7
31005, 면부,030001, 25세,2018,13459,8821,4638,190.2,9163,5385,3778,142.5
31005, 면부,030002, 26세,2018,14238,9332,4906,190.2,9628,5641,3987,141.5
31005, 면부,030003, 27세,2018,13419,8909,4510,197.5,8914,5256,3658,143.7
31005, 면부,030004, 28세,2018,13361,9056,4305,210.4,8484,5138,3346,153.6
31005, 면부,030005, 29세,2018,12580,8645,3935,219.7,8079,4976,3103,160.4
31005, 면부,035,30~34세,2018,58483,39326,19157,205.3,38357,23055,15302,150.7
31005, 면부,035001, 30세,2018,12367,8421,3946,213.4,7885,4815,3070,156.8
31005, 면부,035002, 31세,2018,12090,8171,3919,208.5,7772,4677,3095,151.1
31005, 면부,035003, 32세,2018,11715,7962,3753,212.2,7698,4707,2991,157.4
31005, 면부,035004, 33세,2018,11240,7536,3704,203.5,7471,4470,3001,149
31005, 면부,035005, 34세,2018,11071,7236,3835,188.7,7531,4386,3145,139.5
31005, 면부,040,35~39세,2018,56684,35200,21484,163.8,43195,24476,18719,130.8
31005, 면부,040001, 35세,2018,11203,7155,4048,176.8,8032,4578,3454,132.5
31005, 면부,040002, 36세,2018,11841,7418,4423,167.7,8806,4998,3808,131.3
31005, 면부,040003, 37세,2018,11326,6939,4387,158.2,8775,4937,3838,128.6
31005, 면부,040004, 38세,2018,11566,7092,4474,158.5,9111,5150,3961,130
31005, 면부,040005, 39세,2018,10748,6596,4152,158.9,8471,4813,3658,131.6
31005, 면부,045,40~44세,2018,50514,30129,20385,147.8,42843,24421,18422,132.6
31005, 면부,045001, 40세,2018,9932,5997,3935,152.4,8060,4555,3505,130
31005, 면부,045002, 41세,2018,9942,5972,3970,150.4,8271,4695,3576,131.3
31005, 면부,045003, 42세,2018,9829,5891,3938,149.6,8264,4707,3557,132.3
31005, 면부,045004, 43세,2018,10002,5938,4064,146.1,8691,5005,3686,135.8
31005, 면부,045005, 44세,2018,10809,6331,4478,141.4,9557,5459,4098,133.2
31005, 면부,050,45~49세,2018,58719,33599,25120,133.8,53399,30045,23354,128.7
31005, 면부,050001, 45세,2018,11068,6361,4707,135.1,9948,5589,4359,128.2
31005, 면부,050002, 46세,2018,11301,6636,4665,142.3,10171,5862,4309,136
31005, 면부,050003, 47세,2018,11935,6832,5103,133.9,10852,6118,4734,129.2
31005, 면부,050004, 48세,2018,11942,6798,5144,132.2,10871,6099,4772,127.8
31005, 면부,050005, 49세,2018,12473,6972,5501,126.7,11557,6377,5180,123.1
31005, 면부,055,50~54세,2018,64849,35210,29639,118.8,60988,32809,28179,116.4
31005, 면부,055001, 50세,2018,12797,7025,5772,121.7,11877,6428,5449,118
31005, 면부,055002, 51세,2018,12290,6543,5747,113.9,11543,6069,5474,110.9
31005, 면부,055003, 52세,2018,12675,7005,5670,123.5,11938,6553,5385,121.7
31005, 면부,055004, 53세,2018,13903,7574,6329,119.7,13137,7090,6047,117.2
31005, 면부,055005, 54세,2018,13184,7063,6121,115.4,12493,6669,5824,114.5
31005, 면부,060,55~59세,2018,77659,40795,36864,110.7,74942,39204,35738,109.7
31005, 면부,060001, 55세,2018,14207,7574,6633,114.2,13414,7113,6301,112.9
31005, 면부,060002, 56세,2018,14675,7824,6851,114.2,14074,7470,6604,113.1
31005, 면부,060003, 57세,2018,16718,8706,8012,108.7,16307,8456,7851,107.7
31005, 면부,060004, 58세,2018,16667,8626,8041,107.3,16145,8320,7825,106.3
31005, 면부,060005, 59세,2018,15392,8065,7327,110.1,15002,7845,7157,109.6
31005, 면부,065,60~64세,2018,69143,35987,33156,108.5,67523,35060,32463,108
31005, 면부,065001, 60세,2018,15130,8021,7109,112.8,14713,7778,6935,112.2
31005, 면부,065002, 61세,2018,14327,7480,6847,109.2,13928,7241,6687,108.3
31005, 면부,065003, 62세,2018,13744,7147,6597,108.3,13457,6982,6475,107.8
31005, 면부,065004, 63세,2018,13930,7166,6764,105.9,13659,7017,6642,105.6
31005, 면부,065005, 64세,2018,12012,6173,5839,105.7,11766,6042,5724,105.6
31005, 면부,070,65~69세,2018,47003,23683,23320,101.6,46334,23301,23033,101.2
31005, 면부,070001, 65세,2018,10579,5335,5244,101.7,10381,5227,5154,101.4
31005, 면부,070002, 66세,2018,11770,6050,5720,105.8,11619,5964,5655,105.5
31005, 면부,070003, 67세,2018,7487,3764,3723,101.1,7364,3690,3674,100.4
31005, 면부,070004, 68세,2018,8535,4216,4319,97.6,8426,4151,4275,97.1
31005, 면부,070005, 69세,2018,8632,4318,4314,100.1,8544,4269,4275,99.9
31005, 면부,075,70~74세,2018,39275,19280,19995,96.4,39042,19164,19878,96.4
31005, 면부,075001, 70세,2018,8775,4547,4228,107.5,8707,4512,4195,107.6
31005, 면부,075002, 71세,2018,9057,4470,4587,97.4,9001,4443,4558,97.5
31005, 면부,075003, 72세,2018,7250,3561,3689,96.5,7208,3543,3665,96.7
31005, 면부,075004, 73세,2018,7196,3474,3722,93.3,7160,3454,3706,93.2
31005, 면부,075005, 74세,2018,6997,3228,3769,85.6,6966,3212,3754,85.6
31005, 면부,080,75~79세,2018,35573,15561,20012,77.8,35441,15506,19935,77.8
31005, 면부,080001, 75세,2018,7166,3192,3974,80.3,7138,3184,3954,80.5
31005, 면부,080002, 76세,2018,8347,3719,4628,80.4,8315,3704,4611,80.3
31005, 면부,080003, 77세,2018,7120,3159,3961,79.8,7095,3144,3951,79.6
31005, 면부,080004, 78세,2018,6360,2767,3593,77,6335,2756,3579,77
31005, 면부,080005, 79세,2018,6580,2724,3856,70.6,6558,2718,3840,70.8
31005, 면부,085,80~84세,2018,25625,9883,15742,62.8,25553,9858,15695,62.8
31005, 면부,085001, 80세,2018,5992,2400,3592,66.8,5965,2394,3571,67
31005, 면부,085002, 81세,2018,5722,2311,3411,67.8,5705,2306,3399,67.8
31005, 면부,085003, 82세,2018,5160,2068,3092,66.9,5148,2062,3086,66.8
31005, 면부,085004, 83세,2018,4673,1683,2990,56.3,4664,1679,2985,56.2
31005, 면부,085005, 84세,2018,4078,1421,2657,53.5,4071,1417,2654,53.4
31005, 면부,090,85~89세,2018,12487,3641,8846,41.2,12447,3630,8817,41.2
31005, 면부,090001, 85세,2018,3358,1099,2259,48.6,3350,1096,2254,48.6
31005, 면부,090002, 86세,2018,2868,877,1991,44,2860,875,1985,44.1
31005, 면부,090003, 87세,2018,2293,672,1621,41.5,2282,669,1613,41.5
31005, 면부,090004, 88세,2018,2152,544,1608,33.8,2146,543,1603,33.9
31005, 면부,090005, 89세,2018,1816,449,1367,32.8,1809,447,1362,32.8
31005, 면부,095,90~94세,2018,4594,997,3597,27.7,4590,996,3594,27.7
31005, 면부,095001, 90세,2018,1430,309,1121,27.6,1427,308,1119,27.5
31005, 면부,095002, 91세,2018,1101,228,873,26.1,1100,228,872,26.1
31005, 면부,095003, 92세,2018,843,176,667,26.4,843,176,667,26.4
31005, 면부,095004, 93세,2018,728,157,571,27.5,728,157,571,27.5
31005, 면부,095005, 94세,2018,492,127,365,34.8,492,127,365,34.8
31005, 면부,100,95~99세,2018,1186,262,924,28.4,1185,261,924,28.2
31005, 면부,100001, 95세,2018,454,108,346,31.2,453,107,346,30.9
31005, 면부,100002, 96세,2018,300,60,240,25,300,60,240,25
31005, 면부,100003, 97세,2018,197,42,155,27.1,197,42,155,27.1
31005, 면부,100004, 98세,2018,134,28,106,26.4,134,28,106,26.4
31005, 면부,100005, 99세,2018,101,24,77,31.2,101,24,77,31.2
31005, 면부,101,100세이상,2018,127,19,108,17.6,127,19,108,17.6
31005, 면부,102,15세미만,2018,69258,35967,33291,108,68234,35460,32774,108.2
31005, 면부,103,15~64세,2018,594839,347218,247621,140.2,505208,278198,227010,122.5
31005, 면부,104,65세이상,2018,165870,73326,92544,79.2,164719,72735,91984,79.1
31005, 면부,086,85세이상,2018,18394,4919,13475,36.5,18349,4906,13443,36.5
31005, 면부,126,평균연령,2018,45.7,43.7,48.2,,47.1,45.5,48.8,
31005, 면부,127,중위연령,2018,46.9,43.5,50.9,,49.9,47.9,52.3,
31003, 동부,000,합계,2018,10847771,5436723,5411048,100.5,10462143,5227367,5234776,99.9
31003, 동부,005,0~4세,2018,479199,245487,233712,105,468051,239766,228285,105
31003, 동부,005001, 0세,2018,79459,40769,38690,105.4,77137,39576,37561,105.4
31003, 동부,005002, 1세,2018,87615,45284,42331,107,85176,44035,41141,107
31003, 동부,005003, 2세,2018,100697,51352,49345,104.1,98172,50051,48121,104
31003, 동부,005004, 3세,2018,106305,54441,51864,105,104310,53392,50918,104.9
31003, 동부,005005, 4세,2018,105123,53641,51482,104.2,103256,52712,50544,104.3
31003, 동부,010,5~9세,2018,543947,279199,264748,105.5,538005,276203,261802,105.5
31003, 동부,010001, 5세,2018,105524,53902,51622,104.4,103951,53144,50807,104.6
31003, 동부,010002, 6세,2018,114626,58940,55686,105.8,113250,58247,55003,105.9
31003, 동부,010003, 7세,2018,111757,57203,54554,104.9,110669,56645,54024,104.9
31003, 동부,010004, 8세,2018,107529,55334,52195,106,106567,54832,51735,106
31003, 동부,010005, 9세,2018,104511,53820,50691,106.2,103568,53335,50233,106.2
31003, 동부,015,10~14세,2018,530017,271509,258508,105,526804,269910,256894,105.1
31003, 동부,015001, 10세,2018,109872,56378,53494,105.4,109067,55963,53104,105.4
31003, 동부,015002, 11세,2018,111660,57281,54379,105.3,110930,56921,54009,105.4
31003, 동부,015003, 12세,2018,101631,52165,49466,105.5,101005,51857,49148,105.5
31003, 동부,015004, 13세,2018,99118,50497,48621,103.9,98623,50256,48367,103.9
31003, 동부,015005, 14세,2018,107736,55188,52548,105,107179,54913,52266,105.1
31003, 동부,020,15~19세,2018,596781,308080,288701,106.7,590925,305171,285754,106.8
31003, 동부,020001, 15세,2018,108327,55822,52505,106.3,107870,55593,52277,106.3
31003, 동부,020002, 16세,2018,109418,56467,52951,106.6,108888,56207,52681,106.7
31003, 동부,020003, 17세,2018,123971,63952,60019,106.6,123311,63612,59699,106.6
31003, 동부,020004, 18세,2018,132224,68168,64056,106.4,130906,67535,63371,106.6
31003, 동부,020005, 19세,2018,122841,63671,59170,107.6,119950,62224,57726,107.8
31003, 동부,025,20~24세,2018,707034,371598,335436,110.8,681121,356775,324346,110
31003, 동부,025001, 20세,2018,131160,69143,62017,111.5,127220,67049,60171,111.4
31003, 동부,025002, 21세,2018,137131,73047,64084,114,132918,70682,62236,113.6
31003, 동부,025003, 22세,2018,141486,74969,66517,112.7,136427,72095,64332,112.1
31003, 동부,025004, 23세,2018,146367,76094,70273,108.3,140379,72604,67775,107.1
31003, 동부,025005, 24세,2018,150890,78345,72545,108,144177,74345,69832,106.5
31003, 동부,030,25~29세,2018,758275,397563,360712,110.2,711925,370397,341528,108.5
31003, 동부,030001, 25세,2018,155543,81323,74220,109.6,147930,76757,71173,107.8
31003, 동부,030002, 26세,2018,160101,84322,75779,111.3,151618,79248,72370,109.5
31003, 동부,030003, 27세,2018,152821,80107,72714,110.2,143768,74782,68986,108.4
31003, 동부,030004, 28세,2018,145775,76330,69445,109.9,135391,70350,65041,108.2
31003, 동부,030005, 29세,2018,144035,75481,68554,110.1,133218,69260,63958,108.3
31003, 동부,035,30~34세,2018,743889,383112,360777,106.2,687980,350827,337153,104.1
31003, 동부,035001, 30세,2018,142612,73924,68688,107.6,131183,67431,63752,105.8
31003, 동부,035002, 31세,2018,143878,74208,69670,106.5,131977,67286,64691,104
31003, 동부,035003, 32세,2018,147338,75938,71400,106.4,135707,69282,66425,104.3
31003, 동부,035004, 33세,2018,151643,77873,73770,105.6,140936,71703,69233,103.6
31003, 동부,035005, 34세,2018,158418,81169,77249,105.1,148177,75125,73052,102.8
31003, 동부,040,35~39세,2018,948714,482889,465825,103.7,905129,457289,447840,102.1
31003, 동부,040001, 35세,2018,176020,90041,85979,104.7,166458,84471,81987,103
31003, 동부,040002, 36세,2018,192011,98092,93919,104.4,182175,92350,89825,102.8
31003, 동부,040003, 37세,2018,194460,99307,95153,104.4,186248,94460,91788,102.9
31003, 동부,040004, 38세,2018,197740,100104,97636,102.5,189814,95414,94400,101.1
31003, 동부,040005, 39세,2018,188483,95345,93138,102.4,180434,90594,89840,100.8
31003, 동부,045,40~44세,2018,907841,459232,448609,102.4,875305,440275,435030,101.2
31003, 동부,045001, 40세,2018,172332,87527,84805,103.2,165179,83330,81849,101.8
31003, 동부,045002, 41세,2018,178612,90158,88454,101.9,172124,86327,85797,100.6
31003, 동부,045003, 42세,2018,175516,89493,86023,104,168997,85607,83390,102.7
31003, 동부,045004, 43세,2018,182992,92056,90936,101.2,176927,88568,88359,100.2
31003, 동부,045005, 44세,2018,198389,99998,98391,101.6,192078,96443,95635,100.8
31003, 동부,050,45~49세,2018,1026446,514436,512010,100.5,988333,493762,494571,99.8
31003, 동부,050001, 45세,2018,199804,99802,100002,99.8,192890,95963,96927,99
31003, 동부,050002, 46세,2018,202331,102515,99816,102.7,194824,98241,96583,101.7
31003, 동부,050003, 47세,2018,213335,107241,106094,101.1,205387,102968,102419,100.5
31003, 동부,050004, 48세,2018,204925,102728,102197,100.5,196873,98429,98444,100
31003, 동부,050005, 49세,2018,206051,102150,103901,98.3,198359,98161,100198,98
31003, 동부,055,50~54세,2018,913972,456453,457519,99.8,876782,437315,439467,99.5
31003, 동부,055001, 50세,2018,201370,98959,102411,96.6,193689,94906,98783,96.1
31003, 동부,055002, 51세,2018,181982,89618,92364,97,175550,86296,89254,96.7
31003, 동부,055003, 52세,2018,177469,89939,87530,102.8,170235,86288,83947,102.8
31003, 동부,055004, 53세,2018,182998,91736,91262,100.5,174935,87605,87330,100.3
31003, 동부,055005, 54세,2018,170153,86201,83952,102.7,162373,82220,80153,102.6
31003, 동부,060,55~59세,2018,870203,439347,430856,102,836638,423052,413586,102.3
31003, 동부,060001, 55세,2018,177175,90399,86776,104.2,167575,85670,81905,104.6
31003, 동부,060002, 56세,2018,175567,89233,86334,103.4,168368,85757,82611,103.8
31003, 동부,060003, 57세,2018,182513,91231,91282,99.9,177954,89088,88866,100.2
31003, 동부,060004, 58세,2018,178525,89600,88925,100.8,171681,86268,85413,101
31003, 동부,060005, 59세,2018,156423,78884,77539,101.7,151060,76269,74791,102
31003, 동부,065,60~64세,2018,634958,316151,318807,99.2,608406,303171,305235,99.3
31003, 동부,065001, 60세,2018,146403,74144,72259,102.6,140385,71210,69175,102.9
31003, 동부,065002, 61세,2018,138577,69309,69268,100.1,132312,66266,66046,100.3
31003, 동부,065003, 62세,2018,123693,61563,62130,99.1,118485,59001,59484,99.2
31003, 동부,065004, 63세,2018,123915,60747,63168,96.2,119047,58360,60687,96.2
31003, 동부,065005, 64세,2018,102370,50388,51982,96.9,98177,48334,49843,97
31003, 동부,070,65~69세,2018,390938,188381,202557,93,378653,182670,195983,93.2
31003, 동부,070001, 65세,2018,88395,43112,45283,95.2,84937,41458,43479,95.4
31003, 동부,070002, 66세,2018,94411,45997,48414,95,91486,44606,46880,95.1
31003, 동부,070003, 67세,2018,64637,31014,33623,92.2,62252,29909,32343,92.5
31003, 동부,070004, 68세,2018,71739,34033,37706,90.3,69858,33186,36672,90.5
31003, 동부,070005, 69세,2018,71756,34225,37531,91.2,70120,33511,36609,91.5
31003, 동부,075,70~74세,2018,298907,136678,162229,84.3,295171,135189,159982,84.5
31003, 동부,075001, 70세,2018,69846,32739,37107,88.2,68804,32284,36520,88.4
31003, 동부,075002, 71세,2018,70498,32495,38003,85.5,69565,32097,37468,85.7
31003, 동부,075003, 72세,2018,54466,25039,29427,85.1,53749,24780,28969,85.5
31003, 동부,075004, 73세,2018,52326,23696,28630,82.8,51770,23484,28286,83
31003, 동부,075005, 74세,2018,51771,22709,29062,78.1,51283,22544,28739,78.4
31003, 동부,080,75~79세,2018,242935,103004,139931,73.6,240953,102415,138538,73.9
31003, 동부,080001, 75세,2018,51694,22482,29212,77,51268,22360,28908,77.3
31003, 동부,080002, 76세,2018,58888,25646,33242,77.1,58438,25500,32938,77.4
31003, 동부,080003, 77세,2018,47777,20345,27432,74.2,47355,20217,27138,74.5
31003, 동부,080004, 78세,2018,42984,17763,25221,70.4,42628,17656,24972,70.7
31003, 동부,080005, 79세,2018,41592,16768,24824,67.5,41264,16682,24582,67.9
31003, 동부,085,80~84세,2018,151997,55748,96249,57.9,150773,55425,95348,58.1
31003, 동부,085001, 80세,2018,37478,14814,22664,65.4,37129,14704,22425,65.6
31003, 동부,085002, 81세,2018,33642,12819,20823,61.6,33390,12748,20642,61.8
31003, 동부,085003, 82세,2018,30025,10880,19145,56.8,29767,10819,18948,57.1
31003, 동부,085004, 83세,2018,27944,9606,18338,52.4,27757,9562,18195,52.6
31003, 동부,085005, 84세,2018,22908,7629,15279,49.9,22730,7592,15138,50.2
31003, 동부,090,85~89세,2018,70864,20812,50052,41.6,70445,20730,49715,41.7
31003, 동부,090001, 85세,2018,19300,6139,13161,46.6,19176,6112,13064,46.8
31003, 동부,090002, 86세,2018,16862,5193,11669,44.5,16763,5171,11592,44.6
31003, 동부,090003, 87세,2018,12856,3694,9162,40.3,12784,3683,9101,40.5
31003, 동부,090004, 88세,2018,11922,3135,8787,35.7,11856,3123,8733,35.8
31003, 동부,090005, 89세,2018,9924,2651,7273,36.4,9866,2641,7225,36.6
31003, 동부,095,90~94세,2018,24149,5544,18605,29.8,24058,5526,18532,29.8
31003, 동부,095001, 90세,2018,7957,1966,5991,32.8,7926,1958,5968,32.8
31003, 동부,095002, 91세,2018,6183,1429,4754,30.1,6160,1423,4737,30
31003, 동부,095003, 92세,2018,4173,908,3265,27.8,4154,905,3249,27.9
31003, 동부,095004, 93세,2018,3416,677,2739,24.7,3406,677,2729,24.8
31003, 동부,095005, 94세,2018,2420,564,1856,30.4,2412,563,1849,30.4
31003, 동부,100,95~99세,2018,5954,1385,4569,30.3,5938,1385,4553,30.4
31003, 동부,100001, 95세,2018,2264,553,1711,32.3,2255,553,1702,32.5
31003, 동부,100002, 96세,2018,1608,355,1253,28.3,1604,355,1249,28.4
31003, 동부,100003, 97세,2018,963,211,752,28.1,963,211,752,28.1
31003, 동부,100004, 98세,2018,699,159,540,29.4,696,159,537,29.6
31003, 동부,100005, 99세,2018,420,107,313,34.2,420,107,313,34.2
31003, 동부,101,100세이상,2018,751,115,636,18.1,748,114,634,18
31003, 동부,102,15세미만,2018,1553163,796195,756968,105.2,1532860,785879,746981,105.2
31003, 동부,103,15~64세,2018,8108113,4128861,3979252,103.8,7762544,3938034,3824510,103
31003, 동부,104,65세이상,2018,1186495,511667,674828,75.8,1166739,503454,663285,75.9
31003, 동부,086,85세이상,2018,101718,27856,73862,37.7,101189,27755,73434,37.8
31003, 동부,126,평균연령,2018,39.8,39,40.7,,39.8,38.9,40.7,
31003, 동부,127,중위연령,2018,40.7,39.8,41.6,,40.7,39.9,41.6,
31010, 수원시,000,합계,2018,1218843,616240,602603,102.3,1165154,587595,577559,101.7
31010, 수원시,005,0~4세,2018,53278,27413,25865,106,51517,26519,24998,106.1
31010, 수원시,005001, 0세,2018,9206,4707,4499,104.6,8806,4515,4291,105.2
31010, 수원시,005002, 1세,2018,9810,5095,4715,108.1,9443,4901,4542,107.9
31010, 수원시,005003, 2세,2018,11118,5728,5390,106.3,10725,5522,5203,106.1
31010, 수원시,005004, 3세,2018,11801,6075,5726,106.1,11486,5905,5581,105.8
31010, 수원시,005005, 4세,2018,11343,5808,5535,104.9,11057,5676,5381,105.5
31010, 수원시,010,5~9세,2018,57663,29733,27930,106.5,56753,29275,27478,106.5
31010, 수원시,010001, 5세,2018,11362,5880,5482,107.3,11110,5762,5348,107.7
31010, 수원시,010002, 6세,2018,12269,6286,5983,105.1,12060,6185,5875,105.3
31010, 수원시,010003, 7세,2018,11814,6108,5706,107,11647,6026,5621,107.2
31010, 수원시,010004, 8세,2018,11238,5787,5451,106.2,11106,5707,5399,105.7
31010, 수원시,010005, 9세,2018,10980,5672,5308,106.9,10830,5595,5235,106.9
31010, 수원시,015,10~14세,2018,57036,29345,27691,106,56629,29163,27466,106.2
31010, 수원시,015001, 10세,2018,11765,6073,5692,106.7,11661,6018,5643,106.6
31010, 수원시,015002, 11세,2018,12019,6204,5815,106.7,11928,6163,5765,106.9
31010, 수원시,015003, 12세,2018,10815,5544,5271,105.2,10729,5516,5213,105.8
31010, 수원시,015004, 13세,2018,10586,5349,5237,102.1,10525,5325,5200,102.4
31010, 수원시,015005, 14세,2018,11851,6175,5676,108.8,11786,6141,5645,108.8
31010, 수원시,020,15~19세,2018,68845,36128,32717,110.4,67972,35731,32241,110.8
31010, 수원시,020001, 15세,2018,12091,6275,5816,107.9,12039,6252,5787,108
31010, 수원시,020002, 16세,2018,12067,6250,5817,107.4,11999,6223,5776,107.7
31010, 수원시,020003, 17세,2018,14118,7546,6572,114.8,14049,7508,6541,114.8
31010, 수원시,020004, 18세,2018,15324,7962,7362,108.1,15145,7896,7249,108.9
31010, 수원시,020005, 19세,2018,15245,8095,7150,113.2,14740,7852,6888,114
31010, 수원시,025,20~24세,2018,89171,46770,42401,110.3,85592,44847,40745,110.1
31010, 수원시,025001, 20세,2018,16363,8659,7704,112.4,15689,8319,7370,112.9
31010, 수원시,025002, 21세,2018,16863,8916,7947,112.2,16219,8550,7669,111.5
31010, 수원시,025003, 22세,2018,17748,9308,8440,110.3,17072,8960,8112,110.5
31010, 수원시,025004, 23세,2018,18850,9785,9065,107.9,18088,9389,8699,107.9
31010, 수원시,025005, 24세,2018,19347,10102,9245,109.3,18524,9629,8895,108.3
31010, 수원시,030,25~29세,2018,99371,53172,46199,115.1,93546,50035,43511,115
31010, 수원시,030001, 25세,2018,20405,10847,9558,113.5,19410,10295,9115,112.9
31010, 수원시,030002, 26세,2018,21040,11293,9747,115.9,19953,10683,9270,115.2
31010, 수원시,030003, 27세,2018,20042,10781,9261,116.4,18946,10182,8764,116.2
31010, 수원시,030004, 28세,2018,18934,10158,8776,115.7,17648,9470,8178,115.8
31010, 수원시,030005, 29세,2018,18950,10093,8857,114,17589,9405,8184,114.9
31010, 수원시,035,30~34세,2018,91276,47920,43356,110.5,84276,44005,40271,109.3
31010, 수원시,035001, 30세,2018,18154,9608,8546,112.4,16700,8833,7867,112.3
31010, 수원시,035002, 31세,2018,18203,9619,8584,112.1,16719,8750,7969,109.8
31010, 수원시,035003, 32세,2018,17999,9480,8519,111.3,16542,8672,7870,110.2
31010, 수원시,035004, 33세,2018,18363,9504,8859,107.3,17019,8785,8234,106.7
31010, 수원시,035005, 34세,2018,18557,9709,8848,109.7,17296,8965,8331,107.6
31010, 수원시,040,35~39세,2018,107609,55325,52284,105.8,102367,52243,50124,104.2
31010, 수원시,040001, 35세,2018,20313,10608,9705,109.3,19141,9956,9185,108.4
31010, 수원시,040002, 36세,2018,22046,11293,10753,105,20846,10583,10263,103.1
31010, 수원시,040003, 37세,2018,22172,11318,10854,104.3,21239,10759,10480,102.7
31010, 수원시,040004, 38세,2018,22006,11347,10659,106.5,21047,10779,10268,105
31010, 수원시,040005, 39세,2018,21072,10759,10313,104.3,20094,10166,9928,102.4
31010, 수원시,045,40~44세,2018,99776,50766,49010,103.6,95618,48296,47322,102.1
31010, 수원시,045001, 40세,2018,19168,9913,9255,107.1,18261,9392,8869,105.9
31010, 수원시,045002, 41세,2018,19797,10027,9770,102.6,18962,9545,9417,101.4
31010, 수원시,045003, 42세,2018,19440,9995,9445,105.8,18630,9484,9146,103.7
31010, 수원시,045004, 43세,2018,19904,10072,9832,102.4,19138,9624,9514,101.2
31010, 수원시,045005, 44세,2018,21467,10759,10708,100.5,20627,10251,10376,98.8
31010, 수원시,050,45~49세,2018,112564,56312,56252,100.1,107190,53371,53819,99.2
31010, 수원시,050001, 45세,2018,21934,10872,11062,98.3,21000,10364,10636,97.4
31010, 수원시,050002, 46세,2018,21804,11110,10694,103.9,20724,10484,10240,102.4
31010, 수원시,050003, 47세,2018,23327,11802,11525,102.4,22191,11170,11021,101.4
31010, 수원시,050004, 48세,2018,22355,11279,11076,101.8,21241,10674,10567,101
31010, 수원시,050005, 49세,2018,23144,11249,11895,94.6,22034,10679,11355,94
31010, 수원시,055,50~54세,2018,103083,51160,51923,98.5,97318,48122,49196,97.8
31010, 수원시,055001, 50세,2018,22724,10952,11772,93,21628,10369,11259,92.1
31010, 수원시,055002, 51세,2018,20584,10068,10516,95.7,19671,9586,10085,95.1
31010, 수원시,055003, 52세,2018,20030,10097,9933,101.7,18866,9499,9367,101.4
31010, 수원시,055004, 53세,2018,20590,10345,10245,101,19280,9654,9626,100.3
31010, 수원시,055005, 54세,2018,19155,9698,9457,102.5,17873,9014,8859,101.7
31010, 수원시,060,55~59세,2018,96457,49069,47388,103.5,90957,46301,44656,103.7
31010, 수원시,060001, 55세,2018,20254,10380,9874,105.1,18608,9546,9062,105.3
31010, 수원시,060002, 56세,2018,19468,9905,9563,103.6,18266,9335,8931,104.5
31010, 수원시,060003, 57세,2018,20418,10199,10219,99.8,19698,9857,9841,100.2
31010, 수원시,060004, 58세,2018,19461,9965,9496,104.9,18364,9386,8978,104.5
31010, 수원시,060005, 59세,2018,16856,8620,8236,104.7,16021,8177,7844,104.2
31010, 수원시,065,60~64세,2018,65670,32802,32868,99.8,61421,30656,30765,99.6
31010, 수원시,065001, 60세,2018,15477,7898,7579,104.2,14506,7400,7106,104.1
31010, 수원시,065002, 61세,2018,14184,7170,7014,102.2,13135,6650,6485,102.5
31010, 수원시,065003, 62세,2018,12833,6461,6372,101.4,12036,6045,5991,100.9
31010, 수원시,065004, 63세,2018,12742,6171,6571,93.9,11956,5776,6180,93.5
31010, 수원시,065005, 64세,2018,10434,5102,5332,95.7,9788,4785,5003,95.6
31010, 수원시,070,65~69세,2018,39990,19304,20686,93.3,38093,18389,19704,93.3
31010, 수원시,070001, 65세,2018,9052,4306,4746,90.7,8530,4051,4479,90.4
31010, 수원시,070002, 66세,2018,9842,4856,4986,97.4,9407,4633,4774,97
31010, 수원시,070003, 67세,2018,6627,3190,3437,92.8,6226,3003,3223,93.2
31010, 수원시,070004, 68세,2018,7344,3506,3838,91.3,7049,3369,3680,91.5
31010, 수원시,070005, 69세,2018,7125,3446,3679,93.7,6881,3333,3548,93.9
31010, 수원시,075,70~74세,2018,29513,13517,15996,84.5,28929,13277,15652,84.8
31010, 수원시,075001, 70세,2018,7004,3310,3694,89.6,6837,3227,3610,89.4
31010, 수원시,075002, 71세,2018,6970,3194,3776,84.6,6811,3126,3685,84.8
31010, 수원시,075003, 72세,2018,5284,2476,2808,88.2,5182,2434,2748,88.6
31010, 수원시,075004, 73세,2018,5147,2329,2818,82.6,5071,2301,2770,83.1
31010, 수원시,075005, 74세,2018,5108,2208,2900,76.1,5028,2189,2839,77.1
31010, 수원시,080,75~79세,2018,23249,9675,13574,71.3,22944,9597,13347,71.9
31010, 수원시,080001, 75세,2018,5031,2145,2886,74.3,4969,2130,2839,75
31010, 수원시,080002, 76세,2018,5603,2419,3184,76,5538,2400,3138,76.5
31010, 수원시,080003, 77세,2018,4609,1913,2696,71,4534,1897,2637,71.9
31010, 수원시,080004, 78세,2018,4026,1622,2404,67.5,3972,1605,2367,67.8
31010, 수원시,080005, 79세,2018,3980,1576,2404,65.6,3931,1565,2366,66.1
31010, 수원시,085,80~84세,2018,14579,5260,9319,56.4,14392,5212,9180,56.8
31010, 수원시,085001, 80세,2018,3557,1417,2140,66.2,3513,1403,2110,66.5
31010, 수원시,085002, 81세,2018,3252,1200,2052,58.5,3206,1187,2019,58.8
31010, 수원시,085003, 82세,2018,2926,1000,1926,51.9,2884,991,1893,52.4
31010, 수원시,085004, 83세,2018,2642,897,1745,51.4,2616,891,1725,51.7
31010, 수원시,085005, 84세,2018,2202,746,1456,51.2,2173,740,1433,51.6
31010, 수원시,090,85~89세,2018,6772,1908,4864,39.2,6711,1897,4814,39.4
31010, 수원시,090001, 85세,2018,1826,551,1275,43.2,1803,545,1258,43.3
31010, 수원시,090002, 86세,2018,1622,483,1139,42.4,1608,480,1128,42.6
31010, 수원시,090003, 87세,2018,1180,325,855,38,1173,324,849,38.2
31010, 수원시,090004, 88세,2018,1152,291,861,33.8,1141,290,851,34.1
31010, 수원시,090005, 89세,2018,992,258,734,35.1,986,258,728,35.4
31010, 수원시,095,90~94세,2018,2303,532,1771,30,2293,530,1763,30.1
31010, 수원시,095001, 90세,2018,756,185,571,32.4,753,184,569,32.3
31010, 수원시,095002, 91세,2018,593,146,447,32.7,589,145,444,32.7
31010, 수원시,095003, 92세,2018,403,84,319,26.3,401,84,317,26.5
31010, 수원시,095004, 93세,2018,328,59,269,21.9,328,59,269,21.9
31010, 수원시,095005, 94세,2018,223,58,165,35.2,222,58,164,35.4
31010, 수원시,100,95~99세,2018,585,124,461,26.9,583,124,459,27
31010, 수원시,100001, 95세,2018,216,55,161,34.2,215,55,160,34.4
31010, 수원시,100002, 96세,2018,172,32,140,22.9,172,32,140,22.9
31010, 수원시,100003, 97세,2018,104,19,85,22.4,104,19,85,22.4
31010, 수원시,100004, 98세,2018,55,6,49,12.2,54,6,48,12.5
31010, 수원시,100005, 99세,2018,38,12,26,46.2,38,12,26,46.2
31010, 수원시,101,100세이상,2018,53,5,48,10.4,53,5,48,10.4
31010, 수원시,102,15세미만,2018,167977,86491,81486,106.1,164899,84957,79942,106.3
31010, 수원시,103,15~64세,2018,933822,479424,454398,105.5,886257,453607,432650,104.8
31010, 수원시,104,65세이상,2018,117044,50325,66719,75.4,113998,49031,64967,75.5
31010, 수원시,086,85세이상,2018,9713,2569,7144,36,9640,2556,7084,36.1
31010, 수원시,126,평균연령,2018,39,38.2,39.9,,38.9,38,39.8,
31010, 수원시,127,중위연령,2018,39.3,38.4,40.3,,39.2,38.3,40.2,
31011, 장안구,000,합계,2018,288719,146009,142710,102.3,278897,140769,138128,101.9
31011, 장안구,005,0~4세,2018,9952,5177,4775,108.4,9676,5033,4643,108.4
31011, 장안구,005001, 0세,2018,1597,828,769,107.7,1531,800,731,109.4
31011, 장안구,005002, 1세,2018,1793,953,840,113.5,1723,915,808,113.2
31011, 장안구,005003, 2세,2018,2033,1027,1006,102.1,1978,995,983,101.2
31011, 장안구,005004, 3세,2018,2290,1200,1090,110.1,2252,1179,1073,109.9
31011, 장안구,005005, 4세,2018,2239,1169,1070,109.3,2192,1144,1048,109.2
31011, 장안구,010,5~9세,2018,12615,6520,6095,107,12464,6446,6018,107.1
31011, 장안구,010001, 5세,2018,2349,1235,1114,110.9,2299,1212,1087,111.5
31011, 장안구,010002, 6세,2018,2549,1292,1257,102.8,2517,1280,1237,103.5
31011, 장안구,010003, 7세,2018,2627,1382,1245,111,2606,1373,1233,111.4
31011, 장안구,010004, 8세,2018,2509,1297,1212,107,2485,1281,1204,106.4
31011, 장안구,010005, 9세,2018,2581,1314,1267,103.7,2557,1300,1257,103.4
31011, 장안구,015,10~14세,2018,13942,7203,6739,106.9,13888,7186,6702,107.2
31011, 장안구,015001, 10세,2018,2839,1466,1373,106.8,2823,1461,1362,107.3
31011, 장안구,015002, 11세,2018,2899,1493,1406,106.2,2888,1489,1399,106.4
31011, 장안구,015003, 12세,2018,2666,1356,1310,103.5,2658,1354,1304,103.8
31011, 장안구,015004, 13세,2018,2634,1341,1293,103.7,2625,1339,1286,104.1
31011, 장안구,015005, 14세,2018,2904,1547,1357,114,2894,1543,1351,114.2
31011, 장안구,020,15~19세,2018,18200,9849,8351,117.9,17905,9717,8188,118.7
31011, 장안구,020001, 15세,2018,3069,1584,1485,106.7,3062,1581,1481,106.8
31011, 장안구,020002, 16세,2018,3122,1654,1468,112.7,3111,1649,1462,112.8
31011, 장안구,020003, 17세,2018,3765,2090,1675,124.8,3759,2086,1673,124.7
31011, 장안구,020004, 18세,2018,4026,2143,1883,113.8,3975,2122,1853,114.5
31011, 장안구,020005, 19세,2018,4218,2378,1840,129.2,3998,2279,1719,132.6
31011, 장안구,025,20~24세,2018,24013,13311,10702,124.4,22787,12591,10196,123.5
31011, 장안구,025001, 20세,2018,4655,2567,2088,122.9,4439,2448,1991,123
31011, 장안구,025002, 21세,2018,4791,2672,2119,126.1,4530,2519,2011,125.3
31011, 장안구,025003, 22세,2018,4754,2585,2169,119.2,4513,2436,2077,117.3
31011, 장안구,025004, 23세,2018,4908,2751,2157,127.5,4653,2597,2056,126.3
31011, 장안구,025005, 24세,2018,4905,2736,2169,126.1,4652,2591,2061,125.7
31011, 장안구,030,25~29세,2018,21933,12027,9906,121.4,20595,11287,9308,121.3
31011, 장안구,030001, 25세,2018,4947,2712,2235,121.3,4673,2557,2116,120.8
31011, 장안구,030002, 26세,2018,4832,2665,2167,123,4550,2495,2055,121.4
31011, 장안구,030003, 27세,2018,4385,2404,1981,121.4,4136,2269,1867,121.5
31011, 장안구,030004, 28세,2018,4033,2207,1826,120.9,3752,2051,1701,120.6
31011, 장안구,030005, 29세,2018,3736,2039,1697,120.2,3484,1915,1569,122.1
31011, 장안구,035,30~34세,2018,16924,8865,8059,110,15726,8222,7504,109.6
31011, 장안구,035001, 30세,2018,3421,1818,1603,113.4,3152,1683,1469,114.6
31011, 장안구,035002, 31세,2018,3324,1790,1534,116.7,3074,1643,1431,114.8
31011, 장안구,035003, 32세,2018,3330,1755,1575,111.4,3084,1625,1459,111.4
31011, 장안구,035004, 33세,2018,3422,1788,1634,109.4,3202,1674,1528,109.6
31011, 장안구,035005, 34세,2018,3427,1714,1713,100.1,3214,1597,1617,98.8
31011, 장안구,040,35~39세,2018,21238,10667,10571,100.9,20423,10192,10231,99.6
31011, 장안구,040001, 35세,2018,3832,1984,1848,107.4,3651,1877,1774,105.8
31011, 장안구,040002, 36세,2018,4205,2102,2103,100,4030,2000,2030,98.5
31011, 장안구,040003, 37세,2018,4338,2176,2162,100.6,4192,2091,2101,99.5
31011, 장안구,040004, 38세,2018,4430,2236,2194,101.9,4279,2149,2130,100.9
31011, 장안구,040005, 39세,2018,4433,2169,2264,95.8,4271,2075,2196,94.5
31011, 장안구,045,40~44세,2018,22560,11284,11276,100.1,21898,10894,11004,99
31011, 장안구,045001, 40세,2018,4107,2105,2002,105.1,3940,2008,1932,103.9
31011, 장안구,045002, 41세,2018,4330,2122,2208,96.1,4198,2049,2149,95.3
31011, 장안구,045003, 42세,2018,4385,2216,2169,102.2,4260,2135,2125,100.5
31011, 장안구,045004, 43세,2018,4585,2273,2312,98.3,4482,2215,2267,97.7
31011, 장안구,045005, 44세,2018,5153,2568,2585,99.3,5018,2487,2531,98.3
31011, 장안구,050,45~49세,2018,27677,13651,14026,97.3,26813,13178,13635,96.6
31011, 장안구,050001, 45세,2018,5293,2554,2739,93.2,5120,2465,2655,92.8
31011, 장안구,050002, 46세,2018,5245,2657,2588,102.7,5086,2555,2531,100.9
31011, 장안구,050003, 47세,2018,5634,2789,2845,98,5460,2700,2760,97.8
31011, 장안구,050004, 48세,2018,5649,2841,2808,101.2,5466,2731,2735,99.9
31011, 장안구,050005, 49세,2018,5856,2810,3046,92.3,5681,2727,2954,92.3
31011, 장안구,055,50~54세,2018,25994,12870,13124,98.1,25081,12402,12679,97.8
31011, 장안구,055001, 50세,2018,5775,2771,3004,92.2,5586,2672,2914,91.7
31011, 장안구,055002, 51세,2018,5288,2547,2741,92.9,5130,2463,2667,92.4
31011, 장안구,055003, 52세,2018,5152,2610,2542,102.7,4982,2531,2451,103.3
31011, 장안구,055004, 53세,2018,5091,2579,2512,102.7,4892,2468,2424,101.8
31011, 장안구,055005, 54세,2018,4688,2363,2325,101.6,4491,2268,2223,102
31011, 장안구,060,55~59세,2018,24143,12249,11894,103,23268,11834,11434,103.5
31011, 장안구,060001, 55세,2018,5074,2625,2449,107.2,4817,2505,2312,108.3
31011, 장안구,060002, 56세,2018,4846,2479,2367,104.7,4668,2397,2271,105.5
31011, 장안구,060003, 57세,2018,5141,2551,2590,98.5,5035,2505,2530,99
31011, 장안구,060004, 58세,2018,4853,2467,2386,103.4,4664,2369,2295,103.2
31011, 장안구,060005, 59세,2018,4229,2127,2102,101.2,4084,2058,2026,101.6
31011, 장안구,065,60~64세,2018,16567,8295,8272,100.3,15918,7962,7956,100.1
31011, 장안구,065001, 60세,2018,3921,2012,1909,105.4,3766,1922,1844,104.2
31011, 장안구,065002, 61세,2018,3500,1793,1707,105,3360,1720,1640,104.9
31011, 장안구,065003, 62세,2018,3239,1628,1611,101.1,3133,1570,1563,100.4
31011, 장안구,065004, 63세,2018,3232,1540,1692,91,3094,1471,1623,90.6
31011, 장안구,065005, 64세,2018,2675,1322,1353,97.7,2565,1279,1286,99.5
31011, 장안구,070,65~69세,2018,10455,5006,5449,91.9,10162,4862,5300,91.7
31011, 장안구,070001, 65세,2018,2327,1105,1222,90.4,2240,1061,1179,90
31011, 장안구,070002, 66세,2018,2532,1239,1293,95.8,2466,1200,1266,94.8
31011, 장안구,070003, 67세,2018,1721,811,910,89.1,1664,786,878,89.5
31011, 장안구,070004, 68세,2018,1982,936,1046,89.5,1933,913,1020,89.5
31011, 장안구,070005, 69세,2018,1893,915,978,93.6,1859,902,957,94.3
31011, 장안구,075,70~74세,2018,8175,3696,4479,82.5,8072,3651,4421,82.6
31011, 장안구,075001, 70세,2018,1885,906,979,92.5,1861,892,969,92.1
31011, 장안구,075002, 71세,2018,1908,863,1045,82.6,1882,852,1030,82.7
31011, 장안구,075003, 72세,2018,1461,672,789,85.2,1442,663,779,85.1
31011, 장안구,075004, 73세,2018,1486,631,855,73.8,1466,622,844,73.7
31011, 장안구,075005, 74세,2018,1435,624,811,76.9,1421,622,799,77.8
31011, 장안구,080,75~79세,2018,6799,2868,3931,73,6740,2855,3885,73.5
31011, 장안구,080001, 75세,2018,1479,636,843,75.4,1469,634,835,75.9
31011, 장안구,080002, 76세,2018,1625,682,943,72.3,1605,678,927,73.1
31011, 장안구,080003, 77세,2018,1320,583,737,79.1,1309,581,728,79.8
31011, 장안구,080004, 78세,2018,1199,486,713,68.2,1190,484,706,68.6
31011, 장안구,080005, 79세,2018,1176,481,695,69.2,1167,478,689,69.4
31011, 장안구,085,80~84세,2018,4444,1623,2821,57.5,4409,1613,2796,57.7
31011, 장안구,085001, 80세,2018,1061,445,616,72.2,1053,442,611,72.3
31011, 장안구,085002, 81세,2018,1011,390,621,62.8,1001,387,614,63
31011, 장안구,085003, 82세,2018,907,298,609,48.9,901,296,605,48.9
31011, 장안구,085004, 83세,2018,813,268,545,49.2,807,267,540,49.4
31011, 장안구,085005, 84세,2018,652,222,430,51.6,647,221,426,51.9
31011, 장안구,090,85~89세,2018,2120,610,1510,40.4,2109,607,1502,40.4
31011, 장안구,090001, 85세,2018,549,162,387,41.9,544,160,384,41.7
31011, 장안구,090002, 86세,2018,502,153,349,43.8,499,152,347,43.8
31011, 장안구,090003, 87세,2018,377,114,263,43.3,375,114,261,43.7
31011, 장안구,090004, 88세,2018,376,97,279,34.8,376,97,279,34.8
31011, 장안구,090005, 89세,2018,316,84,232,36.2,315,84,231,36.4
31011, 장안구,095,90~94세,2018,768,197,571,34.5,764,196,568,34.5
31011, 장안구,095001, 90세,2018,247,74,173,42.8,245,73,172,42.4
31011, 장안구,095002, 91세,2018,203,43,160,26.9,201,43,158,27.2
31011, 장안구,095003, 92세,2018,132,31,101,30.7,132,31,101,30.7
31011, 장안구,095004, 93세,2018,108,25,83,30.1,108,25,83,30.1
31011, 장안구,095005, 94세,2018,78,24,54,44.4,78,24,54,44.4
31011, 장안구,100,95~99세,2018,180,39,141,27.7,179,39,140,27.9
31011, 장안구,100001, 95세,2018,66,19,47,40.4,65,19,46,41.3
31011, 장안구,100002, 96세,2018,58,8,50,16,58,8,50,16
31011, 장안구,100003, 97세,2018,29,6,23,26.1,29,6,23,26.1
31011, 장안구,100004, 98세,2018,16,X,15,6.7,16,X,15,6.7
31011, 장안구,100005, 99세,2018,11,5,6,83.3,11,5,6,83.3
31011, 장안구,101,100세이상,2018,20,X,18,11.1,20,X,18,11.1
31011, 장안구,102,15세미만,2018,36509,18900,17609,107.3,36028,18665,17363,107.5
31011, 장안구,103,15~64세,2018,219249,113068,106181,106.5,210414,108279,102135,106
31011, 장안구,104,65세이상,2018,32961,14041,18920,74.2,32455,13825,18630,74.2
31011, 장안구,086,85세이상,2018,3088,848,2240,37.9,3072,844,2228,37.9
31011, 장안구,126,평균연령,2018,40.3,39.1,41.5,,40.3,39.1,41.6,
31011, 장안구,127,중위연령,2018,41.3,39.7,42.9,,41.5,39.9,43,
31012, 권선구,000,합계,2018,379834,191697,188137,101.9,365133,184151,180982,101.8
31012, 권선구,005,0~4세,2018,18940,9764,9176,106.4,18407,9488,8919,106.4
31012, 권선구,005001, 0세,2018,3268,1680,1588,105.8,3133,1612,1521,106
31012, 권선구,005002, 1세,2018,3577,1841,1736,106,3461,1776,1685,105.4
31012, 권선구,005003, 2세,2018,4028,2126,1902,111.8,3908,2060,1848,111.5
31012, 권선구,005004, 3세,2018,4071,2100,1971,106.5,3985,2053,1932,106.3
31012, 권선구,005005, 4세,2018,3996,2017,1979,101.9,3920,1987,1933,102.8
31012, 권선구,010,5~9세,2018,18506,9451,9055,104.4,18300,9355,8945,104.6
31012, 권선구,010001, 5세,2018,3826,1947,1879,103.6,3767,1925,1842,104.5
31012, 권선구,010002, 6세,2018,4102,2115,1987,106.4,4055,2090,1965,106.4
31012, 권선구,010003, 7세,2018,3806,1956,1850,105.7,3767,1935,1832,105.6
31012, 권선구,010004, 8세,2018,3455,1731,1724,100.4,3423,1714,1709,100.3
31012, 권선구,010005, 9세,2018,3317,1702,1615,105.4,3288,1691,1597,105.9
31012, 권선구,015,10~14세,2018,16332,8487,7845,108.2,16224,8443,7781,108.5
31012, 권선구,015001, 10세,2018,3426,1790,1636,109.4,3399,1776,1623,109.4
31012, 권선구,015002, 11세,2018,3517,1818,1699,107,3491,1807,1684,107.3
31012, 권선구,015003, 12세,2018,3094,1602,1492,107.4,3074,1594,1480,107.7
31012, 권선구,015004, 13세,2018,2945,1496,1449,103.2,2929,1492,1437,103.8
31012, 권선구,015005, 14세,2018,3350,1781,1569,113.5,3331,1774,1557,113.9
31012, 권선구,020,15~19세,2018,18517,9671,8846,109.3,18400,9626,8774,109.7
31012, 권선구,020001, 15세,2018,3365,1792,1573,113.9,3348,1785,1563,114.2
31012, 권선구,020002, 16세,2018,3336,1733,1603,108.1,3315,1729,1586,109
31012, 권선구,020003, 17세,2018,3893,2053,1840,111.6,3870,2041,1829,111.6
31012, 권선구,020004, 18세,2018,4081,2103,1978,106.3,4066,2097,1969,106.5
31012, 권선구,020005, 19세,2018,3842,1990,1852,107.5,3801,1974,1827,108
31012, 권선구,025,20~24세,2018,25035,12917,12118,106.6,24524,12646,11878,106.5
31012, 권선구,025001, 20세,2018,4345,2353,1992,118.1,4289,2325,1964,118.4
31012, 권선구,025002, 21세,2018,4790,2468,2322,106.3,4717,2432,2285,106.4
31012, 권선구,025003, 22세,2018,5080,2612,2468,105.8,4979,2567,2412,106.4
31012, 권선구,025004, 23세,2018,5311,2670,2641,101.1,5185,2596,2589,100.3
31012, 권선구,025005, 24세,2018,5509,2814,2695,104.4,5354,2726,2628,103.7
31012, 권선구,030,25~29세,2018,29788,15445,14343,107.7,28391,14762,13629,108.3
31012, 권선구,030001, 25세,2018,5911,3080,2831,108.8,5702,2972,2730,108.9
31012, 권선구,030002, 26세,2018,6246,3219,3027,106.3,6010,3101,2909,106.6
31012, 권선구,030003, 27세,2018,6103,3161,2942,107.4,5822,3022,2800,107.9
31012, 권선구,030004, 28세,2018,5686,2963,2723,108.8,5392,2827,2565,110.2
31012, 권선구,030005, 29세,2018,5842,3022,2820,107.2,5465,2840,2625,108.2
31012, 권선구,035,30~34세,2018,30300,15751,14549,108.3,28201,14625,13576,107.7
31012, 권선구,035001, 30세,2018,5697,2995,2702,110.8,5286,2791,2495,111.9
31012, 권선구,035002, 31세,2018,6017,3115,2902,107.3,5546,2851,2695,105.8
31012, 권선구,035003, 32세,2018,5954,3028,2926,103.5,5534,2814,2720,103.5
31012, 권선구,035004, 33세,2018,6178,3166,3012,105.1,5763,2946,2817,104.6
31012, 권선구,035005, 34세,2018,6454,3447,3007,114.6,6072,3223,2849,113.1
31012, 권선구,040,35~39세,2018,36390,19020,17370,109.5,34860,18169,16691,108.9
31012, 권선구,040001, 35세,2018,6950,3614,3336,108.3,6602,3431,3171,108.2
31012, 권선구,040002, 36세,2018,7500,3884,3616,107.4,7158,3692,3466,106.5
31012, 권선구,040003, 37세,2018,7609,3941,3668,107.4,7329,3793,3536,107.3
31012, 권선구,040004, 38세,2018,7388,3934,3454,113.9,7124,3779,3345,113
31012, 권선구,040005, 39세,2018,6943,3647,3296,110.6,6647,3474,3173,109.5
31012, 권선구,045,40~44세,2018,30522,16034,14488,110.7,29330,15338,13992,109.6
31012, 권선구,045001, 40세,2018,6117,3230,2887,111.9,5870,3099,2771,111.8
31012, 권선구,045002, 41세,2018,6113,3234,2879,112.3,5886,3102,2784,111.4
31012, 권선구,045003, 42세,2018,5915,3158,2757,114.5,5676,3007,2669,112.7
31012, 권선구,045004, 43세,2018,6019,3118,2901,107.5,5779,2978,2801,106.3
31012, 권선구,045005, 44세,2018,6358,3294,3064,107.5,6119,3152,2967,106.2
31012, 권선구,050,45~49세,2018,33234,16599,16635,99.8,31732,15826,15906,99.5
31012, 권선구,050001, 45세,2018,6457,3291,3166,103.9,6211,3161,3050,103.6
31012, 권선구,050002, 46세,2018,6417,3284,3133,104.8,6117,3120,2997,104.1
31012, 권선구,050003, 47세,2018,6936,3556,3380,105.2,6623,3382,3241,104.4
31012, 권선구,050004, 48세,2018,6426,3161,3265,96.8,6125,3018,3107,97.1
31012, 권선구,050005, 49세,2018,6998,3307,3691,89.6,6656,3145,3511,89.6
31012, 권선구,055,50~54세,2018,32620,15985,16635,96.1,30965,15130,15835,95.5
31012, 권선구,055001, 50세,2018,6962,3309,3653,90.6,6615,3133,3482,90
31012, 권선구,055002, 51세,2018,6492,3137,3355,93.5,6238,3005,3233,92.9
31012, 권선구,055003, 52세,2018,6323,3161,3162,100,6013,3001,3012,99.6
31012, 권선구,055004, 53세,2018,6683,3269,3414,95.8,6311,3078,3233,95.2
31012, 권선구,055005, 54세,2018,6160,3109,3051,101.9,5788,2913,2875,101.3
31012, 권선구,060,55~59세,2018,31748,15924,15824,100.6,30107,15139,14968,101.1
31012, 권선구,060001, 55세,2018,6391,3235,3156,102.5,5900,3011,2889,104.2
31012, 권선구,060002, 56세,2018,6315,3161,3154,100.2,5966,3005,2961,101.5
31012, 권선구,060003, 57세,2018,6840,3371,3469,97.2,6611,3257,3354,97.1
31012, 권선구,060004, 58세,2018,6503,3294,3209,102.6,6177,3131,3046,102.8
31012, 권선구,060005, 59세,2018,5699,2863,2836,101,5453,2735,2718,100.6
31012, 권선구,065,60~64세,2018,21630,10798,10832,99.7,20333,10140,10193,99.5
31012, 권선구,065001, 60세,2018,5067,2560,2507,102.1,4775,2415,2360,102.3
31012, 권선구,065002, 61세,2018,4687,2353,2334,100.8,4357,2182,2175,100.3
31012, 권선구,065003, 62세,2018,4271,2150,2121,101.4,4025,2022,2003,100.9
31012, 권선구,065004, 63세,2018,4215,2084,2131,97.8,3987,1974,2013,98.1
31012, 권선구,065005, 64세,2018,3390,1651,1739,94.9,3189,1547,1642,94.2
31012, 권선구,070,65~69세,2018,12977,6344,6633,95.6,12399,6062,6337,95.7
31012, 권선구,070001, 65세,2018,3056,1478,1578,93.7,2893,1392,1501,92.7
31012, 권선구,070002, 66세,2018,3217,1612,1605,100.4,3073,1545,1528,101.1
31012, 권선구,070003, 67세,2018,2138,1030,1108,93,2027,975,1052,92.7
31012, 권선구,070004, 68세,2018,2297,1110,1187,93.5,2204,1069,1135,94.2
31012, 권선구,070005, 69세,2018,2269,1114,1155,96.5,2202,1081,1121,96.4
31012, 권선구,075,70~74세,2018,9247,4347,4900,88.7,9078,4286,4792,89.4
31012, 권선구,075001, 70세,2018,2188,1047,1141,91.8,2141,1028,1113,92.4
31012, 권선구,075002, 71세,2018,2269,1089,1180,92.3,2221,1071,1150,93.1
31012, 권선구,075003, 72세,2018,1632,758,874,86.7,1603,750,853,87.9
31012, 권선구,075004, 73세,2018,1571,745,826,90.2,1547,736,811,90.8
31012, 권선구,075005, 74세,2018,1587,708,879,80.5,1566,701,865,81
31012, 권선구,080,75~79세,2018,6920,2874,4046,71,6830,2851,3979,71.7
31012, 권선구,080001, 75세,2018,1472,639,833,76.7,1455,634,821,77.2
31012, 권선구,080002, 76세,2018,1654,733,921,79.6,1637,725,912,79.5
31012, 권선구,080003, 77세,2018,1381,568,813,69.9,1357,563,794,70.9
31012, 권선구,080004, 78세,2018,1195,457,738,61.9,1177,454,723,62.8
31012, 권선구,080005, 79세,2018,1218,477,741,64.4,1204,475,729,65.2
31012, 권선구,085,80~84세,2018,4322,1559,2763,56.4,4261,1541,2720,56.7
31012, 권선구,085001, 80세,2018,1061,414,647,64,1044,410,634,64.7
31012, 권선구,085002, 81세,2018,971,349,622,56.1,956,343,613,56
31012, 권선구,085003, 82세,2018,854,310,544,57,842,306,536,57.1
31012, 권선구,085004, 83세,2018,760,255,505,50.5,754,254,500,50.8
31012, 권선구,085005, 84세,2018,676,231,445,51.9,665,228,437,52.2
31012, 권선구,090,85~89세,2018,1993,560,1433,39.1,1981,557,1424,39.1
31012, 권선구,090001, 85세,2018,561,167,394,42.4,554,165,389,42.4
31012, 권선구,090002, 86세,2018,466,141,325,43.4,465,141,324,43.5
31012, 권선구,090003, 87세,2018,338,95,243,39.1,336,95,241,39.4
31012, 권선구,090004, 88세,2018,341,82,259,31.7,340,81,259,31.3
31012, 권선구,090005, 89세,2018,287,75,212,35.4,286,75,211,35.5
31012, 권선구,095,90~94세,2018,640,140,500,28,637,140,497,28.2
31012, 권선구,095001, 90세,2018,215,50,165,30.3,214,50,164,30.5
31012, 권선구,095002, 91세,2018,156,41,115,35.7,156,41,115,35.7
31012, 권선구,095003, 92세,2018,115,24,91,26.4,114,24,90,26.7
31012, 권선구,095004, 93세,2018,99,12,87,13.8,99,12,87,13.8
31012, 권선구,095005, 94세,2018,55,13,42,31,54,13,41,31.7
31012, 권선구,100,95~99세,2018,157,25,132,18.9,157,25,132,18.9
31012, 권선구,100001, 95세,2018,58,9,49,18.4,58,9,49,18.4
31012, 권선구,100002, 96세,2018,41,8,33,24.2,41,8,33,24.2
31012, 권선구,100003, 97세,2018,33,X,30,10,33,X,30,10
31012, 권선구,100004, 98세,2018,12,X,11,9.1,12,X,11,9.1
31012, 권선구,100005, 99세,2018,13,X,9,44.4,13,X,9,44.4
31012, 권선구,101,100세이상,2018,16,X,14,14.3,16,X,14,14.3
31012, 권선구,102,15세미만,2018,53778,27702,26076,106.2,52931,27286,25645,106.4
31012, 권선구,103,15~64세,2018,289784,148144,141640,104.6,276843,141401,135442,104.4
31012, 권선구,104,65세이상,2018,36272,15851,20421,77.6,35359,15464,19895,77.7
31012, 권선구,086,85세이상,2018,2806,727,2079,35,2791,724,2067,35
31012, 권선구,126,평균연령,2018,39.2,38.4,40,,39.1,38.3,39.9,
31012, 권선구,127,중위연령,2018,39.4,38.7,40.3,,39.3,38.6,40.1,
31013, 팔달구,000,합계,2018,194299,98496,95803,102.8,174315,87626,86689,101.1
31013, 팔달구,005,0~4세,2018,6067,3059,3008,101.7,5478,2764,2714,101.8
31013, 팔달구,005001, 0세,2018,1093,542,551,98.4,965,480,485,99
31013, 팔달구,005002, 1세,2018,1115,560,555,100.9,1006,505,501,100.8
31013, 팔달구,005003, 2세,2018,1298,633,665,95.2,1160,563,597,94.3
31013, 팔달구,005004, 3세,2018,1277,661,616,107.3,1164,595,569,104.6
31013, 팔달구,005005, 4세,2018,1284,663,621,106.8,1183,621,562,110.5
31013, 팔달구,010,5~9세,2018,6351,3302,3049,108.3,6049,3154,2895,108.9
31013, 팔달구,010001, 5세,2018,1249,641,608,105.4,1173,605,568,106.5
31013, 팔달구,010002, 6세,2018,1321,674,647,104.2,1251,637,614,103.7
31013, 팔달구,010003, 7세,2018,1251,643,608,105.8,1192,617,575,107.3
31013, 팔달구,010004, 8세,2018,1301,672,629,106.8,1258,649,609,106.6
31013, 팔달구,010005, 9세,2018,1229,672,557,120.6,1175,646,529,122.1
31013, 팔달구,015,10~14세,2018,6810,3463,3347,103.5,6662,3392,3270,103.7
31013, 팔달구,015001, 10세,2018,1392,734,658,111.6,1353,712,641,111.1
31013, 팔달구,015002, 11세,2018,1365,695,670,103.7,1335,681,654,104.1
31013, 팔달구,015003, 12세,2018,1270,644,626,102.9,1233,631,602,104.8
31013, 팔달구,015004, 13세,2018,1279,636,643,98.9,1259,628,631,99.5
31013, 팔달구,015005, 14세,2018,1504,754,750,100.5,1482,740,742,99.7
31013, 팔달구,020,15~19세,2018,8783,4582,4201,109.1,8622,4495,4127,108.9
31013, 팔달구,020001, 15세,2018,1495,793,702,113,1479,786,693,113.4
31013, 팔달구,020002, 16세,2018,1580,807,773,104.4,1560,797,763,104.5
31013, 팔달구,020003, 17세,2018,1859,982,877,112,1835,966,869,111.2
31013, 팔달구,020004, 18세,2018,1984,1032,952,108.4,1938,1012,926,109.3
31013, 팔달구,020005, 19세,2018,1865,968,897,107.9,1810,934,876,106.6
31013, 팔달구,025,20~24세,2018,12542,6345,6197,102.4,12007,6073,5934,102.3
31013, 팔달구,025001, 20세,2018,2077,1051,1026,102.4,2010,1017,993,102.4
31013, 팔달구,025002, 21세,2018,2281,1178,1103,106.8,2195,1127,1068,105.5
31013, 팔달구,025003, 22세,2018,2517,1304,1213,107.5,2405,1249,1156,108
31013, 팔달구,025004, 23세,2018,2753,1335,1418,94.1,2627,1276,1351,94.4
31013, 팔달구,025005, 24세,2018,2914,1477,1437,102.8,2770,1404,1366,102.8
31013, 팔달구,030,25~29세,2018,16287,8753,7534,116.2,14622,7850,6772,115.9
31013, 팔달구,030001, 25세,2018,3195,1714,1481,115.7,2957,1586,1371,115.7
31013, 팔달구,030002, 26세,2018,3374,1800,1574,114.4,3108,1648,1460,112.9
31013, 팔달구,030003, 27세,2018,3294,1771,1523,116.3,2998,1599,1399,114.3
31013, 팔달구,030004, 28세,2018,3184,1718,1466,117.2,2768,1500,1268,118.3
31013, 팔달구,030005, 29세,2018,3240,1750,1490,117.4,2791,1517,1274,119.1
31013, 팔달구,035,30~34세,2018,14709,8011,6698,119.6,12415,6684,5731,116.6
31013, 팔달구,035001, 30세,2018,3084,1654,1430,115.7,2624,1397,1227,113.9
31013, 팔달구,035002, 31세,2018,2963,1605,1358,118.2,2509,1329,1180,112.6
31013, 팔달구,035003, 32세,2018,2959,1649,1310,125.9,2439,1354,1085,124.8
31013, 팔달구,035004, 33세,2018,2807,1501,1306,114.9,2370,1254,1116,112.4
31013, 팔달구,035005, 34세,2018,2896,1602,1294,123.8,2473,1350,1123,120.2
31013, 팔달구,040,35~39세,2018,15585,8363,7222,115.8,13698,7211,6487,111.2
31013, 팔달구,040001, 35세,2018,3061,1666,1395,119.4,2649,1429,1220,117.1
31013, 팔달구,040002, 36세,2018,3209,1707,1502,113.6,2766,1440,1326,108.6
31013, 팔달구,040003, 37세,2018,3174,1700,1474,115.3,2841,1485,1356,109.5
31013, 팔달구,040004, 38세,2018,3158,1712,1446,118.4,2809,1497,1312,114.1
31013, 팔달구,040005, 39세,2018,2983,1578,1405,112.3,2633,1360,1273,106.8
31013, 팔달구,045,40~44세,2018,14774,7726,7048,109.6,13145,6771,6374,106.2
31013, 팔달구,045001, 40세,2018,2786,1478,1308,113,2442,1276,1166,109.4
31013, 팔달구,045002, 41세,2018,2863,1469,1394,105.4,2539,1289,1250,103.1
31013, 팔달구,045003, 42세,2018,2823,1484,1339,110.8,2516,1294,1222,105.9
31013, 팔달구,045004, 43세,2018,3011,1573,1438,109.4,2698,1387,1311,105.8
31013, 팔달구,045005, 44세,2018,3291,1722,1569,109.8,2950,1525,1425,107
31013, 팔달구,050,45~49세,2018,17717,9177,8540,107.5,15379,7868,7511,104.8
31013, 팔달구,050001, 45세,2018,3340,1717,1623,105.8,2974,1514,1460,103.7
31013, 팔달구,050002, 46세,2018,3380,1800,1580,113.9,2898,1518,1380,110
31013, 팔달구,050003, 47세,2018,3716,1910,1806,105.8,3199,1620,1579,102.6
31013, 팔달구,050004, 48세,2018,3638,1915,1723,111.1,3146,1646,1500,109.7
31013, 팔달구,050005, 49세,2018,3643,1835,1808,101.5,3162,1570,1592,98.6
31013, 팔달구,055,50~54세,2018,17568,8929,8639,103.4,14908,7487,7421,100.9
31013, 팔달구,055001, 50세,2018,3749,1810,1939,93.3,3301,1564,1737,90
31013, 팔달구,055002, 51세,2018,3313,1686,1627,103.6,2897,1464,1433,102.2
31013, 팔달구,055003, 52세,2018,3428,1759,1669,105.4,2859,1459,1400,104.2
31013, 팔달구,055004, 53세,2018,3539,1838,1701,108.1,2918,1507,1411,106.8
31013, 팔달구,055005, 54세,2018,3539,1836,1703,107.8,2933,1493,1440,103.7
31013, 팔달구,060,55~59세,2018,17998,9110,8888,102.5,15486,7766,7720,100.6
31013, 팔달구,060001, 55세,2018,3815,1931,1884,102.5,3053,1505,1548,97.2
31013, 팔달구,060002, 56세,2018,3548,1810,1738,104.1,2993,1527,1466,104.2
31013, 팔달구,060003, 57세,2018,3706,1844,1862,99,3389,1694,1695,99.9
31013, 팔달구,060004, 58세,2018,3672,1859,1813,102.5,3175,1587,1588,99.9
31013, 팔달구,060005, 59세,2018,3257,1666,1591,104.7,2876,1453,1423,102.1
31013, 팔달구,065,60~64세,2018,13814,6784,7030,96.5,11890,5803,6087,95.3
31013, 팔달구,065001, 60세,2018,3088,1568,1520,103.2,2659,1348,1311,102.8
31013, 팔달구,065002, 61세,2018,2987,1477,1510,97.8,2500,1246,1254,99.4
31013, 팔달구,065003, 62세,2018,2692,1322,1370,96.5,2328,1134,1194,95
31013, 팔달구,065004, 63세,2018,2711,1287,1424,90.4,2363,1097,1266,86.7
31013, 팔달구,065005, 64세,2018,2336,1130,1206,93.7,2040,978,1062,92.1
31013, 팔달구,070,65~69세,2018,8700,4187,4513,92.8,7852,3765,4087,92.1
31013, 팔달구,070001, 65세,2018,1909,893,1016,87.9,1686,783,903,86.7
31013, 팔달구,070002, 66세,2018,2153,1048,1105,94.8,1961,947,1014,93.4
31013, 팔달구,070003, 67세,2018,1475,721,754,95.6,1291,631,660,95.6
31013, 팔달구,070004, 68세,2018,1611,772,839,92,1483,709,774,91.6
31013, 팔달구,070005, 69세,2018,1552,753,799,94.2,1431,695,736,94.4
31013, 팔달구,075,70~74세,2018,6526,2947,3579,82.3,6273,2841,3432,82.8
31013, 팔달구,075001, 70세,2018,1591,737,854,86.3,1514,697,817,85.3
31013, 팔달구,075002, 71세,2018,1517,645,872,74,1447,614,833,73.7
31013, 팔달구,075003, 72세,2018,1161,555,606,91.6,1120,536,584,91.8
31013, 팔달구,075004, 73세,2018,1118,523,595,87.9,1092,515,577,89.3
31013, 팔달구,075005, 74세,2018,1139,487,652,74.7,1100,479,621,77.1
31013, 팔달구,080,75~79세,2018,5137,2156,2981,72.3,5003,2119,2884,73.5
31013, 팔달구,080001, 75세,2018,1128,480,648,74.1,1099,473,626,75.6
31013, 팔달구,080002, 76세,2018,1257,558,699,79.8,1232,552,680,81.2
31013, 팔달구,080003, 77세,2018,1020,415,605,68.6,987,407,580,70.2
31013, 팔달구,080004, 78세,2018,866,354,512,69.1,842,343,499,68.7
31013, 팔달구,080005, 79세,2018,866,349,517,67.5,843,344,499,68.9
31013, 팔달구,085,80~84세,2018,3011,1121,1890,59.3,2939,1106,1833,60.3
31013, 팔달구,085001, 80세,2018,746,306,440,69.5,729,300,429,69.9
31013, 팔달구,085002, 81세,2018,657,247,410,60.2,642,244,398,61.3
31013, 팔달구,085003, 82세,2018,627,211,416,50.7,606,209,397,52.6
31013, 팔달구,085004, 83세,2018,544,204,340,60,535,202,333,60.7
31013, 팔달구,085005, 84세,2018,437,153,284,53.9,427,151,276,54.7
31013, 팔달구,090,85~89세,2018,1331,355,976,36.4,1301,352,949,37.1
31013, 팔달구,090001, 85세,2018,358,113,245,46.1,351,112,239,46.9
31013, 팔달구,090002, 86세,2018,341,92,249,36.9,334,91,243,37.4
31013, 팔달구,090003, 87세,2018,234,55,179,30.7,231,54,177,30.5
31013, 팔달구,090004, 88세,2018,196,53,143,37.1,187,53,134,39.6
31013, 팔달구,090005, 89세,2018,202,42,160,26.3,198,42,156,26.9
31013, 팔달구,095,90~94세,2018,440,91,349,26.1,438,90,348,25.9
31013, 팔달구,095001, 90세,2018,139,29,110,26.4,139,29,110,26.4
31013, 팔달구,095002, 91세,2018,118,27,91,29.7,116,26,90,28.9
31013, 팔달구,095003, 92세,2018,74,17,57,29.8,74,17,57,29.8
31013, 팔달구,095004, 93세,2018,63,5,58,8.6,63,5,58,8.6
31013, 팔달구,095005, 94세,2018,46,13,33,39.4,46,13,33,39.4
31013, 팔달구,100,95~99세,2018,142,35,107,32.7,141,35,106,33
31013, 팔달구,100001, 95세,2018,53,17,36,47.2,53,17,36,47.2
31013, 팔달구,100002, 96세,2018,42,10,32,31.3,42,10,32,31.3
31013, 팔달구,100003, 97세,2018,28,6,22,27.3,28,6,22,27.3
31013, 팔달구,100004, 98세,2018,14,X,13,7.7,13,X,12,8.3
31013, 팔달구,100005, 99세,2018,5,X,X,25,5,X,X,25
31013, 팔달구,101,100세이상,2018,7,X,7,0,7,X,7,0
31013, 팔달구,102,15세미만,2018,19228,9824,9404,104.5,18189,9310,8879,104.9
31013, 팔달구,103,15~64세,2018,149777,77780,71997,108,132172,68008,64164,106
31013, 팔달구,104,65세이상,2018,25294,10892,14402,75.6,23954,10308,13646,75.5
31013, 팔달구,086,85세이상,2018,1920,481,1439,33.4,1887,477,1410,33.8
31013, 팔달구,126,평균연령,2018,42.5,41.5,43.5,,42.3,41.2,43.3,
31013, 팔달구,127,중위연령,2018,43.5,42.3,44.7,,43,41.7,44.3,
31014, 영통구,000,합계,2018,355991,180038,175953,102.3,346809,175049,171760,101.9
31014, 영통구,005,0~4세,2018,18319,9413,8906,105.7,17956,9234,8722,105.9
31014, 영통구,005001, 0세,2018,3248,1657,1591,104.1,3177,1623,1554,104.4
31014, 영통구,005002, 1세,2018,3325,1741,1584,109.9,3253,1705,1548,110.1
31014, 영통구,005003, 2세,2018,3759,1942,1817,106.9,3679,1904,1775,107.3
31014, 영통구,005004, 3세,2018,4163,2114,2049,103.2,4085,2078,2007,103.5
31014, 영통구,005005, 4세,2018,3824,1959,1865,105,3762,1924,1838,104.7
31014, 영통구,010,5~9세,2018,20191,10460,9731,107.5,19940,10320,9620,107.3
31014, 영통구,010001, 5세,2018,3938,2057,1881,109.4,3871,2020,1851,109.1
31014, 영통구,010002, 6세,2018,4297,2205,2092,105.4,4237,2178,2059,105.8
31014, 영통구,010003, 7세,2018,4130,2127,2003,106.2,4082,2101,1981,106.1
31014, 영통구,010004, 8세,2018,3973,2087,1886,110.7,3940,2063,1877,109.9
31014, 영통구,010005, 9세,2018,3853,1984,1869,106.2,3810,1958,1852,105.7
31014, 영통구,015,10~14세,2018,19952,10192,9760,104.4,19855,10142,9713,104.4
31014, 영통구,015001, 10세,2018,4108,2083,2025,102.9,4086,2069,2017,102.6
31014, 영통구,015002, 11세,2018,4238,2198,2040,107.7,4214,2186,2028,107.8
31014, 영통구,015003, 12세,2018,3785,1942,1843,105.4,3764,1937,1827,106
31014, 영통구,015004, 13세,2018,3728,1876,1852,101.3,3712,1866,1846,101.1
31014, 영통구,015005, 14세,2018,4093,2093,2000,104.7,4079,2084,1995,104.5
31014, 영통구,020,15~19세,2018,23345,12026,11319,106.2,23045,11893,11152,106.6
31014, 영통구,020001, 15세,2018,4162,2106,2056,102.4,4150,2100,2050,102.4
31014, 영통구,020002, 16세,2018,4029,2056,1973,104.2,4013,2048,1965,104.2
31014, 영통구,020003, 17세,2018,4601,2421,2180,111.1,4585,2415,2170,111.3
31014, 영통구,020004, 18세,2018,5233,2684,2549,105.3,5166,2665,2501,106.6
31014, 영통구,020005, 19세,2018,5320,2759,2561,107.7,5131,2665,2466,108.1
31014, 영통구,025,20~24세,2018,27581,14197,13384,106.1,26274,13537,12737,106.3
31014, 영통구,025001, 20세,2018,5286,2688,2598,103.5,4951,2529,2422,104.4
31014, 영통구,025002, 21세,2018,5001,2598,2403,108.1,4777,2472,2305,107.2
31014, 영통구,025003, 22세,2018,5397,2807,2590,108.4,5175,2708,2467,109.8
31014, 영통구,025004, 23세,2018,5878,3029,2849,106.3,5623,2920,2703,108
31014, 영통구,025005, 24세,2018,6019,3075,2944,104.4,5748,2908,2840,102.4
31014, 영통구,030,25~29세,2018,31363,16947,14416,117.6,29938,16136,13802,116.9
31014, 영통구,030001, 25세,2018,6352,3341,3011,111,6078,3180,2898,109.7
31014, 영통구,030002, 26세,2018,6588,3609,2979,121.1,6285,3439,2846,120.8
31014, 영통구,030003, 27세,2018,6260,3445,2815,122.4,5990,3292,2698,122
31014, 영통구,030004, 28세,2018,6031,3270,2761,118.4,5736,3092,2644,116.9
31014, 영통구,030005, 29세,2018,6132,3282,2850,115.2,5849,3133,2716,115.4
31014, 영통구,035,30~34세,2018,29343,15293,14050,108.8,27934,14474,13460,107.5
31014, 영통구,035001, 30세,2018,5952,3141,2811,111.7,5638,2962,2676,110.7
31014, 영통구,035002, 31세,2018,5899,3109,2790,111.4,5590,2927,2663,109.9
31014, 영통구,035003, 32세,2018,5756,3048,2708,112.6,5485,2879,2606,110.5
31014, 영통구,035004, 33세,2018,5956,3049,2907,104.9,5684,2911,2773,105
31014, 영통구,035005, 34세,2018,5780,2946,2834,104,5537,2795,2742,101.9
31014, 영통구,040,35~39세,2018,34396,17275,17121,100.9,33386,16671,16715,99.7
31014, 영통구,040001, 35세,2018,6470,3344,3126,107,6239,3219,3020,106.6
31014, 영통구,040002, 36세,2018,7132,3600,3532,101.9,6892,3451,3441,100.3
31014, 영통구,040003, 37세,2018,7051,3501,3550,98.6,6877,3390,3487,97.2
31014, 영통구,040004, 38세,2018,7030,3465,3565,97.2,6835,3354,3481,96.4
31014, 영통구,040005, 39세,2018,6713,3365,3348,100.5,6543,3257,3286,99.1
31014, 영통구,045,40~44세,2018,31920,15722,16198,97.1,31245,15293,15952,95.9
31014, 영통구,045001, 40세,2018,6158,3100,3058,101.4,6009,3009,3000,100.3
31014, 영통구,045002, 41세,2018,6491,3202,3289,97.4,6339,3105,3234,96
31014, 영통구,045003, 42세,2018,6317,3137,3180,98.6,6178,3048,3130,97.4
31014, 영통구,045004, 43세,2018,6289,3108,3181,97.7,6179,3044,3135,97.1
31014, 영통구,045005, 44세,2018,6665,3175,3490,91,6540,3087,3453,89.4
31014, 영통구,050,45~49세,2018,33936,16885,17051,99,33266,16499,16767,98.4
31014, 영통구,050001, 45세,2018,6844,3310,3534,93.7,6695,3224,3471,92.9
31014, 영통구,050002, 46세,2018,6762,3369,3393,99.3,6623,3291,3332,98.8
31014, 영통구,050003, 47세,2018,7041,3547,3494,101.5,6909,3468,3441,100.8
31014, 영통구,050004, 48세,2018,6642,3362,3280,102.5,6504,3279,3225,101.7
31014, 영통구,050005, 49세,2018,6647,3297,3350,98.4,6535,3237,3298,98.2
31014, 영통구,055,50~54세,2018,26901,13376,13525,98.9,26364,13103,13261,98.8
31014, 영통구,055001, 50세,2018,6238,3062,3176,96.4,6126,3000,3126,96
31014, 영통구,055002, 51세,2018,5491,2698,2793,96.6,5406,2654,2752,96.4
31014, 영통구,055003, 52세,2018,5127,2567,2560,100.3,5012,2508,2504,100.2
31014, 영통구,055004, 53세,2018,5277,2659,2618,101.6,5159,2601,2558,101.7
31014, 영통구,055005, 54세,2018,4768,2390,2378,100.5,4661,2340,2321,100.8
31014, 영통구,060,55~59세,2018,22568,11786,10782,109.3,22096,11562,10534,109.8
31014, 영통구,060001, 55세,2018,4974,2589,2385,108.6,4838,2525,2313,109.2
31014, 영통구,060002, 56세,2018,4759,2455,2304,106.6,4639,2406,2233,107.7
31014, 영통구,060003, 57세,2018,4731,2433,2298,105.9,4663,2401,2262,106.1
31014, 영통구,060004, 58세,2018,4433,2345,2088,112.3,4348,2299,2049,112.2
31014, 영통구,060005, 59세,2018,3671,1964,1707,115.1,3608,1931,1677,115.1
31014, 영통구,065,60~64세,2018,13659,6925,6734,102.8,13280,6751,6529,103.4
31014, 영통구,065001, 60세,2018,3401,1758,1643,107,3306,1715,1591,107.8
31014, 영통구,065002, 61세,2018,3010,1547,1463,105.7,2918,1502,1416,106.1
31014, 영통구,065003, 62세,2018,2631,1361,1270,107.2,2550,1319,1231,107.1
31014, 영통구,065004, 63세,2018,2584,1260,1324,95.2,2512,1234,1278,96.6
31014, 영통구,065005, 64세,2018,2033,999,1034,96.6,1994,981,1013,96.8
31014, 영통구,070,65~69세,2018,7858,3767,4091,92.1,7680,3700,3980,93
31014, 영통구,070001, 65세,2018,1760,830,930,89.2,1711,815,896,91
31014, 영통구,070002, 66세,2018,1940,957,983,97.4,1907,941,966,97.4
31014, 영통구,070003, 67세,2018,1293,628,665,94.4,1244,611,633,96.5
31014, 영통구,070004, 68세,2018,1454,688,766,89.8,1429,678,751,90.3
31014, 영통구,070005, 69세,2018,1411,664,747,88.9,1389,655,734,89.2
31014, 영통구,075,70~74세,2018,5565,2527,3038,83.2,5506,2499,3007,83.1
31014, 영통구,075001, 70세,2018,1340,620,720,86.1,1321,610,711,85.8
31014, 영통구,075002, 71세,2018,1276,597,679,87.9,1261,589,672,87.6
31014, 영통구,075003, 72세,2018,1030,491,539,91.1,1017,485,532,91.2
31014, 영통구,075004, 73세,2018,972,430,542,79.3,966,428,538,79.6
31014, 영통구,075005, 74세,2018,947,389,558,69.7,941,387,554,69.9
31014, 영통구,080,75~79세,2018,4393,1777,2616,67.9,4371,1772,2599,68.2
31014, 영통구,080001, 75세,2018,952,390,562,69.4,946,389,557,69.8
31014, 영통구,080002, 76세,2018,1067,446,621,71.8,1064,445,619,71.9
31014, 영통구,080003, 77세,2018,888,347,541,64.1,881,346,535,64.7
31014, 영통구,080004, 78세,2018,766,325,441,73.7,763,324,439,73.8
31014, 영통구,080005, 79세,2018,720,269,451,59.6,717,268,449,59.7
31014, 영통구,085,80~84세,2018,2802,957,1845,51.9,2783,952,1831,52
31014, 영통구,085001, 80세,2018,689,252,437,57.7,687,251,436,57.6
31014, 영통구,085002, 81세,2018,613,214,399,53.6,607,213,394,54.1
31014, 영통구,085003, 82세,2018,538,181,357,50.7,535,180,355,50.7
31014, 영통구,085004, 83세,2018,525,170,355,47.9,520,168,352,47.7
31014, 영통구,085005, 84세,2018,437,140,297,47.1,434,140,294,47.6
31014, 영통구,090,85~89세,2018,1328,383,945,40.5,1320,381,939,40.6
31014, 영통구,090001, 85세,2018,358,109,249,43.8,354,108,246,43.9
31014, 영통구,090002, 86세,2018,313,97,216,44.9,310,96,214,44.9
31014, 영통구,090003, 87세,2018,231,61,170,35.9,231,61,170,35.9
31014, 영통구,090004, 88세,2018,239,59,180,32.8,238,59,179,33
31014, 영통구,090005, 89세,2018,187,57,130,43.8,187,57,130,43.8
31014, 영통구,095,90~94세,2018,455,104,351,29.6,454,104,350,29.7
31014, 영통구,095001, 90세,2018,155,32,123,26,155,32,123,26
31014, 영통구,095002, 91세,2018,116,35,81,43.2,116,35,81,43.2
31014, 영통구,095003, 92세,2018,82,12,70,17.1,81,12,69,17.4
31014, 영통구,095004, 93세,2018,58,17,41,41.5,58,17,41,41.5
31014, 영통구,095005, 94세,2018,44,8,36,22.2,44,8,36,22.2
31014, 영통구,100,95~99세,2018,106,25,81,30.9,106,25,81,30.9
31014, 영통구,100001, 95세,2018,39,10,29,34.5,39,10,29,34.5
31014, 영통구,100002, 96세,2018,31,6,25,24,31,6,25,24
31014, 영통구,100003, 97세,2018,14,X,10,40,14,X,10,40
31014, 영통구,100004, 98세,2018,13,X,10,30,13,X,10,30
31014, 영통구,100005, 99세,2018,9,X,7,28.6,9,X,7,28.6
31014, 영통구,101,100세이상,2018,10,X,9,11.1,10,X,9,11.1
31014, 영통구,102,15세미만,2018,58462,30065,28397,105.9,57751,29696,28055,105.8
31014, 영통구,103,15~64세,2018,275012,140432,134580,104.3,266828,135919,130909,103.8
31014, 영통구,104,65세이상,2018,22517,9541,12976,73.5,22230,9434,12796,73.7
31014, 영통구,086,85세이상,2018,1899,513,1386,37,1890,511,1379,37.1
31014, 영통구,126,평균연령,2018,35.9,35.3,36.6,,35.9,35.3,36.6,
31014, 영통구,127,중위연령,2018,36.2,35.4,36.9,,36.3,35.6,37.1,
31020, 성남시,000,합계,2018,931393,461018,470375,98,905995,448306,457689,97.9
31020, 성남시,005,0~4세,2018,34651,17758,16893,105.1,34074,17467,16607,105.2
31020, 성남시,005001, 0세,2018,6114,3137,2977,105.4,6015,3083,2932,105.2
31020, 성남시,005002, 1세,2018,6407,3321,3086,107.6,6279,3266,3013,108.4
31020, 성남시,005003, 2세,2018,7100,3622,3478,104.1,6967,3550,3417,103.9
31020, 성남시,005004, 3세,2018,7513,3875,3638,106.5,7409,3820,3589,106.4
31020, 성남시,005005, 4세,2018,7517,3803,3714,102.4,7404,3748,3656,102.5
31020, 성남시,010,5~9세,2018,39532,20351,19181,106.1,39172,20172,19000,106.2
31020, 성남시,010001, 5세,2018,7640,3901,3739,104.3,7543,3855,3688,104.5
31020, 성남시,010002, 6세,2018,8072,4213,3859,109.2,7992,4177,3815,109.5
31020, 성남시,010003, 7세,2018,8108,4216,3892,108.3,8048,4187,3861,108.4
31020, 성남시,010004, 8세,2018,7922,4047,3875,104.4,7862,4017,3845,104.5
31020, 성남시,010005, 9세,2018,7790,3974,3816,104.1,7727,3936,3791,103.8
31020, 성남시,015,10~14세,2018,40961,21102,19859,106.3,40701,20973,19728,106.3
31020, 성남시,015001, 10세,2018,8114,4167,3947,105.6,8065,4143,3922,105.6
31020, 성남시,015002, 11세,2018,8509,4443,4066,109.3,8450,4414,4036,109.4
31020, 성남시,015003, 12세,2018,7787,3975,3812,104.3,7739,3948,3791,104.1
31020, 성남시,015004, 13세,2018,7792,3980,3812,104.4,7743,3958,3785,104.6
31020, 성남시,015005, 14세,2018,8759,4537,4222,107.5,8704,4510,4194,107.5
31020, 성남시,020,15~19세,2018,48871,24858,24013,103.5,48362,24599,23763,103.5
31020, 성남시,020001, 15세,2018,8679,4510,4169,108.2,8641,4491,4150,108.2
31020, 성남시,020002, 16세,2018,8631,4464,4167,107.1,8586,4440,4146,107.1
31020, 성남시,020003, 17세,2018,10168,5178,4990,103.8,10098,5148,4950,104
31020, 성남시,020004, 18세,2018,11025,5459,5566,98.1,10917,5411,5506,98.3
31020, 성남시,020005, 19세,2018,10368,5247,5121,102.5,10120,5109,5011,102
31020, 성남시,025,20~24세,2018,58837,30124,28713,104.9,57012,29194,27818,104.9
31020, 성남시,025001, 20세,2018,10836,5604,5232,107.1,10517,5419,5098,106.3
31020, 성남시,025002, 21세,2018,11169,5837,5332,109.5,10868,5692,5176,110
31020, 성남시,025003, 22세,2018,11780,6150,5630,109.2,11420,5964,5456,109.3
31020, 성남시,025004, 23세,2018,12036,6066,5970,101.6,11621,5861,5760,101.8
31020, 성남시,025005, 24세,2018,13016,6467,6549,98.7,12586,6258,6328,98.9
31020, 성남시,030,25~29세,2018,68293,34929,33364,104.7,65775,33660,32115,104.8
31020, 성남시,030001, 25세,2018,13366,6859,6507,105.4,12912,6625,6287,105.4
31020, 성남시,030002, 26세,2018,14445,7362,7083,103.9,13963,7121,6842,104.1
31020, 성남시,030003, 27세,2018,13916,7089,6827,103.8,13444,6854,6590,104
31020, 성남시,030004, 28세,2018,13315,6832,6483,105.4,12764,6552,6212,105.5
31020, 성남시,030005, 29세,2018,13251,6787,6464,105,12692,6508,6184,105.2
31020, 성남시,035,30~34세,2018,66216,33688,32528,103.6,63296,32167,31129,103.3
31020, 성남시,035001, 30세,2018,13120,6667,6453,103.3,12493,6365,6128,103.9
31020, 성남시,035002, 31세,2018,13114,6697,6417,104.4,12472,6345,6127,103.6
31020, 성남시,035003, 32세,2018,12941,6552,6389,102.6,12376,6250,6126,102
31020, 성남시,035004, 33세,2018,13395,6811,6584,103.4,12859,6539,6320,103.5
31020, 성남시,035005, 34세,2018,13646,6961,6685,104.1,13096,6668,6428,103.7
31020, 성남시,040,35~39세,2018,76955,38740,38215,101.4,74706,37512,37194,100.9
31020, 성남시,040001, 35세,2018,14679,7453,7226,103.1,14216,7196,7020,102.5
31020, 성남시,040002, 36세,2018,15644,7930,7714,102.8,15123,7659,7464,102.6
31020, 성남시,040003, 37세,2018,15607,7917,7690,103,15196,7683,7513,102.3
31020, 성남시,040004, 38세,2018,15886,7908,7978,99.1,15458,7670,7788,98.5
31020, 성남시,040005, 39세,2018,15139,7532,7607,99,14713,7304,7409,98.6
31020, 성남시,045,40~44세,2018,73346,36370,36976,98.4,71392,35298,36094,97.8
31020, 성남시,045001, 40세,2018,13720,6727,6993,96.2,13319,6514,6805,95.7
31020, 성남시,045002, 41세,2018,14345,7184,7161,100.3,13967,6984,6983,100
31020, 성남시,045003, 42세,2018,14188,7147,7041,101.5,13811,6930,6881,100.7
31020, 성남시,045004, 43세,2018,14888,7345,7543,97.4,14496,7121,7375,96.6
31020, 성남시,045005, 44세,2018,16205,7967,8238,96.7,15799,7749,8050,96.3
31020, 성남시,050,45~49세,2018,88376,44050,44326,99.4,85597,42608,42989,99.1
31020, 성남시,050001, 45세,2018,16773,8171,8602,95,16318,7936,8382,94.7
31020, 성남시,050002, 46세,2018,17332,8636,8696,99.3,16799,8353,8446,98.9
31020, 성남시,050003, 47세,2018,18572,9378,9194,102,17972,9047,8925,101.4
31020, 성남시,050004, 48세,2018,17934,9079,8855,102.5,17338,8779,8559,102.6
31020, 성남시,050005, 49세,2018,17765,8786,8979,97.9,17170,8493,8677,97.9
31020, 성남시,055,50~54세,2018,78398,38967,39431,98.8,75430,37540,37890,99.1
31020, 성남시,055001, 50세,2018,17016,8369,8647,96.8,16412,8069,8343,96.7
31020, 성남시,055002, 51세,2018,15746,7824,7922,98.8,15213,7561,7652,98.8
31020, 성남시,055003, 52세,2018,15141,7664,7477,102.5,14551,7394,7157,103.3
31020, 성남시,055004, 53세,2018,15542,7711,7831,98.5,14916,7406,7510,98.6
31020, 성남시,055005, 54세,2018,14953,7399,7554,97.9,14338,7110,7228,98.4
31020, 성남시,060,55~59세,2018,78294,38444,39850,96.5,75535,37181,38354,96.9
31020, 성남시,060001, 55세,2018,15710,7850,7860,99.9,14890,7462,7428,100.5
31020, 성남시,060002, 56세,2018,15300,7602,7698,98.8,14691,7320,7371,99.3
31020, 성남시,060003, 57세,2018,16449,7913,8536,92.7,16086,7745,8341,92.9
31020, 성남시,060004, 58세,2018,16325,7958,8367,95.1,15769,7714,8055,95.8
31020, 성남시,060005, 59세,2018,14510,7121,7389,96.4,14099,6940,7159,96.9
31020, 성남시,065,60~64세,2018,61564,30503,31061,98.2,59444,29455,29989,98.2
31020, 성남시,065001, 60세,2018,13772,7034,6738,104.4,13286,6790,6496,104.5
31020, 성남시,065002, 61세,2018,13442,6747,6695,100.8,12917,6494,6423,101.1
31020, 성남시,065003, 62세,2018,12064,5892,6172,95.5,11622,5677,5945,95.5
31020, 성남시,065004, 63세,2018,12200,5970,6230,95.8,11841,5782,6059,95.4
31020, 성남시,065005, 64세,2018,10086,4860,5226,93,9778,4712,5066,93
31020, 성남시,070,65~69세,2018,39202,18805,20397,92.2,38214,18359,19855,92.5
31020, 성남시,070001, 65세,2018,8783,4256,4527,94,8535,4140,4395,94.2
31020, 성남시,070002, 66세,2018,9305,4535,4770,95.1,9052,4420,4632,95.4
31020, 성남시,070003, 67세,2018,6521,3091,3430,90.1,6344,3021,3323,90.9
31020, 성남시,070004, 68세,2018,7144,3436,3708,92.7,6980,3353,3627,92.4
31020, 성남시,070005, 69세,2018,7449,3487,3962,88,7303,3425,3878,88.3
31020, 성남시,075,70~74세,2018,30118,13770,16348,84.2,29800,13639,16161,84.4
31020, 성남시,075001, 70세,2018,7017,3270,3747,87.3,6925,3227,3698,87.3
31020, 성남시,075002, 71세,2018,7257,3382,3875,87.3,7196,3352,3844,87.2
31020, 성남시,075003, 72세,2018,5430,2427,3003,80.8,5363,2405,2958,81.3
31020, 성남시,075004, 73세,2018,5281,2390,2891,82.7,5227,2369,2858,82.9
31020, 성남시,075005, 74세,2018,5133,2301,2832,81.3,5089,2286,2803,81.6
31020, 성남시,080,75~79세,2018,23574,10344,13230,78.2,23421,10299,13122,78.5
31020, 성남시,080001, 75세,2018,5108,2275,2833,80.3,5072,2268,2804,80.9
31020, 성남시,080002, 76세,2018,5835,2660,3175,83.8,5799,2643,3156,83.7
31020, 성남시,080003, 77세,2018,4551,2038,2513,81.1,4518,2027,2491,81.4
31020, 성남시,080004, 78세,2018,4125,1736,2389,72.7,4098,1728,2370,72.9
31020, 성남시,080005, 79세,2018,3955,1635,2320,70.5,3934,1633,2301,71
31020, 성남시,085,80~84세,2018,14308,5440,8868,61.3,14216,5417,8799,61.6
31020, 성남시,085001, 80세,2018,3502,1429,2073,68.9,3474,1421,2053,69.2
31020, 성남시,085002, 81세,2018,3182,1250,1932,64.7,3162,1245,1917,64.9
31020, 성남시,085003, 82세,2018,2859,1108,1751,63.3,2839,1100,1739,63.3
31020, 성남시,085004, 83세,2018,2582,926,1656,55.9,2570,925,1645,56.2
31020, 성남시,085005, 84세,2018,2183,727,1456,49.9,2171,726,1445,50.2
31020, 성남시,090,85~89세,2018,6833,2034,4799,42.4,6799,2025,4774,42.4
31020, 성남시,090001, 85세,2018,1770,556,1214,45.8,1757,550,1207,45.6
31020, 성남시,090002, 86세,2018,1613,500,1113,44.9,1602,498,1104,45.1
31020, 성남시,090003, 87세,2018,1232,357,875,40.8,1227,357,870,41
31020, 성남시,090004, 88세,2018,1212,336,876,38.4,1210,336,874,38.4
31020, 성남시,090005, 89세,2018,1006,285,721,39.5,1003,284,719,39.5
31020, 성남시,095,90~94세,2018,2416,579,1837,31.5,2408,579,1829,31.7
31020, 성남시,095001, 90세,2018,800,218,582,37.5,798,218,580,37.6
31020, 성남시,095002, 91세,2018,648,155,493,31.4,647,155,492,31.5
31020, 성남시,095003, 92세,2018,380,84,296,28.4,377,84,293,28.7
31020, 성남시,095004, 93세,2018,336,61,275,22.2,335,61,274,22.3
31020, 성남시,095005, 94세,2018,252,61,191,31.9,251,61,190,32.1
31020, 성남시,100,95~99세,2018,585,150,435,34.5,580,150,430,34.9
31020, 성남시,100001, 95세,2018,213,61,152,40.1,212,61,151,40.4
31020, 성남시,100002, 96세,2018,173,36,137,26.3,171,36,135,26.7
31020, 성남시,100003, 97세,2018,93,20,73,27.4,93,20,73,27.4
31020, 성남시,100004, 98세,2018,64,22,42,52.4,62,22,40,55
31020, 성남시,100005, 99세,2018,42,11,31,35.5,42,11,31,35.5
31020, 성남시,101,100세이상,2018,63,12,51,23.5,61,12,49,24.5
31020, 성남시,102,15세미만,2018,115144,59211,55933,105.9,113947,58612,55335,105.9
31020, 성남시,103,15~64세,2018,699150,350673,348477,100.6,676549,339214,337335,100.6
31020, 성남시,104,65세이상,2018,117099,51134,65965,77.5,115499,50480,65019,77.6
31020, 성남시,086,85세이상,2018,9897,2775,7122,39,9848,2766,7082,39.1
31020, 성남시,126,평균연령,2018,41.3,40.4,42.2,,41.3,40.4,42.2,
31020, 성남시,127,중위연령,2018,42.2,41.3,43.2,,42.2,41.3,43.1,
31021, 수정구,000,합계,2018,240405,121508,118897,102.2,225403,113898,111505,102.1
31021, 수정구,005,0~4세,2018,8347,4244,4103,103.4,8011,4084,3927,104
31021, 수정구,005001, 0세,2018,1518,785,733,107.1,1457,755,702,107.5
31021, 수정구,005002, 1세,2018,1603,814,789,103.2,1529,786,743,105.8
31021, 수정구,005003, 2세,2018,1706,882,824,107,1637,845,792,106.7
31021, 수정구,005004, 3세,2018,1745,866,879,98.5,1688,838,850,98.6
31021, 수정구,005005, 4세,2018,1775,897,878,102.2,1700,860,840,102.4
31021, 수정구,010,5~9세,2018,8358,4275,4083,104.7,8170,4183,3987,104.9
31021, 수정구,010001, 5세,2018,1691,873,818,106.7,1638,849,789,107.6
31021, 수정구,010002, 6세,2018,1691,874,817,107,1648,853,795,107.3
31021, 수정구,010003, 7세,2018,1740,897,843,106.4,1709,880,829,106.2
31021, 수정구,010004, 8세,2018,1728,860,868,99.1,1702,847,855,99.1
31021, 수정구,010005, 9세,2018,1508,771,737,104.6,1473,754,719,104.9
31021, 수정구,015,10~14세,2018,8015,4152,3863,107.5,7896,4106,3790,108.3
31021, 수정구,015001, 10세,2018,1618,830,788,105.3,1596,821,775,105.9
31021, 수정구,015002, 11세,2018,1716,899,817,110,1690,891,799,111.5
31021, 수정구,015003, 12세,2018,1484,756,728,103.8,1463,748,715,104.6
31021, 수정구,015004, 13세,2018,1510,767,743,103.2,1488,760,728,104.4
31021, 수정구,015005, 14세,2018,1687,900,787,114.4,1659,886,773,114.6
31021, 수정구,020,15~19세,2018,10778,5515,5263,104.8,10467,5357,5110,104.8
31021, 수정구,020001, 15세,2018,1646,837,809,103.5,1634,833,801,104
31021, 수정구,020002, 16세,2018,1677,876,801,109.4,1658,866,792,109.3
31021, 수정구,020003, 17세,2018,1988,1045,943,110.8,1958,1035,923,112.1
31021, 수정구,020004, 18세,2018,2367,1186,1181,100.4,2290,1153,1137,101.4
31021, 수정구,020005, 19세,2018,3100,1571,1529,102.7,2927,1470,1457,100.9
31021, 수정구,025,20~24세,2018,17013,8631,8382,103,15900,8078,7822,103.3
31021, 수정구,025001, 20세,2018,3158,1516,1642,92.3,2936,1392,1544,90.2
31021, 수정구,025002, 21세,2018,3245,1549,1696,91.3,3047,1468,1579,93
31021, 수정구,025003, 22세,2018,3390,1759,1631,107.8,3156,1644,1512,108.7
31021, 수정구,025004, 23세,2018,3489,1847,1642,112.5,3250,1726,1524,113.3
31021, 수정구,025005, 24세,2018,3731,1960,1771,110.7,3511,1848,1663,111.1
31021, 수정구,030,25~29세,2018,18229,9788,8441,116,17030,9166,7864,116.6
31021, 수정구,030001, 25세,2018,3736,1969,1767,111.4,3512,1853,1659,111.7
31021, 수정구,030002, 26세,2018,3927,2109,1818,116,3707,1994,1713,116.4
31021, 수정구,030003, 27세,2018,3692,1986,1706,116.4,3457,1865,1592,117.1
31021, 수정구,030004, 28세,2018,3470,1868,1602,116.6,3216,1737,1479,117.4
31021, 수정구,030005, 29세,2018,3404,1856,1548,119.9,3138,1717,1421,120.8
31021, 수정구,035,30~34세,2018,17154,9216,7938,116.1,15748,8469,7279,116.3
31021, 수정구,035001, 30세,2018,3387,1796,1591,112.9,3099,1649,1450,113.7
31021, 수정구,035002, 31세,2018,3430,1879,1551,121.1,3107,1700,1407,120.8
31021, 수정구,035003, 32세,2018,3331,1810,1521,119,3053,1656,1397,118.5
31021, 수정구,035004, 33세,2018,3469,1844,1625,113.5,3214,1717,1497,114.7
31021, 수정구,035005, 34세,2018,3537,1887,1650,114.4,3275,1747,1528,114.3
31021, 수정구,040,35~39세,2018,20045,10701,9344,114.5,18942,10061,8881,113.3
31021, 수정구,040001, 35세,2018,3831,2050,1781,115.1,3630,1928,1702,113.3
31021, 수정구,040002, 36세,2018,4167,2229,1938,115,3907,2088,1819,114.8
31021, 수정구,040003, 37세,2018,4089,2230,1859,120,3887,2113,1774,119.1
31021, 수정구,040004, 38세,2018,4107,2158,1949,110.7,3879,2021,1858,108.8
31021, 수정구,040005, 39세,2018,3851,2034,1817,111.9,3639,1911,1728,110.6
31021, 수정구,045,40~44세,2018,17789,9622,8167,117.8,16744,9011,7733,116.5
31021, 수정구,045001, 40세,2018,3447,1815,1632,111.2,3248,1707,1541,110.8
31021, 수정구,045002, 41세,2018,3579,1949,1630,119.6,3361,1824,1537,118.7
31021, 수정구,045003, 42세,2018,3361,1844,1517,121.6,3164,1723,1441,119.6
31021, 수정구,045004, 43세,2018,3667,1983,1684,117.8,3444,1848,1596,115.8
31021, 수정구,045005, 44세,2018,3735,2031,1704,119.2,3527,1909,1618,118
31021, 수정구,050,45~49세,2018,20992,10985,10007,109.8,19249,10080,9169,109.9
31021, 수정구,050001, 45세,2018,3968,2019,1949,103.6,3713,1893,1820,104
31021, 수정구,050002, 46세,2018,4135,2240,1895,118.2,3805,2069,1736,119.2
31021, 수정구,050003, 47세,2018,4363,2347,2016,116.4,3963,2114,1849,114.3
31021, 수정구,050004, 48세,2018,4264,2218,2046,108.4,3882,2025,1857,109
31021, 수정구,050005, 49세,2018,4262,2161,2101,102.9,3886,1979,1907,103.8
31021, 수정구,055,50~54세,2018,20546,10373,10173,102,18532,9389,9143,102.7
31021, 수정구,055001, 50세,2018,4224,2138,2086,102.5,3840,1944,1896,102.5
31021, 수정구,055002, 51세,2018,3984,2014,1970,102.2,3645,1838,1807,101.7
31021, 수정구,055003, 52세,2018,4054,2057,1997,103,3637,1863,1774,105
31021, 수정구,055004, 53세,2018,4131,2057,2074,99.2,3694,1847,1847,100
31021, 수정구,055005, 54세,2018,4153,2107,2046,103,3716,1897,1819,104.3
31021, 수정구,060,55~59세,2018,22059,10876,11183,97.3,20165,9981,10184,98
31021, 수정구,060001, 55세,2018,4469,2262,2207,102.5,3886,1977,1909,103.6
31021, 수정구,060002, 56세,2018,4289,2178,2111,103.2,3865,1972,1893,104.2
31021, 수정구,060003, 57세,2018,4500,2184,2316,94.3,4269,2070,2199,94.1
31021, 수정구,060004, 58세,2018,4693,2244,2449,91.6,4300,2067,2233,92.6
31021, 수정구,060005, 59세,2018,4108,2008,2100,95.6,3845,1895,1950,97.2
31021, 수정구,065,60~64세,2018,18050,8773,9277,94.6,16565,8022,8543,93.9
31021, 수정구,065001, 60세,2018,3973,1969,2004,98.3,3642,1795,1847,97.2
31021, 수정구,065002, 61세,2018,3853,1874,1979,94.7,3483,1690,1793,94.3
31021, 수정구,065003, 62세,2018,3599,1750,1849,94.6,3283,1600,1683,95.1
31021, 수정구,065004, 63세,2018,3534,1717,1817,94.5,3285,1580,1705,92.7
31021, 수정구,065005, 64세,2018,3091,1463,1628,89.9,2872,1357,1515,89.6
31021, 수정구,070,65~69세,2018,11946,5663,6283,90.1,11268,5341,5927,90.1
31021, 수정구,070001, 65세,2018,2666,1271,1395,91.1,2493,1184,1309,90.5
31021, 수정구,070002, 66세,2018,2815,1335,1480,90.2,2636,1250,1386,90.2
31021, 수정구,070003, 67세,2018,2055,979,1076,91,1918,920,998,92.2
31021, 수정구,070004, 68세,2018,2148,1024,1124,91.1,2048,973,1075,90.5
31021, 수정구,070005, 69세,2018,2262,1054,1208,87.3,2173,1014,1159,87.5
31021, 수정구,075,70~74세,2018,8692,3959,4733,83.6,8500,3875,4625,83.8
31021, 수정구,075001, 70세,2018,2096,986,1110,88.8,2038,954,1084,88
31021, 수정구,075002, 71세,2018,2072,965,1107,87.2,2037,945,1092,86.5
31021, 수정구,075003, 72세,2018,1566,701,865,81,1526,688,838,82.1
31021, 수정구,075004, 73세,2018,1493,655,838,78.2,1461,644,817,78.8
31021, 수정구,075005, 74세,2018,1465,652,813,80.2,1438,644,794,81.1
31021, 수정구,080,75~79세,2018,6717,2915,3802,76.7,6624,2896,3728,77.7
31021, 수정구,080001, 75세,2018,1503,648,855,75.8,1485,645,840,76.8
31021, 수정구,080002, 76세,2018,1700,780,920,84.8,1676,771,905,85.2
31021, 수정구,080003, 77세,2018,1263,550,713,77.1,1241,546,695,78.6
31021, 수정구,080004, 78세,2018,1132,477,655,72.8,1120,475,645,73.6
31021, 수정구,080005, 79세,2018,1119,460,659,69.8,1102,459,643,71.4
31021, 수정구,085,80~84세,2018,3539,1304,2235,58.3,3477,1286,2191,58.7
31021, 수정구,085001, 80세,2018,945,374,571,65.5,925,368,557,66.1
31021, 수정구,085002, 81세,2018,739,298,441,67.6,729,295,434,68
31021, 수정구,085003, 82세,2018,711,259,452,57.3,695,251,444,56.5
31021, 수정구,085004, 83세,2018,643,205,438,46.8,635,205,430,47.7
31021, 수정구,085005, 84세,2018,501,168,333,50.5,493,167,326,51.2
31021, 수정구,090,85~89세,2018,1496,388,1108,35,1478,385,1093,35.2
31021, 수정구,090001, 85세,2018,424,130,294,44.2,418,127,291,43.6
31021, 수정구,090002, 86세,2018,344,90,254,35.4,337,90,247,36.4
31021, 수정구,090003, 87세,2018,246,61,185,33,243,61,182,33.5
31021, 수정구,090004, 88세,2018,264,62,202,30.7,263,62,201,30.8
31021, 수정구,090005, 89세,2018,218,45,173,26,217,45,172,26.2
31021, 수정구,095,90~94세,2018,506,107,399,26.8,504,107,397,27
31021, 수정구,095001, 90세,2018,159,33,126,26.2,159,33,126,26.2
31021, 수정구,095002, 91세,2018,139,30,109,27.5,139,30,109,27.5
31021, 수정구,095003, 92세,2018,84,20,64,31.3,82,20,62,32.3
31021, 수정구,095004, 93세,2018,75,14,61,23,75,14,61,23
31021, 수정구,095005, 94세,2018,49,10,39,25.6,49,10,39,25.6
31021, 수정구,100,95~99세,2018,116,18,98,18.4,115,18,97,18.6
31021, 수정구,100001, 95세,2018,47,6,41,14.6,47,6,41,14.6
31021, 수정구,100002, 96세,2018,29,X,26,11.5,29,X,26,11.5
31021, 수정구,100003, 97세,2018,20,X,16,25,20,X,16,25
31021, 수정구,100004, 98세,2018,18,5,13,38.5,17,5,12,41.7
31021, 수정구,100005, 99세,2018,X,X,X,0,X,X,X,0
31021, 수정구,101,100세이상,2018,18,X,15,20,18,X,15,20
31021, 수정구,102,15세미만,2018,24720,12671,12049,105.2,24077,12373,11704,105.7
31021, 수정구,103,15~64세,2018,182655,94480,88175,107.2,169342,87614,81728,107.2
31021, 수정구,104,65세이상,2018,33030,14357,18673,76.9,31984,13911,18073,77
31021, 수정구,086,85세이상,2018,2136,516,1620,31.9,2115,513,1602,32
31021, 수정구,126,평균연령,2018,42.6,41.6,43.6,,42.5,41.4,43.5,
31021, 수정구,127,중위연령,2018,43.5,42.3,44.9,,43.2,42,44.6,
31022, 중원구,000,합계,2018,221034,111506,109528,101.8,216448,109288,107160,102
31022, 중원구,005,0~4세,2018,7408,3830,3578,107,7342,3790,3552,106.7
31022, 중원구,005001, 0세,2018,1295,653,642,101.7,1279,642,637,100.8
31022, 중원구,005002, 1세,2018,1431,781,650,120.2,1419,777,642,121
31022, 중원구,005003, 2세,2018,1514,753,761,98.9,1501,744,757,98.3
31022, 중원구,005004, 3세,2018,1610,845,765,110.5,1598,837,761,110
31022, 중원구,005005, 4세,2018,1558,798,760,105,1545,790,755,104.6
31022, 중원구,010,5~9세,2018,7978,4113,3865,106.4,7933,4090,3843,106.4
31022, 중원구,010001, 5세,2018,1542,788,754,104.5,1529,783,746,105
31022, 중원구,010002, 6세,2018,1680,884,796,111.1,1666,876,790,110.9
31022, 중원구,010003, 7세,2018,1641,879,762,115.4,1637,878,759,115.7
31022, 중원구,010004, 8세,2018,1544,805,739,108.9,1536,801,735,109
31022, 중원구,010005, 9세,2018,1571,757,814,93,1565,752,813,92.5
31022, 중원구,015,10~14세,2018,8103,4151,3952,105,8061,4129,3932,105
31022, 중원구,015001, 10세,2018,1614,865,749,115.5,1606,861,745,115.6
31022, 중원구,015002, 11세,2018,1744,861,883,97.5,1731,854,877,97.4
31022, 중원구,015003, 12세,2018,1505,767,738,103.9,1500,764,736,103.8
31022, 중원구,015004, 13세,2018,1545,769,776,99.1,1537,765,772,99.1
31022, 중원구,015005, 14세,2018,1695,889,806,110.3,1687,885,802,110.3
31022, 중원구,020,15~19세,2018,10439,5339,5100,104.7,10393,5321,5072,104.9
31022, 중원구,020001, 15세,2018,1779,962,817,117.7,1774,960,814,117.9
31022, 중원구,020002, 16세,2018,1814,928,886,104.7,1812,927,885,104.7
31022, 중원구,020003, 17세,2018,2120,1118,1002,111.6,2112,1113,999,111.4
31022, 중원구,020004, 18세,2018,2359,1147,1212,94.6,2345,1140,1205,94.6
31022, 중원구,020005, 19세,2018,2367,1184,1183,100.1,2350,1181,1169,101
31022, 중원구,025,20~24세,2018,14430,7403,7027,105.4,14193,7293,6900,105.7
31022, 중원구,025001, 20세,2018,2476,1265,1211,104.5,2446,1252,1194,104.9
31022, 중원구,025002, 21세,2018,2677,1372,1305,105.1,2639,1354,1285,105.4
31022, 중원구,025003, 22세,2018,2933,1519,1414,107.4,2894,1501,1393,107.8
31022, 중원구,025004, 23세,2018,3076,1581,1495,105.8,3010,1549,1461,106
31022, 중원구,025005, 24세,2018,3268,1666,1602,104,3204,1637,1567,104.5
31022, 중원구,030,25~29세,2018,17061,9046,8015,112.9,16576,8805,7771,113.3
31022, 중원구,030001, 25세,2018,3390,1806,1584,114,3316,1765,1551,113.8
31022, 중원구,030002, 26세,2018,3660,1932,1728,111.8,3555,1878,1677,112
31022, 중원구,030003, 27세,2018,3492,1834,1658,110.6,3412,1790,1622,110.4
31022, 중원구,030004, 28세,2018,3307,1769,1538,115,3186,1713,1473,116.3
31022, 중원구,030005, 29세,2018,3212,1705,1507,113.1,3107,1659,1448,114.6
31022, 중원구,035,30~34세,2018,15636,8335,7301,114.2,15035,8045,6990,115.1
31022, 중원구,035001, 30세,2018,3127,1696,1431,118.5,2981,1633,1348,121.1
31022, 중원구,035002, 31세,2018,3130,1685,1445,116.6,2995,1609,1386,116.1
31022, 중원구,035003, 32세,2018,2965,1582,1383,114.4,2858,1529,1329,115
31022, 중원구,035004, 33세,2018,3123,1641,1482,110.7,3016,1590,1426,111.5
31022, 중원구,035005, 34세,2018,3291,1731,1560,111,3185,1684,1501,112.2
31022, 중원구,040,35~39세,2018,17898,9424,8474,111.2,17436,9209,8227,111.9
31022, 중원구,040001, 35세,2018,3567,1902,1665,114.2,3461,1851,1610,115
31022, 중원구,040002, 36세,2018,3668,1921,1747,110,3559,1869,1690,110.6
31022, 중원구,040003, 37세,2018,3552,1859,1693,109.8,3470,1818,1652,110
31022, 중원구,040004, 38세,2018,3643,1915,1728,110.8,3564,1885,1679,112.3
31022, 중원구,040005, 39세,2018,3468,1827,1641,111.3,3382,1786,1596,111.9
31022, 중원구,045,40~44세,2018,16077,8494,7583,112,15701,8300,7401,112.1
31022, 중원구,045001, 40세,2018,3055,1636,1419,115.3,2976,1591,1385,114.9
31022, 중원구,045002, 41세,2018,3134,1674,1460,114.7,3066,1644,1422,115.6
31022, 중원구,045003, 42세,2018,3082,1668,1414,118,3008,1626,1382,117.7
31022, 중원구,045004, 43세,2018,3216,1657,1559,106.3,3142,1622,1520,106.7
31022, 중원구,045005, 44세,2018,3590,1859,1731,107.4,3509,1817,1692,107.4
31022, 중원구,050,45~49세,2018,19282,9991,9291,107.5,18786,9739,9047,107.6
31022, 중원구,050001, 45세,2018,3693,1921,1772,108.4,3604,1877,1727,108.7
31022, 중원구,050002, 46세,2018,3788,2026,1762,115,3697,1977,1720,114.9
31022, 중원구,050003, 47세,2018,3982,2100,1882,111.6,3890,2057,1833,112.2
31022, 중원구,050004, 48세,2018,3861,1984,1877,105.7,3750,1924,1826,105.4
31022, 중원구,050005, 49세,2018,3958,1960,1998,98.1,3845,1904,1941,98.1
31022, 중원구,055,50~54세,2018,19282,9597,9685,99.1,18743,9344,9399,99.4
31022, 중원구,055001, 50세,2018,4025,2039,1986,102.7,3908,1988,1920,103.5
31022, 중원구,055002, 51세,2018,3878,1941,1937,100.2,3778,1888,1890,99.9
31022, 중원구,055003, 52세,2018,3811,1884,1927,97.8,3707,1840,1867,98.6
31022, 중원구,055004, 53세,2018,3904,1950,1954,99.8,3797,1894,1903,99.5
31022, 중원구,055005, 54세,2018,3664,1783,1881,94.8,3553,1734,1819,95.3
31022, 중원구,060,55~59세,2018,20860,10301,10559,97.6,20359,10066,10293,97.8
31022, 중원구,060001, 55세,2018,3893,1987,1906,104.2,3755,1922,1833,104.9
31022, 중원구,060002, 56세,2018,4123,2034,2089,97.4,4017,1989,2028,98.1
31022, 중원구,060003, 57세,2018,4473,2111,2362,89.4,4414,2082,2332,89.3
31022, 중원구,060004, 58세,2018,4511,2253,2258,99.8,4400,2199,2201,99.9
31022, 중원구,060005, 59세,2018,3860,1916,1944,98.6,3773,1874,1899,98.7
31022, 중원구,065,60~64세,2018,16621,8313,8308,100.1,16255,8124,8131,99.9
31022, 중원구,065001, 60세,2018,3768,1947,1821,106.9,3675,1900,1775,107
31022, 중원구,065002, 61세,2018,3635,1886,1749,107.8,3544,1837,1707,107.6
31022, 중원구,065003, 62세,2018,3204,1572,1632,96.3,3129,1529,1600,95.6
31022, 중원구,065004, 63세,2018,3296,1573,1723,91.3,3241,1548,1693,91.4
31022, 중원구,065005, 64세,2018,2718,1335,1383,96.5,2666,1310,1356,96.6
31022, 중원구,070,65~69세,2018,10644,5200,5444,95.5,10446,5108,5338,95.7
31022, 중원구,070001, 65세,2018,2299,1127,1172,96.2,2252,1105,1147,96.3
31022, 중원구,070002, 66세,2018,2567,1262,1305,96.7,2514,1239,1275,97.2
31022, 중원구,070003, 67세,2018,1820,852,968,88,1791,844,947,89.1
31022, 중원구,070004, 68세,2018,1949,971,978,99.3,1913,947,966,98
31022, 중원구,070005, 69세,2018,2009,988,1021,96.8,1976,973,1003,97
31022, 중원구,075,70~74세,2018,7918,3679,4239,86.8,7852,3650,4202,86.9
31022, 중원구,075001, 70세,2018,1873,904,969,93.3,1854,896,958,93.5
31022, 중원구,075002, 71세,2018,1948,926,1022,90.6,1932,918,1014,90.5
31022, 중원구,075003, 72세,2018,1404,646,758,85.2,1387,639,748,85.4
31022, 중원구,075004, 73세,2018,1388,645,743,86.8,1379,640,739,86.6
31022, 중원구,075005, 74세,2018,1305,558,747,74.7,1300,557,743,75
31022, 중원구,080,75~79세,2018,5988,2602,3386,76.8,5953,2591,3362,77.1
31022, 중원구,080001, 75세,2018,1315,608,707,86,1305,607,698,87
31022, 중원구,080002, 76세,2018,1555,687,868,79.1,1549,684,865,79.1
31022, 중원구,080003, 77세,2018,1149,508,641,79.3,1143,505,638,79.2
31022, 중원구,080004, 78세,2018,1026,423,603,70.1,1016,419,597,70.2
31022, 중원구,080005, 79세,2018,943,376,567,66.3,940,376,564,66.7
31022, 중원구,085,80~84세,2018,3347,1212,2135,56.8,3331,1211,2120,57.1
31022, 중원구,085001, 80세,2018,831,315,516,61,828,315,513,61.4
31022, 중원구,085002, 81세,2018,781,277,504,55,773,276,497,55.5
31022, 중원구,085003, 82세,2018,659,257,402,63.9,658,257,401,64.1
31022, 중원구,085004, 83세,2018,564,201,363,55.4,561,201,360,55.8
31022, 중원구,085005, 84세,2018,512,162,350,46.3,511,162,349,46.4
31022, 중원구,090,85~89세,2018,1417,360,1057,34.1,1411,357,1054,33.9
31022, 중원구,090001, 85세,2018,364,95,269,35.3,361,93,268,34.7
31022, 중원구,090002, 86세,2018,351,101,250,40.4,350,100,250,40
31022, 중원구,090003, 87세,2018,256,57,199,28.6,255,57,198,28.8
31022, 중원구,090004, 88세,2018,251,61,190,32.1,251,61,190,32.1
31022, 중원구,090005, 89세,2018,195,46,149,30.9,194,46,148,31.1
31022, 중원구,095,90~94세,2018,502,95,407,23.3,500,95,405,23.5
31022, 중원구,095001, 90세,2018,157,35,122,28.7,157,35,122,28.7
31022, 중원구,095002, 91세,2018,132,26,106,24.5,131,26,105,24.8
31022, 중원구,095003, 92세,2018,80,14,66,21.2,80,14,66,21.2
31022, 중원구,095004, 93세,2018,79,9,70,12.9,79,9,70,12.9
31022, 중원구,095005, 94세,2018,54,11,43,25.6,53,11,42,26.2
31022, 중원구,100,95~99세,2018,130,19,111,17.1,129,19,110,17.3
31022, 중원구,100001, 95세,2018,47,10,37,27,47,10,37,27
31022, 중원구,100002, 96세,2018,39,X,35,11.4,39,X,35,11.4
31022, 중원구,100003, 97세,2018,18,X,17,5.9,18,X,17,5.9
31022, 중원구,100004, 98세,2018,18,X,14,28.6,17,X,13,30.8
31022, 중원구,100005, 99세,2018,8,X,8,0,8,X,8,0
31022, 중원구,101,100세이상,2018,13,X,11,18.2,13,X,11,18.2
31022, 중원구,102,15세미만,2018,23489,12094,11395,106.1,23336,12009,11327,106
31022, 중원구,103,15~64세,2018,167586,86243,81343,106,163477,84246,79231,106.3
31022, 중원구,104,65세이상,2018,29959,13169,16790,78.4,29635,13033,16602,78.5
31022, 중원구,086,85세이상,2018,2062,476,1586,30,2053,473,1580,29.9
31022, 중원구,126,평균연령,2018,42.5,41.6,43.5,,42.5,41.5,43.5,
31022, 중원구,127,중위연령,2018,43.7,42.5,44.9,,43.7,42.4,44.9,
31023, 분당구,000,합계,2018,469954,228004,241950,94.2,464144,225120,239024,94.2
31023, 분당구,005,0~4세,2018,18896,9684,9212,105.1,18721,9593,9128,105.1
31023, 분당구,005001, 0세,2018,3301,1699,1602,106.1,3279,1686,1593,105.8
31023, 분당구,005002, 1세,2018,3373,1726,1647,104.8,3331,1703,1628,104.6
31023, 분당구,005003, 2세,2018,3880,1987,1893,105,3829,1961,1868,105
31023, 분당구,005004, 3세,2018,4158,2164,1994,108.5,4123,2145,1978,108.4
31023, 분당구,005005, 4세,2018,4184,2108,2076,101.5,4159,2098,2061,101.8
31023, 분당구,010,5~9세,2018,23196,11963,11233,106.5,23069,11899,11170,106.5
31023, 분당구,010001, 5세,2018,4407,2240,2167,103.4,4376,2223,2153,103.3
31023, 분당구,010002, 6세,2018,4701,2455,2246,109.3,4678,2448,2230,109.8
31023, 분당구,010003, 7세,2018,4727,2440,2287,106.7,4702,2429,2273,106.9
31023, 분당구,010004, 8세,2018,4650,2382,2268,105,4624,2369,2255,105.1
31023, 분당구,010005, 9세,2018,4711,2446,2265,108,4689,2430,2259,107.6
31023, 분당구,015,10~14세,2018,24843,12799,12044,106.3,24744,12738,12006,106.1
31023, 분당구,015001, 10세,2018,4882,2472,2410,102.6,4863,2461,2402,102.5
31023, 분당구,015002, 11세,2018,5049,2683,2366,113.4,5029,2669,2360,113.1
31023, 분당구,015003, 12세,2018,4798,2452,2346,104.5,4776,2436,2340,104.1
31023, 분당구,015004, 13세,2018,4737,2444,2293,106.6,4718,2433,2285,106.5
31023, 분당구,015005, 14세,2018,5377,2748,2629,104.5,5358,2739,2619,104.6
31023, 분당구,020,15~19세,2018,27654,14004,13650,102.6,27502,13921,13581,102.5
31023, 분당구,020001, 15세,2018,5254,2711,2543,106.6,5233,2698,2535,106.4
31023, 분당구,020002, 16세,2018,5140,2660,2480,107.3,5116,2647,2469,107.2
31023, 분당구,020003, 17세,2018,6060,3015,3045,99,6028,3000,3028,99.1
31023, 분당구,020004, 18세,2018,6299,3126,3173,98.5,6282,3118,3164,98.5
31023, 분당구,020005, 19세,2018,4901,2492,2409,103.4,4843,2458,2385,103.1
31023, 분당구,025,20~24세,2018,27394,14090,13304,105.9,26919,13823,13096,105.6
31023, 분당구,025001, 20세,2018,5202,2823,2379,118.7,5135,2775,2360,117.6
31023, 분당구,025002, 21세,2018,5247,2916,2331,125.1,5182,2870,2312,124.1
31023, 분당구,025003, 22세,2018,5457,2872,2585,111.1,5370,2819,2551,110.5
31023, 분당구,025004, 23세,2018,5471,2638,2833,93.1,5361,2586,2775,93.2
31023, 분당구,025005, 24세,2018,6017,2841,3176,89.5,5871,2773,3098,89.5
31023, 분당구,030,25~29세,2018,33003,16095,16908,95.2,32169,15689,16480,95.2
31023, 분당구,030001, 25세,2018,6240,3084,3156,97.7,6084,3007,3077,97.7
31023, 분당구,030002, 26세,2018,6858,3321,3537,93.9,6701,3249,3452,94.1
31023, 분당구,030003, 27세,2018,6732,3269,3463,94.4,6575,3199,3376,94.8
31023, 분당구,030004, 28세,2018,6538,3195,3343,95.6,6362,3102,3260,95.2
31023, 분당구,030005, 29세,2018,6635,3226,3409,94.6,6447,3132,3315,94.5
31023, 분당구,035,30~34세,2018,33426,16137,17289,93.3,32513,15653,16860,92.8
31023, 분당구,035001, 30세,2018,6606,3175,3431,92.5,6413,3083,3330,92.6
31023, 분당구,035002, 31세,2018,6554,3133,3421,91.6,6370,3036,3334,91.1
31023, 분당구,035003, 32세,2018,6645,3160,3485,90.7,6465,3065,3400,90.1
31023, 분당구,035004, 33세,2018,6803,3326,3477,95.7,6629,3232,3397,95.1
31023, 분당구,035005, 34세,2018,6818,3343,3475,96.2,6636,3237,3399,95.2
31023, 분당구,040,35~39세,2018,39012,18615,20397,91.3,38328,18242,20086,90.8
31023, 분당구,040001, 35세,2018,7281,3501,3780,92.6,7125,3417,3708,92.2
31023, 분당구,040002, 36세,2018,7809,3780,4029,93.8,7657,3702,3955,93.6
31023, 분당구,040003, 37세,2018,7966,3828,4138,92.5,7839,3752,4087,91.8
31023, 분당구,040004, 38세,2018,8136,3835,4301,89.2,8015,3764,4251,88.5
31023, 분당구,040005, 39세,2018,7820,3671,4149,88.5,7692,3607,4085,88.3
31023, 분당구,045,40~44세,2018,39480,18254,21226,86,38947,17987,20960,85.8
31023, 분당구,045001, 40세,2018,7218,3276,3942,83.1,7095,3216,3879,82.9
31023, 분당구,045002, 41세,2018,7632,3561,4071,87.5,7540,3516,4024,87.4
31023, 분당구,045003, 42세,2018,7745,3635,4110,88.4,7639,3581,4058,88.2
31023, 분당구,045004, 43세,2018,8005,3705,4300,86.2,7910,3651,4259,85.7
31023, 분당구,045005, 44세,2018,8880,4077,4803,84.9,8763,4023,4740,84.9
31023, 분당구,050,45~49세,2018,48102,23074,25028,92.2,47562,22789,24773,92
31023, 분당구,050001, 45세,2018,9112,4231,4881,86.7,9001,4166,4835,86.2
31023, 분당구,050002, 46세,2018,9409,4370,5039,86.7,9297,4307,4990,86.3
31023, 분당구,050003, 47세,2018,10227,4931,5296,93.1,10119,4876,5243,93
31023, 분당구,050004, 48세,2018,9809,4877,4932,98.9,9706,4830,4876,99.1
31023, 분당구,050005, 49세,2018,9545,4665,4880,95.6,9439,4610,4829,95.5
31023, 분당구,055,50~54세,2018,38570,18997,19573,97.1,38155,18807,19348,97.2
31023, 분당구,055001, 50세,2018,8767,4192,4575,91.6,8664,4137,4527,91.4
31023, 분당구,055002, 51세,2018,7884,3869,4015,96.4,7790,3835,3955,97
31023, 분당구,055003, 52세,2018,7276,3723,3553,104.8,7207,3691,3516,105
31023, 분당구,055004, 53세,2018,7507,3704,3803,97.4,7425,3665,3760,97.5
31023, 분당구,055005, 54세,2018,7136,3509,3627,96.7,7069,3479,3590,96.9
31023, 분당구,060,55~59세,2018,35375,17267,18108,95.4,35011,17134,17877,95.8
31023, 분당구,060001, 55세,2018,7348,3601,3747,96.1,7249,3563,3686,96.7
31023, 분당구,060002, 56세,2018,6888,3390,3498,96.9,6809,3359,3450,97.4
31023, 분당구,060003, 57세,2018,7476,3618,3858,93.8,7403,3593,3810,94.3
31023, 분당구,060004, 58세,2018,7121,3461,3660,94.6,7069,3448,3621,95.2
31023, 분당구,060005, 59세,2018,6542,3197,3345,95.6,6481,3171,3310,95.8
31023, 분당구,065,60~64세,2018,26893,13417,13476,99.6,26624,13309,13315,100
31023, 분당구,065001, 60세,2018,6031,3118,2913,107,5969,3095,2874,107.7
31023, 분당구,065002, 61세,2018,5954,2987,2967,100.7,5890,2967,2923,101.5
31023, 분당구,065003, 62세,2018,5261,2570,2691,95.5,5210,2548,2662,95.7
31023, 분당구,065004, 63세,2018,5370,2680,2690,99.6,5315,2654,2661,99.7
31023, 분당구,065005, 64세,2018,4277,2062,2215,93.1,4240,2045,2195,93.2
31023, 분당구,070,65~69세,2018,16612,7942,8670,91.6,16500,7910,8590,92.1
31023, 분당구,070001, 65세,2018,3818,1858,1960,94.8,3790,1851,1939,95.5
31023, 분당구,070002, 66세,2018,3923,1938,1985,97.6,3902,1931,1971,98
31023, 분당구,070003, 67세,2018,2646,1260,1386,90.9,2635,1257,1378,91.2
31023, 분당구,070004, 68세,2018,3047,1441,1606,89.7,3019,1433,1586,90.4
31023, 분당구,070005, 69세,2018,3178,1445,1733,83.4,3154,1438,1716,83.8
31023, 분당구,075,70~74세,2018,13508,6132,7376,83.1,13448,6114,7334,83.4
31023, 분당구,075001, 70세,2018,3048,1380,1668,82.7,3033,1377,1656,83.2
31023, 분당구,075002, 71세,2018,3237,1491,1746,85.4,3227,1489,1738,85.7
31023, 분당구,075003, 72세,2018,2460,1080,1380,78.3,2450,1078,1372,78.6
31023, 분당구,075004, 73세,2018,2400,1090,1310,83.2,2387,1085,1302,83.3
31023, 분당구,075005, 74세,2018,2363,1091,1272,85.8,2351,1085,1266,85.7
31023, 분당구,080,75~79세,2018,10869,4827,6042,79.9,10844,4812,6032,79.8
31023, 분당구,080001, 75세,2018,2290,1019,1271,80.2,2282,1016,1266,80.3
31023, 분당구,080002, 76세,2018,2580,1193,1387,86,2574,1188,1386,85.7
31023, 분당구,080003, 77세,2018,2139,980,1159,84.6,2134,976,1158,84.3
31023, 분당구,080004, 78세,2018,1967,836,1131,73.9,1962,834,1128,73.9
31023, 분당구,080005, 79세,2018,1893,799,1094,73,1892,798,1094,72.9
31023, 분당구,085,80~84세,2018,7422,2924,4498,65,7408,2920,4488,65.1
31023, 분당구,085001, 80세,2018,1726,740,986,75.1,1721,738,983,75.1
31023, 분당구,085002, 81세,2018,1662,675,987,68.4,1660,674,986,68.4
31023, 분당구,085003, 82세,2018,1489,592,897,66,1486,592,894,66.2
31023, 분당구,085004, 83세,2018,1375,520,855,60.8,1374,519,855,60.7
31023, 분당구,085005, 84세,2018,1170,397,773,51.4,1167,397,770,51.6
31023, 분당구,090,85~89세,2018,3920,1286,2634,48.8,3910,1283,2627,48.8
31023, 분당구,090001, 85세,2018,982,331,651,50.8,978,330,648,50.9
31023, 분당구,090002, 86세,2018,918,309,609,50.7,915,308,607,50.7
31023, 분당구,090003, 87세,2018,730,239,491,48.7,729,239,490,48.8
31023, 분당구,090004, 88세,2018,697,213,484,44,696,213,483,44.1
31023, 분당구,090005, 89세,2018,593,194,399,48.6,592,193,399,48.4
31023, 분당구,095,90~94세,2018,1408,377,1031,36.6,1404,377,1027,36.7
31023, 분당구,095001, 90세,2018,484,150,334,44.9,482,150,332,45.2
31023, 분당구,095002, 91세,2018,377,99,278,35.6,377,99,278,35.6
31023, 분당구,095003, 92세,2018,216,50,166,30.1,215,50,165,30.3
31023, 분당구,095004, 93세,2018,182,38,144,26.4,181,38,143,26.6
31023, 분당구,095005, 94세,2018,149,40,109,36.7,149,40,109,36.7
31023, 분당구,100,95~99세,2018,339,113,226,50,336,113,223,50.7
31023, 분당구,100001, 95세,2018,119,45,74,60.8,118,45,73,61.6
31023, 분당구,100002, 96세,2018,105,29,76,38.2,103,29,74,39.2
31023, 분당구,100003, 97세,2018,55,15,40,37.5,55,15,40,37.5
31023, 분당구,100004, 98세,2018,28,13,15,86.7,28,13,15,86.7
31023, 분당구,100005, 99세,2018,32,11,21,52.4,32,11,21,52.4
31023, 분당구,101,100세이상,2018,32,7,25,28,30,7,23,30.4
31023, 분당구,102,15세미만,2018,66935,34446,32489,106,66534,34230,32304,106
31023, 분당구,103,15~64세,2018,348909,169950,178959,95,343730,167354,176376,94.9
31023, 분당구,104,65세이상,2018,54110,23608,30502,77.4,53880,23536,30344,77.6
31023, 분당구,086,85세이상,2018,5699,1783,3916,45.5,5680,1780,3900,45.6
31023, 분당구,126,평균연령,2018,40.1,39.3,40.9,,40.1,39.3,40.9,
31023, 분당구,127,중위연령,2018,41,40.2,41.7,,41.1,40.3,41.8,
31030, 의정부시,000,합계,2018,432286,213199,219087,97.3,426103,210212,215891,97.4
31030, 의정부시,005,0~4세,2018,16372,8463,7909,107,16265,8415,7850,107.2
31030, 의정부시,005001, 0세,2018,2685,1444,1241,116.4,2666,1434,1232,116.4
31030, 의정부시,005002, 1세,2018,2996,1551,1445,107.3,2974,1541,1433,107.5
31030, 의정부시,005003, 2세,2018,3388,1696,1692,100.2,3365,1686,1679,100.4
31030, 의정부시,005004, 3세,2018,3698,1926,1772,108.7,3668,1913,1755,109
31030, 의정부시,005005, 4세,2018,3605,1846,1759,104.9,3592,1841,1751,105.1
31030, 의정부시,010,5~9세,2018,19145,9786,9359,104.6,19072,9749,9323,104.6
31030, 의정부시,010001, 5세,2018,3646,1884,1762,106.9,3630,1877,1753,107.1
31030, 의정부시,010002, 6세,2018,4062,2075,1987,104.4,4043,2064,1979,104.3
31030, 의정부시,010003, 7세,2018,3881,1989,1892,105.1,3869,1984,1885,105.3
31030, 의정부시,010004, 8세,2018,3891,2009,1882,106.7,3880,2005,1875,106.9
31030, 의정부시,010005, 9세,2018,3665,1829,1836,99.6,3650,1819,1831,99.3
31030, 의정부시,015,10~14세,2018,19499,10046,9453,106.3,19454,10020,9434,106.2
31030, 의정부시,015001, 10세,2018,3859,2018,1841,109.6,3850,2011,1839,109.4
31030, 의정부시,015002, 11세,2018,4203,2222,1981,112.2,4194,2217,1977,112.1
31030, 의정부시,015003, 12세,2018,3684,1864,1820,102.4,3673,1859,1814,102.5
31030, 의정부시,015004, 13세,2018,3707,1878,1829,102.7,3702,1874,1828,102.5
31030, 의정부시,015005, 14세,2018,4046,2064,1982,104.1,4035,2059,1976,104.2
31030, 의정부시,020,15~19세,2018,23529,12165,11364,107,23328,12051,11277,106.9
31030, 의정부시,020001, 15세,2018,4147,2130,2017,105.6,4136,2124,2012,105.6
31030, 의정부시,020002, 16세,2018,4396,2286,2110,108.3,4386,2280,2106,108.3
31030, 의정부시,020003, 17세,2018,4848,2498,2350,106.3,4817,2481,2336,106.2
31030, 의정부시,020004, 18세,2018,5382,2825,2557,110.5,5319,2792,2527,110.5
31030, 의정부시,020005, 19세,2018,4756,2426,2330,104.1,4670,2374,2296,103.4
31030, 의정부시,025,20~24세,2018,29037,14876,14161,105,28235,14444,13791,104.7
31030, 의정부시,025001, 20세,2018,5236,2784,2452,113.5,5069,2685,2384,112.6
31030, 의정부시,025002, 21세,2018,5726,2971,2755,107.8,5567,2876,2691,106.9
31030, 의정부시,025003, 22세,2018,5804,2987,2817,106,5654,2898,2756,105.2
31030, 의정부시,025004, 23세,2018,6066,2995,3071,97.5,5901,2921,2980,98
31030, 의정부시,025005, 24세,2018,6205,3139,3066,102.4,6044,3064,2980,102.8
31030, 의정부시,030,25~29세,2018,29180,14732,14448,102,28293,14324,13969,102.5
31030, 의정부시,030001, 25세,2018,6341,3193,3148,101.4,6171,3105,3066,101.3
31030, 의정부시,030002, 26세,2018,6305,3245,3060,106,6133,3162,2971,106.4
31030, 의정부시,030003, 27세,2018,6051,3051,3000,101.7,5863,2955,2908,101.6
31030, 의정부시,030004, 28세,2018,5409,2707,2702,100.2,5230,2635,2595,101.5
31030, 의정부시,030005, 29세,2018,5074,2536,2538,99.9,4896,2467,2429,101.6
31030, 의정부시,035,30~34세,2018,25630,12962,12668,102.3,24805,12587,12218,103
31030, 의정부시,035001, 30세,2018,4966,2492,2474,100.7,4800,2422,2378,101.9
31030, 의정부시,035002, 31세,2018,4913,2453,2460,99.7,4736,2369,2367,100.1
31030, 의정부시,035003, 32세,2018,5129,2631,2498,105.3,4965,2556,2409,106.1
31030, 의정부시,035004, 33세,2018,5126,2591,2535,102.2,4974,2524,2450,103
31030, 의정부시,035005, 34세,2018,5496,2795,2701,103.5,5330,2716,2614,103.9
31030, 의정부시,040,35~39세,2018,33542,17101,16441,104,32897,16798,16099,104.3
31030, 의정부시,040001, 35세,2018,6306,3187,3119,102.2,6156,3122,3034,102.9
31030, 의정부시,040002, 36세,2018,6620,3359,3261,103,6472,3289,3183,103.3
31030, 의정부시,040003, 37세,2018,6941,3542,3399,104.2,6822,3481,3341,104.2
31030, 의정부시,040004, 38세,2018,7011,3610,3401,106.1,6885,3545,3340,106.1
31030, 의정부시,040005, 39세,2018,6664,3403,3261,104.4,6562,3361,3201,105
31030, 의정부시,045,40~44세,2018,33109,16547,16562,99.9,32606,16291,16315,99.9
31030, 의정부시,045001, 40세,2018,6093,3066,3027,101.3,5985,3010,2975,101.2
31030, 의정부시,045002, 41세,2018,6416,3207,3209,99.9,6301,3149,3152,99.9
31030, 의정부시,045003, 42세,2018,6170,3107,3063,101.4,6070,3051,3019,101.1
31030, 의정부시,045004, 43세,2018,6801,3360,3441,97.6,6715,3320,3395,97.8
31030, 의정부시,045005, 44세,2018,7629,3807,3822,99.6,7535,3761,3774,99.7
31030, 의정부시,050,45~49세,2018,40389,19958,20431,97.7,39827,19687,20140,97.8
31030, 의정부시,050001, 45세,2018,7623,3726,3897,95.6,7538,3687,3851,95.7
31030, 의정부시,050002, 46세,2018,7991,3971,4020,98.8,7865,3902,3963,98.5
31030, 의정부시,050003, 47세,2018,8441,4218,4223,99.9,8329,4170,4159,100.3
31030, 의정부시,050004, 48세,2018,8150,4060,4090,99.3,8021,3993,4028,99.1
31030, 의정부시,050005, 49세,2018,8184,3983,4201,94.8,8074,3935,4139,95.1
31030, 의정부시,055,50~54세,2018,37527,18461,19066,96.8,37000,18199,18801,96.8
31030, 의정부시,055001, 50세,2018,8080,3894,4186,93,7961,3829,4132,92.7
31030, 의정부시,055002, 51세,2018,7319,3531,3788,93.2,7226,3485,3741,93.2
31030, 의정부시,055003, 52세,2018,7471,3665,3806,96.3,7376,3619,3757,96.3
31030, 의정부시,055004, 53세,2018,7588,3782,3806,99.4,7472,3728,3744,99.6
31030, 의정부시,055005, 54세,2018,7069,3589,3480,103.1,6965,3538,3427,103.2
31030, 의정부시,060,55~59세,2018,37112,18545,18567,99.9,36728,18369,18359,100.1
31030, 의정부시,060001, 55세,2018,7507,3794,3713,102.2,7414,3747,3667,102.2
31030, 의정부시,060002, 56세,2018,7445,3734,3711,100.6,7370,3702,3668,100.9
31030, 의정부시,060003, 57세,2018,7673,3755,3918,95.8,7605,3726,3879,96.1
31030, 의정부시,060004, 58세,2018,7706,3864,3842,100.6,7630,3833,3797,100.9
31030, 의정부시,060005, 59세,2018,6781,3398,3383,100.4,6709,3361,3348,100.4
31030, 의정부시,065,60~64세,2018,28690,14111,14579,96.8,28394,13961,14433,96.7
31030, 의정부시,065001, 60세,2018,6560,3322,3238,102.6,6488,3290,3198,102.9
31030, 의정부시,065002, 61세,2018,6311,3130,3181,98.4,6237,3093,3144,98.4
31030, 의정부시,065003, 62세,2018,5453,2703,2750,98.3,5405,2677,2728,98.1
31030, 의정부시,065004, 63세,2018,5601,2642,2959,89.3,5542,2611,2931,89.1
31030, 의정부시,065005, 64세,2018,4765,2314,2451,94.4,4722,2290,2432,94.2
31030, 의정부시,070,65~69세,2018,18415,8624,9791,88.1,18225,8546,9679,88.3
31030, 의정부시,070001, 65세,2018,4097,1990,2107,94.4,4048,1968,2080,94.6
31030, 의정부시,070002, 66세,2018,4355,2035,2320,87.7,4305,2013,2292,87.8
31030, 의정부시,070003, 67세,2018,2960,1370,1590,86.2,2926,1355,1571,86.3
31030, 의정부시,070004, 68세,2018,3472,1595,1877,85,3443,1583,1860,85.1
31030, 의정부시,070005, 69세,2018,3531,1634,1897,86.1,3503,1627,1876,86.7
31030, 의정부시,075,70~74세,2018,15509,6931,8578,80.8,15443,6900,8543,80.8
31030, 의정부시,075001, 70세,2018,3515,1584,1931,82,3496,1574,1922,81.9
31030, 의정부시,075002, 71세,2018,3654,1670,1984,84.2,3632,1658,1974,84
31030, 의정부시,075003, 72세,2018,2848,1247,1601,77.9,2837,1244,1593,78.1
31030, 의정부시,075004, 73세,2018,2771,1235,1536,80.4,2764,1232,1532,80.4
31030, 의정부시,075005, 74세,2018,2721,1195,1526,78.3,2714,1192,1522,78.3
31030, 의정부시,080,75~79세,2018,13118,5598,7520,74.4,13078,5588,7490,74.6
31030, 의정부시,080001, 75세,2018,2763,1206,1557,77.5,2750,1202,1548,77.6
31030, 의정부시,080002, 76세,2018,3188,1376,1812,75.9,3182,1374,1808,76
31030, 의정부시,080003, 77세,2018,2546,1097,1449,75.7,2538,1096,1442,76
31030, 의정부시,080004, 78세,2018,2371,985,1386,71.1,2367,985,1382,71.3
31030, 의정부시,080005, 79세,2018,2250,934,1316,71,2241,931,1310,71.1
31030, 의정부시,085,80~84세,2018,7861,2918,4943,59,7842,2913,4929,59.1
31030, 의정부시,085001, 80세,2018,2041,815,1226,66.5,2035,811,1224,66.3
31030, 의정부시,085002, 81세,2018,1714,668,1046,63.9,1710,668,1042,64.1
31030, 의정부시,085003, 82세,2018,1554,558,996,56,1549,558,991,56.3
31030, 의정부시,085004, 83세,2018,1373,494,879,56.2,1369,493,876,56.3
31030, 의정부시,085005, 84세,2018,1179,383,796,48.1,1179,383,796,48.1
31030, 의정부시,090,85~89세,2018,3277,1041,2236,46.6,3269,1037,2232,46.5
31030, 의정부시,090001, 85세,2018,930,342,588,58.2,928,342,586,58.4
31030, 의정부시,090002, 86세,2018,768,264,504,52.4,766,262,504,52
31030, 의정부시,090003, 87세,2018,559,172,387,44.4,558,172,386,44.6
31030, 의정부시,090004, 88세,2018,565,141,424,33.3,563,140,423,33.1
31030, 의정부시,090005, 89세,2018,455,122,333,36.6,454,121,333,36.3
31030, 의정부시,095,90~94세,2018,1055,257,798,32.2,1052,256,796,32.2
31030, 의정부시,095001, 90세,2018,354,98,256,38.3,353,98,255,38.4
31030, 의정부시,095002, 91세,2018,280,65,215,30.2,278,64,214,29.9
31030, 의정부시,095003, 92세,2018,178,42,136,30.9,178,42,136,30.9
31030, 의정부시,095004, 93세,2018,141,28,113,24.8,141,28,113,24.8
31030, 의정부시,095005, 94세,2018,102,24,78,30.8,102,24,78,30.8
31030, 의정부시,100,95~99세,2018,262,71,191,37.2,262,71,191,37.2
31030, 의정부시,100001, 95세,2018,101,29,72,40.3,101,29,72,40.3
31030, 의정부시,100002, 96세,2018,66,17,49,34.7,66,17,49,34.7
31030, 의정부시,100003, 97세,2018,44,13,31,41.9,44,13,31,41.9
31030, 의정부시,100004, 98세,2018,28,6,22,27.3,28,6,22,27.3
31030, 의정부시,100005, 99세,2018,23,6,17,35.3,23,6,17,35.3
31030, 의정부시,101,100세이상,2018,28,6,22,27.3,28,6,22,27.3
31030, 의정부시,102,15세미만,2018,55016,28295,26721,105.9,54791,28184,26607,105.9
31030, 의정부시,103,15~64세,2018,317745,159458,158287,100.7,312113,156711,155402,100.8
31030, 의정부시,104,65세이상,2018,59525,25446,34079,74.7,59199,25317,33882,74.7
31030, 의정부시,086,85세이상,2018,4622,1375,3247,42.3,4611,1370,3241,42.3
31030, 의정부시,126,평균연령,2018,41.7,40.7,42.8,,41.8,40.8,42.8,
31030, 의정부시,127,중위연령,2018,43.2,42.1,44.3,,43.3,42.2,44.4,
31040, 안양시,000,합계,2018,566574,280358,286216,98,556062,275201,280861,98
31040, 안양시,005,0~4세,2018,21469,10865,10604,102.5,21185,10718,10467,102.4
31040, 안양시,005001, 0세,2018,3983,2010,1973,101.9,3921,1973,1948,101.3
31040, 안양시,005002, 1세,2018,3869,1998,1871,106.8,3821,1975,1846,107
31040, 안양시,005003, 2세,2018,4487,2283,2204,103.6,4419,2249,2170,103.6
31040, 안양시,005004, 3세,2018,4626,2304,2322,99.2,4572,2273,2299,98.9
31040, 안양시,005005, 4세,2018,4504,2270,2234,101.6,4452,2248,2204,102
31040, 안양시,010,5~9세,2018,23249,11947,11302,105.7,23110,11880,11230,105.8
31040, 안양시,010001, 5세,2018,4354,2189,2165,101.1,4317,2169,2148,101
31040, 안양시,010002, 6세,2018,4837,2516,2321,108.4,4803,2500,2303,108.6
31040, 안양시,010003, 7세,2018,4864,2443,2421,100.9,4843,2434,2409,101
31040, 안양시,010004, 8세,2018,4653,2430,2223,109.3,4625,2419,2206,109.7
31040, 안양시,010005, 9세,2018,4541,2369,2172,109.1,4522,2358,2164,109
31040, 안양시,015,10~14세,2018,25108,12989,12119,107.2,25038,12955,12083,107.2
31040, 안양시,015001, 10세,2018,5001,2572,2429,105.9,4984,2564,2420,106
31040, 안양시,015002, 11세,2018,5064,2640,2424,108.9,5046,2631,2415,108.9
31040, 안양시,015003, 12세,2018,4950,2551,2399,106.3,4938,2546,2392,106.4
31040, 안양시,015004, 13세,2018,4844,2495,2349,106.2,4836,2492,2344,106.3
31040, 안양시,015005, 14세,2018,5249,2731,2518,108.5,5234,2722,2512,108.4
31040, 안양시,020,15~19세,2018,31348,16178,15170,106.6,31185,16106,15079,106.8
31040, 안양시,020001, 15세,2018,5628,2908,2720,106.9,5624,2907,2717,107
31040, 안양시,020002, 16세,2018,5508,2870,2638,108.8,5495,2865,2630,108.9
31040, 안양시,020003, 17세,2018,6533,3361,3172,106,6513,3349,3164,105.8
31040, 안양시,020004, 18세,2018,7003,3619,3384,106.9,6968,3606,3362,107.3
31040, 안양시,020005, 19세,2018,6676,3420,3256,105,6585,3379,3206,105.4
31040, 안양시,025,20~24세,2018,38924,20031,18893,106,38266,19739,18527,106.5
31040, 안양시,025001, 20세,2018,7154,3658,3496,104.6,7016,3606,3410,105.7
31040, 안양시,025002, 21세,2018,7785,4034,3751,107.5,7690,3997,3693,108.2
31040, 안양시,025003, 22세,2018,7851,4102,3749,109.4,7727,4044,3683,109.8
31040, 안양시,025004, 23세,2018,7944,4082,3862,105.7,7819,4024,3795,106
31040, 안양시,025005, 24세,2018,8190,4155,4035,103,8014,4068,3946,103.1
31040, 안양시,030,25~29세,2018,41283,21365,19918,107.3,40203,20876,19327,108
31040, 안양시,030001, 25세,2018,8331,4310,4021,107.2,8153,4229,3924,107.8
31040, 안양시,030002, 26세,2018,8683,4463,4220,105.8,8485,4373,4112,106.3
31040, 안양시,030003, 27세,2018,8481,4411,4070,108.4,8258,4313,3945,109.3
31040, 안양시,030004, 28세,2018,7924,4177,3747,111.5,7669,4055,3614,112.2
31040, 안양시,030005, 29세,2018,7864,4004,3860,103.7,7638,3906,3732,104.7
31040, 안양시,035,30~34세,2018,38836,20069,18767,106.9,37528,19398,18130,107
31040, 안양시,035001, 30세,2018,7833,4080,3753,108.7,7553,3948,3605,109.5
31040, 안양시,035002, 31세,2018,7597,3865,3732,103.6,7331,3736,3595,103.9
31040, 안양시,035003, 32세,2018,7814,4059,3755,108.1,7546,3916,3630,107.9
31040, 안양시,035004, 33세,2018,7629,3965,3664,108.2,7389,3834,3555,107.8
31040, 안양시,035005, 34세,2018,7963,4100,3863,106.1,7709,3964,3745,105.8
31040, 안양시,040,35~39세,2018,43766,22285,21481,103.7,42752,21753,20999,103.6
31040, 안양시,040001, 35세,2018,8495,4404,4091,107.7,8268,4284,3984,107.5
31040, 안양시,040002, 36세,2018,9009,4654,4355,106.9,8766,4524,4242,106.6
31040, 안양시,040003, 37세,2018,8900,4580,4320,106,8726,4493,4233,106.1
31040, 안양시,040004, 38세,2018,8929,4390,4539,96.7,8746,4289,4457,96.2
31040, 안양시,040005, 39세,2018,8433,4257,4176,101.9,8246,4163,4083,102
31040, 안양시,045,40~44세,2018,42461,20977,21484,97.6,41639,20519,21120,97.2
31040, 안양시,045001, 40세,2018,7836,3898,3938,99,7650,3797,3853,98.5
31040, 안양시,045002, 41세,2018,8175,4002,4173,95.9,8024,3921,4103,95.6
31040, 안양시,045003, 42세,2018,8115,4051,4064,99.7,7954,3956,3998,98.9
31040, 안양시,045004, 43세,2018,8748,4292,4456,96.3,8603,4204,4399,95.6
31040, 안양시,045005, 44세,2018,9587,4734,4853,97.5,9408,4641,4767,97.4
31040, 안양시,050,45~49세,2018,52202,25223,26979,93.5,51177,24734,26443,93.5
31040, 안양시,050001, 45세,2018,9779,4680,5099,91.8,9604,4592,5012,91.6
31040, 안양시,050002, 46세,2018,10097,4972,5125,97,9895,4875,5020,97.1
31040, 안양시,050003, 47세,2018,10829,5243,5586,93.9,10641,5160,5481,94.1
31040, 안양시,050004, 48세,2018,10690,5138,5552,92.5,10456,5020,5436,92.3
31040, 안양시,050005, 49세,2018,10807,5190,5617,92.4,10581,5087,5494,92.6
31040, 안양시,055,50~54세,2018,50385,24549,25836,95,49261,23955,25306,94.7
31040, 안양시,055001, 50세,2018,10888,5223,5665,92.2,10673,5108,5565,91.8
31040, 안양시,055002, 51세,2018,9966,4714,5252,89.8,9758,4611,5147,89.6
31040, 안양시,055003, 52세,2018,9794,4874,4920,99.1,9584,4764,4820,98.8
31040, 안양시,055004, 53세,2018,10128,4926,5202,94.7,9881,4795,5086,94.3
31040, 안양시,055005, 54세,2018,9609,4812,4797,100.3,9365,4677,4688,99.8
31040, 안양시,060,55~59세,2018,51885,25253,26632,94.8,50759,24730,26029,95
31040, 안양시,060001, 55세,2018,10003,4941,5062,97.6,9706,4797,4909,97.7
31040, 안양시,060002, 56세,2018,10354,4990,5364,93,10133,4881,5252,92.9
31040, 안양시,060003, 57세,2018,10963,5295,5668,93.4,10788,5223,5565,93.9
31040, 안양시,060004, 58세,2018,11052,5353,5699,93.9,10802,5235,5567,94
31040, 안양시,060005, 59세,2018,9513,4674,4839,96.6,9330,4594,4736,97
31040, 안양시,065,60~64세,2018,38928,19540,19388,100.8,37952,19051,18901,100.8
31040, 안양시,065001, 60세,2018,8939,4517,4422,102.1,8703,4407,4296,102.6
31040, 안양시,065002, 61세,2018,8543,4217,4326,97.5,8301,4104,4197,97.8
31040, 안양시,065003, 62세,2018,7482,3718,3764,98.8,7294,3618,3676,98.4
31040, 안양시,065004, 63세,2018,7742,3876,3866,100.3,7573,3791,3782,100.2
31040, 안양시,065005, 64세,2018,6222,3212,3010,106.7,6081,3131,2950,106.1
31040, 안양시,070,65~69세,2018,23057,11554,11503,100.4,22594,11341,11253,100.8
31040, 안양시,070001, 65세,2018,5379,2731,2648,103.1,5229,2657,2572,103.3
31040, 안양시,070002, 66세,2018,5568,2802,2766,101.3,5459,2750,2709,101.5
31040, 안양시,070003, 67세,2018,3832,1876,1956,95.9,3749,1839,1910,96.3
31040, 안양시,070004, 68세,2018,4254,2157,2097,102.9,4198,2136,2062,103.6
31040, 안양시,070005, 69세,2018,4024,1988,2036,97.6,3959,1959,2000,98
31040, 안양시,075,70~74세,2018,16427,7575,8852,85.6,16314,7537,8777,85.9
31040, 안양시,075001, 70세,2018,3939,1878,2061,91.1,3908,1866,2042,91.4
31040, 안양시,075002, 71세,2018,3822,1782,2040,87.4,3797,1769,2028,87.2
31040, 안양시,075003, 72세,2018,2954,1387,1567,88.5,2934,1384,1550,89.3
31040, 안양시,075004, 73세,2018,2879,1286,1593,80.7,2860,1282,1578,81.2
31040, 안양시,075005, 74세,2018,2833,1242,1591,78.1,2815,1236,1579,78.3
31040, 안양시,080,75~79세,2018,13000,5555,7445,74.6,12919,5526,7393,74.7
31040, 안양시,080001, 75세,2018,2751,1225,1526,80.3,2735,1218,1517,80.3
31040, 안양시,080002, 76세,2018,3268,1438,1830,78.6,3247,1431,1816,78.8
31040, 안양시,080003, 77세,2018,2502,1058,1444,73.3,2481,1051,1430,73.5
31040, 안양시,080004, 78세,2018,2194,881,1313,67.1,2183,879,1304,67.4
31040, 안양시,080005, 79세,2018,2285,953,1332,71.5,2273,947,1326,71.4
31040, 안양시,085,80~84세,2018,8403,2880,5523,52.1,8354,2863,5491,52.1
31040, 안양시,085001, 80세,2018,2085,783,1302,60.1,2074,778,1296,60
31040, 안양시,085002, 81세,2018,1847,672,1175,57.2,1835,668,1167,57.2
31040, 안양시,085003, 82세,2018,1633,540,1093,49.4,1619,536,1083,49.5
31040, 안양시,085004, 83세,2018,1539,487,1052,46.3,1534,486,1048,46.4
31040, 안양시,085005, 84세,2018,1299,398,901,44.2,1292,395,897,44
31040, 안양시,090,85~89세,2018,4132,1141,2991,38.1,4118,1138,2980,38.2
31040, 안양시,090001, 85세,2018,1124,340,784,43.4,1121,339,782,43.4
31040, 안양시,090002, 86세,2018,991,287,704,40.8,987,287,700,41
31040, 안양시,090003, 87세,2018,782,205,577,35.5,780,205,575,35.7
31040, 안양시,090004, 88세,2018,716,182,534,34.1,714,181,533,34
31040, 안양시,090005, 89세,2018,519,127,392,32.4,516,126,390,32.3
31040, 안양시,095,90~94세,2018,1380,316,1064,29.7,1377,316,1061,29.8
31040, 안양시,095001, 90세,2018,464,110,354,31.1,462,110,352,31.3
31040, 안양시,095002, 91세,2018,335,74,261,28.4,334,74,260,28.5
31040, 안양시,095003, 92세,2018,235,45,190,23.7,235,45,190,23.7
31040, 안양시,095004, 93세,2018,217,50,167,29.9,217,50,167,29.9
31040, 안양시,095005, 94세,2018,129,37,92,40.2,129,37,92,40.2
31040, 안양시,100,95~99세,2018,291,61,230,26.5,291,61,230,26.5
31040, 안양시,100001, 95세,2018,122,25,97,25.8,122,25,97,25.8
31040, 안양시,100002, 96세,2018,71,16,55,29.1,71,16,55,29.1
31040, 안양시,100003, 97세,2018,43,8,35,22.9,43,8,35,22.9
31040, 안양시,100004, 98세,2018,37,7,30,23.3,37,7,30,23.3
31040, 안양시,100005, 99세,2018,18,5,13,38.5,18,5,13,38.5
31040, 안양시,101,100세이상,2018,40,5,35,14.3,40,5,35,14.3
31040, 안양시,102,15세미만,2018,69826,35801,34025,105.2,69333,35553,33780,105.2
31040, 안양시,103,15~64세,2018,430018,215470,214548,100.4,420722,210861,209861,100.5
31040, 안양시,104,65세이상,2018,66730,29087,37643,77.3,66007,28787,37220,77.3
31040, 안양시,086,85세이상,2018,5843,1523,4320,35.3,5826,1520,4306,35.3
31040, 안양시,126,평균연령,2018,41.1,40.2,42.1,,41.1,40.1,42.1,
31040, 안양시,127,중위연령,2018,42.4,41.1,43.6,,42.4,41.1,43.6,
31041, 만안구,000,합계,2018,251818,125781,126037,99.8,243891,121862,122029,99.9
31041, 만안구,005,0~4세,2018,9263,4642,4621,100.5,9034,4522,4512,100.2
31041, 만안구,005001, 0세,2018,1696,841,855,98.4,1645,811,834,97.2
31041, 만안구,005002, 1세,2018,1706,880,826,106.5,1664,859,805,106.7
31041, 만안구,005003, 2세,2018,2029,1006,1023,98.3,1973,977,996,98.1
31041, 만안구,005004, 3세,2018,1971,980,991,98.9,1929,958,971,98.7
31041, 만안구,005005, 4세,2018,1861,935,926,101,1823,917,906,101.2
31041, 만안구,010,5~9세,2018,8754,4514,4240,106.5,8656,4469,4187,106.7
31041, 만안구,010001, 5세,2018,1759,883,876,100.8,1736,872,864,100.9
31041, 만안구,010002, 6세,2018,1870,978,892,109.6,1843,968,875,110.6
31041, 만안구,010003, 7세,2018,1774,893,881,101.4,1763,886,877,101
31041, 만안구,010004, 8세,2018,1724,901,823,109.5,1703,893,810,110.2
31041, 만안구,010005, 9세,2018,1627,859,768,111.8,1611,850,761,111.7
31041, 만안구,015,10~14세,2018,8908,4675,4233,110.4,8859,4654,4205,110.7
31041, 만안구,015001, 10세,2018,1833,956,877,109,1819,949,870,109.1
31041, 만안구,015002, 11세,2018,1772,944,828,114,1759,938,821,114.3
31041, 만안구,015003, 12세,2018,1752,906,846,107.1,1745,903,842,107.2
31041, 만안구,015004, 13세,2018,1694,883,811,108.9,1687,881,806,109.3
31041, 만안구,015005, 14세,2018,1857,986,871,113.2,1849,983,866,113.5
31041, 만안구,020,15~19세,2018,12550,6503,6047,107.5,12415,6447,5968,108
31041, 만안구,020001, 15세,2018,2102,1115,987,113,2100,1115,985,113.2
31041, 만안구,020002, 16세,2018,2058,1056,1002,105.4,2047,1052,995,105.7
31041, 만안구,020003, 17세,2018,2522,1358,1164,116.7,2510,1350,1160,116.4
31041, 만안구,020004, 18세,2018,2945,1522,1423,107,2916,1511,1405,107.5
31041, 만안구,020005, 19세,2018,2923,1452,1471,98.7,2842,1419,1423,99.7
31041, 만안구,025,20~24세,2018,18123,9141,8982,101.8,17642,8935,8707,102.6
31041, 만안구,025001, 20세,2018,3201,1586,1615,98.2,3080,1545,1535,100.7
31041, 만안구,025002, 21세,2018,3651,1772,1879,94.3,3578,1748,1830,95.5
31041, 만안구,025003, 22세,2018,3670,1875,1795,104.5,3592,1837,1755,104.7
31041, 만안구,025004, 23세,2018,3743,1947,1796,108.4,3650,1902,1748,108.8
31041, 만안구,025005, 24세,2018,3858,1961,1897,103.4,3742,1903,1839,103.5
31041, 만안구,030,25~29세,2018,19127,9994,9133,109.4,18387,9655,8732,110.6
31041, 만안구,030001, 25세,2018,3912,2038,1874,108.8,3802,1986,1816,109.4
31041, 만안구,030002, 26세,2018,4042,2103,1939,108.5,3912,2043,1869,109.3
31041, 만안구,030003, 27세,2018,3872,2048,1824,112.3,3710,1978,1732,114.2
31041, 만안구,030004, 28세,2018,3689,1953,1736,112.5,3505,1865,1640,113.7
31041, 만안구,030005, 29세,2018,3612,1852,1760,105.2,3458,1783,1675,106.4
31041, 만안구,035,30~34세,2018,17516,9255,8261,112,16606,8793,7813,112.5
31041, 만안구,035001, 30세,2018,3643,1932,1711,112.9,3448,1838,1610,114.2
31041, 만안구,035002, 31세,2018,3418,1743,1675,104.1,3237,1660,1577,105.3
31041, 만안구,035003, 32세,2018,3499,1848,1651,111.9,3313,1753,1560,112.4
31041, 만안구,035004, 33세,2018,3429,1829,1600,114.3,3251,1736,1515,114.6
31041, 만안구,035005, 34세,2018,3527,1903,1624,117.2,3357,1806,1551,116.4
31041, 만안구,040,35~39세,2018,19430,10263,9167,112,18737,9881,8856,111.6
31041, 만안구,040001, 35세,2018,3867,2044,1823,112.1,3717,1966,1751,112.3
31041, 만안구,040002, 36세,2018,4059,2152,1907,112.8,3890,2053,1837,111.8
31041, 만안구,040003, 37세,2018,3944,2129,1815,117.3,3828,2067,1761,117.4
31041, 만안구,040004, 38세,2018,3926,2024,1902,106.4,3808,1954,1854,105.4
31041, 만안구,040005, 39세,2018,3634,1914,1720,111.3,3494,1841,1653,111.4
31041, 만안구,045,40~44세,2018,17271,9111,8160,111.7,16669,8766,7903,110.9
31041, 만안구,045001, 40세,2018,3321,1766,1555,113.6,3185,1689,1496,112.9
31041, 만안구,045002, 41세,2018,3402,1771,1631,108.6,3293,1711,1582,108.2
31041, 만안구,045003, 42세,2018,3325,1776,1549,114.7,3205,1706,1499,113.8
31041, 만안구,045004, 43세,2018,3465,1827,1638,111.5,3356,1756,1600,109.8
31041, 만안구,045005, 44세,2018,3758,1971,1787,110.3,3630,1904,1726,110.3
31041, 만안구,050,45~49세,2018,20966,10298,10668,96.5,20204,9930,10274,96.7
31041, 만안구,050001, 45세,2018,3873,1945,1928,100.9,3748,1874,1874,100
31041, 만안구,050002, 46세,2018,4050,2043,2007,101.8,3900,1970,1930,102.1
31041, 만안구,050003, 47세,2018,4268,2102,2166,97,4136,2044,2092,97.7
31041, 만안구,050004, 48세,2018,4359,2108,2251,93.6,4179,2021,2158,93.7
31041, 만안구,050005, 49세,2018,4416,2100,2316,90.7,4241,2021,2220,91
31041, 만안구,055,50~54세,2018,22381,10943,11438,95.7,21468,10455,11013,94.9
31041, 만안구,055001, 50세,2018,4588,2205,2383,92.5,4423,2116,2307,91.7
31041, 만안구,055002, 51세,2018,4359,2051,2308,88.9,4191,1960,2231,87.9
31041, 만안구,055003, 52세,2018,4427,2194,2233,98.3,4251,2101,2150,97.7
31041, 만안구,055004, 53세,2018,4593,2214,2379,93.1,4395,2111,2284,92.4
31041, 만안구,055005, 54세,2018,4414,2279,2135,106.7,4208,2167,2041,106.2
31041, 만안구,060,55~59세,2018,24395,11940,12455,95.9,23454,11493,11961,96.1
31041, 만안구,060001, 55세,2018,4663,2302,2361,97.5,4418,2180,2238,97.4
31041, 만안구,060002, 56세,2018,4857,2396,2461,97.4,4668,2301,2367,97.2
31041, 만안구,060003, 57세,2018,5163,2510,2653,94.6,5014,2447,2567,95.3
31041, 만안구,060004, 58세,2018,5210,2537,2673,94.9,5002,2438,2564,95.1
31041, 만안구,060005, 59세,2018,4502,2195,2307,95.1,4352,2127,2225,95.6
31041, 만안구,065,60~64세,2018,18987,9438,9549,98.8,18174,9027,9147,98.7
31041, 만안구,065001, 60세,2018,4277,2163,2114,102.3,4081,2072,2009,103.1
31041, 만안구,065002, 61세,2018,4185,2029,2156,94.1,3985,1933,2052,94.2
31041, 만안구,065003, 62세,2018,3664,1826,1838,99.3,3502,1735,1767,98.2
31041, 만안구,065004, 63세,2018,3707,1798,1909,94.2,3567,1728,1839,94
31041, 만안구,065005, 64세,2018,3154,1622,1532,105.9,3039,1559,1480,105.3
31041, 만안구,070,65~69세,2018,11833,5910,5923,99.8,11458,5739,5719,100.3
31041, 만안구,070001, 65세,2018,2704,1358,1346,100.9,2576,1296,1280,101.3
31041, 만안구,070002, 66세,2018,2860,1406,1454,96.7,2771,1365,1406,97.1
31041, 만안구,070003, 67세,2018,1982,964,1018,94.7,1919,935,984,95
31041, 만안구,070004, 68세,2018,2174,1125,1049,107.2,2129,1108,1021,108.5
31041, 만안구,070005, 69세,2018,2113,1057,1056,100.1,2063,1035,1028,100.7
31041, 만안구,075,70~74세,2018,8529,3986,4543,87.7,8452,3964,4488,88.3
31041, 만안구,075001, 70세,2018,2040,1007,1033,97.5,2015,1000,1015,98.5
31041, 만안구,075002, 71세,2018,1973,922,1051,87.7,1957,914,1043,87.6
31041, 만안구,075003, 72세,2018,1535,727,808,90,1521,724,797,90.8
31041, 만안구,075004, 73세,2018,1510,670,840,79.8,1499,668,831,80.4
31041, 만안구,075005, 74세,2018,1471,660,811,81.4,1460,658,802,82
31041, 만안구,080,75~79세,2018,6769,2976,3793,78.5,6707,2954,3753,78.7
31041, 만안구,080001, 75세,2018,1455,661,794,83.2,1441,655,786,83.3
31041, 만안구,080002, 76세,2018,1755,790,965,81.9,1740,784,956,82
31041, 만안구,080003, 77세,2018,1282,561,721,77.8,1264,556,708,78.5
31041, 만안구,080004, 78세,2018,1121,461,660,69.8,1112,459,653,70.3
31041, 만안구,080005, 79세,2018,1156,503,653,77,1150,500,650,76.9
31041, 만안구,085,80~84세,2018,4212,1483,2729,54.3,4177,1471,2706,54.4
31041, 만안구,085001, 80세,2018,1072,402,670,60,1065,398,667,59.7
31041, 만안구,085002, 81세,2018,925,349,576,60.6,917,345,572,60.3
31041, 만안구,085003, 82세,2018,812,276,536,51.5,801,274,527,52
31041, 만안구,085004, 83세,2018,771,248,523,47.4,766,247,519,47.6
31041, 만안구,085005, 84세,2018,632,208,424,49.1,628,207,421,49.2
31041, 만안구,090,85~89세,2018,1973,527,1446,36.4,1962,525,1437,36.5
31041, 만안구,090001, 85세,2018,555,174,381,45.7,553,174,379,45.9
31041, 만안구,090002, 86세,2018,468,125,343,36.4,465,125,340,36.8
31041, 만안구,090003, 87세,2018,359,95,264,36,357,95,262,36.3
31041, 만안구,090004, 88세,2018,330,71,259,27.4,329,70,259,27
31041, 만안구,090005, 89세,2018,261,62,199,31.2,258,61,197,31
31041, 만안구,095,90~94세,2018,662,153,509,30.1,661,153,508,30.1
31041, 만안구,095001, 90세,2018,216,52,164,31.7,216,52,164,31.7
31041, 만안구,095002, 91세,2018,165,35,130,26.9,164,35,129,27.1
31041, 만안구,095003, 92세,2018,106,16,90,17.8,106,16,90,17.8
31041, 만안구,095004, 93세,2018,113,29,84,34.5,113,29,84,34.5
31041, 만안구,095005, 94세,2018,62,21,41,51.2,62,21,41,51.2
31041, 만안구,100,95~99세,2018,146,25,121,20.7,146,25,121,20.7
31041, 만안구,100001, 95세,2018,65,11,54,20.4,65,11,54,20.4
31041, 만안구,100002, 96세,2018,34,7,27,25.9,34,7,27,25.9
31041, 만안구,100003, 97세,2018,20,X,18,11.1,20,X,18,11.1
31041, 만안구,100004, 98세,2018,18,X,14,28.6,18,X,14,28.6
31041, 만안구,100005, 99세,2018,9,X,8,12.5,9,X,8,12.5
31041, 만안구,101,100세이상,2018,23,X,19,21.1,23,X,19,21.1
31041, 만안구,102,15세미만,2018,26925,13831,13094,105.6,26549,13645,12904,105.7
31041, 만안구,103,15~64세,2018,190746,96886,93860,103.2,183756,93382,90374,103.3
31041, 만안구,104,65세이상,2018,34147,15064,19083,78.9,33586,14835,18751,79.1
31041, 만안구,086,85세이상,2018,2804,709,2095,33.8,2792,707,2085,33.9
31041, 만안구,126,평균연령,2018,42.4,41.4,43.4,,42.4,41.4,43.4,
31041, 만안구,127,중위연령,2018,43.6,42.2,45.1,,43.6,42.1,45.1,
31042, 동안구,000,합계,2018,314756,154577,160179,96.5,312171,153339,158832,96.5
31042, 동안구,005,0~4세,2018,12206,6223,5983,104,12151,6196,5955,104
31042, 동안구,005001, 0세,2018,2287,1169,1118,104.6,2276,1162,1114,104.3
31042, 동안구,005002, 1세,2018,2163,1118,1045,107,2157,1116,1041,107.2
31042, 동안구,005003, 2세,2018,2458,1277,1181,108.1,2446,1272,1174,108.3
31042, 동안구,005004, 3세,2018,2655,1324,1331,99.5,2643,1315,1328,99
31042, 동안구,005005, 4세,2018,2643,1335,1308,102.1,2629,1331,1298,102.5
31042, 동안구,010,5~9세,2018,14495,7433,7062,105.3,14454,7411,7043,105.2
31042, 동안구,010001, 5세,2018,2595,1306,1289,101.3,2581,1297,1284,101
31042, 동안구,010002, 6세,2018,2967,1538,1429,107.6,2960,1532,1428,107.3
31042, 동안구,010003, 7세,2018,3090,1550,1540,100.6,3080,1548,1532,101
31042, 동안구,010004, 8세,2018,2929,1529,1400,109.2,2922,1526,1396,109.3
31042, 동안구,010005, 9세,2018,2914,1510,1404,107.5,2911,1508,1403,107.5
31042, 동안구,015,10~14세,2018,16200,8314,7886,105.4,16179,8301,7878,105.4
31042, 동안구,015001, 10세,2018,3168,1616,1552,104.1,3165,1615,1550,104.2
31042, 동안구,015002, 11세,2018,3292,1696,1596,106.3,3287,1693,1594,106.2
31042, 동안구,015003, 12세,2018,3198,1645,1553,105.9,3193,1643,1550,106
31042, 동안구,015004, 13세,2018,3150,1612,1538,104.8,3149,1611,1538,104.7
31042, 동안구,015005, 14세,2018,3392,1745,1647,106,3385,1739,1646,105.7
31042, 동안구,020,15~19세,2018,18798,9675,9123,106.1,18770,9659,9111,106
31042, 동안구,020001, 15세,2018,3526,1793,1733,103.5,3524,1792,1732,103.5
31042, 동안구,020002, 16세,2018,3450,1814,1636,110.9,3448,1813,1635,110.9
31042, 동안구,020003, 17세,2018,4011,2003,2008,99.8,4003,1999,2004,99.8
31042, 동안구,020004, 18세,2018,4058,2097,1961,106.9,4052,2095,1957,107.1
31042, 동안구,020005, 19세,2018,3753,1968,1785,110.3,3743,1960,1783,109.9
31042, 동안구,025,20~24세,2018,20801,10890,9911,109.9,20624,10804,9820,110
31042, 동안구,025001, 20세,2018,3953,2072,1881,110.2,3936,2061,1875,109.9
31042, 동안구,025002, 21세,2018,4134,2262,1872,120.8,4112,2249,1863,120.7
31042, 동안구,025003, 22세,2018,4181,2227,1954,114,4135,2207,1928,114.5
31042, 동안구,025004, 23세,2018,4201,2135,2066,103.3,4169,2122,2047,103.7
31042, 동안구,025005, 24세,2018,4332,2194,2138,102.6,4272,2165,2107,102.8
31042, 동안구,030,25~29세,2018,22156,11371,10785,105.4,21816,11221,10595,105.9
31042, 동안구,030001, 25세,2018,4419,2272,2147,105.8,4351,2243,2108,106.4
31042, 동안구,030002, 26세,2018,4641,2360,2281,103.5,4573,2330,2243,103.9
31042, 동안구,030003, 27세,2018,4609,2363,2246,105.2,4548,2335,2213,105.5
31042, 동안구,030004, 28세,2018,4235,2224,2011,110.6,4164,2190,1974,110.9
31042, 동안구,030005, 29세,2018,4252,2152,2100,102.5,4180,2123,2057,103.2
31042, 동안구,035,30~34세,2018,21320,10814,10506,102.9,20922,10605,10317,102.8
31042, 동안구,035001, 30세,2018,4190,2148,2042,105.2,4105,2110,1995,105.8
31042, 동안구,035002, 31세,2018,4179,2122,2057,103.2,4094,2076,2018,102.9
31042, 동안구,035003, 32세,2018,4315,2211,2104,105.1,4233,2163,2070,104.5
31042, 동안구,035004, 33세,2018,4200,2136,2064,103.5,4138,2098,2040,102.8
31042, 동안구,035005, 34세,2018,4436,2197,2239,98.1,4352,2158,2194,98.4
31042, 동안구,040,35~39세,2018,24336,12022,12314,97.6,24015,11872,12143,97.8
31042, 동안구,040001, 35세,2018,4628,2360,2268,104.1,4551,2318,2233,103.8
31042, 동안구,040002, 36세,2018,4950,2502,2448,102.2,4876,2471,2405,102.7
31042, 동안구,040003, 37세,2018,4956,2451,2505,97.8,4898,2426,2472,98.1
31042, 동안구,040004, 38세,2018,5003,2366,2637,89.7,4938,2335,2603,89.7
31042, 동안구,040005, 39세,2018,4799,2343,2456,95.4,4752,2322,2430,95.6
31042, 동안구,045,40~44세,2018,25190,11866,13324,89.1,24970,11753,13217,88.9
31042, 동안구,045001, 40세,2018,4515,2132,2383,89.5,4465,2108,2357,89.4
31042, 동안구,045002, 41세,2018,4773,2231,2542,87.8,4731,2210,2521,87.7
31042, 동안구,045003, 42세,2018,4790,2275,2515,90.5,4749,2250,2499,90
31042, 동안구,045004, 43세,2018,5283,2465,2818,87.5,5247,2448,2799,87.5
31042, 동안구,045005, 44세,2018,5829,2763,3066,90.1,5778,2737,3041,90
31042, 동안구,050,45~49세,2018,31236,14925,16311,91.5,30973,14804,16169,91.6
31042, 동안구,050001, 45세,2018,5906,2735,3171,86.3,5856,2718,3138,86.6
31042, 동안구,050002, 46세,2018,6047,2929,3118,93.9,5995,2905,3090,94
31042, 동안구,050003, 47세,2018,6561,3141,3420,91.8,6505,3116,3389,91.9
31042, 동안구,050004, 48세,2018,6331,3030,3301,91.8,6277,2999,3278,91.5
31042, 동안구,050005, 49세,2018,6391,3090,3301,93.6,6340,3066,3274,93.6
31042, 동안구,055,50~54세,2018,28004,13606,14398,94.5,27793,13500,14293,94.5
31042, 동안구,055001, 50세,2018,6300,3018,3282,92,6250,2992,3258,91.8
31042, 동안구,055002, 51세,2018,5607,2663,2944,90.5,5567,2651,2916,90.9
31042, 동안구,055003, 52세,2018,5367,2680,2687,99.7,5333,2663,2670,99.7
31042, 동안구,055004, 53세,2018,5535,2712,2823,96.1,5486,2684,2802,95.8
31042, 동안구,055005, 54세,2018,5195,2533,2662,95.2,5157,2510,2647,94.8
31042, 동안구,060,55~59세,2018,27490,13313,14177,93.9,27305,13237,14068,94.1
31042, 동안구,060001, 55세,2018,5340,2639,2701,97.7,5288,2617,2671,98
31042, 동안구,060002, 56세,2018,5497,2594,2903,89.4,5465,2580,2885,89.4
31042, 동안구,060003, 57세,2018,5800,2785,3015,92.4,5774,2776,2998,92.6
31042, 동안구,060004, 58세,2018,5842,2816,3026,93.1,5800,2797,3003,93.1
31042, 동안구,060005, 59세,2018,5011,2479,2532,97.9,4978,2467,2511,98.2
31042, 동안구,065,60~64세,2018,19941,10102,9839,102.7,19778,10024,9754,102.8
31042, 동안구,065001, 60세,2018,4662,2354,2308,102,4622,2335,2287,102.1
31042, 동안구,065002, 61세,2018,4358,2188,2170,100.8,4316,2171,2145,101.2
31042, 동안구,065003, 62세,2018,3818,1892,1926,98.2,3792,1883,1909,98.6
31042, 동안구,065004, 63세,2018,4035,2078,1957,106.2,4006,2063,1943,106.2
31042, 동안구,065005, 64세,2018,3068,1590,1478,107.6,3042,1572,1470,106.9
31042, 동안구,070,65~69세,2018,11224,5644,5580,101.1,11136,5602,5534,101.2
31042, 동안구,070001, 65세,2018,2675,1373,1302,105.5,2653,1361,1292,105.3
31042, 동안구,070002, 66세,2018,2708,1396,1312,106.4,2688,1385,1303,106.3
31042, 동안구,070003, 67세,2018,1850,912,938,97.2,1830,904,926,97.6
31042, 동안구,070004, 68세,2018,2080,1032,1048,98.5,2069,1028,1041,98.8
31042, 동안구,070005, 69세,2018,1911,931,980,95,1896,924,972,95.1
31042, 동안구,075,70~74세,2018,7898,3589,4309,83.3,7862,3573,4289,83.3
31042, 동안구,075001, 70세,2018,1899,871,1028,84.7,1893,866,1027,84.3
31042, 동안구,075002, 71세,2018,1849,860,989,87,1840,855,985,86.8
31042, 동안구,075003, 72세,2018,1419,660,759,87,1413,660,753,87.6
31042, 동안구,075004, 73세,2018,1369,616,753,81.8,1361,614,747,82.2
31042, 동안구,075005, 74세,2018,1362,582,780,74.6,1355,578,777,74.4
31042, 동안구,080,75~79세,2018,6231,2579,3652,70.6,6212,2572,3640,70.7
31042, 동안구,080001, 75세,2018,1296,564,732,77,1294,563,731,77
31042, 동안구,080002, 76세,2018,1513,648,865,74.9,1507,647,860,75.2
31042, 동안구,080003, 77세,2018,1220,497,723,68.7,1217,495,722,68.6
31042, 동안구,080004, 78세,2018,1073,420,653,64.3,1071,420,651,64.5
31042, 동안구,080005, 79세,2018,1129,450,679,66.3,1123,447,676,66.1
31042, 동안구,085,80~84세,2018,4191,1397,2794,50,4177,1392,2785,50
31042, 동안구,085001, 80세,2018,1013,381,632,60.3,1009,380,629,60.4
31042, 동안구,085002, 81세,2018,922,323,599,53.9,918,323,595,54.3
31042, 동안구,085003, 82세,2018,821,264,557,47.4,818,262,556,47.1
31042, 동안구,085004, 83세,2018,768,239,529,45.2,768,239,529,45.2
31042, 동안구,085005, 84세,2018,667,190,477,39.8,664,188,476,39.5
31042, 동안구,090,85~89세,2018,2159,614,1545,39.7,2156,613,1543,39.7
31042, 동안구,090001, 85세,2018,569,166,403,41.2,568,165,403,40.9
31042, 동안구,090002, 86세,2018,523,162,361,44.9,522,162,360,45
31042, 동안구,090003, 87세,2018,423,110,313,35.1,423,110,313,35.1
31042, 동안구,090004, 88세,2018,386,111,275,40.4,385,111,274,40.5
31042, 동안구,090005, 89세,2018,258,65,193,33.7,258,65,193,33.7
31042, 동안구,095,90~94세,2018,718,163,555,29.4,716,163,553,29.5
31042, 동안구,095001, 90세,2018,248,58,190,30.5,246,58,188,30.9
31042, 동안구,095002, 91세,2018,170,39,131,29.8,170,39,131,29.8
31042, 동안구,095003, 92세,2018,129,29,100,29,129,29,100,29
31042, 동안구,095004, 93세,2018,104,21,83,25.3,104,21,83,25.3
31042, 동안구,095005, 94세,2018,67,16,51,31.4,67,16,51,31.4
31042, 동안구,100,95~99세,2018,145,36,109,33,145,36,109,33
31042, 동안구,100001, 95세,2018,57,14,43,32.6,57,14,43,32.6
31042, 동안구,100002, 96세,2018,37,9,28,32.1,37,9,28,32.1
31042, 동안구,100003, 97세,2018,23,6,17,35.3,23,6,17,35.3
31042, 동안구,100004, 98세,2018,19,X,16,18.8,19,X,16,18.8
31042, 동안구,100005, 99세,2018,9,X,5,80,9,X,5,80
31042, 동안구,101,100세이상,2018,17,X,16,6.3,17,X,16,6.3
31042, 동안구,102,15세미만,2018,42901,21970,20931,105,42784,21908,20876,104.9
31042, 동안구,103,15~64세,2018,239272,118584,120688,98.3,236966,117479,119487,98.3
31042, 동안구,104,65세이상,2018,32583,14023,18560,75.6,32421,13952,18469,75.5
31042, 동안구,086,85세이상,2018,3039,814,2225,36.6,3034,813,2221,36.6
31042, 동안구,126,평균연령,2018,40.1,39.2,41.1,,40.1,39.2,41.1,
31042, 동안구,127,중위연령,2018,41.5,40.3,42.6,,41.6,40.3,42.7,
31050, 부천시,000,합계,2018,848756,421816,426940,98.8,815331,404899,410432,98.7
31050, 부천시,005,0~4세,2018,32492,16656,15836,105.2,31385,16087,15298,105.2
31050, 부천시,005001, 0세,2018,5733,2929,2804,104.5,5487,2806,2681,104.7
31050, 부천시,005002, 1세,2018,6068,3129,2939,106.5,5812,2984,2828,105.5
31050, 부천시,005003, 2세,2018,6782,3477,3305,105.2,6534,3359,3175,105.8
31050, 부천시,005004, 3세,2018,6903,3577,3326,107.5,6721,3481,3240,107.4
31050, 부천시,005005, 4세,2018,7006,3544,3462,102.4,6831,3457,3374,102.5
31050, 부천시,010,5~9세,2018,34698,17760,16938,104.9,34173,17497,16676,104.9
31050, 부천시,010001, 5세,2018,6748,3460,3288,105.2,6605,3385,3220,105.1
31050, 부천시,010002, 6세,2018,7319,3772,3547,106.3,7183,3713,3470,107
31050, 부천시,010003, 7세,2018,7096,3596,3500,102.7,6999,3545,3454,102.6
31050, 부천시,010004, 8세,2018,6878,3509,3369,104.2,6801,3473,3328,104.4
31050, 부천시,010005, 9세,2018,6657,3423,3234,105.8,6585,3381,3204,105.5
31050, 부천시,015,10~14세,2018,34361,17584,16777,104.8,34068,17422,16646,104.7
31050, 부천시,015001, 10세,2018,6942,3589,3353,107,6875,3552,3323,106.9
31050, 부천시,015002, 11세,2018,7295,3737,3558,105,7232,3706,3526,105.1
31050, 부천시,015003, 12세,2018,6642,3438,3204,107.3,6576,3398,3178,106.9
31050, 부천시,015004, 13세,2018,6413,3274,3139,104.3,6373,3249,3124,104
31050, 부천시,015005, 14세,2018,7069,3546,3523,100.7,7012,3517,3495,100.6
31050, 부천시,020,15~19세,2018,41987,21620,20367,106.2,41596,21433,20163,106.3
31050, 부천시,020001, 15세,2018,7323,3834,3489,109.9,7294,3818,3476,109.8
31050, 부천시,020002, 16세,2018,7489,3858,3631,106.3,7456,3842,3614,106.3
31050, 부천시,020003, 17세,2018,8658,4457,4201,106.1,8598,4426,4172,106.1
31050, 부천시,020004, 18세,2018,9427,4874,4553,107.1,9333,4830,4503,107.3
31050, 부천시,020005, 19세,2018,9090,4597,4493,102.3,8915,4517,4398,102.7
31050, 부천시,025,20~24세,2018,56885,29672,27213,109,55230,28838,26392,109.3
31050, 부천시,025001, 20세,2018,10150,5351,4799,111.5,9899,5228,4671,111.9
31050, 부천시,025002, 21세,2018,10955,5802,5153,112.6,10672,5644,5028,112.3
31050, 부천시,025003, 22세,2018,11387,6017,5370,112,11066,5859,5207,112.5
31050, 부천시,025004, 23세,2018,11903,6101,5802,105.2,11532,5915,5617,105.3
31050, 부천시,025005, 24세,2018,12490,6401,6089,105.1,12061,6192,5869,105.5
31050, 부천시,030,25~29세,2018,64112,32875,31237,105.2,60586,31095,29491,105.4
31050, 부천시,030001, 25세,2018,13063,6721,6342,106,12578,6493,6085,106.7
31050, 부천시,030002, 26세,2018,13690,7113,6577,108.1,13082,6823,6259,109
31050, 부천시,030003, 27세,2018,12809,6512,6297,103.4,12155,6175,5980,103.3
31050, 부천시,030004, 28세,2018,12376,6251,6125,102.1,11489,5802,5687,102
31050, 부천시,030005, 29세,2018,12174,6278,5896,106.5,11282,5802,5480,105.9
31050, 부천시,035,30~34세,2018,60736,31236,29500,105.9,56071,28755,27316,105.3
31050, 부천시,035001, 30세,2018,12115,6248,5867,106.5,11185,5781,5404,107
31050, 부천시,035002, 31세,2018,11934,6098,5836,104.5,10911,5550,5361,103.5
31050, 부천시,035003, 32세,2018,11942,6114,5828,104.9,11010,5616,5394,104.1
31050, 부천시,035004, 33세,2018,12199,6330,5869,107.9,11268,5842,5426,107.7
31050, 부천시,035005, 34세,2018,12546,6446,6100,105.7,11697,5966,5731,104.1
31050, 부천시,040,35~39세,2018,70846,36569,34277,106.7,67445,34617,32828,105.4
31050, 부천시,040001, 35세,2018,13726,7107,6619,107.4,12893,6632,6261,105.9
31050, 부천시,040002, 36세,2018,14573,7587,6986,108.6,13772,7141,6631,107.7
31050, 부천시,040003, 37세,2018,14484,7514,6970,107.8,13867,7157,6710,106.7
31050, 부천시,040004, 38세,2018,14420,7315,7105,103,13862,6988,6874,101.7
31050, 부천시,040005, 39세,2018,13643,7046,6597,106.8,13051,6699,6352,105.5
31050, 부천시,045,40~44세,2018,63375,32343,31032,104.2,60942,31004,29938,103.6
31050, 부천시,045001, 40세,2018,12198,6305,5893,107,11661,5999,5662,106
31050, 부천시,045002, 41세,2018,12496,6368,6128,103.9,12019,6082,5937,102.4
31050, 부천시,045003, 42세,2018,12102,6220,5882,105.7,11604,5950,5654,105.2
31050, 부천시,045004, 43세,2018,12640,6392,6248,102.3,12196,6158,6038,102
31050, 부천시,045005, 44세,2018,13939,7058,6881,102.6,13462,6815,6647,102.5
31050, 부천시,050,45~49세,2018,74364,36816,37548,98.1,71408,35291,36117,97.7
31050, 부천시,050001, 45세,2018,14106,7105,7001,101.5,13552,6815,6737,101.2
31050, 부천시,050002, 46세,2018,14388,7265,7123,102,13812,6974,6838,102
31050, 부천시,050003, 47세,2018,15520,7698,7822,98.4,14954,7412,7542,98.3
31050, 부천시,050004, 48세,2018,14977,7266,7711,94.2,14349,6953,7396,94
31050, 부천시,050005, 49세,2018,15373,7482,7891,94.8,14741,7137,7604,93.9
31050, 부천시,055,50~54세,2018,74858,35971,38887,92.5,71464,34330,37134,92.4
31050, 부천시,055001, 50세,2018,15669,7466,8203,91,14979,7143,7836,91.2
31050, 부천시,055002, 51세,2018,14347,6855,7492,91.5,13798,6583,7215,91.2
31050, 부천시,055003, 52세,2018,14425,7011,7414,94.6,13817,6719,7098,94.7
31050, 부천시,055004, 53세,2018,15608,7468,8140,91.7,14837,7094,7743,91.6
31050, 부천시,055005, 54세,2018,14809,7171,7638,93.9,14033,6791,7242,93.8
31050, 부천시,060,55~59세,2018,80840,39869,40971,97.3,77193,38099,39094,97.5
31050, 부천시,060001, 55세,2018,15501,7654,7847,97.5,14510,7169,7341,97.7
31050, 부천시,060002, 56세,2018,16040,7969,8071,98.7,15257,7593,7664,99.1
31050, 부천시,060003, 57세,2018,16979,8274,8705,95,16479,8019,8460,94.8
31050, 부천시,060004, 58세,2018,17249,8444,8805,95.9,16465,8073,8392,96.2
31050, 부천시,060005, 59세,2018,15071,7528,7543,99.8,14482,7245,7237,100.1
31050, 부천시,065,60~64세,2018,60758,30125,30633,98.3,57641,28635,29006,98.7
31050, 부천시,065001, 60세,2018,13971,6942,7029,98.8,13300,6614,6686,98.9
31050, 부천시,065002, 61세,2018,13401,6650,6751,98.5,12686,6304,6382,98.8
31050, 부천시,065003, 62세,2018,11949,5927,6022,98.4,11315,5631,5684,99.1
31050, 부천시,065004, 63세,2018,11834,5887,5947,99,11248,5615,5633,99.7
31050, 부천시,065005, 64세,2018,9603,4719,4884,96.6,9092,4471,4621,96.8
31050, 부천시,070,65~69세,2018,35392,17639,17753,99.4,33896,16963,16933,100.2
31050, 부천시,070001, 65세,2018,8134,4060,4074,99.7,7742,3880,3862,100.5
31050, 부천시,070002, 66세,2018,8644,4275,4369,97.8,8267,4095,4172,98.2
31050, 부천시,070003, 67세,2018,5937,3047,2890,105.4,5648,2917,2731,106.8
31050, 부천시,070004, 68세,2018,6486,3182,3304,96.3,6247,3076,3171,97
31050, 부천시,070005, 69세,2018,6191,3075,3116,98.7,5992,2995,2997,99.9
31050, 부천시,075,70~74세,2018,23754,11330,12424,91.2,23392,11192,12200,91.7
31050, 부천시,075001, 70세,2018,5869,2900,2969,97.7,5770,2857,2913,98.1
31050, 부천시,075002, 71세,2018,5670,2684,2986,89.9,5594,2651,2943,90.1
31050, 부천시,075003, 72세,2018,4185,2061,2124,97,4110,2039,2071,98.5
31050, 부천시,075004, 73세,2018,3991,1894,2097,90.3,3925,1868,2057,90.8
31050, 부천시,075005, 74세,2018,4039,1791,2248,79.7,3993,1777,2216,80.2
31050, 부천시,080,75~79세,2018,18673,7685,10988,69.9,18446,7626,10820,70.5
31050, 부천시,080001, 75세,2018,3953,1713,2240,76.5,3911,1701,2210,77
31050, 부천시,080002, 76세,2018,4651,2009,2642,76,4605,1999,2606,76.7
31050, 부천시,080003, 77세,2018,3513,1400,2113,66.3,3465,1392,2073,67.1
31050, 부천시,080004, 78세,2018,3279,1322,1957,67.6,3236,1309,1927,67.9
31050, 부천시,080005, 79세,2018,3277,1241,2036,61,3229,1225,2004,61.1
31050, 부천시,085,80~84세,2018,11899,3911,7988,49,11740,3874,7866,49.2
31050, 부천시,085001, 80세,2018,2840,1008,1832,55,2788,995,1793,55.5
31050, 부천시,085002, 81세,2018,2526,881,1645,53.6,2498,873,1625,53.7
31050, 부천시,085003, 82세,2018,2421,771,1650,46.7,2394,763,1631,46.8
31050, 부천시,085004, 83세,2018,2313,681,1632,41.7,2281,676,1605,42.1
31050, 부천시,085005, 84세,2018,1799,570,1229,46.4,1779,567,1212,46.8
31050, 부천시,090,85~89세,2018,6047,1595,4452,35.8,5990,1584,4406,36
31050, 부천시,090001, 85세,2018,1668,478,1190,40.2,1652,475,1177,40.4
31050, 부천시,090002, 86세,2018,1409,368,1041,35.4,1397,364,1033,35.2
31050, 부천시,090003, 87세,2018,1085,297,788,37.7,1074,295,779,37.9
31050, 부천시,090004, 88세,2018,997,234,763,30.7,986,232,754,30.8
31050, 부천시,090005, 89세,2018,888,218,670,32.5,881,218,663,32.9
31050, 부천시,095,90~94세,2018,2078,443,1635,27.1,2064,440,1624,27.1
31050, 부천시,095001, 90세,2018,716,164,552,29.7,709,162,547,29.6
31050, 부천시,095002, 91세,2018,542,126,416,30.3,537,125,412,30.3
31050, 부천시,095003, 92세,2018,352,73,279,26.2,350,73,277,26.4
31050, 부천시,095004, 93세,2018,274,42,232,18.1,274,42,232,18.1
31050, 부천시,095005, 94세,2018,194,38,156,24.4,194,38,156,24.4
31050, 부천시,100,95~99세,2018,523,107,416,25.7,523,107,416,25.7
31050, 부천시,100001, 95세,2018,203,44,159,27.7,203,44,159,27.7
31050, 부천시,100002, 96세,2018,126,23,103,22.3,126,23,103,22.3
31050, 부천시,100003, 97세,2018,92,16,76,21.1,92,16,76,21.1
31050, 부천시,100004, 98세,2018,65,15,50,30,65,15,50,30
31050, 부천시,100005, 99세,2018,37,9,28,32.1,37,9,28,32.1
31050, 부천시,101,100세이상,2018,78,10,68,14.7,78,10,68,14.7
31050, 부천시,102,15세미만,2018,101551,52000,49551,104.9,99626,51006,48620,104.9
31050, 부천시,103,15~64세,2018,648761,327096,321665,101.7,619576,312097,307479,101.5
31050, 부천시,104,65세이상,2018,98444,42720,55724,76.7,96129,41796,54333,76.9
31050, 부천시,086,85세이상,2018,8726,2155,6571,32.8,8655,2141,6514,32.9
31050, 부천시,126,평균연령,2018,41.3,40.4,42.3,,41.3,40.3,42.2,
31050, 부천시,127,중위연령,2018,42.3,41.1,43.5,,42.3,41.1,43.5,
31060, 광명시,000,합계,2018,323460,160088,163372,98,314500,155672,158828,98
31060, 광명시,005,0~4세,2018,12978,6636,6342,104.6,12723,6516,6207,105
31060, 광명시,005001, 0세,2018,2242,1143,1099,104,2190,1120,1070,104.7
31060, 광명시,005002, 1세,2018,2378,1218,1160,105,2315,1191,1124,106
31060, 광명시,005003, 2세,2018,2718,1381,1337,103.3,2653,1348,1305,103.3
31060, 광명시,005004, 3세,2018,2777,1416,1361,104,2733,1391,1342,103.7
31060, 광명시,005005, 4세,2018,2863,1478,1385,106.7,2832,1466,1366,107.3
31060, 광명시,010,5~9세,2018,15296,7841,7455,105.2,15165,7770,7395,105.1
31060, 광명시,010001, 5세,2018,2882,1478,1404,105.3,2842,1455,1387,104.9
31060, 광명시,010002, 6세,2018,3186,1636,1550,105.5,3158,1620,1538,105.3
31060, 광명시,010003, 7세,2018,3159,1604,1555,103.2,3137,1590,1547,102.8
31060, 광명시,010004, 8세,2018,3058,1583,1475,107.3,3036,1575,1461,107.8
31060, 광명시,010005, 9세,2018,3011,1540,1471,104.7,2992,1530,1462,104.7
31060, 광명시,015,10~14세,2018,15970,8132,7838,103.8,15917,8110,7807,103.9
31060, 광명시,015001, 10세,2018,3268,1662,1606,103.5,3252,1654,1598,103.5
31060, 광명시,015002, 11세,2018,3303,1626,1677,97,3289,1623,1666,97.4
31060, 광명시,015003, 12세,2018,3063,1578,1485,106.3,3054,1573,1481,106.2
31060, 광명시,015004, 13세,2018,3013,1569,1444,108.7,3006,1566,1440,108.8
31060, 광명시,015005, 14세,2018,3323,1697,1626,104.4,3316,1694,1622,104.4
31060, 광명시,020,15~19세,2018,17627,9189,8438,108.9,17563,9160,8403,109
31060, 광명시,020001, 15세,2018,3260,1719,1541,111.6,3254,1715,1539,111.4
31060, 광명시,020002, 16세,2018,3262,1719,1543,111.4,3259,1717,1542,111.3
31060, 광명시,020003, 17세,2018,3802,1943,1859,104.5,3790,1939,1851,104.8
31060, 광명시,020004, 18세,2018,3892,2047,1845,110.9,3882,2040,1842,110.7
31060, 광명시,020005, 19세,2018,3411,1761,1650,106.7,3378,1749,1629,107.4
31060, 광명시,025,20~24세,2018,19178,10240,8938,114.6,18895,10106,8789,115
31060, 광명시,025001, 20세,2018,3612,1936,1676,115.5,3574,1915,1659,115.4
31060, 광명시,025002, 21세,2018,3807,2058,1749,117.7,3760,2042,1718,118.9
31060, 광명시,025003, 22세,2018,3840,2071,1769,117.1,3790,2059,1731,118.9
31060, 광명시,025004, 23세,2018,3880,2066,1814,113.9,3810,2027,1783,113.7
31060, 광명시,025005, 24세,2018,4039,2109,1930,109.3,3961,2063,1898,108.7
31060, 광명시,030,25~29세,2018,20764,10732,10032,107,19963,10347,9616,107.6
31060, 광명시,030001, 25세,2018,4093,2139,1954,109.5,3968,2076,1892,109.7
31060, 광명시,030002, 26세,2018,4320,2255,2065,109.2,4212,2198,2014,109.1
31060, 광명시,030003, 27세,2018,4240,2166,2074,104.4,4077,2093,1984,105.5
31060, 광명시,030004, 28세,2018,4052,2105,1947,108.1,3865,2016,1849,109
31060, 광명시,030005, 29세,2018,4059,2067,1992,103.8,3841,1964,1877,104.6
31060, 광명시,035,30~34세,2018,21583,10963,10620,103.2,20494,10402,10092,103.1
31060, 광명시,035001, 30세,2018,4089,2072,2017,102.7,3867,1959,1908,102.7
31060, 광명시,035002, 31세,2018,4135,2080,2055,101.2,3881,1951,1930,101.1
31060, 광명시,035003, 32세,2018,4354,2261,2093,108,4128,2144,1984,108.1
31060, 광명시,035004, 33세,2018,4354,2192,2162,101.4,4171,2097,2074,101.1
31060, 광명시,035005, 34세,2018,4651,2358,2293,102.8,4447,2251,2196,102.5
31060, 광명시,040,35~39세,2018,27425,13774,13651,100.9,26570,13335,13235,100.8
31060, 광명시,040001, 35세,2018,4941,2537,2404,105.5,4754,2442,2312,105.6
31060, 광명시,040002, 36세,2018,5748,2907,2841,102.3,5551,2809,2742,102.4
31060, 광명시,040003, 37세,2018,5593,2769,2824,98.1,5454,2698,2756,97.9
31060, 광명시,040004, 38세,2018,5678,2858,2820,101.3,5517,2771,2746,100.9
31060, 광명시,040005, 39세,2018,5465,2703,2762,97.9,5294,2615,2679,97.6
31060, 광명시,045,40~44세,2018,27006,13452,13554,99.2,26411,13133,13278,98.9
31060, 광명시,045001, 40세,2018,4997,2481,2516,98.6,4866,2405,2461,97.7
31060, 광명시,045002, 41세,2018,5233,2535,2698,94,5119,2473,2646,93.5
31060, 광명시,045003, 42세,2018,5181,2577,2604,99,5054,2515,2539,99.1
31060, 광명시,045004, 43세,2018,5613,2811,2802,100.3,5499,2750,2749,100
31060, 광명시,045005, 44세,2018,5982,3048,2934,103.9,5873,2990,2883,103.7
31060, 광명시,050,45~49세,2018,30366,15145,15221,99.5,29438,14668,14770,99.3
31060, 광명시,050001, 45세,2018,6122,3067,3055,100.4,5962,2975,2987,99.6
31060, 광명시,050002, 46세,2018,6005,2981,3024,98.6,5823,2887,2936,98.3
31060, 광명시,050003, 47세,2018,6320,3166,3154,100.4,6122,3073,3049,100.8
31060, 광명시,050004, 48세,2018,5904,2912,2992,97.3,5698,2800,2898,96.6
31060, 광명시,050005, 49세,2018,6015,3019,2996,100.8,5833,2933,2900,101.1
31060, 광명시,055,50~54세,2018,26845,13330,13515,98.6,25780,12807,12973,98.7
31060, 광명시,055001, 50세,2018,5934,2900,3034,95.6,5705,2785,2920,95.4
31060, 광명시,055002, 51세,2018,5370,2590,2780,93.2,5195,2510,2685,93.5
31060, 광명시,055003, 52세,2018,5126,2617,2509,104.3,4930,2523,2407,104.8
31060, 광명시,055004, 53세,2018,5415,2679,2736,97.9,5204,2578,2626,98.2
31060, 광명시,055005, 54세,2018,5000,2544,2456,103.6,4746,2411,2335,103.3
31060, 광명시,060,55~59세,2018,27209,13195,14014,94.2,26038,12647,13391,94.4
31060, 광명시,060001, 55세,2018,5285,2639,2646,99.7,4929,2461,2468,99.7
31060, 광명시,060002, 56세,2018,5253,2611,2642,98.8,5030,2499,2531,98.7
31060, 광명시,060003, 57세,2018,5741,2797,2944,95,5605,2732,2873,95.1
31060, 광명시,060004, 58세,2018,5675,2699,2976,90.7,5423,2586,2837,91.2
31060, 광명시,060005, 59세,2018,5255,2449,2806,87.3,5051,2369,2682,88.3
31060, 광명시,065,60~64세,2018,22174,10725,11449,93.7,21196,10226,10970,93.2
31060, 광명시,065001, 60세,2018,4921,2421,2500,96.8,4697,2309,2388,96.7
31060, 광명시,065002, 61세,2018,4746,2259,2487,90.8,4508,2127,2381,89.3
31060, 광명시,065003, 62세,2018,4364,2064,2300,89.7,4178,1971,2207,89.3
31060, 광명시,065004, 63세,2018,4414,2164,2250,96.2,4214,2066,2148,96.2
31060, 광명시,065005, 64세,2018,3729,1817,1912,95,3599,1753,1846,95
31060, 광명시,070,65~69세,2018,13832,6652,7180,92.6,13376,6435,6941,92.7
31060, 광명시,070001, 65세,2018,3144,1507,1637,92.1,3009,1442,1567,92
31060, 광명시,070002, 66세,2018,3321,1608,1713,93.9,3190,1545,1645,93.9
31060, 광명시,070003, 67세,2018,2318,1131,1187,95.3,2237,1092,1145,95.4
31060, 광명시,070004, 68세,2018,2557,1217,1340,90.8,2500,1190,1310,90.8
31060, 광명시,070005, 69세,2018,2492,1189,1303,91.3,2440,1166,1274,91.5
31060, 광명시,075,70~74세,2018,9752,4505,5247,85.9,9630,4457,5173,86.2
31060, 광명시,075001, 70세,2018,2365,1157,1208,95.8,2325,1140,1185,96.2
31060, 광명시,075002, 71세,2018,2401,1108,1293,85.7,2376,1098,1278,85.9
31060, 광명시,075003, 72세,2018,1694,764,930,82.2,1672,757,915,82.7
31060, 광명시,075004, 73세,2018,1668,752,916,82.1,1649,745,904,82.4
31060, 광명시,075005, 74세,2018,1624,724,900,80.4,1608,717,891,80.5
31060, 광명시,080,75~79세,2018,7794,3218,4576,70.3,7736,3203,4533,70.7
31060, 광명시,080001, 75세,2018,1721,736,985,74.7,1706,732,974,75.2
31060, 광명시,080002, 76세,2018,1957,808,1149,70.3,1945,804,1141,70.5
31060, 광명시,080003, 77세,2018,1515,609,906,67.2,1497,603,894,67.4
31060, 광명시,080004, 78세,2018,1302,537,765,70.2,1295,536,759,70.6
31060, 광명시,080005, 79세,2018,1299,528,771,68.5,1293,528,765,69
31060, 광명시,085,80~84세,2018,4673,1577,3096,50.9,4628,1569,3059,51.3
31060, 광명시,085001, 80세,2018,1130,428,702,61,1120,428,692,61.8
31060, 광명시,085002, 81세,2018,1012,377,635,59.4,1004,375,629,59.6
31060, 광명시,085003, 82세,2018,910,295,615,48,897,290,607,47.8
31060, 광명시,085004, 83세,2018,892,256,636,40.3,886,255,631,40.4
31060, 광명시,085005, 84세,2018,729,221,508,43.5,721,221,500,44.2
31060, 광명시,090,85~89세,2018,2172,592,1580,37.5,2162,591,1571,37.6
31060, 광명시,090001, 85세,2018,587,169,418,40.4,585,169,416,40.6
31060, 광명시,090002, 86세,2018,534,159,375,42.4,532,158,374,42.2
31060, 광명시,090003, 87세,2018,405,105,300,35,402,105,297,35.4
31060, 광명시,090004, 88세,2018,367,88,279,31.5,365,88,277,31.8
31060, 광명시,090005, 89세,2018,279,71,208,34.1,278,71,207,34.3
31060, 광명시,095,90~94세,2018,646,152,494,30.8,646,152,494,30.8
31060, 광명시,095001, 90세,2018,224,54,170,31.8,224,54,170,31.8
31060, 광명시,095002, 91세,2018,160,42,118,35.6,160,42,118,35.6
31060, 광명시,095003, 92세,2018,113,26,87,29.9,113,26,87,29.9
31060, 광명시,095004, 93세,2018,88,19,69,27.5,88,19,69,27.5
31060, 광명시,095005, 94세,2018,61,11,50,22,61,11,50,22
31060, 광명시,100,95~99세,2018,143,34,109,31.2,142,34,108,31.5
31060, 광명시,100001, 95세,2018,54,16,38,42.1,54,16,38,42.1
31060, 광명시,100002, 96세,2018,34,7,27,25.9,33,7,26,26.9
31060, 광명시,100003, 97세,2018,20,6,14,42.9,20,6,14,42.9
31060, 광명시,100004, 98세,2018,20,X,16,25,20,X,16,25
31060, 광명시,100005, 99세,2018,15,X,14,7.1,15,X,14,7.1
31060, 광명시,101,100세이상,2018,27,X,23,17.4,27,X,23,17.4
31060, 광명시,102,15세미만,2018,44244,22609,21635,104.5,43805,22396,21409,104.6
31060, 광명시,103,15~64세,2018,240177,120745,119432,101.1,232348,116831,115517,101.1
31060, 광명시,104,65세이상,2018,39039,16734,22305,75,38347,16445,21902,75.1
31060, 광명시,086,85세이상,2018,2988,782,2206,35.4,2977,781,2196,35.6
31060, 광명시,126,평균연령,2018,40.9,39.8,41.9,,40.8,39.7,41.8,
31060, 광명시,127,중위연령,2018,42.1,41,43.2,,42,40.9,43.1,
31070, 평택시,000,합계,2018,504485,262531,241954,108.5,472806,243767,229039,106.4
31070, 평택시,005,0~4세,2018,22856,11705,11151,105,21907,11241,10666,105.4
31070, 평택시,005001, 0세,2018,3883,2025,1858,109,3692,1924,1768,108.8
31070, 평택시,005002, 1세,2018,4288,2150,2138,100.6,4081,2059,2022,101.8
31070, 평택시,005003, 2세,2018,4855,2501,2354,106.2,4602,2375,2227,106.6
31070, 평택시,005004, 3세,2018,5000,2593,2407,107.7,4834,2509,2325,107.9
31070, 평택시,005005, 4세,2018,4830,2436,2394,101.8,4698,2374,2324,102.2
31070, 평택시,010,5~9세,2018,25397,12984,12413,104.6,24906,12744,12162,104.8
31070, 평택시,010001, 5세,2018,4870,2414,2456,98.3,4739,2357,2382,99
31070, 평택시,010002, 6세,2018,5300,2743,2557,107.3,5193,2691,2502,107.6
31070, 평택시,010003, 7세,2018,5179,2616,2563,102.1,5093,2569,2524,101.8
31070, 평택시,010004, 8세,2018,5079,2652,2427,109.3,4998,2611,2387,109.4
31070, 평택시,010005, 9세,2018,4969,2559,2410,106.2,4883,2516,2367,106.3
31070, 평택시,015,10~14세,2018,24281,12400,11881,104.4,24014,12270,11744,104.5
31070, 평택시,015001, 10세,2018,5087,2594,2493,104.1,5017,2561,2456,104.3
31070, 평택시,015002, 11세,2018,5126,2637,2489,105.9,5068,2614,2454,106.5
31070, 평택시,015003, 12세,2018,4779,2416,2363,102.2,4726,2384,2342,101.8
31070, 평택시,015004, 13세,2018,4535,2321,2214,104.8,4492,2300,2192,104.9
31070, 평택시,015005, 14세,2018,4754,2432,2322,104.7,4711,2411,2300,104.8
31070, 평택시,020,15~19세,2018,27527,14385,13142,109.5,26805,14010,12795,109.5
31070, 평택시,020001, 15세,2018,4987,2551,2436,104.7,4947,2528,2419,104.5
31070, 평택시,020002, 16세,2018,5242,2762,2480,111.4,5198,2742,2456,111.6
31070, 평택시,020003, 17세,2018,5693,2933,2760,106.3,5641,2907,2734,106.3
31070, 평택시,020004, 18세,2018,6116,3212,2904,110.6,5931,3121,2810,111.1
31070, 평택시,020005, 19세,2018,5489,2927,2562,114.2,5088,2712,2376,114.1
31070, 평택시,025,20~24세,2018,32546,17769,14777,120.2,29993,16102,13891,115.9
31070, 평택시,025001, 20세,2018,5969,3282,2687,122.1,5579,3063,2516,121.7
31070, 평택시,025002, 21세,2018,6301,3513,2788,126,5909,3258,2651,122.9
31070, 평택시,025003, 22세,2018,6393,3417,2976,114.8,5898,3089,2809,110
31070, 평택시,025004, 23세,2018,6852,3727,3125,119.3,6250,3309,2941,112.5
31070, 평택시,025005, 24세,2018,7031,3830,3201,119.7,6357,3383,2974,113.8
31070, 평택시,030,25~29세,2018,36992,21177,15815,133.9,32361,18144,14217,127.6
31070, 평택시,030001, 25세,2018,7346,4097,3249,126.1,6543,3563,2980,119.6
31070, 평택시,030002, 26세,2018,7615,4344,3271,132.8,6764,3766,2998,125.6
31070, 평택시,030003, 27세,2018,7473,4288,3185,134.6,6583,3712,2871,129.3
31070, 평택시,030004, 28세,2018,7456,4295,3161,135.9,6404,3625,2779,130.4
31070, 평택시,030005, 29세,2018,7102,4153,2949,140.8,6067,3478,2589,134.3
31070, 평택시,035,30~34세,2018,37196,20765,16431,126.4,31940,17435,14505,120.2
31070, 평택시,035001, 30세,2018,7002,3982,3020,131.9,5951,3317,2634,125.9
31070, 평택시,035002, 31세,2018,7434,4172,3262,127.9,6311,3472,2839,122.3
31070, 평택시,035003, 32세,2018,7433,4190,3243,129.2,6347,3493,2854,122.4
31070, 평택시,035004, 33세,2018,7540,4128,3412,121,6517,3492,3025,115.4
31070, 평택시,035005, 34세,2018,7787,4293,3494,122.9,6814,3661,3153,116.1
31070, 평택시,040,35~39세,2018,45333,24605,20728,118.7,40989,21826,19163,113.9
31070, 평택시,040001, 35세,2018,8394,4535,3859,117.5,7428,3908,3520,111
31070, 평택시,040002, 36세,2018,9327,5052,4275,118.2,8352,4452,3900,114.2
31070, 평택시,040003, 37세,2018,9282,5119,4163,123,8451,4580,3871,118.3
31070, 평택시,040004, 38세,2018,9293,5028,4265,117.9,8538,4533,4005,113.2
31070, 평택시,040005, 39세,2018,9037,4871,4166,116.9,8220,4353,3867,112.6
31070, 평택시,045,40~44세,2018,42627,22837,19790,115.4,39892,21077,18815,112
31070, 평택시,045001, 40세,2018,8341,4525,3816,118.6,7682,4090,3592,113.9
31070, 평택시,045002, 41세,2018,8320,4494,3826,117.5,7747,4122,3625,113.7
31070, 평택시,045003, 42세,2018,8228,4415,3813,115.8,7683,4063,3620,112.2
31070, 평택시,045004, 43세,2018,8596,4531,4065,111.5,8129,4244,3885,109.2
31070, 평택시,045005, 44세,2018,9142,4872,4270,114.1,8651,4558,4093,111.4
31070, 평택시,050,45~49세,2018,46926,24688,22238,111,44211,23180,21031,110.2
31070, 평택시,050001, 45세,2018,9187,4730,4457,106.1,8692,4451,4241,105
31070, 평택시,050002, 46세,2018,9245,4975,4270,116.5,8687,4670,4017,116.3
31070, 평택시,050003, 47세,2018,9645,5138,4507,114,9085,4821,4264,113.1
31070, 평택시,050004, 48세,2018,9370,4991,4379,114,8803,4670,4133,113
31070, 평택시,050005, 49세,2018,9479,4854,4625,105,8944,4568,4376,104.4
31070, 평택시,055,50~54세,2018,41262,21584,19678,109.7,38887,20319,18568,109.4
31070, 평택시,055001, 50세,2018,9041,4660,4381,106.4,8510,4381,4129,106.1
31070, 평택시,055002, 51세,2018,8167,4195,3972,105.6,7786,3970,3816,104
31070, 평택시,055003, 52세,2018,8069,4328,3741,115.7,7605,4084,3521,116
31070, 평택시,055004, 53세,2018,8397,4383,4014,109.2,7878,4117,3761,109.5
31070, 평택시,055005, 54세,2018,7588,4018,3570,112.5,7108,3767,3341,112.8
31070, 평택시,060,55~59세,2018,38298,20041,18257,109.8,36318,19116,17202,111.1
31070, 평택시,060001, 55세,2018,7834,4171,3663,113.9,7271,3911,3360,116.4
31070, 평택시,060002, 56세,2018,7741,4121,3620,113.8,7337,3918,3419,114.6
31070, 평택시,060003, 57세,2018,8146,4279,3867,110.7,7876,4161,3715,112
31070, 평택시,060004, 58세,2018,7731,3925,3806,103.1,7340,3734,3606,103.5
31070, 평택시,060005, 59세,2018,6846,3545,3301,107.4,6494,3392,3102,109.3
31070, 평택시,065,60~64세,2018,27229,13794,13435,102.7,25704,13051,12653,103.1
31070, 평택시,065001, 60세,2018,6415,3330,3085,107.9,6064,3156,2908,108.5
31070, 평택시,065002, 61세,2018,5667,2944,2723,108.1,5311,2780,2531,109.8
31070, 평택시,065003, 62세,2018,5480,2797,2683,104.2,5166,2642,2524,104.7
31070, 평택시,065004, 63세,2018,5268,2583,2685,96.2,4984,2443,2541,96.1
31070, 평택시,065005, 64세,2018,4399,2140,2259,94.7,4179,2030,2149,94.5
31070, 평택시,070,65~69세,2018,17247,8244,9003,91.6,16593,7904,8689,91
31070, 평택시,070001, 65세,2018,3789,1857,1932,96.1,3606,1759,1847,95.2
31070, 평택시,070002, 66세,2018,4122,2011,2111,95.3,3971,1938,2033,95.3
31070, 평택시,070003, 67세,2018,2919,1381,1538,89.8,2781,1301,1480,87.9
31070, 평택시,070004, 68세,2018,3249,1530,1719,89,3144,1482,1662,89.2
31070, 평택시,070005, 69세,2018,3168,1465,1703,86,3091,1424,1667,85.4
31070, 평택시,075,70~74세,2018,13688,6179,7509,82.3,13431,6060,7371,82.2
31070, 평택시,075001, 70세,2018,3171,1446,1725,83.8,3090,1411,1679,84
31070, 평택시,075002, 71세,2018,3182,1500,1682,89.2,3115,1474,1641,89.8
31070, 평택시,075003, 72세,2018,2417,1133,1284,88.2,2376,1109,1267,87.5
31070, 평택시,075004, 73세,2018,2450,1078,1372,78.6,2413,1059,1354,78.2
31070, 평택시,075005, 74세,2018,2468,1022,1446,70.7,2437,1007,1430,70.4
31070, 평택시,080,75~79세,2018,12134,5061,7073,71.6,12017,5011,7006,71.5
31070, 평택시,080001, 75세,2018,2505,1075,1430,75.2,2478,1063,1415,75.1
31070, 평택시,080002, 76세,2018,2899,1230,1669,73.7,2874,1217,1657,73.4
31070, 평택시,080003, 77세,2018,2446,1027,1419,72.4,2414,1013,1401,72.3
31070, 평택시,080004, 78세,2018,2160,910,1250,72.8,2141,903,1238,72.9
31070, 평택시,080005, 79세,2018,2124,819,1305,62.8,2110,815,1295,62.9
31070, 평택시,085,80~84세,2018,8149,2964,5185,57.2,8068,2940,5128,57.3
31070, 평택시,085001, 80세,2018,2015,750,1265,59.3,1992,739,1253,59
31070, 평택시,085002, 81세,2018,1842,693,1149,60.3,1819,688,1131,60.8
31070, 평택시,085003, 82세,2018,1642,605,1037,58.3,1626,602,1024,58.8
31070, 평택시,085004, 83세,2018,1459,511,948,53.9,1446,507,939,54
31070, 평택시,085005, 84세,2018,1191,405,786,51.5,1185,404,781,51.7
31070, 평택시,090,85~89세,2018,3397,996,2401,41.5,3375,985,2390,41.2
31070, 평택시,090001, 85세,2018,959,318,641,49.6,951,311,640,48.6
31070, 평택시,090002, 86세,2018,811,228,583,39.1,808,226,582,38.8
31070, 평택시,090003, 87세,2018,605,167,438,38.1,604,167,437,38.2
31070, 평택시,090004, 88세,2018,539,152,387,39.3,535,151,384,39.3
31070, 평택시,090005, 89세,2018,483,131,352,37.2,477,130,347,37.5
31070, 평택시,095,90~94세,2018,1099,271,828,32.7,1096,270,826,32.7
31070, 평택시,095001, 90세,2018,367,99,268,36.9,366,98,268,36.6
31070, 평택시,095002, 91세,2018,298,72,226,31.9,297,72,225,32
31070, 평택시,095003, 92세,2018,188,44,144,30.6,187,44,143,30.8
31070, 평택시,095004, 93세,2018,148,29,119,24.4,148,29,119,24.4
31070, 평택시,095005, 94세,2018,98,27,71,38,98,27,71,38
31070, 평택시,100,95~99세,2018,269,71,198,35.9,267,71,196,36.2
31070, 평택시,100001, 95세,2018,110,34,76,44.7,109,34,75,45.3
31070, 평택시,100002, 96세,2018,67,19,48,39.6,66,19,47,40.4
31070, 평택시,100003, 97세,2018,42,10,32,31.3,42,10,32,31.3
31070, 평택시,100004, 98세,2018,29,X,25,16,29,X,25,16
31070, 평택시,100005, 99세,2018,21,X,17,23.5,21,X,17,23.5
31070, 평택시,101,100세이상,2018,32,11,21,52.4,32,11,21,52.4
31070, 평택시,102,15세미만,2018,72534,37089,35445,104.6,70827,36255,34572,104.9
31070, 평택시,103,15~64세,2018,375936,201645,174291,115.7,347100,184260,162840,113.2
31070, 평택시,104,65세이상,2018,56015,23797,32218,73.9,54879,23252,31627,73.5
31070, 평택시,086,85세이상,2018,4797,1349,3448,39.1,4770,1337,3433,38.9
31070, 평택시,126,평균연령,2018,39.6,38.7,40.6,,39.7,38.8,40.7,
31070, 평택시,127,중위연령,2018,40,39.1,41.2,,40.5,39.6,41.5,
31080, 동두천시,000,합계,2018,97535,48888,48647,100.5,93080,46304,46776,99
31080, 동두천시,005,0~4세,2018,3366,1748,1618,108,3247,1676,1571,106.7
31080, 동두천시,005001, 0세,2018,487,240,247,97.2,472,231,241,95.9
31080, 동두천시,005002, 1세,2018,617,316,301,105,589,296,293,101
31080, 동두천시,005003, 2세,2018,705,365,340,107.4,680,348,332,104.8
31080, 동두천시,005004, 3세,2018,778,414,364,113.7,746,394,352,111.9
31080, 동두천시,005005, 4세,2018,779,413,366,112.8,760,407,353,115.3
31080, 동두천시,010,5~9세,2018,4257,2155,2102,102.5,4211,2130,2081,102.4
31080, 동두천시,010001, 5세,2018,805,412,393,104.8,792,404,388,104.1
31080, 동두천시,010002, 6세,2018,833,421,412,102.2,825,416,409,101.7
31080, 동두천시,010003, 7세,2018,868,449,419,107.2,861,448,413,108.5
31080, 동두천시,010004, 8세,2018,884,457,427,107,875,454,421,107.8
31080, 동두천시,010005, 9세,2018,867,416,451,92.2,858,408,450,90.7
31080, 동두천시,015,10~14세,2018,4290,2143,2147,99.8,4237,2118,2119,100
31080, 동두천시,015001, 10세,2018,858,397,461,86.1,845,395,450,87.8
31080, 동두천시,015002, 11세,2018,947,487,460,105.9,932,480,452,106.2
31080, 동두천시,015003, 12세,2018,812,406,406,100,806,402,404,99.5
31080, 동두천시,015004, 13세,2018,804,402,402,100,795,396,399,99.2
31080, 동두천시,015005, 14세,2018,869,451,418,107.9,859,445,414,107.5
31080, 동두천시,020,15~19세,2018,5496,2774,2722,101.9,5428,2728,2700,101
31080, 동두천시,020001, 15세,2018,931,476,455,104.6,925,472,453,104.2
31080, 동두천시,020002, 16세,2018,925,472,453,104.2,916,464,452,102.7
31080, 동두천시,020003, 17세,2018,1271,614,657,93.5,1252,605,647,93.5
31080, 동두천시,020004, 18세,2018,1291,626,665,94.1,1284,623,661,94.3
31080, 동두천시,020005, 19세,2018,1078,586,492,119.1,1051,564,487,115.8
31080, 동두천시,025,20~24세,2018,5837,3187,2650,120.3,5433,2914,2519,115.7
31080, 동두천시,025001, 20세,2018,1110,601,509,118.1,1068,570,498,114.5
31080, 동두천시,025002, 21세,2018,1105,569,536,106.2,1051,530,521,101.7
31080, 동두천시,025003, 22세,2018,1115,622,493,126.2,1029,564,465,121.3
31080, 동두천시,025004, 23세,2018,1239,683,556,122.8,1136,617,519,118.9
31080, 동두천시,025005, 24세,2018,1268,712,556,128.1,1149,633,516,122.7
31080, 동두천시,030,25~29세,2018,5791,3123,2668,117.1,5057,2719,2338,116.3
31080, 동두천시,030001, 25세,2018,1209,673,536,125.6,1081,594,487,122
31080, 동두천시,030002, 26세,2018,1199,663,536,123.7,1060,591,469,126
31080, 동두천시,030003, 27세,2018,1186,612,574,106.6,1034,530,504,105.2
31080, 동두천시,030004, 28세,2018,1126,594,532,111.7,965,514,451,114
31080, 동두천시,030005, 29세,2018,1071,581,490,118.6,917,490,427,114.8
31080, 동두천시,035,30~34세,2018,5477,2885,2592,111.3,4719,2483,2236,111
31080, 동두천시,035001, 30세,2018,1020,568,452,125.7,853,476,377,126.3
31080, 동두천시,035002, 31세,2018,1065,567,498,113.9,914,486,428,113.6
31080, 동두천시,035003, 32세,2018,1095,589,506,116.4,953,516,437,118.1
31080, 동두천시,035004, 33세,2018,1137,593,544,109,990,519,471,110.2
31080, 동두천시,035005, 34세,2018,1160,568,592,95.9,1009,486,523,92.9
31080, 동두천시,040,35~39세,2018,6935,3596,3339,107.7,6321,3240,3081,105.2
31080, 동두천시,040001, 35세,2018,1300,693,607,114.2,1138,606,532,113.9
31080, 동두천시,040002, 36세,2018,1358,701,657,106.7,1245,637,608,104.8
31080, 동두천시,040003, 37세,2018,1443,732,711,103,1332,668,664,100.6
31080, 동두천시,040004, 38세,2018,1447,754,693,108.8,1324,672,652,103.1
31080, 동두천시,040005, 39세,2018,1387,716,671,106.7,1282,657,625,105.1
31080, 동두천시,045,40~44세,2018,7077,3754,3323,113,6609,3462,3147,110
31080, 동두천시,045001, 40세,2018,1257,657,600,109.5,1156,595,561,106.1
31080, 동두천시,045002, 41세,2018,1375,727,648,112.2,1268,658,610,107.9
31080, 동두천시,045003, 42세,2018,1421,772,649,119,1336,722,614,117.6
31080, 동두천시,045004, 43세,2018,1476,783,693,113,1374,718,656,109.5
31080, 동두천시,045005, 44세,2018,1548,815,733,111.2,1475,769,706,108.9
31080, 동두천시,050,45~49세,2018,8486,4462,4024,110.9,8114,4218,3896,108.3
31080, 동두천시,050001, 45세,2018,1629,842,787,107,1552,791,761,103.9
31080, 동두천시,050002, 46세,2018,1704,889,815,109.1,1645,854,791,108
31080, 동두천시,050003, 47세,2018,1721,895,826,108.4,1629,834,795,104.9
31080, 동두천시,050004, 48세,2018,1697,901,796,113.2,1610,841,769,109.4
31080, 동두천시,050005, 49세,2018,1735,935,800,116.9,1678,898,780,115.1
31080, 동두천시,055,50~54세,2018,7931,4263,3668,116.2,7614,4066,3548,114.6
31080, 동두천시,055001, 50세,2018,1750,953,797,119.6,1667,894,773,115.7
31080, 동두천시,055002, 51세,2018,1508,806,702,114.8,1454,771,683,112.9
31080, 동두천시,055003, 52세,2018,1601,893,708,126.1,1549,864,685,126.1
31080, 동두천시,055004, 53세,2018,1601,827,774,106.8,1522,782,740,105.7
31080, 동두천시,055005, 54세,2018,1471,784,687,114.1,1422,755,667,113.2
31080, 동두천시,060,55~59세,2018,8107,4183,3924,106.6,7904,4066,3838,105.9
31080, 동두천시,060001, 55세,2018,1592,849,743,114.3,1527,812,715,113.6
31080, 동두천시,060002, 56세,2018,1580,833,747,111.5,1537,808,729,110.8
31080, 동두천시,060003, 57세,2018,1704,861,843,102.1,1673,843,830,101.6
31080, 동두천시,060004, 58세,2018,1672,845,827,102.2,1639,825,814,101.4
31080, 동두천시,060005, 59세,2018,1559,795,764,104.1,1528,778,750,103.7
31080, 동두천시,065,60~64세,2018,6778,3388,3390,99.9,6610,3311,3299,100.4
31080, 동두천시,065001, 60세,2018,1565,776,789,98.4,1524,766,758,101.1
31080, 동두천시,065002, 61세,2018,1420,717,703,102,1368,692,676,102.4
31080, 동두천시,065003, 62세,2018,1288,637,651,97.8,1261,624,637,98
31080, 동두천시,065004, 63세,2018,1341,682,659,103.5,1317,668,649,102.9
31080, 동두천시,065005, 64세,2018,1164,576,588,98,1140,561,579,96.9
31080, 동두천시,070,65~69세,2018,4625,2154,2471,87.2,4551,2121,2430,87.3
31080, 동두천시,070001, 65세,2018,991,461,530,87,968,454,514,88.3
31080, 동두천시,070002, 66세,2018,1042,497,545,91.2,1030,493,537,91.8
31080, 동두천시,070003, 67세,2018,812,380,432,88,796,371,425,87.3
31080, 동두천시,070004, 68세,2018,856,410,446,91.9,848,404,444,91
31080, 동두천시,070005, 69세,2018,924,406,518,78.4,909,399,510,78.2
31080, 동두천시,075,70~74세,2018,4346,1848,2498,74,4322,1837,2485,73.9
31080, 동두천시,075001, 70세,2018,953,404,549,73.6,947,400,547,73.1
31080, 동두천시,075002, 71세,2018,1050,465,585,79.5,1043,459,584,78.6
31080, 동두천시,075003, 72세,2018,815,362,453,79.9,810,362,448,80.8
31080, 동두천시,075004, 73세,2018,752,330,422,78.2,748,330,418,78.9
31080, 동두천시,075005, 74세,2018,776,287,489,58.7,774,286,488,58.6
31080, 동두천시,080,75~79세,2018,4256,1717,2539,67.6,4239,1710,2529,67.6
31080, 동두천시,080001, 75세,2018,832,368,464,79.3,828,367,461,79.6
31080, 동두천시,080002, 76세,2018,971,383,588,65.1,966,382,584,65.4
31080, 동두천시,080003, 77세,2018,921,370,551,67.2,919,368,551,66.8
31080, 동두천시,080004, 78세,2018,799,318,481,66.1,795,316,479,66
31080, 동두천시,080005, 79세,2018,733,278,455,61.1,731,277,454,61
31080, 동두천시,085,80~84세,2018,2700,1002,1698,59,2690,1001,1689,59.3
31080, 동두천시,085001, 80세,2018,710,278,432,64.4,708,278,430,64.7
31080, 동두천시,085002, 81세,2018,603,215,388,55.4,601,215,386,55.7
31080, 동두천시,085003, 82세,2018,556,219,337,65,551,218,333,65.5
31080, 동두천시,085004, 83세,2018,468,171,297,57.6,468,171,297,57.6
31080, 동두천시,085005, 84세,2018,363,119,244,48.8,362,119,243,49
31080, 동두천시,090,85~89세,2018,1196,370,826,44.8,1192,368,824,44.7
31080, 동두천시,090001, 85세,2018,326,102,224,45.5,324,102,222,45.9
31080, 동두천시,090002, 86세,2018,291,101,190,53.2,291,101,190,53.2
31080, 동두천시,090003, 87세,2018,209,56,153,36.6,208,55,153,35.9
31080, 동두천시,090004, 88세,2018,194,61,133,45.9,193,60,133,45.1
31080, 동두천시,090005, 89세,2018,176,50,126,39.7,176,50,126,39.7
31080, 동두천시,095,90~94세,2018,457,103,354,29.1,455,103,352,29.3
31080, 동두천시,095001, 90세,2018,168,44,124,35.5,167,44,123,35.8
31080, 동두천시,095002, 91세,2018,103,23,80,28.8,103,23,80,28.8
31080, 동두천시,095003, 92세,2018,80,15,65,23.1,80,15,65,23.1
31080, 동두천시,095004, 93세,2018,64,12,52,23.1,64,12,52,23.1
31080, 동두천시,095005, 94세,2018,42,9,33,27.3,41,9,32,28.1
31080, 동두천시,100,95~99세,2018,109,30,79,38,109,30,79,38
31080, 동두천시,100001, 95세,2018,38,8,30,26.7,38,8,30,26.7
31080, 동두천시,100002, 96세,2018,32,11,21,52.4,32,11,21,52.4
31080, 동두천시,100003, 97세,2018,15,6,9,66.7,15,6,9,66.7
31080, 동두천시,100004, 98세,2018,16,X,13,23.1,16,X,13,23.1
31080, 동두천시,100005, 99세,2018,8,X,6,33.3,8,X,6,33.3
31080, 동두천시,101,100세이상,2018,18,X,15,20,18,X,15,20
31080, 동두천시,102,15세미만,2018,11913,6046,5867,103.1,11695,5924,5771,102.7
31080, 동두천시,103,15~64세,2018,67915,35615,32300,110.3,63809,33207,30602,108.5
31080, 동두천시,104,65세이상,2018,17707,7227,10480,69,17576,7173,10403,69
31080, 동두천시,086,85세이상,2018,1780,506,1274,39.7,1774,504,1270,39.7
31080, 동두천시,126,평균연령,2018,43.7,42.3,45.2,,44.1,42.6,45.5,
31080, 동두천시,127,중위연령,2018,45.1,43.9,46.5,,45.8,44.6,47.1,
31090, 안산시,000,합계,2018,720105,373477,346628,107.7,643837,329424,314413,104.8
31090, 안산시,005,0~4세,2018,24747,12628,12119,104.2,22365,11409,10956,104.1
31090, 안산시,005001, 0세,2018,4187,2144,2043,104.9,3712,1900,1812,104.9
31090, 안산시,005002, 1세,2018,4582,2362,2220,106.4,4087,2110,1977,106.7
31090, 안산시,005003, 2세,2018,5104,2643,2461,107.4,4592,2378,2214,107.4
31090, 안산시,005004, 3세,2018,5515,2764,2751,100.5,5065,2539,2526,100.5
31090, 안산시,005005, 4세,2018,5359,2715,2644,102.7,4909,2482,2427,102.3
31090, 안산시,010,5~9세,2018,28152,14372,13780,104.3,26720,13654,13066,104.5
31090, 안산시,010001, 5세,2018,5309,2683,2626,102.2,4940,2515,2425,103.7
31090, 안산시,010002, 6세,2018,5733,2883,2850,101.2,5409,2718,2691,101
31090, 안산시,010003, 7세,2018,5797,2939,2858,102.8,5546,2806,2740,102.4
31090, 안산시,010004, 8세,2018,5656,2924,2732,107,5418,2790,2628,106.2
31090, 안산시,010005, 9세,2018,5657,2943,2714,108.4,5407,2825,2582,109.4
31090, 안산시,015,10~14세,2018,31114,16017,15097,106.1,30212,15583,14629,106.5
31090, 안산시,015001, 10세,2018,6070,3159,2911,108.5,5843,3045,2798,108.8
31090, 안산시,015002, 11세,2018,6518,3312,3206,103.3,6294,3212,3082,104.2
31090, 안산시,015003, 12세,2018,5771,3021,2750,109.9,5605,2937,2668,110.1
31090, 안산시,015004, 13세,2018,6039,3061,2978,102.8,5905,2998,2907,103.1
31090, 안산시,015005, 14세,2018,6716,3464,3252,106.5,6565,3391,3174,106.8
31090, 안산시,020,15~19세,2018,42368,22071,20297,108.7,41419,21572,19847,108.7
31090, 안산시,020001, 15세,2018,6926,3546,3380,104.9,6794,3485,3309,105.3
31090, 안산시,020002, 16세,2018,7493,3843,3650,105.3,7354,3780,3574,105.8
31090, 안산시,020003, 17세,2018,8836,4583,4253,107.8,8709,4507,4202,107.3
31090, 안산시,020004, 18세,2018,9632,5098,4534,112.4,9401,4969,4432,112.1
31090, 안산시,020005, 19세,2018,9481,5001,4480,111.6,9161,4831,4330,111.6
31090, 안산시,025,20~24세,2018,56084,29838,26246,113.7,52120,27363,24757,110.5
31090, 안산시,025001, 20세,2018,9932,5230,4702,111.2,9461,4968,4493,110.6
31090, 안산시,025002, 21세,2018,10642,5783,4859,119,10024,5398,4626,116.7
31090, 안산시,025003, 22세,2018,11325,5996,5329,112.5,10535,5506,5029,109.5
31090, 안산시,025004, 23세,2018,11983,6259,5724,109.3,11006,5655,5351,105.7
31090, 안산시,025005, 24세,2018,12202,6570,5632,116.7,11094,5836,5258,111
31090, 안산시,030,25~29세,2018,59096,32989,26107,126.4,50361,27306,23055,118.4
31090, 안산시,030001, 25세,2018,12287,6705,5582,120.1,10987,5850,5137,113.9
31090, 안산시,030002, 26세,2018,12790,7076,5714,123.8,11180,5987,5193,115.3
31090, 안산시,030003, 27세,2018,11789,6618,5171,128,10081,5481,4600,119.2
31090, 안산시,030004, 28세,2018,11279,6368,4911,129.7,9329,5111,4218,121.2
31090, 안산시,030005, 29세,2018,10951,6222,4729,131.6,8784,4877,3907,124.8
31090, 안산시,035,30~34세,2018,50682,28659,22023,130.1,39498,21677,17821,121.6
31090, 안산시,035001, 30세,2018,10455,5942,4513,131.7,8181,4509,3672,122.8
31090, 안산시,035002, 31세,2018,10148,5829,4319,135,7802,4385,3417,128.3
31090, 안산시,035003, 32세,2018,10080,5697,4383,130,7758,4264,3494,122
31090, 안산시,035004, 33세,2018,9856,5492,4364,125.8,7684,4142,3542,116.9
31090, 안산시,035005, 34세,2018,10143,5699,4444,128.2,8073,4377,3696,118.4
31090, 안산시,040,35~39세,2018,56283,30728,25555,120.2,47189,25089,22100,113.5
31090, 안산시,040001, 35세,2018,10610,5908,4702,125.6,8737,4730,4007,118
31090, 안산시,040002, 36세,2018,11549,6463,5086,127.1,9527,5201,4326,120.2
31090, 안산시,040003, 37세,2018,11197,6110,5087,120.1,9450,5065,4385,115.5
31090, 안산시,040004, 38세,2018,11763,6301,5462,115.4,10077,5248,4829,108.7
31090, 안산시,040005, 39세,2018,11164,5946,5218,114,9398,4845,4553,106.4
31090, 안산시,045,40~44세,2018,57344,30181,27163,111.1,50091,25783,24308,106.1
31090, 안산시,045001, 40세,2018,10549,5592,4957,112.8,8993,4663,4330,107.7
31090, 안산시,045002, 41세,2018,10880,5779,5101,113.3,9421,4871,4550,107.1
31090, 안산시,045003, 42세,2018,10950,5799,5151,112.6,9512,4915,4597,106.9
31090, 안산시,045004, 43세,2018,11886,6200,5686,109,10531,5372,5159,104.1
31090, 안산시,045005, 44세,2018,13079,6811,6268,108.7,11634,5962,5672,105.1
31090, 안산시,050,45~49세,2018,72922,36671,36251,101.2,64500,31843,32657,97.5
31090, 안산시,050001, 45세,2018,13477,6853,6624,103.5,11959,5970,5989,99.7
31090, 안산시,050002, 46세,2018,13906,7048,6858,102.8,12276,6060,6216,97.5
31090, 안산시,050003, 47세,2018,15126,7572,7554,100.2,13308,6569,6739,97.5
31090, 안산시,050004, 48세,2018,14881,7497,7384,101.5,13121,6493,6628,98
31090, 안산시,050005, 49세,2018,15532,7701,7831,98.3,13836,6751,7085,95.3
31090, 안산시,055,50~54세,2018,71199,36436,34763,104.8,63534,32222,31312,102.9
31090, 안산시,055001, 50세,2018,15423,7696,7727,99.6,13792,6782,7010,96.7
31090, 안산시,055002, 51세,2018,14057,7113,6944,102.4,12723,6350,6373,99.6
31090, 안산시,055003, 52세,2018,14128,7269,6859,106,12593,6448,6145,104.9
31090, 안산시,055004, 53세,2018,14552,7497,7055,106.3,12897,6601,6296,104.8
31090, 안산시,055005, 54세,2018,13039,6861,6178,111.1,11529,6041,5488,110.1
31090, 안산시,060,55~59세,2018,63942,34103,29839,114.3,57677,30849,26828,115
31090, 안산시,060001, 55세,2018,13514,7239,6275,115.4,11734,6294,5440,115.7
31090, 안산시,060002, 56세,2018,13393,7110,6283,113.2,11998,6385,5613,113.8
31090, 안산시,060003, 57세,2018,13272,7030,6242,112.6,12421,6593,5828,113.1
31090, 안산시,060004, 58세,2018,12873,6853,6020,113.8,11601,6211,5390,115.2
31090, 안산시,060005, 59세,2018,10890,5871,5019,117,9923,5366,4557,117.8
31090, 안산시,065,60~64세,2018,40503,21185,19318,109.7,35827,18823,17004,110.7
31090, 안산시,065001, 60세,2018,9937,5359,4578,117.1,8889,4817,4072,118.3
31090, 안산시,065002, 61세,2018,9133,4797,4336,110.6,8029,4241,3788,112
31090, 안산시,065003, 62세,2018,7906,4124,3782,109,6947,3654,3293,111
31090, 안산시,065004, 63세,2018,7470,3836,3634,105.6,6648,3424,3224,106.2
31090, 안산시,065005, 64세,2018,6057,3069,2988,102.7,5314,2687,2627,102.3
31090, 안산시,070,65~69세,2018,22071,11006,11065,99.5,19973,10053,9920,101.3
31090, 안산시,070001, 65세,2018,5072,2609,2463,105.9,4456,2310,2146,107.6
31090, 안산시,070002, 66세,2018,5330,2660,2670,99.6,4889,2464,2425,101.6
31090, 안산시,070003, 67세,2018,3787,1916,1871,102.4,3366,1716,1650,104
31090, 안산시,070004, 68세,2018,4044,1967,2077,94.7,3731,1826,1905,95.9
31090, 안산시,070005, 69세,2018,3838,1854,1984,93.4,3531,1737,1794,96.8
31090, 안산시,075,70~74세,2018,15392,7010,8382,83.6,14760,6785,7975,85.1
31090, 안산시,075001, 70세,2018,3606,1702,1904,89.4,3446,1644,1802,91.2
31090, 안산시,075002, 71세,2018,3641,1706,1935,88.2,3469,1642,1827,89.9
31090, 안산시,075003, 72세,2018,2799,1283,1516,84.6,2675,1243,1432,86.8
31090, 안산시,075004, 73세,2018,2671,1163,1508,77.1,2587,1134,1453,78
31090, 안산시,075005, 74세,2018,2675,1156,1519,76.1,2583,1122,1461,76.8
31090, 안산시,080,75~79세,2018,13172,5216,7956,65.6,12811,5101,7710,66.2
31090, 안산시,080001, 75세,2018,2787,1156,1631,70.9,2712,1133,1579,71.8
31090, 안산시,080002, 76세,2018,3123,1300,1823,71.3,3043,1274,1769,72
31090, 안산시,080003, 77세,2018,2536,968,1568,61.7,2466,944,1522,62
31090, 안산시,080004, 78세,2018,2361,914,1447,63.2,2289,889,1400,63.5
31090, 안산시,080005, 79세,2018,2365,878,1487,59,2301,861,1440,59.8
31090, 안산시,085,80~84세,2018,8988,2879,6109,47.1,8791,2830,5961,47.5
31090, 안산시,085001, 80세,2018,2114,707,1407,50.2,2048,693,1355,51.1
31090, 안산시,085002, 81세,2018,1954,668,1286,51.9,1914,654,1260,51.9
31090, 안산시,085003, 82세,2018,1798,577,1221,47.3,1762,572,1190,48.1
31090, 안산시,085004, 83세,2018,1757,536,1221,43.9,1723,528,1195,44.2
31090, 안산시,085005, 84세,2018,1365,391,974,40.1,1344,383,961,39.9
31090, 안산시,090,85~89세,2018,4183,1142,3041,37.6,4132,1137,2995,38
31090, 안산시,090001, 85세,2018,1152,337,815,41.3,1141,336,805,41.7
31090, 안산시,090002, 86세,2018,1051,294,757,38.8,1037,291,746,39
31090, 안산시,090003, 87세,2018,750,213,537,39.7,738,212,526,40.3
31090, 안산시,090004, 88세,2018,681,168,513,32.7,672,168,504,33.3
31090, 안산시,090005, 89세,2018,549,130,419,31,544,130,414,31.4
31090, 안산시,095,90~94세,2018,1472,280,1192,23.5,1466,279,1187,23.5
31090, 안산시,095001, 90세,2018,466,94,372,25.3,463,93,370,25.1
31090, 안산시,095002, 91세,2018,364,59,305,19.3,363,59,304,19.4
31090, 안산시,095003, 92세,2018,278,63,215,29.3,277,63,214,29.4
31090, 안산시,095004, 93세,2018,213,35,178,19.7,213,35,178,19.7
31090, 안산시,095005, 94세,2018,151,29,122,23.8,150,29,121,24
31090, 안산시,100,95~99세,2018,339,61,278,21.9,339,61,278,21.9
31090, 안산시,100001, 95세,2018,134,31,103,30.1,134,31,103,30.1
31090, 안산시,100002, 96세,2018,96,15,81,18.5,96,15,81,18.5
31090, 안산시,100003, 97세,2018,46,6,40,15,46,6,40,15
31090, 안산시,100004, 98세,2018,43,8,35,22.9,43,8,35,22.9
31090, 안산시,100005, 99세,2018,20,X,19,5.3,20,X,19,5.3
31090, 안산시,101,100세이상,2018,52,5,47,10.6,52,5,47,10.6
31090, 안산시,102,15세미만,2018,84013,43017,40996,104.9,79297,40646,38651,105.2
31090, 안산시,103,15~64세,2018,570423,302861,267562,113.2,502216,262527,239689,109.5
31090, 안산시,104,65세이상,2018,65669,27599,38070,72.5,62324,26251,36073,72.8
31090, 안산시,086,85세이상,2018,6046,1488,4558,32.6,5989,1482,4507,32.9
31090, 안산시,126,평균연령,2018,40,39.2,40.9,,39.9,39.1,40.8,
31090, 안산시,127,중위연령,2018,41.1,39.9,42.4,,41.3,40.2,42.5,
31091, 상록구,000,합계,2018,367063,187160,179903,104,349690,178053,171637,103.7
31091, 상록구,005,0~4세,2018,12968,6692,6276,106.6,12228,6301,5927,106.3
31091, 상록구,005001, 0세,2018,2190,1128,1062,106.2,2023,1039,984,105.6
31091, 상록구,005002, 1세,2018,2355,1212,1143,106,2198,1135,1063,106.8
31091, 상록구,005003, 2세,2018,2682,1420,1262,112.5,2537,1335,1202,111.1
31091, 상록구,005004, 3세,2018,2979,1510,1469,102.8,2836,1442,1394,103.4
31091, 상록구,005005, 4세,2018,2762,1422,1340,106.1,2634,1350,1284,105.1
31091, 상록구,010,5~9세,2018,14567,7434,7133,104.2,14211,7246,6965,104
31091, 상록구,010001, 5세,2018,2760,1391,1369,101.6,2665,1342,1323,101.4
31091, 상록구,010002, 6세,2018,2951,1507,1444,104.4,2875,1465,1410,103.9
31091, 상록구,010003, 7세,2018,2987,1495,1492,100.2,2926,1469,1457,100.8
31091, 상록구,010004, 8세,2018,2968,1529,1439,106.3,2908,1490,1418,105.1
31091, 상록구,010005, 9세,2018,2901,1512,1389,108.9,2837,1480,1357,109.1
31091, 상록구,015,10~14세,2018,16095,8270,7825,105.7,15907,8176,7731,105.8
31091, 상록구,015001, 10세,2018,3064,1590,1474,107.9,3013,1562,1451,107.6
31091, 상록구,015002, 11세,2018,3379,1704,1675,101.7,3333,1681,1652,101.8
31091, 상록구,015003, 12세,2018,3009,1573,1436,109.5,2973,1556,1417,109.8
31091, 상록구,015004, 13세,2018,3155,1567,1588,98.7,3133,1557,1576,98.8
31091, 상록구,015005, 14세,2018,3488,1836,1652,111.1,3455,1820,1635,111.3
31091, 상록구,020,15~19세,2018,22635,11715,10920,107.3,22340,11553,10787,107.1
31091, 상록구,020001, 15세,2018,3605,1835,1770,103.7,3572,1818,1754,103.6
31091, 상록구,020002, 16세,2018,3901,2013,1888,106.6,3878,2000,1878,106.5
31091, 상록구,020003, 17세,2018,4589,2334,2255,103.5,4552,2311,2241,103.1
31091, 상록구,020004, 18세,2018,5128,2709,2419,112,5043,2659,2384,111.5
31091, 상록구,020005, 19세,2018,5412,2824,2588,109.1,5295,2765,2530,109.3
31091, 상록구,025,20~24세,2018,30861,16235,14626,111,29673,15617,14056,111.1
31091, 상록구,025001, 20세,2018,5629,2932,2697,108.7,5446,2848,2598,109.6
31091, 상록구,025002, 21세,2018,5911,3151,2760,114.2,5695,3033,2662,113.9
31091, 상록구,025003, 22세,2018,6258,3293,2965,111.1,5999,3151,2848,110.6
31091, 상록구,025004, 23세,2018,6513,3362,3151,106.7,6241,3229,3012,107.2
31091, 상록구,025005, 24세,2018,6550,3497,3053,114.5,6292,3356,2936,114.3
31091, 상록구,030,25~29세,2018,29858,16189,13669,118.4,27764,15039,12725,118.2
31091, 상록구,030001, 25세,2018,6469,3491,2978,117.2,6148,3315,2833,117
31091, 상록구,030002, 26세,2018,6624,3575,3049,117.3,6245,3365,2880,116.8
31091, 상록구,030003, 27세,2018,5966,3202,2764,115.8,5581,2980,2601,114.6
31091, 상록구,030004, 28세,2018,5574,3031,2543,119.2,5089,2758,2331,118.3
31091, 상록구,030005, 29세,2018,5225,2890,2335,123.8,4701,2621,2080,126
31091, 상록구,035,30~34세,2018,23950,13037,10913,119.5,21350,11609,9741,119.2
31091, 상록구,035001, 30세,2018,4931,2712,2219,122.2,4454,2449,2005,122.1
31091, 상록구,035002, 31세,2018,4748,2588,2160,119.8,4220,2310,1910,120.9
31091, 상록구,035003, 32세,2018,4796,2588,2208,117.2,4221,2281,1940,117.6
31091, 상록구,035004, 33세,2018,4633,2540,2093,121.4,4135,2252,1883,119.6
31091, 상록구,035005, 34세,2018,4842,2609,2233,116.8,4320,2317,2003,115.7
31091, 상록구,040,35~39세,2018,27140,14366,12774,112.5,25102,13243,11859,111.7
31091, 상록구,040001, 35세,2018,5105,2744,2361,116.2,4686,2508,2178,115.2
31091, 상록구,040002, 36세,2018,5533,3018,2515,120,5102,2781,2321,119.8
31091, 상록구,040003, 37세,2018,5328,2820,2508,112.4,4922,2611,2311,113
31091, 상록구,040004, 38세,2018,5714,2976,2738,108.7,5331,2768,2563,108
31091, 상록구,040005, 39세,2018,5460,2808,2652,105.9,5061,2575,2486,103.6
31091, 상록구,045,40~44세,2018,28278,14620,13658,107,26719,13732,12987,105.7
31091, 상록구,045001, 40세,2018,5097,2692,2405,111.9,4784,2517,2267,111
31091, 상록구,045002, 41세,2018,5331,2774,2557,108.5,5042,2619,2423,108.1
31091, 상록구,045003, 42세,2018,5388,2828,2560,110.5,5073,2643,2430,108.8
31091, 상록구,045004, 43세,2018,5949,3007,2942,102.2,5623,2816,2807,100.3
31091, 상록구,045005, 44세,2018,6513,3319,3194,103.9,6197,3137,3060,102.5
31091, 상록구,050,45~49세,2018,36566,18060,18506,97.6,35000,17227,17773,96.9
31091, 상록구,050001, 45세,2018,6700,3319,3381,98.2,6412,3173,3239,98
31091, 상록구,050002, 46세,2018,7010,3531,3479,101.5,6674,3332,3342,99.7
31091, 상록구,050003, 47세,2018,7520,3684,3836,96,7185,3509,3676,95.5
31091, 상록구,050004, 48세,2018,7475,3714,3761,98.8,7161,3548,3613,98.2
31091, 상록구,050005, 49세,2018,7861,3812,4049,94.1,7568,3665,3903,93.9
31091, 상록구,055,50~54세,2018,35660,17942,17718,101.3,34221,17196,17025,101
31091, 상록구,055001, 50세,2018,7704,3733,3971,94,7406,3573,3833,93.2
31091, 상록구,055002, 51세,2018,7210,3604,3606,99.9,6950,3472,3478,99.8
31091, 상록구,055003, 52세,2018,7160,3637,3523,103.2,6865,3483,3382,103
31091, 상록구,055004, 53세,2018,7240,3684,3556,103.6,6958,3532,3426,103.1
31091, 상록구,055005, 54세,2018,6346,3284,3062,107.3,6042,3136,2906,107.9
31091, 상록구,060,55~59세,2018,32284,17164,15120,113.5,30893,16516,14377,114.9
31091, 상록구,060001, 55세,2018,6727,3576,3151,113.5,6347,3404,2943,115.7
31091, 상록구,060002, 56세,2018,6681,3574,3107,115,6370,3426,2944,116.4
31091, 상록구,060003, 57세,2018,6891,3633,3258,111.5,6688,3542,3146,112.6
31091, 상록구,060004, 58세,2018,6469,3435,3034,113.2,6203,3312,2891,114.6
31091, 상록구,060005, 59세,2018,5516,2946,2570,114.6,5285,2832,2453,115.5
31091, 상록구,065,60~64세,2018,20178,10443,9735,107.3,19116,9934,9182,108.2
31091, 상록구,065001, 60세,2018,4917,2642,2275,116.1,4672,2517,2155,116.8
31091, 상록구,065002, 61세,2018,4601,2355,2246,104.9,4335,2233,2102,106.2
31091, 상록구,065003, 62세,2018,3931,2056,1875,109.7,3721,1959,1762,111.2
31091, 상록구,065004, 63세,2018,3725,1887,1838,102.7,3556,1812,1744,103.9
31091, 상록구,065005, 64세,2018,3004,1503,1501,100.1,2832,1413,1419,99.6
31091, 상록구,070,65~69세,2018,11265,5562,5703,97.5,10757,5342,5415,98.7
31091, 상록구,070001, 65세,2018,2532,1291,1241,104,2385,1225,1160,105.6
31091, 상록구,070002, 66세,2018,2758,1376,1382,99.6,2649,1333,1316,101.3
31091, 상록구,070003, 67세,2018,1908,915,993,92.1,1799,863,936,92.2
31091, 상록구,070004, 68세,2018,2066,1027,1039,98.8,1992,995,997,99.8
31091, 상록구,070005, 69세,2018,2001,953,1048,90.9,1932,926,1006,92
31091, 상록구,075,70~74세,2018,8687,3880,4807,80.7,8505,3817,4688,81.4
31091, 상록구,075001, 70세,2018,2018,930,1088,85.5,1980,918,1062,86.4
31091, 상록구,075002, 71세,2018,2053,951,1102,86.3,1992,928,1064,87.2
31091, 상록구,075003, 72세,2018,1583,715,868,82.4,1553,703,850,82.7
31091, 상록구,075004, 73세,2018,1546,662,884,74.9,1522,657,865,76
31091, 상록구,075005, 74세,2018,1487,622,865,71.9,1458,611,847,72.1
31091, 상록구,080,75~79세,2018,7609,3002,4607,65.2,7517,2966,4551,65.2
31091, 상록구,080001, 75세,2018,1624,659,965,68.3,1603,653,950,68.7
31091, 상록구,080002, 76세,2018,1848,767,1081,71,1831,758,1073,70.6
31091, 상록구,080003, 77세,2018,1463,565,898,62.9,1443,558,885,63.1
31091, 상록구,080004, 78세,2018,1350,523,827,63.2,1331,514,817,62.9
31091, 상록구,080005, 79세,2018,1324,488,836,58.4,1309,483,826,58.5
31091, 상록구,085,80~84세,2018,5081,1664,3417,48.7,5026,1657,3369,49.2
31091, 상록구,085001, 80세,2018,1208,413,795,51.9,1187,411,776,53
31091, 상록구,085002, 81세,2018,1139,391,748,52.3,1130,389,741,52.5
31091, 상록구,085003, 82세,2018,1019,336,683,49.2,1007,335,672,49.9
31091, 상록구,085004, 83세,2018,940,290,650,44.6,933,290,643,45.1
31091, 상록구,085005, 84세,2018,775,234,541,43.3,769,232,537,43.2
31091, 상록구,090,85~89세,2018,2320,693,1627,42.6,2302,690,1612,42.8
31091, 상록구,090001, 85세,2018,631,193,438,44.1,628,193,435,44.4
31091, 상록구,090002, 86세,2018,605,189,416,45.4,598,187,411,45.5
31091, 상록구,090003, 87세,2018,415,122,293,41.6,411,121,290,41.7
31091, 상록구,090004, 88세,2018,363,106,257,41.2,360,106,254,41.7
31091, 상록구,090005, 89세,2018,306,83,223,37.2,305,83,222,37.4
31091, 상록구,095,90~94세,2018,828,156,672,23.2,826,156,670,23.3
31091, 상록구,095001, 90세,2018,257,55,202,27.2,255,55,200,27.5
31091, 상록구,095002, 91세,2018,203,29,174,16.7,203,29,174,16.7
31091, 상록구,095003, 92세,2018,162,37,125,29.6,162,37,125,29.6
31091, 상록구,095004, 93세,2018,116,20,96,20.8,116,20,96,20.8
31091, 상록구,095005, 94세,2018,90,15,75,20,90,15,75,20
31091, 상록구,100,95~99세,2018,201,33,168,19.6,201,33,168,19.6
31091, 상록구,100001, 95세,2018,73,13,60,21.7,73,13,60,21.7
31091, 상록구,100002, 96세,2018,57,11,46,23.9,57,11,46,23.9
31091, 상록구,100003, 97세,2018,28,X,25,12,28,X,25,12
31091, 상록구,100004, 98세,2018,31,5,26,19.2,31,5,26,19.2
31091, 상록구,100005, 99세,2018,12,X,11,9.1,12,X,11,9.1
31091, 상록구,101,100세이상,2018,32,X,29,10.3,32,X,29,10.3
31091, 상록구,102,15세미만,2018,43630,22396,21234,105.5,42346,21723,20623,105.3
31091, 상록구,103,15~64세,2018,287410,149771,137639,108.8,272178,141666,130512,108.5
31091, 상록구,104,65세이상,2018,36023,14993,21030,71.3,35166,14664,20502,71.5
31091, 상록구,086,85세이상,2018,3381,885,2496,35.5,3361,882,2479,35.6
31091, 상록구,126,평균연령,2018,40,39.1,40.9,,40,39.1,40.9,
31091, 상록구,127,중위연령,2018,41.1,39.9,42.3,,41.3,40.1,42.6,
31092, 단원구,000,합계,2018,353042,186317,166725,111.8,294147,151371,142776,106
31092, 단원구,005,0~4세,2018,11779,5936,5843,101.6,10137,5108,5029,101.6
31092, 단원구,005001, 0세,2018,1997,1016,981,103.6,1689,861,828,104
31092, 단원구,005002, 1세,2018,2227,1150,1077,106.8,1889,975,914,106.7
31092, 단원구,005003, 2세,2018,2422,1223,1199,102,2055,1043,1012,103.1
31092, 단원구,005004, 3세,2018,2536,1254,1282,97.8,2229,1097,1132,96.9
31092, 단원구,005005, 4세,2018,2597,1293,1304,99.2,2275,1132,1143,99
31092, 단원구,010,5~9세,2018,13585,6938,6647,104.4,12509,6408,6101,105
31092, 단원구,010001, 5세,2018,2549,1292,1257,102.8,2275,1173,1102,106.4
31092, 단원구,010002, 6세,2018,2782,1376,1406,97.9,2534,1253,1281,97.8
31092, 단원구,010003, 7세,2018,2810,1444,1366,105.7,2620,1337,1283,104.2
31092, 단원구,010004, 8세,2018,2688,1395,1293,107.9,2510,1300,1210,107.4
31092, 단원구,010005, 9세,2018,2756,1431,1325,108,2570,1345,1225,109.8
31092, 단원구,015,10~14세,2018,15019,7747,7272,106.5,14305,7407,6898,107.4
31092, 단원구,015001, 10세,2018,3006,1569,1437,109.2,2830,1483,1347,110.1
31092, 단원구,015002, 11세,2018,3139,1608,1531,105,2961,1531,1430,107.1
31092, 단원구,015003, 12세,2018,2762,1448,1314,110.2,2632,1381,1251,110.4
31092, 단원구,015004, 13세,2018,2884,1494,1390,107.5,2772,1441,1331,108.3
31092, 단원구,015005, 14세,2018,3228,1628,1600,101.8,3110,1571,1539,102.1
31092, 단원구,020,15~19세,2018,19733,10356,9377,110.4,19079,10019,9060,110.6
31092, 단원구,020001, 15세,2018,3321,1711,1610,106.3,3222,1667,1555,107.2
31092, 단원구,020002, 16세,2018,3592,1830,1762,103.9,3476,1780,1696,105
31092, 단원구,020003, 17세,2018,4247,2249,1998,112.6,4157,2196,1961,112
31092, 단원구,020004, 18세,2018,4504,2389,2115,113,4358,2310,2048,112.8
31092, 단원구,020005, 19세,2018,4069,2177,1892,115.1,3866,2066,1800,114.8
31092, 단원구,025,20~24세,2018,25223,13603,11620,117.1,22447,11746,10701,109.8
31092, 단원구,025001, 20세,2018,4303,2298,2005,114.6,4015,2120,1895,111.9
31092, 단원구,025002, 21세,2018,4731,2632,2099,125.4,4329,2365,1964,120.4
31092, 단원구,025003, 22세,2018,5067,2703,2364,114.3,4536,2355,2181,108
31092, 단원구,025004, 23세,2018,5470,2897,2573,112.6,4765,2426,2339,103.7
31092, 단원구,025005, 24세,2018,5652,3073,2579,119.2,4802,2480,2322,106.8
31092, 단원구,030,25~29세,2018,29238,16800,12438,135.1,22597,12267,10330,118.8
31092, 단원구,030001, 25세,2018,5818,3214,2604,123.4,4839,2535,2304,110
31092, 단원구,030002, 26세,2018,6166,3501,2665,131.4,4935,2622,2313,113.4
31092, 단원구,030003, 27세,2018,5823,3416,2407,141.9,4500,2501,1999,125.1
31092, 단원구,030004, 28세,2018,5705,3337,2368,140.9,4240,2353,1887,124.7
31092, 단원구,030005, 29세,2018,5726,3332,2394,139.2,4083,2256,1827,123.5
31092, 단원구,035,30~34세,2018,26732,15622,11110,140.6,18148,10068,8080,124.6
31092, 단원구,035001, 30세,2018,5524,3230,2294,140.8,3727,2060,1667,123.6
31092, 단원구,035002, 31세,2018,5400,3241,2159,150.1,3582,2075,1507,137.7
31092, 단원구,035003, 32세,2018,5284,3109,2175,142.9,3537,1983,1554,127.6
31092, 단원구,035004, 33세,2018,5223,2952,2271,130,3549,1890,1659,113.9
31092, 단원구,035005, 34세,2018,5301,3090,2211,139.8,3753,2060,1693,121.7
31092, 단원구,040,35~39세,2018,29143,16362,12781,128,22087,11846,10241,115.7
31092, 단원구,040001, 35세,2018,5505,3164,2341,135.2,4051,2222,1829,121.5
31092, 단원구,040002, 36세,2018,6016,3445,2571,134,4425,2420,2005,120.7
31092, 단원구,040003, 37세,2018,5869,3290,2579,127.6,4528,2454,2074,118.3
31092, 단원구,040004, 38세,2018,6049,3325,2724,122.1,4746,2480,2266,109.4
31092, 단원구,040005, 39세,2018,5704,3138,2566,122.3,4337,2270,2067,109.8
31092, 단원구,045,40~44세,2018,29066,15561,13505,115.2,23372,12051,11321,106.4
31092, 단원구,045001, 40세,2018,5452,2900,2552,113.6,4209,2146,2063,104
31092, 단원구,045002, 41세,2018,5549,3005,2544,118.1,4379,2252,2127,105.9
31092, 단원구,045003, 42세,2018,5562,2971,2591,114.7,4439,2272,2167,104.8
31092, 단원구,045004, 43세,2018,5937,3193,2744,116.4,4908,2556,2352,108.7
31092, 단원구,045005, 44세,2018,6566,3492,3074,113.6,5437,2825,2612,108.2
31092, 단원구,050,45~49세,2018,36356,18611,17745,104.9,29500,14616,14884,98.2
31092, 단원구,050001, 45세,2018,6777,3534,3243,109,5547,2797,2750,101.7
31092, 단원구,050002, 46세,2018,6896,3517,3379,104.1,5602,2728,2874,94.9
31092, 단원구,050003, 47세,2018,7606,3888,3718,104.6,6123,3060,3063,99.9
31092, 단원구,050004, 48세,2018,7406,3783,3623,104.4,5960,2945,3015,97.7
31092, 단원구,050005, 49세,2018,7671,3889,3782,102.8,6268,3086,3182,97
31092, 단원구,055,50~54세,2018,35539,18494,17045,108.5,29313,15026,14287,105.2
31092, 단원구,055001, 50세,2018,7719,3963,3756,105.5,6386,3209,3177,101
31092, 단원구,055002, 51세,2018,6847,3509,3338,105.1,5773,2878,2895,99.4
31092, 단원구,055003, 52세,2018,6968,3632,3336,108.9,5728,2965,2763,107.3
31092, 단원구,055004, 53세,2018,7312,3813,3499,109,5939,3069,2870,106.9
31092, 단원구,055005, 54세,2018,6693,3577,3116,114.8,5487,2905,2582,112.5
31092, 단원구,060,55~59세,2018,31658,16939,14719,115.1,26784,14333,12451,115.1
31092, 단원구,060001, 55세,2018,6787,3663,3124,117.3,5387,2890,2497,115.7
31092, 단원구,060002, 56세,2018,6712,3536,3176,111.3,5628,2959,2669,110.9
31092, 단원구,060003, 57세,2018,6381,3397,2984,113.8,5733,3051,2682,113.8
31092, 단원구,060004, 58세,2018,6404,3418,2986,114.5,5398,2899,2499,116
31092, 단원구,060005, 59세,2018,5374,2925,2449,119.4,4638,2534,2104,120.4
31092, 단원구,065,60~64세,2018,20325,10742,9583,112.1,16711,8889,7822,113.6
31092, 단원구,065001, 60세,2018,5020,2717,2303,118,4217,2300,1917,120
31092, 단원구,065002, 61세,2018,4532,2442,2090,116.8,3694,2008,1686,119.1
31092, 단원구,065003, 62세,2018,3975,2068,1907,108.4,3226,1695,1531,110.7
31092, 단원구,065004, 63세,2018,3745,1949,1796,108.5,3092,1612,1480,108.9
31092, 단원구,065005, 64세,2018,3053,1566,1487,105.3,2482,1274,1208,105.5
31092, 단원구,070,65~69세,2018,10806,5444,5362,101.5,9216,4711,4505,104.6
31092, 단원구,070001, 65세,2018,2540,1318,1222,107.9,2071,1085,986,110
31092, 단원구,070002, 66세,2018,2572,1284,1288,99.7,2240,1131,1109,102
31092, 단원구,070003, 67세,2018,1879,1001,878,114,1567,853,714,119.5
31092, 단원구,070004, 68세,2018,1978,940,1038,90.6,1739,831,908,91.5
31092, 단원구,070005, 69세,2018,1837,901,936,96.3,1599,811,788,102.9
31092, 단원구,075,70~74세,2018,6705,3130,3575,87.6,6255,2968,3287,90.3
31092, 단원구,075001, 70세,2018,1588,772,816,94.6,1466,726,740,98.1
31092, 단원구,075002, 71세,2018,1588,755,833,90.6,1477,714,763,93.6
31092, 단원구,075003, 72세,2018,1216,568,648,87.7,1122,540,582,92.8
31092, 단원구,075004, 73세,2018,1125,501,624,80.3,1065,477,588,81.1
31092, 단원구,075005, 74세,2018,1188,534,654,81.7,1125,511,614,83.2
31092, 단원구,080,75~79세,2018,5563,2214,3349,66.1,5294,2135,3159,67.6
31092, 단원구,080001, 75세,2018,1163,497,666,74.6,1109,480,629,76.3
31092, 단원구,080002, 76세,2018,1275,533,742,71.8,1212,516,696,74.1
31092, 단원구,080003, 77세,2018,1073,403,670,60.1,1023,386,637,60.6
31092, 단원구,080004, 78세,2018,1011,391,620,63.1,958,375,583,64.3
31092, 단원구,080005, 79세,2018,1041,390,651,59.9,992,378,614,61.6
31092, 단원구,085,80~84세,2018,3907,1215,2692,45.1,3765,1173,2592,45.3
31092, 단원구,085001, 80세,2018,906,294,612,48,861,282,579,48.7
31092, 단원구,085002, 81세,2018,815,277,538,51.5,784,265,519,51.1
31092, 단원구,085003, 82세,2018,779,241,538,44.8,755,237,518,45.8
31092, 단원구,085004, 83세,2018,817,246,571,43.1,790,238,552,43.1
31092, 단원구,085005, 84세,2018,590,157,433,36.3,575,151,424,35.6
31092, 단원구,090,85~89세,2018,1863,449,1414,31.8,1830,447,1383,32.3
31092, 단원구,090001, 85세,2018,521,144,377,38.2,513,143,370,38.6
31092, 단원구,090002, 86세,2018,446,105,341,30.8,439,104,335,31
31092, 단원구,090003, 87세,2018,335,91,244,37.3,327,91,236,38.6
31092, 단원구,090004, 88세,2018,318,62,256,24.2,312,62,250,24.8
31092, 단원구,090005, 89세,2018,243,47,196,24,239,47,192,24.5
31092, 단원구,095,90~94세,2018,644,124,520,23.8,640,123,517,23.8
31092, 단원구,095001, 90세,2018,209,39,170,22.9,208,38,170,22.4
31092, 단원구,095002, 91세,2018,161,30,131,22.9,160,30,130,23.1
31092, 단원구,095003, 92세,2018,116,26,90,28.9,115,26,89,29.2
31092, 단원구,095004, 93세,2018,97,15,82,18.3,97,15,82,18.3
31092, 단원구,095005, 94세,2018,61,14,47,29.8,60,14,46,30.4
31092, 단원구,100,95~99세,2018,138,28,110,25.5,138,28,110,25.5
31092, 단원구,100001, 95세,2018,61,18,43,41.9,61,18,43,41.9
31092, 단원구,100002, 96세,2018,39,X,35,11.4,39,X,35,11.4
31092, 단원구,100003, 97세,2018,18,X,15,20,18,X,15,20
31092, 단원구,100004, 98세,2018,12,X,9,33.3,12,X,9,33.3
31092, 단원구,100005, 99세,2018,8,X,8,0,8,X,8,0
31092, 단원구,101,100세이상,2018,20,X,18,11.1,20,X,18,11.1
31092, 단원구,102,15세미만,2018,40383,20621,19762,104.3,36951,18923,18028,105
31092, 단원구,103,15~64세,2018,283013,153090,129923,117.8,230038,120861,109177,110.7
31092, 단원구,104,65세이상,2018,29646,12606,17040,74,27158,11587,15571,74.4
31092, 단원구,086,85세이상,2018,2665,603,2062,29.2,2628,600,2028,29.6
31092, 단원구,126,평균연령,2018,40,39.3,40.8,,39.9,39.1,40.6,
31092, 단원구,127,중위연령,2018,41.1,39.9,42.5,,41.4,40.4,42.3,
31100, 고양시,000,합계,2018,1006992,493670,513322,96.2,989031,484278,504753,95.9
31100, 고양시,005,0~4세,2018,38032,19414,18618,104.3,37683,19241,18442,104.3
31100, 고양시,005001, 0세,2018,6094,3087,3007,102.7,6015,3052,2963,103
31100, 고양시,005002, 1세,2018,6943,3607,3336,108.1,6868,3569,3299,108.2
31100, 고양시,005003, 2세,2018,7967,4012,3955,101.4,7895,3978,3917,101.6
31100, 고양시,005004, 3세,2018,8592,4394,4198,104.7,8531,4362,4169,104.6
31100, 고양시,005005, 4세,2018,8436,4314,4122,104.7,8374,4280,4094,104.5
31100, 고양시,010,5~9세,2018,45897,23636,22261,106.2,45671,23538,22133,106.3
31100, 고양시,010001, 5세,2018,8625,4401,4224,104.2,8581,4380,4201,104.3
31100, 고양시,010002, 6세,2018,9572,4965,4607,107.8,9517,4940,4577,107.9
31100, 고양시,010003, 7세,2018,9486,4828,4658,103.6,9443,4813,4630,104
31100, 고양시,010004, 8세,2018,9220,4751,4469,106.3,9184,4734,4450,106.4
31100, 고양시,010005, 9세,2018,8994,4691,4303,109,8946,4671,4275,109.3
31100, 고양시,015,10~14세,2018,48222,24606,23616,104.2,48118,24559,23559,104.2
31100, 고양시,015001, 10세,2018,9744,4945,4799,103,9717,4934,4783,103.2
31100, 고양시,015002, 11세,2018,9655,5021,4634,108.4,9635,5007,4628,108.2
31100, 고양시,015003, 12세,2018,9211,4681,4530,103.3,9196,4673,4523,103.3
31100, 고양시,015004, 13세,2018,9230,4649,4581,101.5,9208,4641,4567,101.6
31100, 고양시,015005, 14세,2018,10382,5310,5072,104.7,10362,5304,5058,104.9
31100, 고양시,020,15~19세,2018,56864,29374,27490,106.9,56627,29254,27373,106.9
31100, 고양시,020001, 15세,2018,10458,5482,4976,110.2,10432,5466,4966,110.1
31100, 고양시,020002, 16세,2018,10650,5467,5183,105.5,10627,5455,5172,105.5
31100, 고양시,020003, 17세,2018,12015,6182,5833,106,11997,6177,5820,106.1
31100, 고양시,020004, 18세,2018,12800,6520,6280,103.8,12749,6492,6257,103.8
31100, 고양시,020005, 19세,2018,10941,5723,5218,109.7,10822,5664,5158,109.8
31100, 고양시,025,20~24세,2018,65125,34267,30858,111,63700,33397,30303,110.2
31100, 고양시,025001, 20세,2018,11745,6256,5489,114,11595,6169,5426,113.7
31100, 고양시,025002, 21세,2018,12407,6753,5654,119.4,12231,6640,5591,118.8
31100, 고양시,025003, 22세,2018,13169,7079,6090,116.2,12878,6909,5969,115.7
31100, 고양시,025004, 23세,2018,13646,6941,6705,103.5,13283,6713,6570,102.2
31100, 고양시,025005, 24세,2018,14158,7238,6920,104.6,13713,6966,6747,103.2
31100, 고양시,030,25~29세,2018,68682,34477,34205,100.8,66167,33002,33165,99.5
31100, 고양시,030001, 25세,2018,14543,7273,7270,100,14052,6974,7078,98.5
31100, 고양시,030002, 26세,2018,14860,7448,7412,100.5,14394,7158,7236,98.9
31100, 고양시,030003, 27세,2018,14067,7070,6997,101,13563,6793,6770,100.3
31100, 고양시,030004, 28세,2018,13033,6505,6528,99.6,12481,6193,6288,98.5
31100, 고양시,030005, 29세,2018,12179,6181,5998,103.1,11677,5884,5793,101.6
31100, 고양시,035,30~34세,2018,59990,29749,30241,98.4,57373,28290,29083,97.3
31100, 고양시,035001, 30세,2018,11843,5900,5943,99.3,11296,5617,5679,98.9
31100, 고양시,035002, 31세,2018,11613,5733,5880,97.5,11066,5409,5657,95.6
31100, 고양시,035003, 32세,2018,11791,5826,5965,97.7,11230,5512,5718,96.4
31100, 고양시,035004, 33세,2018,12209,6062,6147,98.6,11723,5793,5930,97.7
31100, 고양시,035005, 34세,2018,12534,6228,6306,98.8,12058,5959,6099,97.7
31100, 고양시,040,35~39세,2018,76226,37040,39186,94.5,74057,35849,38208,93.8
31100, 고양시,040001, 35세,2018,14074,6982,7092,98.4,13616,6723,6893,97.5
31100, 고양시,040002, 36세,2018,14909,7323,7586,96.5,14414,7055,7359,95.9
31100, 고양시,040003, 37세,2018,15685,7595,8090,93.9,15272,7362,7910,93.1
31100, 고양시,040004, 38세,2018,15759,7572,8187,92.5,15341,7355,7986,92.1
31100, 고양시,040005, 39세,2018,15799,7568,8231,91.9,15414,7354,8060,91.2
31100, 고양시,045,40~44세,2018,80472,38975,41497,93.9,78875,38104,40771,93.5
31100, 고양시,045001, 40세,2018,14451,7083,7368,96.1,14124,6891,7233,95.3
31100, 고양시,045002, 41세,2018,15393,7349,8044,91.4,15076,7169,7907,90.7
31100, 고양시,045003, 42세,2018,15461,7597,7864,96.6,15129,7408,7721,95.9
31100, 고양시,045004, 43세,2018,16521,7965,8556,93.1,16208,7806,8402,92.9
31100, 고양시,045005, 44세,2018,18646,8981,9665,92.9,18338,8830,9508,92.9
31100, 고양시,050,45~49세,2018,102363,49697,52666,94.4,100691,48847,51844,94.2
31100, 고양시,050001, 45세,2018,19044,9140,9904,92.3,18723,8977,9746,92.1
31100, 고양시,050002, 46세,2018,20300,9770,10530,92.8,19971,9586,10385,92.3
31100, 고양시,050003, 47세,2018,21339,10432,10907,95.6,21017,10270,10747,95.6
31100, 고양시,050004, 48세,2018,20848,10149,10699,94.9,20490,9966,10524,94.7
31100, 고양시,050005, 49세,2018,20832,10206,10626,96,20490,10048,10442,96.2
31100, 고양시,055,50~54세,2018,92673,45223,47450,95.3,91210,44554,46656,95.5
31100, 고양시,055001, 50세,2018,20129,9701,10428,93,19823,9545,10278,92.9
31100, 고양시,055002, 51세,2018,18465,8898,9567,93,18199,8782,9417,93.3
31100, 고양시,055003, 52세,2018,17970,8920,9050,98.6,17672,8776,8896,98.7
31100, 고양시,055004, 53세,2018,18572,9016,9556,94.3,18274,8891,9383,94.8
31100, 고양시,055005, 54세,2018,17537,8688,8849,98.2,17242,8560,8682,98.6
31100, 고양시,060,55~59세,2018,87338,44217,43121,102.5,85870,43582,42288,103.1
31100, 고양시,060001, 55세,2018,18365,9237,9128,101.2,17982,9074,8908,101.9
31100, 고양시,060002, 56세,2018,17743,8906,8837,100.8,17448,8788,8660,101.5
31100, 고양시,060003, 57세,2018,18209,9310,8899,104.6,17969,9205,8764,105
31100, 고양시,060004, 58세,2018,17627,8918,8709,102.4,17328,8782,8546,102.8
31100, 고양시,060005, 59세,2018,15394,7846,7548,103.9,15143,7733,7410,104.4
31100, 고양시,065,60~64세,2018,60615,31137,29478,105.6,59484,30601,28883,105.9
31100, 고양시,065001, 60세,2018,14075,7267,6808,106.7,13810,7149,6661,107.3
31100, 고양시,065002, 61세,2018,13505,7013,6492,108,13247,6897,6350,108.6
31100, 고양시,065003, 62세,2018,11903,6155,5748,107.1,11695,6044,5651,107
31100, 고양시,065004, 63세,2018,11702,5859,5843,100.3,11484,5752,5732,100.3
31100, 고양시,065005, 64세,2018,9430,4843,4587,105.6,9248,4759,4489,106
31100, 고양시,070,65~69세,2018,35403,16824,18579,90.6,34828,16576,18252,90.8
31100, 고양시,070001, 65세,2018,8102,4011,4091,98,7939,3937,4002,98.4
31100, 고양시,070002, 66세,2018,8394,4130,4264,96.9,8260,4077,4183,97.5
31100, 고양시,070003, 67세,2018,5637,2664,2973,89.6,5539,2623,2916,90
31100, 고양시,070004, 68세,2018,6515,2942,3573,82.3,6418,2899,3519,82.4
31100, 고양시,070005, 69세,2018,6755,3077,3678,83.7,6672,3040,3632,83.7
31100, 고양시,075,70~74세,2018,30191,13021,17170,75.8,29974,12917,17057,75.7
31100, 고양시,075001, 70세,2018,6741,2991,3750,79.8,6682,2966,3716,79.8
31100, 고양시,075002, 71세,2018,6925,3020,3905,77.3,6877,2997,3880,77.2
31100, 고양시,075003, 72세,2018,5607,2449,3158,77.5,5558,2426,3132,77.5
31100, 고양시,075004, 73세,2018,5416,2304,3112,74,5382,2283,3099,73.7
31100, 고양시,075005, 74세,2018,5502,2257,3245,69.6,5475,2245,3230,69.5
31100, 고양시,080,75~79세,2018,27657,11258,16399,68.7,27568,11233,16335,68.8
31100, 고양시,080001, 75세,2018,5653,2351,3302,71.2,5638,2342,3296,71.1
31100, 고양시,080002, 76세,2018,6453,2692,3761,71.6,6421,2683,3738,71.8
31100, 고양시,080003, 77세,2018,5487,2265,3222,70.3,5466,2261,3205,70.5
31100, 고양시,080004, 78세,2018,5104,2027,3077,65.9,5093,2026,3067,66.1
31100, 고양시,080005, 79세,2018,4960,1923,3037,63.3,4950,1921,3029,63.4
31100, 고양시,085,80~84세,2018,18813,7008,11805,59.4,18741,6991,11750,59.5
31100, 고양시,085001, 80세,2018,4515,1777,2738,64.9,4496,1770,2726,64.9
31100, 고양시,085002, 81세,2018,4175,1575,2600,60.6,4158,1570,2588,60.7
31100, 고양시,085003, 82세,2018,3768,1443,2325,62.1,3755,1440,2315,62.2
31100, 고양시,085004, 83세,2018,3516,1261,2255,55.9,3504,1260,2244,56.1
31100, 고양시,085005, 84세,2018,2839,952,1887,50.5,2828,951,1877,50.7
31100, 고양시,090,85~89세,2018,8825,2813,6012,46.8,8801,2812,5989,47
31100, 고양시,090001, 85세,2018,2404,802,1602,50.1,2401,802,1599,50.2
31100, 고양시,090002, 86세,2018,2091,710,1381,51.4,2082,710,1372,51.7
31100, 고양시,090003, 87세,2018,1654,540,1114,48.5,1649,540,1109,48.7
31100, 고양시,090004, 88세,2018,1452,412,1040,39.6,1448,411,1037,39.6
31100, 고양시,090005, 89세,2018,1224,349,875,39.9,1221,349,872,40
31100, 고양시,095,90~94세,2018,2823,718,2105,34.1,2817,715,2102,34
31100, 고양시,095001, 90세,2018,933,246,687,35.8,932,245,687,35.7
31100, 고양시,095002, 91세,2018,704,182,522,34.9,702,181,521,34.7
31100, 고양시,095003, 92세,2018,484,117,367,31.9,483,116,367,31.6
31100, 고양시,095004, 93세,2018,415,99,316,31.3,413,99,314,31.5
31100, 고양시,095005, 94세,2018,287,74,213,34.7,287,74,213,34.7
31100, 고양시,100,95~99세,2018,696,197,499,39.5,691,197,494,39.9
31100, 고양시,100001, 95세,2018,264,74,190,38.9,259,74,185,40
31100, 고양시,100002, 96세,2018,197,54,143,37.8,197,54,143,37.8
31100, 고양시,100003, 97세,2018,106,31,75,41.3,106,31,75,41.3
31100, 고양시,100004, 98세,2018,78,26,52,50,78,26,52,50
31100, 고양시,100005, 99세,2018,51,12,39,30.8,51,12,39,30.8
31100, 고양시,101,100세이상,2018,85,19,66,28.8,85,19,66,28.8
31100, 고양시,102,15세미만,2018,132151,67656,64495,104.9,131472,67338,64134,105
31100, 고양시,103,15~64세,2018,750348,374156,376192,99.5,734054,365480,368574,99.2
31100, 고양시,104,65세이상,2018,124493,51858,72635,71.4,123505,51460,72045,71.4
31100, 고양시,086,85세이상,2018,12429,3747,8682,43.2,12394,3743,8651,43.3
31100, 고양시,126,평균연령,2018,41.2,40.2,42.2,,41.3,40.3,42.2,
31100, 고양시,127,중위연령,2018,42.9,42,43.8,,43,42.1,43.9,
31101, 덕양구,000,합계,2018,436865,216427,220438,98.2,429930,213007,216923,98.2
31101, 덕양구,005,0~4세,2018,17896,9099,8797,103.4,17786,9044,8742,103.5
31101, 덕양구,005001, 0세,2018,2863,1436,1427,100.6,2834,1424,1410,101
31101, 덕양구,005002, 1세,2018,3262,1733,1529,113.3,3235,1720,1515,113.5
31101, 덕양구,005003, 2세,2018,3786,1898,1888,100.5,3766,1887,1879,100.4
31101, 덕양구,005004, 3세,2018,4036,2021,2015,100.3,4019,2012,2007,100.2
31101, 덕양구,005005, 4세,2018,3949,2011,1938,103.8,3932,2001,1931,103.6
31101, 덕양구,010,5~9세,2018,20245,10454,9791,106.8,20175,10423,9752,106.9
31101, 덕양구,010001, 5세,2018,3904,2003,1901,105.4,3895,1997,1898,105.2
31101, 덕양구,010002, 6세,2018,4335,2246,2089,107.5,4314,2237,2077,107.7
31101, 덕양구,010003, 7세,2018,4260,2177,2083,104.5,4247,2173,2074,104.8
31101, 덕양구,010004, 8세,2018,3935,2041,1894,107.8,3922,2035,1887,107.8
31101, 덕양구,010005, 9세,2018,3811,1987,1824,108.9,3797,1981,1816,109.1
31101, 덕양구,015,10~14세,2018,18955,9646,9309,103.6,18920,9630,9290,103.7
31101, 덕양구,015001, 10세,2018,4004,2024,1980,102.2,3997,2020,1977,102.2
31101, 덕양구,015002, 11세,2018,3867,2010,1857,108.2,3859,2005,1854,108.1
31101, 덕양구,015003, 12세,2018,3576,1798,1778,101.1,3570,1796,1774,101.2
31101, 덕양구,015004, 13세,2018,3562,1759,1803,97.6,3554,1756,1798,97.7
31101, 덕양구,015005, 14세,2018,3946,2055,1891,108.7,3940,2053,1887,108.8
31101, 덕양구,020,15~19세,2018,22216,11560,10656,108.5,22104,11508,10596,108.6
31101, 덕양구,020001, 15세,2018,4052,2104,1948,108,4042,2101,1941,108.2
31101, 덕양구,020002, 16세,2018,4002,2066,1936,106.7,3997,2063,1934,106.7
31101, 덕양구,020003, 17세,2018,4618,2361,2257,104.6,4611,2359,2252,104.8
31101, 덕양구,020004, 18세,2018,4984,2566,2418,106.1,4955,2550,2405,106
31101, 덕양구,020005, 19세,2018,4560,2463,2097,117.5,4499,2435,2064,118
31101, 덕양구,025,20~24세,2018,27483,14659,12824,114.3,26874,14333,12541,114.3
31101, 덕양구,025001, 20세,2018,4774,2546,2228,114.3,4704,2507,2197,114.1
31101, 덕양구,025002, 21세,2018,5221,2863,2358,121.4,5131,2814,2317,121.5
31101, 덕양구,025003, 22세,2018,5708,3061,2647,115.6,5566,2994,2572,116.4
31101, 덕양구,025004, 23세,2018,5830,3022,2808,107.6,5687,2943,2744,107.3
31101, 덕양구,025005, 24세,2018,5950,3167,2783,113.8,5786,3075,2711,113.4
31101, 덕양구,030,25~29세,2018,29419,15035,14384,104.5,28443,14494,13949,103.9
31101, 덕양구,030001, 25세,2018,6243,3229,3014,107.1,6053,3125,2928,106.7
31101, 덕양구,030002, 26세,2018,6294,3267,3027,107.9,6113,3157,2956,106.8
31101, 덕양구,030003, 27세,2018,5975,3028,2947,102.7,5792,2933,2859,102.6
31101, 덕양구,030004, 28세,2018,5656,2833,2823,100.4,5441,2722,2719,100.1
31101, 덕양구,030005, 29세,2018,5251,2678,2573,104.1,5044,2557,2487,102.8
31101, 덕양구,035,30~34세,2018,27286,13691,13595,100.7,26309,13205,13104,100.8
31101, 덕양구,035001, 30세,2018,5195,2606,2589,100.7,4975,2501,2474,101.1
31101, 덕양구,035002, 31세,2018,5207,2590,2617,99,5012,2491,2521,98.8
31101, 덕양구,035003, 32세,2018,5341,2711,2630,103.1,5148,2606,2542,102.5
31101, 덕양구,035004, 33세,2018,5714,2864,2850,100.5,5525,2774,2751,100.8
31101, 덕양구,035005, 34세,2018,5829,2920,2909,100.4,5649,2833,2816,100.6
31101, 덕양구,040,35~39세,2018,35124,17532,17592,99.7,34315,17131,17184,99.7
31101, 덕양구,040001, 35세,2018,6600,3318,3282,101.1,6440,3235,3205,100.9
31101, 덕양구,040002, 36세,2018,6920,3478,3442,101,6732,3387,3345,101.3
31101, 덕양구,040003, 37세,2018,7282,3651,3631,100.6,7131,3570,3561,100.3
31101, 덕양구,040004, 38세,2018,7250,3639,3611,100.8,7066,3546,3520,100.7
31101, 덕양구,040005, 39세,2018,7072,3446,3626,95,6946,3393,3553,95.5
31101, 덕양구,045,40~44세,2018,34775,17538,17237,101.7,34128,17201,16927,101.6
31101, 덕양구,045001, 40세,2018,6444,3256,3188,102.1,6321,3186,3135,101.6
31101, 덕양구,045002, 41세,2018,6808,3366,3442,97.8,6689,3299,3390,97.3
31101, 덕양구,045003, 42세,2018,6684,3472,3212,108.1,6537,3393,3144,107.9
31101, 덕양구,045004, 43세,2018,7062,3533,3529,100.1,6935,3476,3459,100.5
31101, 덕양구,045005, 44세,2018,7777,3911,3866,101.2,7646,3847,3799,101.3
31101, 덕양구,050,45~49세,2018,40921,20452,20469,99.9,40275,20156,20119,100.2
31101, 덕양구,050001, 45세,2018,7708,3889,3819,101.8,7586,3834,3752,102.2
31101, 덕양구,050002, 46세,2018,8193,4124,4069,101.4,8062,4043,4019,100.6
31101, 덕양구,050003, 47세,2018,8507,4271,4236,100.8,8374,4219,4155,101.5
31101, 덕양구,050004, 48세,2018,8226,4084,4142,98.6,8087,4023,4064,99
31101, 덕양구,050005, 49세,2018,8287,4084,4203,97.2,8166,4037,4129,97.8
31101, 덕양구,055,50~54세,2018,38198,18790,19408,96.8,37647,18535,19112,97
31101, 덕양구,055001, 50세,2018,8100,3934,4166,94.4,7992,3877,4115,94.2
31101, 덕양구,055002, 51세,2018,7526,3647,3879,94,7412,3594,3818,94.1
31101, 덕양구,055003, 52세,2018,7516,3751,3765,99.6,7415,3693,3722,99.2
31101, 덕양구,055004, 53세,2018,7783,3813,3970,96,7660,3764,3896,96.6
31101, 덕양구,055005, 54세,2018,7273,3645,3628,100.5,7168,3607,3561,101.3
31101, 덕양구,060,55~59세,2018,37897,19241,18656,103.1,37331,18985,18346,103.5
31101, 덕양구,060001, 55세,2018,7852,3988,3864,103.2,7695,3921,3774,103.9
31101, 덕양구,060002, 56세,2018,7574,3818,3756,101.7,7457,3768,3689,102.1
31101, 덕양구,060003, 57세,2018,7874,3996,3878,103,7789,3960,3829,103.4
31101, 덕양구,060004, 58세,2018,7790,3953,3837,103,7675,3895,3780,103
31101, 덕양구,060005, 59세,2018,6807,3486,3321,105,6715,3441,3274,105.1
31101, 덕양구,065,60~64세,2018,27824,14051,13773,102,27392,13850,13542,102.3
31101, 덕양구,065001, 60세,2018,6333,3255,3078,105.8,6230,3208,3022,106.2
31101, 덕양구,065002, 61세,2018,6088,3106,2982,104.2,5971,3057,2914,104.9
31101, 덕양구,065003, 62세,2018,5426,2742,2684,102.2,5364,2711,2653,102.2
31101, 덕양구,065004, 63세,2018,5497,2687,2810,95.6,5411,2642,2769,95.4
31101, 덕양구,065005, 64세,2018,4480,2261,2219,101.9,4416,2232,2184,102.2
31101, 덕양구,070,65~69세,2018,17248,8142,9106,89.4,17006,8032,8974,89.5
31101, 덕양구,070001, 65세,2018,3857,1886,1971,95.7,3795,1850,1945,95.1
31101, 덕양구,070002, 66세,2018,4120,2028,2092,96.9,4066,2007,2059,97.5
31101, 덕양구,070003, 67세,2018,2781,1297,1484,87.4,2738,1279,1459,87.7
31101, 덕양구,070004, 68세,2018,3173,1417,1756,80.7,3132,1402,1730,81
31101, 덕양구,070005, 69세,2018,3317,1514,1803,84,3275,1494,1781,83.9
31101, 덕양구,075,70~74세,2018,14809,6454,8355,77.2,14725,6409,8316,77.1
31101, 덕양구,075001, 70세,2018,3346,1521,1825,83.3,3319,1507,1812,83.2
31101, 덕양구,075002, 71세,2018,3374,1491,1883,79.2,3355,1483,1872,79.2
31101, 덕양구,075003, 72세,2018,2784,1254,1530,82,2766,1244,1522,81.7
31101, 덕양구,075004, 73세,2018,2672,1134,1538,73.7,2659,1125,1534,73.3
31101, 덕양구,075005, 74세,2018,2633,1054,1579,66.8,2626,1050,1576,66.6
31101, 덕양구,080,75~79세,2018,13121,5458,7663,71.2,13090,5453,7637,71.4
31101, 덕양구,080001, 75세,2018,2702,1132,1570,72.1,2698,1132,1566,72.3
31101, 덕양구,080002, 76세,2018,3106,1283,1823,70.4,3091,1279,1812,70.6
31101, 덕양구,080003, 77세,2018,2552,1108,1444,76.7,2545,1107,1438,77
31101, 덕양구,080004, 78세,2018,2428,1009,1419,71.1,2424,1009,1415,71.3
31101, 덕양구,080005, 79세,2018,2333,926,1407,65.8,2332,926,1406,65.9
31101, 덕양구,085,80~84세,2018,8229,3094,5135,60.3,8204,3091,5113,60.5
31101, 덕양구,085001, 80세,2018,2048,814,1234,66,2039,812,1227,66.2
31101, 덕양구,085002, 81세,2018,1855,711,1144,62.2,1851,711,1140,62.4
31101, 덕양구,085003, 82세,2018,1648,626,1022,61.3,1645,626,1019,61.4
31101, 덕양구,085004, 83세,2018,1487,547,940,58.2,1484,547,937,58.4
31101, 덕양구,085005, 84세,2018,1191,396,795,49.8,1185,395,790,50
31101, 덕양구,090,85~89세,2018,3700,1161,2539,45.7,3693,1160,2533,45.8
31101, 덕양구,090001, 85세,2018,1034,338,696,48.6,1033,338,695,48.6
31101, 덕양구,090002, 86세,2018,904,288,616,46.8,903,288,615,46.8
31101, 덕양구,090003, 87세,2018,686,233,453,51.4,684,233,451,51.7
31101, 덕양구,090004, 88세,2018,586,163,423,38.5,584,162,422,38.4
31101, 덕양구,090005, 89세,2018,490,139,351,39.6,489,139,350,39.7
31101, 덕양구,095,90~94세,2018,1212,296,916,32.3,1208,293,915,32
31101, 덕양구,095001, 90세,2018,381,104,277,37.5,380,103,277,37.2
31101, 덕양구,095002, 91세,2018,320,75,245,30.6,319,74,245,30.2
31101, 덕양구,095003, 92세,2018,217,48,169,28.4,216,47,169,27.8
31101, 덕양구,095004, 93세,2018,174,40,134,29.9,173,40,133,30.1
31101, 덕양구,095005, 94세,2018,120,29,91,31.9,120,29,91,31.9
31101, 덕양구,100,95~99세,2018,275,72,203,35.5,273,72,201,35.8
31101, 덕양구,100001, 95세,2018,94,21,73,28.8,92,21,71,29.6
31101, 덕양구,100002, 96세,2018,74,19,55,34.5,74,19,55,34.5
31101, 덕양구,100003, 97세,2018,50,13,37,35.1,50,13,37,35.1
31101, 덕양구,100004, 98세,2018,37,15,22,68.2,37,15,22,68.2
31101, 덕양구,100005, 99세,2018,20,X,16,25,20,X,16,25
31101, 덕양구,101,100세이상,2018,32,X,30,6.7,32,X,30,6.7
31101, 덕양구,102,15세미만,2018,57096,29199,27897,104.7,56881,29097,27784,104.7
31101, 덕양구,103,15~64세,2018,321143,162549,158594,102.5,314818,159398,155420,102.6
31101, 덕양구,104,65세이상,2018,58626,24679,33947,72.7,58231,24512,33719,72.7
31101, 덕양구,086,85세이상,2018,5219,1531,3688,41.5,5206,1527,3679,41.5
31101, 덕양구,126,평균연령,2018,41.6,40.6,42.7,,41.7,40.6,42.7,
31101, 덕양구,127,중위연령,2018,43,42,44,,43.1,42.1,44,
31103, 일산동구,000,합계,2018,287473,140138,147335,95.1,281171,136570,144601,94.4
31103, 일산동구,005,0~4세,2018,9886,5070,4816,105.3,9744,4997,4747,105.3
31103, 일산동구,005001, 0세,2018,1642,830,812,102.2,1614,816,798,102.3
31103, 일산동구,005002, 1세,2018,1867,929,938,99,1838,914,924,98.9
31103, 일산동구,005003, 2세,2018,1949,1015,934,108.7,1923,1004,919,109.2
31103, 일산동구,005004, 3세,2018,2242,1188,1054,112.7,2211,1172,1039,112.8
31103, 일산동구,005005, 4세,2018,2186,1108,1078,102.8,2158,1091,1067,102.2
31103, 일산동구,010,5~9세,2018,12135,6276,5859,107.1,12053,6242,5811,107.4
31103, 일산동구,010001, 5세,2018,2228,1152,1076,107.1,2211,1144,1067,107.2
31103, 일산동구,010002, 6세,2018,2446,1296,1150,112.7,2426,1288,1138,113.2
31103, 일산동구,010003, 7세,2018,2472,1219,1253,97.3,2453,1213,1240,97.8
31103, 일산동구,010004, 8세,2018,2521,1294,1227,105.5,2513,1289,1224,105.3
31103, 일산동구,010005, 9세,2018,2468,1315,1153,114.1,2450,1308,1142,114.5
31103, 일산동구,015,10~14세,2018,13499,6900,6599,104.6,13454,6884,6570,104.8
31103, 일산동구,015001, 10세,2018,2658,1374,1284,107,2642,1370,1272,107.7
31103, 일산동구,015002, 11세,2018,2653,1374,1279,107.4,2648,1371,1277,107.4
31103, 일산동구,015003, 12세,2018,2642,1345,1297,103.7,2638,1342,1296,103.5
31103, 일산동구,015004, 13세,2018,2582,1322,1260,104.9,2571,1318,1253,105.2
31103, 일산동구,015005, 14세,2018,2964,1485,1479,100.4,2955,1483,1472,100.7
31103, 일산동구,020,15~19세,2018,16521,8563,7958,107.6,16450,8520,7930,107.4
31103, 일산동구,020001, 15세,2018,3014,1593,1421,112.1,3006,1586,1420,111.7
31103, 일산동구,020002, 16세,2018,3113,1599,1514,105.6,3104,1595,1509,105.7
31103, 일산동구,020003, 17세,2018,3508,1878,1630,115.2,3501,1876,1625,115.4
31103, 일산동구,020004, 18세,2018,3718,1875,1843,101.7,3708,1866,1842,101.3
31103, 일산동구,020005, 19세,2018,3168,1618,1550,104.4,3131,1597,1534,104.1
31103, 일산동구,025,20~24세,2018,19200,9932,9268,107.2,18650,9555,9095,105.1
31103, 일산동구,025001, 20세,2018,3453,1812,1641,110.4,3407,1783,1624,109.8
31103, 일산동구,025002, 21세,2018,3582,1886,1696,111.2,3526,1845,1681,109.8
31103, 일산동구,025003, 22세,2018,3815,2022,1793,112.8,3704,1946,1758,110.7
31103, 일산동구,025004, 23세,2018,4053,2056,1997,103,3900,1946,1954,99.6
31103, 일산동구,025005, 24세,2018,4297,2156,2141,100.7,4113,2035,2078,97.9
31103, 일산동구,030,25~29세,2018,21219,10493,10726,97.8,20175,9815,10360,94.7
31103, 일산동구,030001, 25세,2018,4431,2117,2314,91.5,4206,1968,2238,87.9
31103, 일산동구,030002, 26세,2018,4642,2283,2359,96.8,4453,2156,2297,93.9
31103, 일산동구,030003, 27세,2018,4319,2142,2177,98.4,4109,2012,2097,95.9
31103, 일산동구,030004, 28세,2018,4057,2040,2017,101.1,3826,1887,1939,97.3
31103, 일산동구,030005, 29세,2018,3770,1911,1859,102.8,3581,1792,1789,100.2
31103, 일산동구,035,30~34세,2018,17818,8871,8947,99.2,16777,8222,8555,96.1
31103, 일산동구,035001, 30세,2018,3671,1828,1843,99.2,3456,1704,1752,97.3
31103, 일산동구,035002, 31세,2018,3566,1764,1802,97.9,3330,1608,1722,93.4
31103, 일산동구,035003, 32세,2018,3543,1754,1789,98,3326,1628,1698,95.9
31103, 일산동구,035004, 33세,2018,3492,1741,1751,99.4,3308,1618,1690,95.7
31103, 일산동구,035005, 34세,2018,3546,1784,1762,101.2,3357,1664,1693,98.3
31103, 일산동구,040,35~39세,2018,21413,10223,11190,91.4,20579,9716,10863,89.4
31103, 일산동구,040001, 35세,2018,3932,1932,2000,96.6,3741,1816,1925,94.3
31103, 일산동구,040002, 36세,2018,4180,2038,2142,95.1,3995,1922,2073,92.7
31103, 일산동구,040003, 37세,2018,4396,2064,2332,88.5,4231,1960,2271,86.3
31103, 일산동구,040004, 38세,2018,4382,2029,2353,86.2,4248,1955,2293,85.3
31103, 일산동구,040005, 39세,2018,4523,2160,2363,91.4,4364,2063,2301,89.7
31103, 일산동구,045,40~44세,2018,22845,10810,12035,89.8,22336,10522,11814,89.1
31103, 일산동구,045001, 40세,2018,4102,1985,2117,93.8,3988,1920,2068,92.8
31103, 일산동구,045002, 41세,2018,4294,1982,2312,85.7,4198,1927,2271,84.9
31103, 일산동구,045003, 42세,2018,4461,2149,2312,92.9,4361,2084,2277,91.5
31103, 일산동구,045004, 43세,2018,4582,2174,2408,90.3,4476,2114,2362,89.5
31103, 일산동구,045005, 44세,2018,5406,2520,2886,87.3,5313,2477,2836,87.3
31103, 일산동구,050,45~49세,2018,30466,14584,15882,91.8,29908,14297,15611,91.6
31103, 일산동구,050001, 45세,2018,5608,2586,3022,85.6,5498,2530,2968,85.2
31103, 일산동구,050002, 46세,2018,6041,2870,3171,90.5,5928,2817,3111,90.5
31103, 일산동구,050003, 47세,2018,6335,3057,3278,93.3,6225,2995,3230,92.7
31103, 일산동구,050004, 48세,2018,6288,3046,3242,94,6175,2985,3190,93.6
31103, 일산동구,050005, 49세,2018,6194,3025,3169,95.5,6082,2970,3112,95.4
31103, 일산동구,055,50~54세,2018,27152,13163,13989,94.1,26715,12967,13748,94.3
31103, 일산동구,055001, 50세,2018,5890,2831,3059,92.5,5804,2793,3011,92.8
31103, 일산동구,055002, 51세,2018,5414,2606,2808,92.8,5343,2574,2769,93
31103, 일산동구,055003, 52세,2018,5269,2591,2678,96.8,5170,2547,2623,97.1
31103, 일산동구,055004, 53세,2018,5355,2585,2770,93.3,5263,2545,2718,93.6
31103, 일산동구,055005, 54세,2018,5224,2550,2674,95.4,5135,2508,2627,95.5
31103, 일산동구,060,55~59세,2018,25151,12648,12503,101.2,24743,12477,12266,101.7
31103, 일산동구,060001, 55세,2018,5327,2647,2680,98.8,5230,2602,2628,99
31103, 일산동구,060002, 56세,2018,5181,2598,2583,100.6,5109,2567,2542,101
31103, 일산동구,060003, 57세,2018,5256,2733,2523,108.3,5182,2700,2482,108.8
31103, 일산동구,060004, 58세,2018,5022,2490,2532,98.3,4934,2456,2478,99.1
31103, 일산동구,060005, 59세,2018,4365,2180,2185,99.8,4288,2152,2136,100.7
31103, 일산동구,065,60~64세,2018,16993,8795,8198,107.3,16690,8648,8042,107.5
31103, 일산동구,065001, 60세,2018,4052,2088,1964,106.3,3973,2051,1922,106.7
31103, 일산동구,065002, 61세,2018,3831,1998,1833,109,3776,1972,1804,109.3
31103, 일산동구,065003, 62세,2018,3360,1753,1607,109.1,3301,1719,1582,108.7
31103, 일산동구,065004, 63세,2018,3163,1589,1574,101,3104,1564,1540,101.6
31103, 일산동구,065005, 64세,2018,2587,1367,1220,112,2536,1342,1194,112.4
31103, 일산동구,070,65~69세,2018,9359,4552,4807,94.7,9208,4495,4713,95.4
31103, 일산동구,070001, 65세,2018,2245,1168,1077,108.4,2205,1158,1047,110.6
31103, 일산동구,070002, 66세,2018,2180,1074,1106,97.1,2143,1064,1079,98.6
31103, 일산동구,070003, 67세,2018,1438,693,745,93,1411,681,730,93.3
31103, 일산동구,070004, 68세,2018,1748,831,917,90.6,1721,816,905,90.2
31103, 일산동구,070005, 69세,2018,1748,786,962,81.7,1728,776,952,81.5
31103, 일산동구,075,70~74세,2018,7721,3349,4372,76.6,7660,3325,4335,76.7
31103, 일산동구,075001, 70세,2018,1703,739,964,76.7,1691,736,955,77.1
31103, 일산동구,075002, 71세,2018,1765,781,984,79.4,1753,775,978,79.2
31103, 일산동구,075003, 72세,2018,1419,603,816,73.9,1403,597,806,74.1
31103, 일산동구,075004, 73세,2018,1338,588,750,78.4,1328,584,744,78.5
31103, 일산동구,075005, 74세,2018,1496,638,858,74.4,1485,633,852,74.3
31103, 일산동구,080,75~79세,2018,7086,2887,4199,68.8,7056,2873,4183,68.7
31103, 일산동구,080001, 75세,2018,1467,639,828,77.2,1457,631,826,76.4
31103, 일산동구,080002, 76세,2018,1618,686,932,73.6,1611,683,928,73.6
31103, 일산동구,080003, 77세,2018,1386,556,830,67,1379,554,825,67.2
31103, 일산동구,080004, 78세,2018,1338,533,805,66.2,1334,533,801,66.5
31103, 일산동구,080005, 79세,2018,1277,473,804,58.8,1275,472,803,58.8
31103, 일산동구,085,80~84세,2018,5227,1898,3329,57,5201,1891,3310,57.1
31103, 일산동구,085001, 80세,2018,1174,472,702,67.2,1167,468,699,67
31103, 일산동구,085002, 81세,2018,1162,447,715,62.5,1155,444,711,62.4
31103, 일산동구,085003, 82세,2018,1038,372,666,55.9,1033,372,661,56.3
31103, 일산동구,085004, 83세,2018,1009,343,666,51.5,1005,343,662,51.8
31103, 일산동구,085005, 84세,2018,844,264,580,45.5,841,264,577,45.8
31103, 일산동구,090,85~89세,2018,2633,821,1812,45.3,2625,821,1804,45.5
31103, 일산동구,090001, 85세,2018,721,245,476,51.5,721,245,476,51.5
31103, 일산동구,090002, 86세,2018,623,205,418,49,619,205,414,49.5
31103, 일산동구,090003, 87세,2018,470,148,322,46,468,148,320,46.3
31103, 일산동구,090004, 88세,2018,430,114,316,36.1,428,114,314,36.3
31103, 일산동구,090005, 89세,2018,389,109,280,38.9,389,109,280,38.9
31103, 일산동구,095,90~94세,2018,878,228,650,35.1,877,228,649,35.1
31103, 일산동구,095001, 90세,2018,304,79,225,35.1,304,79,225,35.1
31103, 일산동구,095002, 91세,2018,202,59,143,41.3,201,59,142,41.5
31103, 일산동구,095003, 92세,2018,138,34,104,32.7,138,34,104,32.7
31103, 일산동구,095004, 93세,2018,146,33,113,29.2,146,33,113,29.2
31103, 일산동구,095005, 94세,2018,88,23,65,35.4,88,23,65,35.4
31103, 일산동구,100,95~99세,2018,243,67,176,38.1,242,67,175,38.3
31103, 일산동구,100001, 95세,2018,110,34,76,44.7,109,34,75,45.3
31103, 일산동구,100002, 96세,2018,67,17,50,34,67,17,50,34
31103, 일산동구,100003, 97세,2018,30,9,21,42.9,30,9,21,42.9
31103, 일산동구,100004, 98세,2018,20,X,17,17.6,20,X,17,17.6
31103, 일산동구,100005, 99세,2018,16,X,12,33.3,16,X,12,33.3
31103, 일산동구,101,100세이상,2018,28,8,20,40,28,8,20,40
31103, 일산동구,102,15세미만,2018,35520,18246,17274,105.6,35251,18123,17128,105.8
31103, 일산동구,103,15~64세,2018,218778,108082,110696,97.6,213023,104739,108284,96.7
31103, 일산동구,104,65세이상,2018,33175,13810,19365,71.3,32897,13708,19189,71.4
31103, 일산동구,086,85세이상,2018,3782,1124,2658,42.3,3772,1124,2648,42.4
31103, 일산동구,126,평균연령,2018,41.2,40.2,42.1,,41.2,40.3,42.1,
31103, 일산동구,127,중위연령,2018,42.8,41.9,43.6,,43,42.2,43.7,
31104, 일산서구,000,합계,2018,282654,137105,145549,94.2,277930,134701,143229,94
31104, 일산서구,005,0~4세,2018,10250,5245,5005,104.8,10153,5200,4953,105
31104, 일산서구,005001, 0세,2018,1589,821,768,106.9,1567,812,755,107.5
31104, 일산서구,005002, 1세,2018,1814,945,869,108.7,1795,935,860,108.7
31104, 일산서구,005003, 2세,2018,2232,1099,1133,97,2206,1087,1119,97.1
31104, 일산서구,005004, 3세,2018,2314,1185,1129,105,2301,1178,1123,104.9
31104, 일산서구,005005, 4세,2018,2301,1195,1106,108,2284,1188,1096,108.4
31104, 일산서구,010,5~9세,2018,13517,6906,6611,104.5,13443,6873,6570,104.6
31104, 일산서구,010001, 5세,2018,2493,1246,1247,99.9,2475,1239,1236,100.2
31104, 일산서구,010002, 6세,2018,2791,1423,1368,104,2777,1415,1362,103.9
31104, 일산서구,010003, 7세,2018,2754,1432,1322,108.3,2743,1427,1316,108.4
31104, 일산서구,010004, 8세,2018,2764,1416,1348,105,2749,1410,1339,105.3
31104, 일산서구,010005, 9세,2018,2715,1389,1326,104.8,2699,1382,1317,104.9
31104, 일산서구,015,10~14세,2018,15768,8060,7708,104.6,15744,8045,7699,104.5
31104, 일산서구,015001, 10세,2018,3082,1547,1535,100.8,3078,1544,1534,100.7
31104, 일산서구,015002, 11세,2018,3135,1637,1498,109.3,3128,1631,1497,109
31104, 일산서구,015003, 12세,2018,2993,1538,1455,105.7,2988,1535,1453,105.6
31104, 일산서구,015004, 13세,2018,3086,1568,1518,103.3,3083,1567,1516,103.4
31104, 일산서구,015005, 14세,2018,3472,1770,1702,104,3467,1768,1699,104.1
31104, 일산서구,020,15~19세,2018,18127,9251,8876,104.2,18073,9226,8847,104.3
31104, 일산서구,020001, 15세,2018,3392,1785,1607,111.1,3384,1779,1605,110.8
31104, 일산서구,020002, 16세,2018,3535,1802,1733,104,3526,1797,1729,103.9
31104, 일산서구,020003, 17세,2018,3889,1943,1946,99.8,3885,1942,1943,99.9
31104, 일산서구,020004, 18세,2018,4098,2079,2019,103,4086,2076,2010,103.3
31104, 일산서구,020005, 19세,2018,3213,1642,1571,104.5,3192,1632,1560,104.6
31104, 일산서구,025,20~24세,2018,18442,9676,8766,110.4,18176,9509,8667,109.7
31104, 일산서구,025001, 20세,2018,3518,1898,1620,117.2,3484,1879,1605,117.1
31104, 일산서구,025002, 21세,2018,3604,2004,1600,125.3,3574,1981,1593,124.4
31104, 일산서구,025003, 22세,2018,3646,1996,1650,121,3608,1969,1639,120.1
31104, 일산서구,025004, 23세,2018,3763,1863,1900,98.1,3696,1824,1872,97.4
31104, 일산서구,025005, 24세,2018,3911,1915,1996,95.9,3814,1856,1958,94.8
31104, 일산서구,030,25~29세,2018,18044,8949,9095,98.4,17549,8693,8856,98.2
31104, 일산서구,030001, 25세,2018,3869,1927,1942,99.2,3793,1881,1912,98.4
31104, 일산서구,030002, 26세,2018,3924,1898,2026,93.7,3828,1845,1983,93
31104, 일산서구,030003, 27세,2018,3773,1900,1873,101.4,3662,1848,1814,101.9
31104, 일산서구,030004, 28세,2018,3320,1632,1688,96.7,3214,1584,1630,97.2
31104, 일산서구,030005, 29세,2018,3158,1592,1566,101.7,3052,1535,1517,101.2
31104, 일산서구,035,30~34세,2018,14886,7187,7699,93.3,14287,6863,7424,92.4
31104, 일산서구,035001, 30세,2018,2977,1466,1511,97,2865,1412,1453,97.2
31104, 일산서구,035002, 31세,2018,2840,1379,1461,94.4,2724,1310,1414,92.6
31104, 일산서구,035003, 32세,2018,2907,1361,1546,88,2756,1278,1478,86.5
31104, 일산서구,035004, 33세,2018,3003,1457,1546,94.2,2890,1401,1489,94.1
31104, 일산서구,035005, 34세,2018,3159,1524,1635,93.2,3052,1462,1590,91.9
31104, 일산서구,040,35~39세,2018,19689,9285,10404,89.2,19163,9002,10161,88.6
31104, 일산서구,040001, 35세,2018,3542,1732,1810,95.7,3435,1672,1763,94.8
31104, 일산서구,040002, 36세,2018,3809,1807,2002,90.3,3687,1746,1941,90
31104, 일산서구,040003, 37세,2018,4007,1880,2127,88.4,3910,1832,2078,88.2
31104, 일산서구,040004, 38세,2018,4127,1904,2223,85.7,4027,1854,2173,85.3
31104, 일산서구,040005, 39세,2018,4204,1962,2242,87.5,4104,1898,2206,86
31104, 일산서구,045,40~44세,2018,22852,10627,12225,86.9,22411,10381,12030,86.3
31104, 일산서구,045001, 40세,2018,3905,1842,2063,89.3,3815,1785,2030,87.9
31104, 일산서구,045002, 41세,2018,4291,2001,2290,87.4,4189,1943,2246,86.5
31104, 일산서구,045003, 42세,2018,4316,1976,2340,84.4,4231,1931,2300,84
31104, 일산서구,045004, 43세,2018,4877,2258,2619,86.2,4797,2216,2581,85.9
31104, 일산서구,045005, 44세,2018,5463,2550,2913,87.5,5379,2506,2873,87.2
31104, 일산서구,050,45~49세,2018,30976,14661,16315,89.9,30508,14394,16114,89.3
31104, 일산서구,050001, 45세,2018,5728,2665,3063,87,5639,2613,3026,86.4
31104, 일산서구,050002, 46세,2018,6066,2776,3290,84.4,5981,2726,3255,83.7
31104, 일산서구,050003, 47세,2018,6497,3104,3393,91.5,6418,3056,3362,90.9
31104, 일산서구,050004, 48세,2018,6334,3019,3315,91.1,6228,2958,3270,90.5
31104, 일산서구,050005, 49세,2018,6351,3097,3254,95.2,6242,3041,3201,95
31104, 일산서구,055,50~54세,2018,27323,13270,14053,94.4,26848,13052,13796,94.6
31104, 일산서구,055001, 50세,2018,6139,2936,3203,91.7,6027,2875,3152,91.2
31104, 일산서구,055002, 51세,2018,5525,2645,2880,91.8,5444,2614,2830,92.4
31104, 일산서구,055003, 52세,2018,5185,2578,2607,98.9,5087,2536,2551,99.4
31104, 일산서구,055004, 53세,2018,5434,2618,2816,93,5351,2582,2769,93.2
31104, 일산서구,055005, 54세,2018,5040,2493,2547,97.9,4939,2445,2494,98
31104, 일산서구,060,55~59세,2018,24290,12328,11962,103.1,23796,12120,11676,103.8
31104, 일산서구,060001, 55세,2018,5186,2602,2584,100.7,5057,2551,2506,101.8
31104, 일산서구,060002, 56세,2018,4988,2490,2498,99.7,4882,2453,2429,101
31104, 일산서구,060003, 57세,2018,5079,2581,2498,103.3,4998,2545,2453,103.8
31104, 일산서구,060004, 58세,2018,4815,2475,2340,105.8,4719,2431,2288,106.3
31104, 일산서구,060005, 59세,2018,4222,2180,2042,106.8,4140,2140,2000,107
31104, 일산서구,065,60~64세,2018,15798,8291,7507,110.4,15402,8103,7299,111
31104, 일산서구,065001, 60세,2018,3690,1924,1766,108.9,3607,1890,1717,110.1
31104, 일산서구,065002, 61세,2018,3586,1909,1677,113.8,3500,1868,1632,114.5
31104, 일산서구,065003, 62세,2018,3117,1660,1457,113.9,3030,1614,1416,114
31104, 일산서구,065004, 63세,2018,3042,1583,1459,108.5,2969,1546,1423,108.6
31104, 일산서구,065005, 64세,2018,2363,1215,1148,105.8,2296,1185,1111,106.7
31104, 일산서구,070,65~69세,2018,8796,4130,4666,88.5,8614,4049,4565,88.7
31104, 일산서구,070001, 65세,2018,2000,957,1043,91.8,1939,929,1010,92
31104, 일산서구,070002, 66세,2018,2094,1028,1066,96.4,2051,1006,1045,96.3
31104, 일산서구,070003, 67세,2018,1418,674,744,90.6,1390,663,727,91.2
31104, 일산서구,070004, 68세,2018,1594,694,900,77.1,1565,681,884,77
31104, 일산서구,070005, 69세,2018,1690,777,913,85.1,1669,770,899,85.7
31104, 일산서구,075,70~74세,2018,7661,3218,4443,72.4,7589,3183,4406,72.2
31104, 일산서구,075001, 70세,2018,1692,731,961,76.1,1672,723,949,76.2
31104, 일산서구,075002, 71세,2018,1786,748,1038,72.1,1769,739,1030,71.7
31104, 일산서구,075003, 72세,2018,1404,592,812,72.9,1389,585,804,72.8
31104, 일산서구,075004, 73세,2018,1406,582,824,70.6,1395,574,821,69.9
31104, 일산서구,075005, 74세,2018,1373,565,808,69.9,1364,562,802,70.1
31104, 일산서구,080,75~79세,2018,7450,2913,4537,64.2,7422,2907,4515,64.4
31104, 일산서구,080001, 75세,2018,1484,580,904,64.2,1483,579,904,64
31104, 일산서구,080002, 76세,2018,1729,723,1006,71.9,1719,721,998,72.2
31104, 일산서구,080003, 77세,2018,1549,601,948,63.4,1542,600,942,63.7
31104, 일산서구,080004, 78세,2018,1338,485,853,56.9,1335,484,851,56.9
31104, 일산서구,080005, 79세,2018,1350,524,826,63.4,1343,523,820,63.8
31104, 일산서구,085,80~84세,2018,5357,2016,3341,60.3,5336,2009,3327,60.4
31104, 일산서구,085001, 80세,2018,1293,491,802,61.2,1290,490,800,61.3
31104, 일산서구,085002, 81세,2018,1158,417,741,56.3,1152,415,737,56.3
31104, 일산서구,085003, 82세,2018,1082,445,637,69.9,1077,442,635,69.6
31104, 일산서구,085004, 83세,2018,1020,371,649,57.2,1015,370,645,57.4
31104, 일산서구,085005, 84세,2018,804,292,512,57,802,292,510,57.3
31104, 일산서구,090,85~89세,2018,2492,831,1661,50,2483,831,1652,50.3
31104, 일산서구,090001, 85세,2018,649,219,430,50.9,647,219,428,51.2
31104, 일산서구,090002, 86세,2018,564,217,347,62.5,560,217,343,63.3
31104, 일산서구,090003, 87세,2018,498,159,339,46.9,497,159,338,47
31104, 일산서구,090004, 88세,2018,436,135,301,44.9,436,135,301,44.9
31104, 일산서구,090005, 89세,2018,345,101,244,41.4,343,101,242,41.7
31104, 일산서구,095,90~94세,2018,733,194,539,36,732,194,538,36.1
31104, 일산서구,095001, 90세,2018,248,63,185,34.1,248,63,185,34.1
31104, 일산서구,095002, 91세,2018,182,48,134,35.8,182,48,134,35.8
31104, 일산서구,095003, 92세,2018,129,35,94,37.2,129,35,94,37.2
31104, 일산서구,095004, 93세,2018,95,26,69,37.7,94,26,68,38.2
31104, 일산서구,095005, 94세,2018,79,22,57,38.6,79,22,57,38.6
31104, 일산서구,100,95~99세,2018,178,58,120,48.3,176,58,118,49.2
31104, 일산서구,100001, 95세,2018,60,19,41,46.3,58,19,39,48.7
31104, 일산서구,100002, 96세,2018,56,18,38,47.4,56,18,38,47.4
31104, 일산서구,100003, 97세,2018,26,9,17,52.9,26,9,17,52.9
31104, 일산서구,100004, 98세,2018,21,8,13,61.5,21,8,13,61.5
31104, 일산서구,100005, 99세,2018,15,X,11,36.4,15,X,11,36.4
31104, 일산서구,101,100세이상,2018,25,9,16,56.3,25,9,16,56.3
31104, 일산서구,102,15세미만,2018,39535,20211,19324,104.6,39340,20118,19222,104.7
31104, 일산서구,103,15~64세,2018,210427,103525,106902,96.8,206213,101343,104870,96.6
31104, 일산서구,104,65세이상,2018,32692,13369,19323,69.2,32377,13240,19137,69.2
31104, 일산서구,086,85세이상,2018,3428,1092,2336,46.7,3416,1092,2324,47
31104, 일산서구,126,평균연령,2018,40.7,39.7,41.7,,40.7,39.7,41.6,
31104, 일산서구,127,중위연령,2018,43,42.1,43.7,,43,42.1,43.7,
31110, 과천시,000,합계,2018,53740,26376,27364,96.4,53341,26159,27182,96.2
31110, 과천시,005,0~4세,2018,1855,999,856,116.7,1849,994,855,116.3
31110, 과천시,005001, 0세,2018,316,179,137,130.7,315,178,137,129.9
31110, 과천시,005002, 1세,2018,330,184,146,126,327,182,145,125.5
31110, 과천시,005003, 2세,2018,400,213,187,113.9,398,211,187,112.8
31110, 과천시,005004, 3세,2018,390,194,196,99,390,194,196,99
31110, 과천시,005005, 4세,2018,419,229,190,120.5,419,229,190,120.5
31110, 과천시,010,5~9세,2018,2387,1218,1169,104.2,2386,1218,1168,104.3
31110, 과천시,010001, 5세,2018,443,224,219,102.3,442,224,218,102.8
31110, 과천시,010002, 6세,2018,487,253,234,108.1,487,253,234,108.1
31110, 과천시,010003, 7세,2018,477,241,236,102.1,477,241,236,102.1
31110, 과천시,010004, 8세,2018,484,254,230,110.4,484,254,230,110.4
31110, 과천시,010005, 9세,2018,496,246,250,98.4,496,246,250,98.4
31110, 과천시,015,10~14세,2018,2828,1514,1314,115.2,2825,1511,1314,115
31110, 과천시,015001, 10세,2018,536,286,250,114.4,536,286,250,114.4
31110, 과천시,015002, 11세,2018,558,300,258,116.3,557,299,258,115.9
31110, 과천시,015003, 12세,2018,555,293,262,111.8,554,292,262,111.5
31110, 과천시,015004, 13세,2018,545,289,256,112.9,545,289,256,112.9
31110, 과천시,015005, 14세,2018,634,346,288,120.1,633,345,288,119.8
31110, 과천시,020,15~19세,2018,3287,1697,1590,106.7,3284,1696,1588,106.8
31110, 과천시,020001, 15세,2018,599,302,297,101.7,599,302,297,101.7
31110, 과천시,020002, 16세,2018,632,316,316,100,632,316,316,100
31110, 과천시,020003, 17세,2018,707,370,337,109.8,707,370,337,109.8
31110, 과천시,020004, 18세,2018,717,378,339,111.5,717,378,339,111.5
31110, 과천시,020005, 19세,2018,632,331,301,110,629,330,299,110.4
31110, 과천시,025,20~24세,2018,3528,1878,1650,113.8,3492,1857,1635,113.6
31110, 과천시,025001, 20세,2018,671,346,325,106.5,664,342,322,106.2
31110, 과천시,025002, 21세,2018,722,436,286,152.4,713,430,283,151.9
31110, 과천시,025003, 22세,2018,706,372,334,111.4,699,367,332,110.5
31110, 과천시,025004, 23세,2018,711,370,341,108.5,704,367,337,108.9
31110, 과천시,025005, 24세,2018,718,354,364,97.3,712,351,361,97.2
31110, 과천시,030,25~29세,2018,3491,1831,1660,110.3,3436,1799,1637,109.9
31110, 과천시,030001, 25세,2018,767,377,390,96.7,750,365,385,94.8
31110, 과천시,030002, 26세,2018,675,353,322,109.6,665,347,318,109.1
31110, 과천시,030003, 27세,2018,726,384,342,112.3,721,381,340,112.1
31110, 과천시,030004, 28세,2018,679,373,306,121.9,668,368,300,122.7
31110, 과천시,030005, 29세,2018,644,344,300,114.7,632,338,294,115
31110, 과천시,035,30~34세,2018,3135,1580,1555,101.6,3079,1549,1530,101.2
31110, 과천시,035001, 30세,2018,642,342,300,114,626,333,293,113.7
31110, 과천시,035002, 31세,2018,649,309,340,90.9,637,303,334,90.7
31110, 과천시,035003, 32세,2018,596,295,301,98,587,291,296,98.3
31110, 과천시,035004, 33세,2018,596,295,301,98,588,291,297,98
31110, 과천시,035005, 34세,2018,652,339,313,108.3,641,331,310,106.8
31110, 과천시,040,35~39세,2018,3479,1757,1722,102,3441,1728,1713,100.9
31110, 과천시,040001, 35세,2018,666,337,329,102.4,658,330,328,100.6
31110, 과천시,040002, 36세,2018,693,348,345,100.9,687,344,343,100.3
31110, 과천시,040003, 37세,2018,708,369,339,108.8,700,362,338,107.1
31110, 과천시,040004, 38세,2018,697,344,353,97.5,690,339,351,96.6
31110, 과천시,040005, 39세,2018,715,359,356,100.8,706,353,353,100
31110, 과천시,045,40~44세,2018,3747,1739,2008,86.6,3711,1718,1993,86.2
31110, 과천시,045001, 40세,2018,650,304,346,87.9,641,299,342,87.4
31110, 과천시,045002, 41세,2018,656,290,366,79.2,650,286,364,78.6
31110, 과천시,045003, 42세,2018,770,361,409,88.3,764,357,407,87.7
31110, 과천시,045004, 43세,2018,767,347,420,82.6,757,343,414,82.9
31110, 과천시,045005, 44세,2018,904,437,467,93.6,899,433,466,92.9
31110, 과천시,050,45~49세,2018,5293,2520,2773,90.9,5255,2498,2757,90.6
31110, 과천시,050001, 45세,2018,990,481,509,94.5,978,473,505,93.7
31110, 과천시,050002, 46세,2018,1001,472,529,89.2,997,471,526,89.5
31110, 과천시,050003, 47세,2018,1151,561,590,95.1,1142,554,588,94.2
31110, 과천시,050004, 48세,2018,1083,497,586,84.8,1077,494,583,84.7
31110, 과천시,050005, 49세,2018,1068,509,559,91.1,1061,506,555,91.2
31110, 과천시,055,50~54세,2018,5050,2446,2604,93.9,5015,2432,2583,94.2
31110, 과천시,055001, 50세,2018,1117,519,598,86.8,1110,515,595,86.6
31110, 과천시,055002, 51세,2018,994,466,528,88.3,983,462,521,88.7
31110, 과천시,055003, 52세,2018,997,514,483,106.4,991,511,480,106.5
31110, 과천시,055004, 53세,2018,1009,486,523,92.9,1003,483,520,92.9
31110, 과천시,055005, 54세,2018,933,461,472,97.7,928,461,467,98.7
31110, 과천시,060,55~59세,2018,4802,2345,2457,95.4,4770,2332,2438,95.7
31110, 과천시,060001, 55세,2018,1035,535,500,107,1027,531,496,107.1
31110, 과천시,060002, 56세,2018,926,465,461,100.9,921,463,458,101.1
31110, 과천시,060003, 57세,2018,1032,506,526,96.2,1027,504,523,96.4
31110, 과천시,060004, 58세,2018,970,430,540,79.6,963,427,536,79.7
31110, 과천시,060005, 59세,2018,839,409,430,95.1,832,407,425,95.8
31110, 과천시,065,60~64세,2018,3615,1810,1805,100.3,3582,1796,1786,100.6
31110, 과천시,065001, 60세,2018,832,423,409,103.4,824,417,407,102.5
31110, 과천시,065002, 61세,2018,801,396,405,97.8,795,396,399,99.2
31110, 과천시,065003, 62세,2018,709,352,357,98.6,701,348,353,98.6
31110, 과천시,065004, 63세,2018,707,360,347,103.7,700,359,341,105.3
31110, 과천시,065005, 64세,2018,566,279,287,97.2,562,276,286,96.5
31110, 과천시,070,65~69세,2018,2223,1056,1167,90.5,2214,1054,1160,90.9
31110, 과천시,070001, 65세,2018,521,262,259,101.2,519,261,258,101.2
31110, 과천시,070002, 66세,2018,491,231,260,88.8,489,231,258,89.5
31110, 과천시,070003, 67세,2018,367,168,199,84.4,367,168,199,84.4
31110, 과천시,070004, 68세,2018,441,210,231,90.9,439,210,229,91.7
31110, 과천시,070005, 69세,2018,403,185,218,84.9,400,184,216,85.2
31110, 과천시,075,70~74세,2018,1711,749,962,77.9,1699,743,956,77.7
31110, 과천시,075001, 70세,2018,387,179,208,86.1,383,177,206,85.9
31110, 과천시,075002, 71세,2018,390,164,226,72.6,387,164,223,73.5
31110, 과천시,075003, 72세,2018,328,147,181,81.2,326,146,180,81.1
31110, 과천시,075004, 73세,2018,290,141,149,94.6,289,140,149,94
31110, 과천시,075005, 74세,2018,316,118,198,59.6,314,116,198,58.6
31110, 과천시,080,75~79세,2018,1502,633,869,72.8,1500,632,868,72.8
31110, 과천시,080001, 75세,2018,334,150,184,81.5,334,150,184,81.5
31110, 과천시,080002, 76세,2018,355,151,204,74,355,151,204,74
31110, 과천시,080003, 77세,2018,280,114,166,68.7,278,113,165,68.5
31110, 과천시,080004, 78세,2018,272,115,157,73.2,272,115,157,73.2
31110, 과천시,080005, 79세,2018,261,103,158,65.2,261,103,158,65.2
31110, 과천시,085,80~84세,2018,1039,393,646,60.8,1037,392,645,60.8
31110, 과천시,085001, 80세,2018,233,101,132,76.5,232,100,132,75.8
31110, 과천시,085002, 81세,2018,227,82,145,56.6,227,82,145,56.6
31110, 과천시,085003, 82세,2018,206,75,131,57.3,206,75,131,57.3
31110, 과천시,085004, 83세,2018,216,85,131,64.9,216,85,131,64.9
31110, 과천시,085005, 84세,2018,157,50,107,46.7,156,50,106,47.2
31110, 과천시,090,85~89세,2018,499,149,350,42.6,498,149,349,42.7
31110, 과천시,090001, 85세,2018,133,39,94,41.5,133,39,94,41.5
31110, 과천시,090002, 86세,2018,108,34,74,45.9,108,34,74,45.9
31110, 과천시,090003, 87세,2018,94,26,68,38.2,94,26,68,38.2
31110, 과천시,090004, 88세,2018,87,22,65,33.8,86,22,64,34.4
31110, 과천시,090005, 89세,2018,77,28,49,57.1,77,28,49,57.1
31110, 과천시,095,90~94세,2018,219,48,171,28.1,218,47,171,27.5
31110, 과천시,095001, 90세,2018,81,18,63,28.6,81,18,63,28.6
31110, 과천시,095002, 91세,2018,47,7,40,17.5,47,7,40,17.5
31110, 과천시,095003, 92세,2018,35,9,26,34.6,35,9,26,34.6
31110, 과천시,095004, 93세,2018,35,9,26,34.6,35,9,26,34.6
31110, 과천시,095005, 94세,2018,21,5,16,31.3,20,X,16,25
31110, 과천시,100,95~99세,2018,40,11,29,37.9,40,11,29,37.9
31110, 과천시,100001, 95세,2018,19,X,16,18.8,19,X,16,18.8
31110, 과천시,100002, 96세,2018,12,6,6,100,12,6,6,100
31110, 과천시,100003, 97세,2018,X,X,X,33.3,X,X,X,33.3
31110, 과천시,100004, 98세,2018,X,X,X,0,X,X,X,0
31110, 과천시,100005, 99세,2018,X,X,X,50,X,X,X,50
31110, 과천시,101,100세이상,2018,10,X,7,42.9,10,X,7,42.9
31110, 과천시,102,15세미만,2018,7070,3731,3339,111.7,7060,3723,3337,111.6
31110, 과천시,103,15~64세,2018,39427,19603,19824,98.9,39065,19405,19660,98.7
31110, 과천시,104,65세이상,2018,7243,3042,4201,72.4,7216,3031,4185,72.4
31110, 과천시,086,85세이상,2018,768,211,557,37.9,766,210,556,37.8
31110, 과천시,126,평균연령,2018,41.8,40.4,43.1,,41.8,40.4,43.1,
31110, 과천시,127,중위연령,2018,44,42.3,45.3,,44.1,42.4,45.3,
31120, 구리시,000,합계,2018,195868,96907,98961,97.9,193966,96042,97924,98.1
31120, 구리시,005,0~4세,2018,8305,4256,4049,105.1,8265,4233,4032,105
31120, 구리시,005001, 0세,2018,1380,709,671,105.7,1372,705,667,105.7
31120, 구리시,005002, 1세,2018,1502,790,712,111,1495,787,708,111.2
31120, 구리시,005003, 2세,2018,1724,858,866,99.1,1714,852,862,98.8
31120, 구리시,005004, 3세,2018,1825,918,907,101.2,1817,913,904,101
31120, 구리시,005005, 4세,2018,1874,981,893,109.9,1867,976,891,109.5
31120, 구리시,010,5~9세,2018,9018,4688,4330,108.3,8998,4679,4319,108.3
31120, 구리시,010001, 5세,2018,1795,957,838,114.2,1793,955,838,114
31120, 구리시,010002, 6세,2018,1939,1001,938,106.7,1933,998,935,106.7
31120, 구리시,010003, 7세,2018,1852,954,898,106.2,1847,953,894,106.6
31120, 구리시,010004, 8세,2018,1713,882,831,106.1,1708,881,827,106.5
31120, 구리시,010005, 9세,2018,1719,894,825,108.4,1717,892,825,108.1
31120, 구리시,015,10~14세,2018,8876,4656,4220,110.3,8864,4649,4215,110.3
31120, 구리시,015001, 10세,2018,1770,904,866,104.4,1767,902,865,104.3
31120, 구리시,015002, 11세,2018,1823,942,881,106.9,1822,942,880,107
31120, 구리시,015003, 12세,2018,1751,963,788,122.2,1747,961,786,122.3
31120, 구리시,015004, 13세,2018,1676,914,762,119.9,1675,914,761,120.1
31120, 구리시,015005, 14세,2018,1856,933,923,101.1,1853,930,923,100.8
31120, 구리시,020,15~19세,2018,10356,5258,5098,103.1,10331,5243,5088,103
31120, 구리시,020001, 15세,2018,1862,918,944,97.2,1858,914,944,96.8
31120, 구리시,020002, 16세,2018,1933,993,940,105.6,1929,991,938,105.7
31120, 구리시,020003, 17세,2018,2178,1105,1073,103,2173,1102,1071,102.9
31120, 구리시,020004, 18세,2018,2379,1240,1139,108.9,2376,1239,1137,109
31120, 구리시,020005, 19세,2018,2004,1002,1002,100,1995,997,998,99.9
31120, 구리시,025,20~24세,2018,12921,6770,6151,110.1,12794,6710,6084,110.3
31120, 구리시,025001, 20세,2018,2316,1242,1074,115.6,2303,1238,1065,116.2
31120, 구리시,025002, 21세,2018,2506,1358,1148,118.3,2486,1348,1138,118.5
31120, 구리시,025003, 22세,2018,2624,1387,1237,112.1,2596,1376,1220,112.8
31120, 구리시,025004, 23세,2018,2664,1364,1300,104.9,2629,1347,1282,105.1
31120, 구리시,025005, 24세,2018,2811,1419,1392,101.9,2780,1401,1379,101.6
31120, 구리시,030,25~29세,2018,13205,6584,6621,99.4,12902,6446,6456,99.8
31120, 구리시,030001, 25세,2018,2832,1439,1393,103.3,2769,1412,1357,104.1
31120, 구리시,030002, 26세,2018,2890,1487,1403,106,2821,1453,1368,106.2
31120, 구리시,030003, 27세,2018,2604,1274,1330,95.8,2546,1247,1299,96
31120, 구리시,030004, 28세,2018,2507,1218,1289,94.5,2455,1192,1263,94.4
31120, 구리시,030005, 29세,2018,2372,1166,1206,96.7,2311,1142,1169,97.7
31120, 구리시,035,30~34세,2018,12250,6121,6129,99.9,11990,5991,5999,99.9
31120, 구리시,035001, 30세,2018,2288,1180,1108,106.5,2224,1155,1069,108
31120, 구리시,035002, 31세,2018,2352,1177,1175,100.2,2306,1146,1160,98.8
31120, 구리시,035003, 32세,2018,2379,1177,1202,97.9,2326,1158,1168,99.1
31120, 구리시,035004, 33세,2018,2548,1268,1280,99.1,2501,1240,1261,98.3
31120, 구리시,035005, 34세,2018,2683,1319,1364,96.7,2633,1292,1341,96.3
31120, 구리시,040,35~39세,2018,16513,8322,8191,101.6,16305,8215,8090,101.5
31120, 구리시,040001, 35세,2018,3056,1553,1503,103.3,3002,1530,1472,103.9
31120, 구리시,040002, 36세,2018,3375,1656,1719,96.3,3332,1628,1704,95.5
31120, 구리시,040003, 37세,2018,3388,1739,1649,105.5,3350,1722,1628,105.8
31120, 구리시,040004, 38세,2018,3453,1755,1698,103.4,3409,1727,1682,102.7
31120, 구리시,040005, 39세,2018,3241,1619,1622,99.8,3212,1608,1604,100.2
31120, 구리시,045,40~44세,2018,15376,7664,7712,99.4,15202,7588,7614,99.7
31120, 구리시,045001, 40세,2018,2874,1445,1429,101.1,2843,1429,1414,101.1
31120, 구리시,045002, 41세,2018,3018,1547,1471,105.2,2975,1530,1445,105.9
31120, 구리시,045003, 42세,2018,2978,1492,1486,100.4,2944,1477,1467,100.7
31120, 구리시,045004, 43세,2018,3145,1525,1620,94.1,3108,1512,1596,94.7
31120, 구리시,045005, 44세,2018,3361,1655,1706,97,3332,1640,1692,96.9
31120, 구리시,050,45~49세,2018,18415,8920,9495,93.9,18221,8834,9387,94.1
31120, 구리시,050001, 45세,2018,3490,1714,1776,96.5,3451,1698,1753,96.9
31120, 구리시,050002, 46세,2018,3595,1808,1787,101.2,3559,1788,1771,101
31120, 구리시,050003, 47세,2018,3794,1774,2020,87.8,3754,1763,1991,88.5
31120, 구리시,050004, 48세,2018,3718,1823,1895,96.2,3671,1798,1873,96
31120, 구리시,050005, 49세,2018,3818,1801,2017,89.3,3786,1787,1999,89.4
31120, 구리시,055,50~54세,2018,17587,8547,9040,94.5,17405,8471,8934,94.8
31120, 구리시,055001, 50세,2018,3852,1796,2056,87.4,3809,1779,2030,87.6
31120, 구리시,055002, 51세,2018,3414,1635,1779,91.9,3383,1624,1759,92.3
31120, 구리시,055003, 52세,2018,3499,1708,1791,95.4,3461,1691,1770,95.5
31120, 구리시,055004, 53세,2018,3526,1781,1745,102.1,3487,1759,1728,101.8
31120, 구리시,055005, 54세,2018,3296,1627,1669,97.5,3265,1618,1647,98.2
31120, 구리시,060,55~59세,2018,17355,8743,8612,101.5,17206,8696,8510,102.2
31120, 구리시,060001, 55세,2018,3448,1774,1674,106,3408,1763,1645,107.2
31120, 구리시,060002, 56세,2018,3601,1859,1742,106.7,3571,1851,1720,107.6
31120, 구리시,060003, 57세,2018,3670,1785,1885,94.7,3651,1776,1875,94.7
31120, 구리시,060004, 58세,2018,3550,1723,1827,94.3,3515,1711,1804,94.8
31120, 구리시,060005, 59세,2018,3086,1602,1484,108,3061,1595,1466,108.8
31120, 구리시,065,60~64세,2018,12606,6328,6278,100.8,12495,6282,6213,101.1
31120, 구리시,065001, 60세,2018,2926,1471,1455,101.1,2897,1458,1439,101.3
31120, 구리시,065002, 61세,2018,2714,1344,1370,98.1,2684,1328,1356,97.9
31120, 구리시,065003, 62세,2018,2461,1240,1221,101.6,2446,1234,1212,101.8
31120, 구리시,065004, 63세,2018,2479,1243,1236,100.6,2461,1236,1225,100.9
31120, 구리시,065005, 64세,2018,2026,1030,996,103.4,2007,1026,981,104.6
31120, 구리시,070,65~69세,2018,7686,3737,3949,94.6,7627,3705,3922,94.5
31120, 구리시,070001, 65세,2018,1763,859,904,95,1746,848,898,94.4
31120, 구리시,070002, 66세,2018,1942,946,996,95,1926,939,987,95.1
31120, 구리시,070003, 67세,2018,1272,647,625,103.5,1262,642,620,103.5
31120, 구리시,070004, 68세,2018,1388,655,733,89.4,1379,649,730,88.9
31120, 구리시,070005, 69세,2018,1321,630,691,91.2,1314,627,687,91.3
31120, 구리시,075,70~74세,2018,6008,2723,3285,82.9,5988,2715,3273,83
31120, 구리시,075001, 70세,2018,1406,656,750,87.5,1404,655,749,87.4
31120, 구리시,075002, 71세,2018,1404,631,773,81.6,1397,627,770,81.4
31120, 구리시,075003, 72세,2018,1117,506,611,82.8,1114,506,608,83.2
31120, 구리시,075004, 73세,2018,1042,480,562,85.4,1038,478,560,85.4
31120, 구리시,075005, 74세,2018,1039,450,589,76.4,1035,449,586,76.6
31120, 구리시,080,75~79세,2018,4844,2090,2754,75.9,4833,2086,2747,75.9
31120, 구리시,080001, 75세,2018,1060,464,596,77.9,1058,462,596,77.5
31120, 구리시,080002, 76세,2018,1169,523,646,81,1166,522,644,81.1
31120, 구리시,080003, 77세,2018,954,413,541,76.3,951,412,539,76.4
31120, 구리시,080004, 78세,2018,845,344,501,68.7,844,344,500,68.8
31120, 구리시,080005, 79세,2018,816,346,470,73.6,814,346,468,73.9
31120, 구리시,085,80~84세,2018,2780,1025,1755,58.4,2778,1025,1753,58.5
31120, 구리시,085001, 80세,2018,712,293,419,69.9,711,293,418,70.1
31120, 구리시,085002, 81세,2018,614,237,377,62.9,614,237,377,62.9
31120, 구리시,085003, 82세,2018,519,182,337,54,519,182,337,54
31120, 구리시,085004, 83세,2018,512,166,346,48,512,166,346,48
31120, 구리시,085005, 84세,2018,423,147,276,53.3,422,147,275,53.5
31120, 구리시,090,85~89세,2018,1251,372,879,42.3,1247,371,876,42.4
31120, 구리시,090001, 85세,2018,342,114,228,50,340,113,227,49.8
31120, 구리시,090002, 86세,2018,294,83,211,39.3,293,83,210,39.5
31120, 구리시,090003, 87세,2018,216,66,150,44,216,66,150,44
31120, 구리시,090004, 88세,2018,241,64,177,36.2,240,64,176,36.4
31120, 구리시,090005, 89세,2018,158,45,113,39.8,158,45,113,39.8
31120, 구리시,095,90~94세,2018,403,81,322,25.2,403,81,322,25.2
31120, 구리시,095001, 90세,2018,126,23,103,22.3,126,23,103,22.3
31120, 구리시,095002, 91세,2018,96,15,81,18.5,96,15,81,18.5
31120, 구리시,095003, 92세,2018,73,13,60,21.7,73,13,60,21.7
31120, 구리시,095004, 93세,2018,65,16,49,32.7,65,16,49,32.7
31120, 구리시,095005, 94세,2018,43,14,29,48.3,43,14,29,48.3
31120, 구리시,100,95~99세,2018,101,21,80,26.3,100,21,79,26.6
31120, 구리시,100001, 95세,2018,33,X,29,13.8,32,X,28,14.3
31120, 구리시,100002, 96세,2018,26,X,22,18.2,26,X,22,18.2
31120, 구리시,100003, 97세,2018,13,5,8,62.5,13,5,8,62.5
31120, 구리시,100004, 98세,2018,20,5,15,33.3,20,5,15,33.3
31120, 구리시,100005, 99세,2018,9,X,6,50,9,X,6,50
31120, 구리시,101,100세이상,2018,12,X,11,9.1,12,X,11,9.1
31120, 구리시,102,15세미만,2018,26199,13600,12599,107.9,26127,13561,12566,107.9
31120, 구리시,103,15~64세,2018,146584,73257,73327,99.9,144851,72476,72375,100.1
31120, 구리시,104,65세이상,2018,23085,10050,13035,77.1,22988,10005,12983,77.1
31120, 구리시,086,85세이상,2018,1767,475,1292,36.8,1762,474,1288,36.8
31120, 구리시,126,평균연령,2018,40.9,40,41.7,,40.9,40,41.7,
31120, 구리시,127,중위연령,2018,42.2,41.2,43.2,,42.2,41.3,43.2,
31130, 남양주시,000,합계,2018,661866,330430,331436,99.7,652055,324516,327539,99.1
31130, 남양주시,005,0~4세,2018,29195,14993,14202,105.6,29122,14955,14167,105.6
31130, 남양주시,005001, 0세,2018,4370,2292,2078,110.3,4358,2287,2071,110.4
31130, 남양주시,005002, 1세,2018,5142,2595,2547,101.9,5124,2587,2537,102
31130, 남양주시,005003, 2세,2018,6185,3192,2993,106.6,6167,3180,2987,106.5
31130, 남양주시,005004, 3세,2018,6685,3382,3303,102.4,6671,3374,3297,102.3
31130, 남양주시,005005, 4세,2018,6813,3532,3281,107.7,6802,3527,3275,107.7
31130, 남양주시,010,5~9세,2018,37858,19443,18415,105.6,37801,19417,18384,105.6
31130, 남양주시,010001, 5세,2018,7155,3665,3490,105,7144,3661,3483,105.1
31130, 남양주시,010002, 6세,2018,7956,4087,3869,105.6,7940,4080,3860,105.7
31130, 남양주시,010003, 7세,2018,7861,4024,3837,104.9,7851,4019,3832,104.9
31130, 남양주시,010004, 8세,2018,7497,3905,3592,108.7,7489,3901,3588,108.7
31130, 남양주시,010005, 9세,2018,7389,3762,3627,103.7,7377,3756,3621,103.7
31130, 남양주시,015,10~14세,2018,36328,18683,17645,105.9,36281,18661,17620,105.9
31130, 남양주시,015001, 10세,2018,7669,3979,3690,107.8,7661,3976,3685,107.9
31130, 남양주시,015002, 11세,2018,7756,3987,3769,105.8,7749,3985,3764,105.9
31130, 남양주시,015003, 12세,2018,6926,3542,3384,104.7,6915,3534,3381,104.5
31130, 남양주시,015004, 13세,2018,6697,3420,3277,104.4,6690,3418,3272,104.5
31130, 남양주시,015005, 14세,2018,7280,3755,3525,106.5,7266,3748,3518,106.5
31130, 남양주시,020,15~19세,2018,36624,18852,17772,106.1,36428,18752,17676,106.1
31130, 남양주시,020001, 15세,2018,6909,3526,3383,104.2,6902,3522,3380,104.2
31130, 남양주시,020002, 16세,2018,6972,3613,3359,107.6,6960,3609,3351,107.7
31130, 남양주시,020003, 17세,2018,7795,3993,3802,105,7769,3985,3784,105.3
31130, 남양주시,020004, 18세,2018,7819,4072,3747,108.7,7788,4059,3729,108.8
31130, 남양주시,020005, 19세,2018,7129,3648,3481,104.8,7009,3577,3432,104.2
31130, 남양주시,025,20~24세,2018,38932,20733,18199,113.9,37740,19964,17776,112.3
31130, 남양주시,025001, 20세,2018,7525,4023,3502,114.9,7399,3947,3452,114.3
31130, 남양주시,025002, 21세,2018,7883,4272,3611,118.3,7681,4153,3528,117.7
31130, 남양주시,025003, 22세,2018,7763,4154,3609,115.1,7532,3998,3534,113.1
31130, 남양주시,025004, 23세,2018,7924,4187,3737,112,7638,3994,3644,109.6
31130, 남양주시,025005, 24세,2018,7837,4097,3740,109.5,7490,3872,3618,107
31130, 남양주시,030,25~29세,2018,36533,19252,17281,111.4,34589,17895,16694,107.2
31130, 남양주시,030001, 25세,2018,7869,4118,3751,109.8,7525,3876,3649,106.2
31130, 남양주시,030002, 26세,2018,7934,4189,3745,111.9,7547,3913,3634,107.7
31130, 남양주시,030003, 27세,2018,7320,3841,3479,110.4,6913,3554,3359,105.8
31130, 남양주시,030004, 28세,2018,6820,3632,3188,113.9,6402,3348,3054,109.6
31130, 남양주시,030005, 29세,2018,6590,3472,3118,111.4,6202,3204,2998,106.9
31130, 남양주시,035,30~34세,2018,35974,17990,17984,100,34177,16789,17388,96.6
31130, 남양주시,035001, 30세,2018,6548,3445,3103,111,6136,3146,2990,105.2
31130, 남양주시,035002, 31세,2018,6444,3236,3208,100.9,6094,3000,3094,97
31130, 남양주시,035003, 32세,2018,7092,3521,3571,98.6,6734,3306,3428,96.4
31130, 남양주시,035004, 33세,2018,7593,3740,3853,97.1,7241,3498,3743,93.5
31130, 남양주시,035005, 34세,2018,8297,4048,4249,95.3,7972,3839,4133,92.9
31130, 남양주시,040,35~39세,2018,56423,27647,28776,96.1,55078,26791,28287,94.7
31130, 남양주시,040001, 35세,2018,9496,4703,4793,98.1,9202,4523,4679,96.7
31130, 남양주시,040002, 36세,2018,10945,5281,5664,93.2,10647,5086,5561,91.5
31130, 남양주시,040003, 37세,2018,11690,5741,5949,96.5,11428,5577,5851,95.3
31130, 남양주시,040004, 38세,2018,12281,6001,6280,95.6,12030,5839,6191,94.3
31130, 남양주시,040005, 39세,2018,12011,5921,6090,97.2,11771,5766,6005,96
31130, 남양주시,045,40~44세,2018,58742,29466,29276,100.6,57965,29032,28933,100.3
31130, 남양주시,045001, 40세,2018,11084,5491,5593,98.2,10912,5394,5518,97.8
31130, 남양주시,045002, 41세,2018,11436,5711,5725,99.8,11279,5623,5656,99.4
31130, 남양주시,045003, 42세,2018,11337,5655,5682,99.5,11169,5558,5611,99.1
31130, 남양주시,045004, 43세,2018,12059,6082,5977,101.8,11921,6006,5915,101.5
31130, 남양주시,045005, 44세,2018,12826,6527,6299,103.6,12684,6451,6233,103.5
31130, 남양주시,050,45~49세,2018,63443,32510,30933,105.1,62765,32132,30633,104.9
31130, 남양주시,050001, 45세,2018,12772,6525,6247,104.5,12631,6441,6190,104.1
31130, 남양주시,050002, 46세,2018,12844,6655,6189,107.5,12720,6580,6140,107.2
31130, 남양주시,050003, 47세,2018,13220,6733,6487,103.8,13072,6655,6417,103.7
31130, 남양주시,050004, 48세,2018,12396,6434,5962,107.9,12260,6364,5896,107.9
31130, 남양주시,050005, 49세,2018,12211,6163,6048,101.9,12082,6092,5990,101.7
31130, 남양주시,055,50~54세,2018,54059,27475,26584,103.4,53508,27225,26283,103.6
31130, 남양주시,055001, 50세,2018,11827,5879,5948,98.8,11712,5824,5888,98.9
31130, 남양주시,055002, 51세,2018,10883,5468,5415,101,10760,5406,5354,101
31130, 남양주시,055003, 52세,2018,10593,5521,5072,108.9,10478,5464,5014,109
31130, 남양주시,055004, 53세,2018,10567,5351,5216,102.6,10465,5311,5154,103
31130, 남양주시,055005, 54세,2018,10189,5256,4933,106.5,10093,5220,4873,107.1
31130, 남양주시,060,55~59세,2018,51254,26024,25230,103.1,50803,25839,24964,103.5
31130, 남양주시,060001, 55세,2018,10307,5341,4966,107.6,10173,5277,4896,107.8
31130, 남양주시,060002, 56세,2018,10217,5307,4910,108.1,10111,5266,4845,108.7
31130, 남양주시,060003, 57세,2018,10676,5338,5338,100,10599,5315,5284,100.6
31130, 남양주시,060004, 58세,2018,10638,5361,5277,101.6,10575,5328,5247,101.5
31130, 남양주시,060005, 59세,2018,9416,4677,4739,98.7,9345,4653,4692,99.2
31130, 남양주시,065,60~64세,2018,41057,20053,21004,95.5,40676,19887,20789,95.7
31130, 남양주시,065001, 60세,2018,9142,4566,4576,99.8,9057,4535,4522,100.3
31130, 남양주시,065002, 61세,2018,8798,4287,4511,95,8705,4243,4462,95.1
31130, 남양주시,065003, 62세,2018,7981,3937,4044,97.4,7902,3898,4004,97.4
31130, 남양주시,065004, 63세,2018,8151,3882,4269,90.9,8093,3855,4238,91
31130, 남양주시,065005, 64세,2018,6985,3381,3604,93.8,6919,3356,3563,94.2
31130, 남양주시,070,65~69세,2018,27421,12987,14434,90,27235,12909,14326,90.1
31130, 남양주시,070001, 65세,2018,5871,2834,3037,93.3,5825,2812,3013,93.3
31130, 남양주시,070002, 66세,2018,6715,3191,3524,90.6,6679,3177,3502,90.7
31130, 남양주시,070003, 67세,2018,4544,2141,2403,89.1,4512,2129,2383,89.3
31130, 남양주시,070004, 68세,2018,5106,2366,2740,86.4,5057,2347,2710,86.6
31130, 남양주시,070005, 69세,2018,5185,2455,2730,89.9,5162,2444,2718,89.9
31130, 남양주시,075,70~74세,2018,22212,10366,11846,87.5,22150,10337,11813,87.5
31130, 남양주시,075001, 70세,2018,5174,2450,2724,89.9,5154,2440,2714,89.9
31130, 남양주시,075002, 71세,2018,5185,2489,2696,92.3,5179,2486,2693,92.3
31130, 남양주시,075003, 72세,2018,4045,1848,2197,84.1,4032,1842,2190,84.1
31130, 남양주시,075004, 73세,2018,3950,1843,2107,87.5,3943,1841,2102,87.6
31130, 남양주시,075005, 74세,2018,3858,1736,2122,81.8,3842,1728,2114,81.7
31130, 남양주시,080,75~79세,2018,18099,7935,10164,78.1,18059,7920,10139,78.1
31130, 남양주시,080001, 75세,2018,3844,1695,2149,78.9,3835,1694,2141,79.1
31130, 남양주시,080002, 76세,2018,4418,2011,2407,83.5,4407,2008,2399,83.7
31130, 남양주시,080003, 77세,2018,3497,1546,1951,79.2,3489,1541,1948,79.1
31130, 남양주시,080004, 78세,2018,3212,1395,1817,76.8,3204,1392,1812,76.8
31130, 남양주시,080005, 79세,2018,3128,1288,1840,70,3124,1285,1839,69.9
31130, 남양주시,085,80~84세,2018,10614,4090,6524,62.7,10593,4082,6511,62.7
31130, 남양주시,085001, 80세,2018,2548,1044,1504,69.4,2543,1043,1500,69.5
31130, 남양주시,085002, 81세,2018,2370,953,1417,67.3,2366,952,1414,67.3
31130, 남양주시,085003, 82세,2018,2145,807,1338,60.3,2142,804,1338,60.1
31130, 남양주시,085004, 83세,2018,1955,720,1235,58.3,1952,719,1233,58.3
31130, 남양주시,085005, 84세,2018,1596,566,1030,55,1590,564,1026,55
31130, 남양주시,090,85~89세,2018,4921,1445,3476,41.6,4912,1445,3467,41.7
31130, 남양주시,090001, 85세,2018,1304,403,901,44.7,1300,403,897,44.9
31130, 남양주시,090002, 86세,2018,1159,378,781,48.4,1157,378,779,48.5
31130, 남양주시,090003, 87세,2018,897,252,645,39.1,894,252,642,39.3
31130, 남양주시,090004, 88세,2018,839,210,629,33.4,839,210,629,33.4
31130, 남양주시,090005, 89세,2018,722,202,520,38.8,722,202,520,38.8
31130, 남양주시,095,90~94세,2018,1655,359,1296,27.7,1652,358,1294,27.7
31130, 남양주시,095001, 90세,2018,531,131,400,32.8,530,130,400,32.5
31130, 남양주시,095002, 91세,2018,407,76,331,23,406,76,330,23
31130, 남양주시,095003, 92세,2018,321,63,258,24.4,321,63,258,24.4
31130, 남양주시,095004, 93세,2018,239,45,194,23.2,238,45,193,23.3
31130, 남양주시,095005, 94세,2018,157,44,113,38.9,157,44,113,38.9
31130, 남양주시,100,95~99세,2018,462,117,345,33.9,461,116,345,33.6
31130, 남양주시,100001, 95세,2018,168,43,125,34.4,168,43,125,34.4
31130, 남양주시,100002, 96세,2018,134,37,97,38.1,133,36,97,37.1
31130, 남양주시,100003, 97세,2018,82,21,61,34.4,82,21,61,34.4
31130, 남양주시,100004, 98세,2018,37,X,33,12.1,37,X,33,12.1
31130, 남양주시,100005, 99세,2018,41,12,29,41.4,41,12,29,41.4
31130, 남양주시,101,100세이상,2018,60,10,50,20,60,10,50,20
31130, 남양주시,102,15세미만,2018,103381,53119,50262,105.7,103204,53033,50171,105.7
31130, 남양주시,103,15~64세,2018,473041,240002,233039,103,463729,234306,229423,102.1
31130, 남양주시,104,65세이상,2018,85444,37309,48135,77.5,85122,37177,47945,77.5
31130, 남양주시,086,85세이상,2018,7098,1931,5167,37.4,7085,1929,5156,37.4
31130, 남양주시,126,평균연령,2018,40.6,39.6,41.5,,40.6,39.7,41.5,
31130, 남양주시,127,중위연령,2018,42,41.4,42.7,,42.2,41.6,42.8,
31140, 오산시,000,합계,2018,228059,117424,110635,106.1,214399,110270,104129,105.9
31140, 오산시,005,0~4세,2018,12444,6397,6047,105.8,11898,6099,5799,105.2
31140, 오산시,005001, 0세,2018,2021,1067,954,111.8,1899,1004,895,112.2
31140, 오산시,005002, 1세,2018,2259,1205,1054,114.3,2126,1128,998,113
31140, 오산시,005003, 2세,2018,2615,1298,1317,98.6,2504,1237,1267,97.6
31140, 오산시,005004, 3세,2018,2756,1412,1344,105.1,2663,1360,1303,104.4
31140, 오산시,005005, 4세,2018,2793,1415,1378,102.7,2706,1370,1336,102.5
31140, 오산시,010,5~9세,2018,14335,7409,6926,107,14135,7303,6832,106.9
31140, 오산시,010001, 5세,2018,2827,1490,1337,111.4,2782,1465,1317,111.2
31140, 오산시,010002, 6세,2018,3096,1595,1501,106.3,3040,1562,1478,105.7
31140, 오산시,010003, 7세,2018,2931,1520,1411,107.7,2897,1502,1395,107.7
31140, 오산시,010004, 8세,2018,2841,1437,1404,102.4,2807,1423,1384,102.8
31140, 오산시,010005, 9세,2018,2640,1367,1273,107.4,2609,1351,1258,107.4
31140, 오산시,015,10~14세,2018,12345,6368,5977,106.5,12257,6317,5940,106.3
31140, 오산시,015001, 10세,2018,2745,1458,1287,113.3,2717,1441,1276,112.9
31140, 오산시,015002, 11세,2018,2719,1406,1313,107.1,2707,1397,1310,106.6
31140, 오산시,015003, 12세,2018,2341,1182,1159,102,2322,1172,1150,101.9
31140, 오산시,015004, 13세,2018,2248,1158,1090,106.2,2236,1149,1087,105.7
31140, 오산시,015005, 14세,2018,2292,1164,1128,103.2,2275,1158,1117,103.7
31140, 오산시,020,15~19세,2018,12067,6183,5884,105.1,11940,6116,5824,105
31140, 오산시,020001, 15세,2018,2287,1177,1110,106,2277,1173,1104,106.3
31140, 오산시,020002, 16세,2018,2267,1138,1129,100.8,2255,1133,1122,101
31140, 오산시,020003, 17세,2018,2524,1293,1231,105,2501,1280,1221,104.8
31140, 오산시,020004, 18세,2018,2613,1342,1271,105.6,2577,1321,1256,105.2
31140, 오산시,020005, 19세,2018,2376,1233,1143,107.9,2330,1209,1121,107.9
31140, 오산시,025,20~24세,2018,13493,7031,6462,108.8,12981,6763,6218,108.8
31140, 오산시,025001, 20세,2018,2559,1329,1230,108,2477,1284,1193,107.6
31140, 오산시,025002, 21세,2018,2666,1360,1306,104.1,2587,1328,1259,105.5
31140, 오산시,025003, 22세,2018,2607,1395,1212,115.1,2514,1341,1173,114.3
31140, 오산시,025004, 23세,2018,2865,1453,1412,102.9,2737,1374,1363,100.8
31140, 오산시,025005, 24세,2018,2796,1494,1302,114.7,2666,1436,1230,116.7
31140, 오산시,030,25~29세,2018,15967,8706,7261,119.9,14613,8012,6601,121.4
31140, 오산시,030001, 25세,2018,3001,1612,1389,116.1,2824,1510,1314,114.9
31140, 오산시,030002, 26세,2018,3348,1831,1517,120.7,3150,1738,1412,123.1
31140, 오산시,030003, 27세,2018,3272,1774,1498,118.4,2987,1629,1358,120
31140, 오산시,030004, 28세,2018,3144,1723,1421,121.3,2820,1554,1266,122.7
31140, 오산시,030005, 29세,2018,3202,1766,1436,123,2832,1581,1251,126.4
31140, 오산시,035,30~34세,2018,18551,9728,8823,110.3,16347,8564,7783,110
31140, 오산시,035001, 30세,2018,3343,1773,1570,112.9,2908,1545,1363,113.4
31140, 오산시,035002, 31세,2018,3513,1827,1686,108.4,3028,1577,1451,108.7
31140, 오산시,035003, 32세,2018,3708,1959,1749,112,3250,1728,1522,113.5
31140, 오산시,035004, 33세,2018,3905,2057,1848,111.3,3483,1817,1666,109.1
31140, 오산시,035005, 34세,2018,4082,2112,1970,107.2,3678,1897,1781,106.5
31140, 오산시,040,35~39세,2018,25101,13284,11817,112.4,23369,12304,11065,111.2
31140, 오산시,040001, 35세,2018,4597,2396,2201,108.9,4245,2215,2030,109.1
31140, 오산시,040002, 36세,2018,5319,2864,2455,116.7,4894,2607,2287,114
31140, 오산시,040003, 37세,2018,5092,2744,2348,116.9,4803,2580,2223,116.1
31140, 오산시,040004, 38세,2018,5224,2701,2523,107.1,4902,2523,2379,106.1
31140, 오산시,040005, 39세,2018,4869,2579,2290,112.6,4525,2379,2146,110.9
31140, 오산시,045,40~44세,2018,21612,11552,10060,114.8,20430,10876,9554,113.8
31140, 오산시,045001, 40세,2018,4357,2316,2041,113.5,4094,2169,1925,112.7
31140, 오산시,045002, 41세,2018,4372,2341,2031,115.3,4140,2205,1935,114
31140, 오산시,045003, 42세,2018,4137,2244,1893,118.5,3910,2106,1804,116.7
31140, 오산시,045004, 43세,2018,4291,2284,2007,113.8,4068,2159,1909,113.1
31140, 오산시,045005, 44세,2018,4455,2367,2088,113.4,4218,2237,1981,112.9
31140, 오산시,050,45~49세,2018,20628,10867,9761,111.3,19142,10061,9081,110.8
31140, 오산시,050001, 45세,2018,4300,2247,2053,109.4,4035,2105,1930,109.1
31140, 오산시,050002, 46세,2018,4157,2219,1938,114.5,3880,2048,1832,111.8
31140, 오산시,050003, 47세,2018,4205,2167,2038,106.3,3896,2017,1879,107.3
31140, 오산시,050004, 48세,2018,3953,2099,1854,113.2,3638,1942,1696,114.5
31140, 오산시,050005, 49세,2018,4013,2135,1878,113.7,3693,1949,1744,111.8
31140, 오산시,055,50~54세,2018,16951,8789,8162,107.7,15548,8053,7495,107.4
31140, 오산시,055001, 50세,2018,3928,2003,1925,104.1,3639,1849,1790,103.3
31140, 오산시,055002, 51세,2018,3353,1707,1646,103.7,3109,1578,1531,103.1
31140, 오산시,055003, 52세,2018,3262,1703,1559,109.2,2986,1568,1418,110.6
31140, 오산시,055004, 53세,2018,3360,1755,1605,109.3,3048,1599,1449,110.4
31140, 오산시,055005, 54세,2018,3048,1621,1427,113.6,2766,1459,1307,111.6
31140, 오산시,060,55~59세,2018,15001,7675,7326,104.8,13808,7104,6704,106
31140, 오산시,060001, 55세,2018,3029,1560,1469,106.2,2700,1408,1292,109
31140, 오산시,060002, 56세,2018,3104,1614,1490,108.3,2844,1487,1357,109.6
31140, 오산시,060003, 57세,2018,3170,1618,1552,104.3,3014,1552,1462,106.2
31140, 오산시,060004, 58세,2018,3102,1576,1526,103.3,2831,1437,1394,103.1
31140, 오산시,060005, 59세,2018,2596,1307,1289,101.4,2419,1220,1199,101.8
31140, 오산시,065,60~64세,2018,10617,5229,5388,97,9635,4766,4869,97.9
31140, 오산시,065001, 60세,2018,2500,1229,1271,96.7,2256,1114,1142,97.5
31140, 오산시,065002, 61세,2018,2253,1108,1145,96.8,2022,999,1023,97.7
31140, 오산시,065003, 62세,2018,2082,1029,1053,97.7,1907,936,971,96.4
31140, 오산시,065004, 63세,2018,2068,1021,1047,97.5,1892,940,952,98.7
31140, 오산시,065005, 64세,2018,1714,842,872,96.6,1558,777,781,99.5
31140, 오산시,070,65~69세,2018,6471,3126,3345,93.5,6033,2922,3111,93.9
31140, 오산시,070001, 65세,2018,1416,699,717,97.5,1292,632,660,95.8
31140, 오산시,070002, 66세,2018,1635,808,827,97.7,1523,759,764,99.3
31140, 오산시,070003, 67세,2018,1130,529,601,88,1041,487,554,87.9
31140, 오산시,070004, 68세,2018,1137,544,593,91.7,1064,518,546,94.9
31140, 오산시,070005, 69세,2018,1153,546,607,90,1113,526,587,89.6
31140, 오산시,075,70~74세,2018,4882,2226,2656,83.8,4756,2178,2578,84.5
31140, 오산시,075001, 70세,2018,1151,555,596,93.1,1116,541,575,94.1
31140, 오산시,075002, 71세,2018,1118,530,588,90.1,1087,518,569,91
31140, 오산시,075003, 72세,2018,873,409,464,88.1,851,401,450,89.1
31140, 오산시,075004, 73세,2018,856,363,493,73.6,839,360,479,75.2
31140, 오산시,075005, 74세,2018,884,369,515,71.7,863,358,505,70.9
31140, 오산시,080,75~79세,2018,3894,1614,2280,70.8,3842,1600,2242,71.4
31140, 오산시,080001, 75세,2018,840,337,503,67,827,335,492,68.1
31140, 오산시,080002, 76세,2018,974,422,552,76.4,960,417,543,76.8
31140, 오산시,080003, 77세,2018,742,314,428,73.4,736,311,425,73.2
31140, 오산시,080004, 78세,2018,679,271,408,66.4,670,269,401,67.1
31140, 오산시,080005, 79세,2018,659,270,389,69.4,649,268,381,70.3
31140, 오산시,085,80~84세,2018,2395,912,1483,61.5,2370,905,1465,61.8
31140, 오산시,085001, 80세,2018,628,249,379,65.7,623,246,377,65.3
31140, 오산시,085002, 81세,2018,484,177,307,57.7,479,175,304,57.6
31140, 오산시,085003, 82세,2018,521,205,316,64.9,514,205,309,66.3
31140, 오산시,085004, 83세,2018,423,149,274,54.4,419,148,271,54.6
31140, 오산시,085005, 84세,2018,339,132,207,63.8,335,131,204,64.2
31140, 오산시,090,85~89세,2018,893,239,654,36.5,883,238,645,36.9
31140, 오산시,090001, 85세,2018,257,82,175,46.9,253,81,172,47.1
31140, 오산시,090002, 86세,2018,214,64,150,42.7,212,64,148,43.2
31140, 오산시,090003, 87세,2018,164,41,123,33.3,161,41,120,34.2
31140, 오산시,090004, 88세,2018,163,28,135,20.7,162,28,134,20.9
31140, 오산시,090005, 89세,2018,95,24,71,33.8,95,24,71,33.8
31140, 오산시,095,90~94세,2018,335,72,263,27.4,335,72,263,27.4
31140, 오산시,095001, 90세,2018,103,27,76,35.5,103,27,76,35.5
31140, 오산시,095002, 91세,2018,92,14,78,17.9,92,14,78,17.9
31140, 오산시,095003, 92세,2018,57,8,49,16.3,57,8,49,16.3
31140, 오산시,095004, 93세,2018,53,16,37,43.2,53,16,37,43.2
31140, 오산시,095005, 94세,2018,30,7,23,30.4,30,7,23,30.4
31140, 오산시,100,95~99세,2018,67,16,51,31.4,67,16,51,31.4
31140, 오산시,100001, 95세,2018,33,6,27,22.2,33,6,27,22.2
31140, 오산시,100002, 96세,2018,15,5,10,50,15,5,10,50
31140, 오산시,100003, 97세,2018,9,X,9,0,9,X,9,0
31140, 오산시,100004, 98세,2018,X,X,X,33.3,X,X,X,33.3
31140, 오산시,100005, 99세,2018,6,X,X,200,6,X,X,200
31140, 오산시,101,100세이상,2018,10,X,9,11.1,10,X,9,11.1
31140, 오산시,102,15세미만,2018,39124,20174,18950,106.5,38290,19719,18571,106.2
31140, 오산시,103,15~64세,2018,169988,89044,80944,110,157813,82619,75194,109.9
31140, 오산시,104,65세이상,2018,18947,8206,10741,76.4,18296,7932,10364,76.5
31140, 오산시,086,85세이상,2018,1305,328,977,33.6,1295,327,968,33.8
31140, 오산시,126,평균연령,2018,37.3,36.7,38,,37.1,36.4,37.7,
31140, 오산시,127,중위연령,2018,38,37.6,38.4,,37.8,37.4,38.2,
31150, 시흥시,000,합계,2018,480201,254589,225612,112.8,432752,226421,206331,109.7
31150, 시흥시,005,0~4세,2018,21745,11132,10613,104.9,20189,10303,9886,104.2
31150, 시흥시,005001, 0세,2018,3622,1838,1784,103,3263,1647,1616,101.9
31150, 시흥시,005002, 1세,2018,4028,2041,1987,102.7,3691,1870,1821,102.7
31150, 시흥시,005003, 2세,2018,4642,2334,2308,101.1,4293,2144,2149,99.8
31150, 시흥시,005004, 3세,2018,4914,2590,2324,111.4,4644,2439,2205,110.6
31150, 시흥시,005005, 4세,2018,4539,2329,2210,105.4,4298,2203,2095,105.2
31150, 시흥시,010,5~9세,2018,23677,12221,11456,106.7,22930,11826,11104,106.5
31150, 시흥시,010001, 5세,2018,4659,2399,2260,106.2,4455,2298,2157,106.5
31150, 시흥시,010002, 6세,2018,4993,2582,2411,107.1,4814,2485,2329,106.7
31150, 시흥시,010003, 7세,2018,4836,2514,2322,108.3,4690,2431,2259,107.6
31150, 시흥시,010004, 8세,2018,4618,2333,2285,102.1,4496,2271,2225,102.1
31150, 시흥시,010005, 9세,2018,4571,2393,2178,109.9,4475,2341,2134,109.7
31150, 시흥시,015,10~14세,2018,22623,11547,11076,104.3,22308,11370,10938,103.9
31150, 시흥시,015001, 10세,2018,4758,2467,2291,107.7,4671,2417,2254,107.2
31150, 시흥시,015002, 11세,2018,4702,2349,2353,99.8,4630,2305,2325,99.1
31150, 시흥시,015003, 12세,2018,4380,2195,2185,100.5,4320,2166,2154,100.6
31150, 시흥시,015004, 13세,2018,4281,2176,2105,103.4,4230,2147,2083,103.1
31150, 시흥시,015005, 14세,2018,4502,2360,2142,110.2,4457,2335,2122,110
31150, 시흥시,020,15~19세,2018,25991,13786,12205,113,25618,13607,12011,113.3
31150, 시흥시,020001, 15세,2018,4628,2381,2247,106,4584,2362,2222,106.3
31150, 시흥시,020002, 16세,2018,4680,2458,2222,110.6,4637,2434,2203,110.5
31150, 시흥시,020003, 17세,2018,5362,2809,2553,110,5301,2777,2524,110
31150, 시흥시,020004, 18세,2018,5875,3160,2715,116.4,5789,3119,2670,116.8
31150, 시흥시,020005, 19세,2018,5446,2978,2468,120.7,5307,2915,2392,121.9
31150, 시흥시,025,20~24세,2018,33147,18412,14735,125,30757,16787,13970,120.2
31150, 시흥시,025001, 20세,2018,6014,3248,2766,117.4,5772,3101,2671,116.1
31150, 시흥시,025002, 21세,2018,6174,3307,2867,115.3,5894,3139,2755,113.9
31150, 시흥시,025003, 22세,2018,6708,3712,2996,123.9,6248,3400,2848,119.4
31150, 시흥시,025004, 23세,2018,7066,4073,2993,136.1,6459,3636,2823,128.8
31150, 시흥시,025005, 24세,2018,7185,4072,3113,130.8,6384,3511,2873,122.2
31150, 시흥시,030,25~29세,2018,35768,20501,15267,134.3,29438,16259,13179,123.4
31150, 시흥시,030001, 25세,2018,7314,4227,3087,136.9,6366,3553,2813,126.3
31150, 시흥시,030002, 26세,2018,7384,4210,3174,132.6,6266,3454,2812,122.8
31150, 시흥시,030003, 27세,2018,7084,4023,3061,131.4,5894,3238,2656,121.9
31150, 시흥시,030004, 28세,2018,7046,4020,3026,132.8,5571,3063,2508,122.1
31150, 시흥시,030005, 29세,2018,6940,4021,2919,137.8,5341,2951,2390,123.5
31150, 시흥시,035,30~34세,2018,36437,20385,16052,127,27891,15004,12887,116.4
31150, 시흥시,035001, 30세,2018,6890,3858,3032,127.2,5201,2788,2413,115.5
31150, 시흥시,035002, 31세,2018,7065,3966,3099,128,5238,2841,2397,118.5
31150, 시흥시,035003, 32세,2018,7410,4120,3290,125.2,5546,2964,2582,114.8
31150, 시흥시,035004, 33세,2018,7375,4153,3222,128.9,5747,3099,2648,117
31150, 시흥시,035005, 34세,2018,7697,4288,3409,125.8,6159,3312,2847,116.3
31150, 시흥시,040,35~39세,2018,45072,24892,20180,123.3,38732,20792,17940,115.9
31150, 시흥시,040001, 35세,2018,8449,4602,3847,119.6,7024,3682,3342,110.2
31150, 시흥시,040002, 36세,2018,9255,5106,4149,123.1,7811,4207,3604,116.7
31150, 시흥시,040003, 37세,2018,9267,5153,4114,125.3,8030,4333,3697,117.2
31150, 시흥시,040004, 38세,2018,9364,5175,4189,123.5,8246,4459,3787,117.7
31150, 시흥시,040005, 39세,2018,8737,4856,3881,125.1,7621,4111,3510,117.1
31150, 시흥시,045,40~44세,2018,42470,23391,19079,122.6,38159,20622,17537,117.6
31150, 시흥시,045001, 40세,2018,8257,4522,3735,121.1,7236,3841,3395,113.1
31150, 시흥시,045002, 41세,2018,8245,4603,3642,126.4,7411,4053,3358,120.7
31150, 시흥시,045003, 42세,2018,8302,4610,3692,124.9,7403,4031,3372,119.5
31150, 시흥시,045004, 43세,2018,8520,4650,3870,120.2,7730,4149,3581,115.9
31150, 시흥시,045005, 44세,2018,9146,5006,4140,120.9,8379,4548,3831,118.7
31150, 시흥시,050,45~49세,2018,47692,25090,22602,111,43054,22386,20668,108.3
31150, 시흥시,050001, 45세,2018,9166,4927,4239,116.2,8319,4404,3915,112.5
31150, 시흥시,050002, 46세,2018,9269,4933,4336,113.8,8298,4357,3941,110.6
31150, 시흥시,050003, 47세,2018,9785,5126,4659,110,8786,4522,4264,106.1
31150, 시흥시,050004, 48세,2018,9553,4943,4610,107.2,8601,4415,4186,105.5
31150, 시흥시,050005, 49세,2018,9919,5161,4758,108.5,9050,4688,4362,107.5
31150, 시흥시,055,50~54세,2018,44227,23205,21022,110.4,40249,21072,19177,109.9
31150, 시흥시,055001, 50세,2018,9801,5046,4755,106.1,8917,4553,4364,104.3
31150, 시흥시,055002, 51세,2018,8921,4577,4344,105.4,8237,4208,4029,104.4
31150, 시흥시,055003, 52세,2018,8559,4593,3966,115.8,7816,4205,3611,116.4
31150, 시흥시,055004, 53세,2018,8876,4650,4226,110,8036,4209,3827,110
31150, 시흥시,055005, 54세,2018,8070,4339,3731,116.3,7243,3897,3346,116.5
31150, 시흥시,060,55~59세,2018,38414,20955,17459,120,35153,19366,15787,122.7
31150, 시흥시,060001, 55세,2018,8375,4557,3818,119.4,7407,4067,3340,121.8
31150, 시흥시,060002, 56세,2018,8161,4439,3722,119.3,7483,4112,3371,122
31150, 시흥시,060003, 57세,2018,7822,4262,3560,119.7,7395,4060,3335,121.7
31150, 시흥시,060004, 58세,2018,7629,4165,3464,120.2,6944,3841,3103,123.8
31150, 시흥시,060005, 59세,2018,6427,3532,2895,122,5924,3286,2638,124.6
31150, 시흥시,065,60~64세,2018,24255,12705,11550,110,21462,11417,10045,113.7
31150, 시흥시,065001, 60세,2018,5930,3159,2771,114,5310,2873,2437,117.9
31150, 시흥시,065002, 61세,2018,5481,2899,2582,112.3,4860,2610,2250,116
31150, 시흥시,065003, 62세,2018,4639,2375,2264,104.9,4083,2129,1954,109
31150, 시흥시,065004, 63세,2018,4478,2310,2168,106.5,3964,2074,1890,109.7
31150, 시흥시,065005, 64세,2018,3727,1962,1765,111.2,3245,1731,1514,114.3
31150, 시흥시,070,65~69세,2018,13078,6605,6473,102,11880,6047,5833,103.7
31150, 시흥시,070001, 65세,2018,3072,1584,1488,106.5,2706,1418,1288,110.1
31150, 시흥시,070002, 66세,2018,3222,1657,1565,105.9,2912,1495,1417,105.5
31150, 시흥시,070003, 67세,2018,2159,1044,1115,93.6,1933,945,988,95.6
31150, 시흥시,070004, 68세,2018,2313,1172,1141,102.7,2146,1097,1049,104.6
31150, 시흥시,070005, 69세,2018,2312,1148,1164,98.6,2183,1092,1091,100.1
31150, 시흥시,075,70~74세,2018,9146,4150,4996,83.1,8809,4028,4781,84.3
31150, 시흥시,075001, 70세,2018,2152,1041,1111,93.7,2063,1006,1057,95.2
31150, 시흥시,075002, 71세,2018,2140,991,1149,86.2,2060,965,1095,88.1
31150, 시흥시,075003, 72세,2018,1649,717,932,76.9,1579,688,891,77.2
31150, 시흥시,075004, 73세,2018,1625,706,919,76.8,1562,684,878,77.9
31150, 시흥시,075005, 74세,2018,1580,695,885,78.5,1545,685,860,79.7
31150, 시흥시,080,75~79세,2018,7853,3096,4757,65.1,7675,3053,4622,66.1
31150, 시흥시,080001, 75세,2018,1616,688,928,74.1,1576,676,900,75.1
31150, 시흥시,080002, 76세,2018,1882,772,1110,69.5,1851,762,1089,70
31150, 시흥시,080003, 77세,2018,1549,617,932,66.2,1511,608,903,67.3
31150, 시흥시,080004, 78세,2018,1404,516,888,58.1,1366,508,858,59.2
31150, 시흥시,080005, 79세,2018,1402,503,899,56,1371,499,872,57.2
31150, 시흥시,085,80~84세,2018,5133,1724,3409,50.6,5029,1698,3331,51
31150, 시흥시,085001, 80세,2018,1332,486,846,57.4,1305,478,827,57.8
31150, 시흥시,085002, 81세,2018,1085,395,690,57.2,1069,390,679,57.4
31150, 시흥시,085003, 82세,2018,997,315,682,46.2,971,310,661,46.9
31150, 시흥시,085004, 83세,2018,912,293,619,47.3,893,286,607,47.1
31150, 시흥시,085005, 84세,2018,807,235,572,41.1,791,234,557,42
31150, 시흥시,090,85~89세,2018,2380,574,1806,31.8,2334,567,1767,32.1
31150, 시흥시,090001, 85세,2018,636,185,451,41,617,184,433,42.5
31150, 시흥시,090002, 86세,2018,580,138,442,31.2,575,137,438,31.3
31150, 시흥시,090003, 87세,2018,433,109,324,33.6,424,107,317,33.8
31150, 시흥시,090004, 88세,2018,398,75,323,23.2,392,73,319,22.9
31150, 시흥시,090005, 89세,2018,333,67,266,25.2,326,66,260,25.4
31150, 시흥시,095,90~94세,2018,863,169,694,24.4,855,168,687,24.5
31150, 시흥시,095001, 90세,2018,288,64,224,28.6,286,64,222,28.8
31150, 시흥시,095002, 91세,2018,243,38,205,18.5,241,37,204,18.1
31150, 시흥시,095003, 92세,2018,153,28,125,22.4,151,28,123,22.8
31150, 시흥시,095004, 93세,2018,106,26,80,32.5,105,26,79,32.9
31150, 시흥시,095005, 94세,2018,73,13,60,21.7,72,13,59,22
31150, 시흥시,100,95~99세,2018,201,46,155,29.7,201,46,155,29.7
31150, 시흥시,100001, 95세,2018,74,19,55,34.5,74,19,55,34.5
31150, 시흥시,100002, 96세,2018,62,16,46,34.8,62,16,46,34.8
31150, 시흥시,100003, 97세,2018,31,X,28,10.7,31,X,28,10.7
31150, 시흥시,100004, 98세,2018,23,5,18,27.8,23,5,18,27.8
31150, 시흥시,100005, 99세,2018,11,X,8,37.5,11,X,8,37.5
31150, 시흥시,101,100세이상,2018,29,X,26,11.5,29,X,26,11.5
31150, 시흥시,102,15세미만,2018,68045,34900,33145,105.3,65427,33499,31928,104.9
31150, 시흥시,103,15~64세,2018,373473,203322,170151,119.5,330513,177312,153201,115.7
31150, 시흥시,104,65세이상,2018,38683,16367,22316,73.3,36812,15610,21202,73.6
31150, 시흥시,086,85세이상,2018,3473,792,2681,29.5,3419,784,2635,29.8
31150, 시흥시,126,평균연령,2018,38.7,38,39.4,,38.6,38,39.2,
31150, 시흥시,127,중위연령,2018,39.5,38.9,40.3,,39.8,39.3,40.4,
31160, 군포시,000,합계,2018,276860,137539,139321,98.7,267023,132411,134612,98.4
31160, 군포시,005,0~4세,2018,11401,5893,5508,107,11106,5735,5371,106.8
31160, 군포시,005001, 0세,2018,1951,1061,890,119.2,1891,1025,866,118.4
31160, 군포시,005002, 1세,2018,2126,1073,1053,101.9,2058,1037,1021,101.6
31160, 군포시,005003, 2세,2018,2483,1265,1218,103.9,2409,1226,1183,103.6
31160, 군포시,005004, 3세,2018,2418,1246,1172,106.3,2374,1224,1150,106.4
31160, 군포시,005005, 4세,2018,2423,1248,1175,106.2,2374,1223,1151,106.3
31160, 군포시,010,5~9세,2018,12681,6523,6158,105.9,12533,6443,6090,105.8
31160, 군포시,010001, 5세,2018,2454,1241,1213,102.3,2416,1218,1198,101.7
31160, 군포시,010002, 6세,2018,2607,1328,1279,103.8,2577,1312,1265,103.7
31160, 군포시,010003, 7세,2018,2669,1387,1282,108.2,2634,1368,1266,108.1
31160, 군포시,010004, 8세,2018,2523,1332,1191,111.8,2496,1317,1179,111.7
31160, 군포시,010005, 9세,2018,2428,1235,1193,103.5,2410,1228,1182,103.9
31160, 군포시,015,10~14세,2018,12845,6609,6236,106,12795,6585,6210,106
31160, 군포시,015001, 10세,2018,2675,1380,1295,106.6,2662,1372,1290,106.4
31160, 군포시,015002, 11세,2018,2617,1358,1259,107.9,2608,1355,1253,108.1
31160, 군포시,015003, 12세,2018,2452,1260,1192,105.7,2439,1255,1184,106
31160, 군포시,015004, 13세,2018,2422,1250,1172,106.7,2413,1244,1169,106.4
31160, 군포시,015005, 14세,2018,2679,1361,1318,103.3,2673,1359,1314,103.4
31160, 군포시,020,15~19세,2018,15027,7773,7254,107.2,14925,7727,7198,107.3
31160, 군포시,020001, 15세,2018,2762,1427,1335,106.9,2748,1421,1327,107.1
31160, 군포시,020002, 16세,2018,2809,1442,1367,105.5,2795,1435,1360,105.5
31160, 군포시,020003, 17세,2018,3082,1539,1543,99.7,3067,1530,1537,99.5
31160, 군포시,020004, 18세,2018,3381,1777,1604,110.8,3363,1768,1595,110.8
31160, 군포시,020005, 19세,2018,2993,1588,1405,113,2952,1573,1379,114.1
31160, 군포시,025,20~24세,2018,17402,9153,8249,111,16949,8915,8034,111
31160, 군포시,025001, 20세,2018,3197,1721,1476,116.6,3146,1694,1452,116.7
31160, 군포시,025002, 21세,2018,3347,1779,1568,113.5,3284,1746,1538,113.5
31160, 군포시,025003, 22세,2018,3520,1863,1657,112.4,3430,1810,1620,111.7
31160, 군포시,025004, 23세,2018,3591,1858,1733,107.2,3480,1803,1677,107.5
31160, 군포시,025005, 24세,2018,3747,1932,1815,106.4,3609,1862,1747,106.6
31160, 군포시,030,25~29세,2018,19566,10083,9483,106.3,18504,9516,8988,105.9
31160, 군포시,030001, 25세,2018,3880,2019,1861,108.5,3729,1937,1792,108.1
31160, 군포시,030002, 26세,2018,4027,2068,1959,105.6,3847,1984,1863,106.5
31160, 군포시,030003, 27세,2018,4030,2062,1968,104.8,3819,1940,1879,103.2
31160, 군포시,030004, 28세,2018,3744,1935,1809,107,3511,1809,1702,106.3
31160, 군포시,030005, 29세,2018,3885,1999,1886,106,3598,1846,1752,105.4
31160, 군포시,035,30~34세,2018,19515,10165,9350,108.7,18179,9440,8739,108
31160, 군포시,035001, 30세,2018,3716,1897,1819,104.3,3489,1786,1703,104.9
31160, 군포시,035002, 31세,2018,3800,1987,1813,109.6,3506,1828,1678,108.9
31160, 군포시,035003, 32세,2018,3968,2035,1933,105.3,3673,1886,1787,105.5
31160, 군포시,035004, 33세,2018,3928,2107,1821,115.7,3643,1938,1705,113.7
31160, 군포시,035005, 34세,2018,4103,2139,1964,108.9,3868,2002,1866,107.3
31160, 군포시,040,35~39세,2018,22574,11556,11018,104.9,21527,10955,10572,103.6
31160, 군포시,040001, 35세,2018,4290,2284,2006,113.9,4050,2146,1904,112.7
31160, 군포시,040002, 36세,2018,4614,2287,2327,98.3,4378,2144,2234,96
31160, 군포시,040003, 37세,2018,4613,2411,2202,109.5,4439,2312,2127,108.7
31160, 군포시,040004, 38세,2018,4619,2357,2262,104.2,4435,2255,2180,103.4
31160, 군포시,040005, 39세,2018,4438,2217,2221,99.8,4225,2098,2127,98.6
31160, 군포시,045,40~44세,2018,21441,10610,10831,98,20666,10175,10491,97
31160, 군포시,045001, 40세,2018,3987,2008,1979,101.5,3820,1914,1906,100.4
31160, 군포시,045002, 41세,2018,4199,2077,2122,97.9,4048,1986,2062,96.3
31160, 군포시,045003, 42세,2018,4162,2075,2087,99.4,4017,1997,2020,98.9
31160, 군포시,045004, 43세,2018,4284,2116,2168,97.6,4136,2036,2100,97
31160, 군포시,045005, 44세,2018,4809,2334,2475,94.3,4645,2242,2403,93.3
31160, 군포시,050,45~49세,2018,25938,12676,13262,95.6,24875,12140,12735,95.3
31160, 군포시,050001, 45세,2018,5097,2527,2570,98.3,4893,2411,2482,97.1
31160, 군포시,050002, 46세,2018,4985,2447,2538,96.4,4818,2359,2459,95.9
31160, 군포시,050003, 47세,2018,5339,2566,2773,92.5,5103,2448,2655,92.2
31160, 군포시,050004, 48세,2018,5251,2558,2693,95,5026,2459,2567,95.8
31160, 군포시,050005, 49세,2018,5266,2578,2688,95.9,5035,2463,2572,95.8
31160, 군포시,055,50~54세,2018,24023,11670,12353,94.5,22911,11112,11799,94.2
31160, 군포시,055001, 50세,2018,5176,2470,2706,91.3,4989,2362,2627,89.9
31160, 군포시,055002, 51세,2018,4622,2188,2434,89.9,4418,2092,2326,89.9
31160, 군포시,055003, 52세,2018,4758,2399,2359,101.7,4552,2298,2254,102
31160, 군포시,055004, 53세,2018,4883,2376,2507,94.8,4621,2246,2375,94.6
31160, 군포시,055005, 54세,2018,4584,2237,2347,95.3,4331,2114,2217,95.4
31160, 군포시,060,55~59세,2018,24706,12149,12557,96.8,23644,11617,12027,96.6
31160, 군포시,060001, 55세,2018,4886,2411,2475,97.4,4573,2248,2325,96.7
31160, 군포시,060002, 56세,2018,4979,2472,2507,98.6,4751,2354,2397,98.2
31160, 군포시,060003, 57세,2018,5153,2480,2673,92.8,5015,2414,2601,92.8
31160, 군포시,060004, 58세,2018,5169,2559,2610,98,4968,2456,2512,97.8
31160, 군포시,060005, 59세,2018,4519,2227,2292,97.2,4337,2145,2192,97.9
31160, 군포시,065,60~64세,2018,17840,8919,8921,100,17046,8512,8534,99.7
31160, 군포시,065001, 60세,2018,4338,2146,2192,97.9,4157,2049,2108,97.2
31160, 군포시,065002, 61세,2018,3888,1947,1941,100.3,3721,1876,1845,101.7
31160, 군포시,065003, 62세,2018,3443,1765,1678,105.2,3291,1680,1611,104.3
31160, 군포시,065004, 63세,2018,3376,1632,1744,93.6,3208,1542,1666,92.6
31160, 군포시,065005, 64세,2018,2795,1429,1366,104.6,2669,1365,1304,104.7
31160, 군포시,070,65~69세,2018,10136,5068,5068,100,9815,4916,4899,100.3
31160, 군포시,070001, 65세,2018,2363,1184,1179,100.4,2268,1137,1131,100.5
31160, 군포시,070002, 66세,2018,2451,1220,1231,99.1,2375,1185,1190,99.6
31160, 군포시,070003, 67세,2018,1706,857,849,100.9,1635,820,815,100.6
31160, 군포시,070004, 68세,2018,1814,894,920,97.2,1780,881,899,98
31160, 군포시,070005, 69세,2018,1802,913,889,102.7,1757,893,864,103.4
31160, 군포시,075,70~74세,2018,7622,3489,4133,84.4,7522,3452,4070,84.8
31160, 군포시,075001, 70세,2018,1721,846,875,96.7,1693,836,857,97.5
31160, 군포시,075002, 71세,2018,1880,861,1019,84.5,1850,850,1000,85
31160, 군포시,075003, 72세,2018,1418,631,787,80.2,1404,627,777,80.7
31160, 군포시,075004, 73세,2018,1287,586,701,83.6,1268,575,693,83
31160, 군포시,075005, 74세,2018,1316,565,751,75.2,1307,564,743,75.9
31160, 군포시,080,75~79세,2018,6335,2601,3734,69.7,6279,2586,3693,70
31160, 군포시,080001, 75세,2018,1317,558,759,73.5,1304,555,749,74.1
31160, 군포시,080002, 76세,2018,1551,663,888,74.7,1539,659,880,74.9
31160, 군포시,080003, 77세,2018,1260,536,724,74,1252,532,720,73.9
31160, 군포시,080004, 78세,2018,1121,426,695,61.3,1107,422,685,61.6
31160, 군포시,080005, 79세,2018,1086,418,668,62.6,1077,418,659,63.4
31160, 군포시,085,80~84세,2018,4561,1651,2910,56.7,4517,1638,2879,56.9
31160, 군포시,085001, 80세,2018,1118,412,706,58.4,1100,406,694,58.5
31160, 군포시,085002, 81세,2018,1014,395,619,63.8,1005,392,613,63.9
31160, 군포시,085003, 82세,2018,848,300,548,54.7,843,299,544,55
31160, 군포시,085004, 83세,2018,833,288,545,52.8,830,287,543,52.9
31160, 군포시,085005, 84세,2018,748,256,492,52,739,254,485,52.4
31160, 군포시,090,85~89세,2018,2252,712,1540,46.2,2239,709,1530,46.3
31160, 군포시,090001, 85세,2018,619,223,396,56.3,616,223,393,56.7
31160, 군포시,090002, 86세,2018,542,170,372,45.7,539,169,370,45.7
31160, 군포시,090003, 87세,2018,386,110,276,39.9,384,110,274,40.1
31160, 군포시,090004, 88세,2018,396,114,282,40.4,394,114,280,40.7
31160, 군포시,090005, 89세,2018,309,95,214,44.4,306,93,213,43.7
31160, 군포시,095,90~94세,2018,771,194,577,33.6,767,193,574,33.6
31160, 군포시,095001, 90세,2018,259,64,195,32.8,257,63,194,32.5
31160, 군포시,095002, 91세,2018,187,58,129,45,187,58,129,45
31160, 군포시,095003, 92세,2018,128,35,93,37.6,127,35,92,38
31160, 군포시,095004, 93세,2018,112,18,94,19.1,111,18,93,19.4
31160, 군포시,095005, 94세,2018,85,19,66,28.8,85,19,66,28.8
31160, 군포시,100,95~99세,2018,197,43,154,27.9,197,43,154,27.9
31160, 군포시,100001, 95세,2018,72,14,58,24.1,72,14,58,24.1
31160, 군포시,100002, 96세,2018,50,11,39,28.2,50,11,39,28.2
31160, 군포시,100003, 97세,2018,40,7,33,21.2,40,7,33,21.2
31160, 군포시,100004, 98세,2018,19,5,14,35.7,19,5,14,35.7
31160, 군포시,100005, 99세,2018,16,6,10,60,16,6,10,60
31160, 군포시,101,100세이상,2018,27,X,25,8,27,X,25,8
31160, 군포시,102,15세미만,2018,36927,19025,17902,106.3,36434,18763,17671,106.2
31160, 군포시,103,15~64세,2018,208032,104754,103278,101.4,199226,100109,99117,101
31160, 군포시,104,65세이상,2018,31901,13760,18141,75.9,31363,13539,17824,76
31160, 군포시,086,85세이상,2018,3247,951,2296,41.4,3230,947,2283,41.5
31160, 군포시,126,평균연령,2018,40.8,39.7,41.8,,40.7,39.7,41.7,
31160, 군포시,127,중위연령,2018,41.8,40.5,43.1,,41.8,40.5,43.1,
31170, 의왕시,000,합계,2018,149599,74569,75030,99.4,147909,73688,74221,99.3
31170, 의왕시,005,0~4세,2018,5584,2885,2699,106.9,5559,2875,2684,107.1
31170, 의왕시,005001, 0세,2018,843,435,408,106.6,841,433,408,106.1
31170, 의왕시,005002, 1세,2018,988,534,454,117.6,981,531,450,118
31170, 의왕시,005003, 2세,2018,1189,593,596,99.5,1181,590,591,99.8
31170, 의왕시,005004, 3세,2018,1271,659,612,107.7,1266,657,609,107.9
31170, 의왕시,005005, 4세,2018,1293,664,629,105.6,1290,664,626,106.1
31170, 의왕시,010,5~9세,2018,6734,3451,3283,105.1,6718,3443,3275,105.1
31170, 의왕시,010001, 5세,2018,1327,635,692,91.8,1324,634,690,91.9
31170, 의왕시,010002, 6세,2018,1410,742,668,111.1,1405,740,665,111.3
31170, 의왕시,010003, 7세,2018,1328,697,631,110.5,1325,695,630,110.3
31170, 의왕시,010004, 8세,2018,1314,678,636,106.6,1310,676,634,106.6
31170, 의왕시,010005, 9세,2018,1355,699,656,106.6,1354,698,656,106.4
31170, 의왕시,015,10~14세,2018,6415,3297,3118,105.7,6404,3292,3112,105.8
31170, 의왕시,015001, 10세,2018,1361,712,649,109.7,1359,711,648,109.7
31170, 의왕시,015002, 11세,2018,1321,668,653,102.3,1317,666,651,102.3
31170, 의왕시,015003, 12세,2018,1226,653,573,114,1225,653,572,114.2
31170, 의왕시,015004, 13세,2018,1212,621,591,105.1,1211,621,590,105.3
31170, 의왕시,015005, 14세,2018,1295,643,652,98.6,1292,641,651,98.5
31170, 의왕시,020,15~19세,2018,8726,4388,4338,101.2,8713,4379,4334,101
31170, 의왕시,020001, 15세,2018,1405,761,644,118.2,1402,760,642,118.4
31170, 의왕시,020002, 16세,2018,1558,783,775,101,1558,783,775,101
31170, 의왕시,020003, 17세,2018,1783,886,897,98.8,1781,885,896,98.8
31170, 의왕시,020004, 18세,2018,2118,1002,1116,89.8,2116,1001,1115,89.8
31170, 의왕시,020005, 19세,2018,1862,956,906,105.5,1856,950,906,104.9
31170, 의왕시,025,20~24세,2018,10325,5445,4880,111.6,10164,5364,4800,111.8
31170, 의왕시,025001, 20세,2018,1928,979,949,103.2,1906,967,939,103
31170, 의왕시,025002, 21세,2018,2000,1055,945,111.6,1979,1042,937,111.2
31170, 의왕시,025003, 22세,2018,2103,1136,967,117.5,2065,1121,944,118.8
31170, 의왕시,025004, 23세,2018,2191,1172,1019,115,2157,1150,1007,114.2
31170, 의왕시,025005, 24세,2018,2103,1103,1000,110.3,2057,1084,973,111.4
31170, 의왕시,030,25~29세,2018,10403,5577,4826,115.6,10140,5432,4708,115.4
31170, 의왕시,030001, 25세,2018,2230,1222,1008,121.2,2182,1188,994,119.5
31170, 의왕시,030002, 26세,2018,2205,1205,1000,120.5,2146,1166,980,119
31170, 의왕시,030003, 27세,2018,2124,1122,1002,112,2078,1100,978,112.5
31170, 의왕시,030004, 28세,2018,1940,1012,928,109.1,1889,991,898,110.4
31170, 의왕시,030005, 29세,2018,1904,1016,888,114.4,1845,987,858,115
31170, 의왕시,035,30~34세,2018,8976,4751,4225,112.4,8707,4601,4106,112.1
31170, 의왕시,035001, 30세,2018,1783,943,840,112.3,1725,903,822,109.9
31170, 의왕시,035002, 31세,2018,1819,995,824,120.8,1766,971,795,122.1
31170, 의왕시,035003, 32세,2018,1720,886,834,106.2,1674,863,811,106.4
31170, 의왕시,035004, 33세,2018,1798,966,832,116.1,1748,939,809,116.1
31170, 의왕시,035005, 34세,2018,1856,961,895,107.4,1794,925,869,106.4
31170, 의왕시,040,35~39세,2018,11025,5623,5402,104.1,10800,5492,5308,103.5
31170, 의왕시,040001, 35세,2018,2103,1068,1035,103.2,2054,1035,1019,101.6
31170, 의왕시,040002, 36세,2018,2218,1163,1055,110.2,2163,1134,1029,110.2
31170, 의왕시,040003, 37세,2018,2259,1132,1127,100.4,2213,1107,1106,100.1
31170, 의왕시,040004, 38세,2018,2273,1132,1141,99.2,2238,1109,1129,98.2
31170, 의왕시,040005, 39세,2018,2172,1128,1044,108,2132,1107,1025,108
31170, 의왕시,045,40~44세,2018,10775,5443,5332,102.1,10628,5367,5261,102
31170, 의왕시,045001, 40세,2018,1934,1000,934,107.1,1897,986,911,108.2
31170, 의왕시,045002, 41세,2018,2180,1089,1091,99.8,2146,1072,1074,99.8
31170, 의왕시,045003, 42세,2018,2141,1096,1045,104.9,2117,1080,1037,104.1
31170, 의왕시,045004, 43세,2018,2158,1079,1079,100,2131,1065,1066,99.9
31170, 의왕시,045005, 44세,2018,2362,1179,1183,99.7,2337,1164,1173,99.2
31170, 의왕시,050,45~49세,2018,13434,6451,6983,92.4,13270,6365,6905,92.2
31170, 의왕시,050001, 45세,2018,2550,1242,1308,95,2518,1230,1288,95.5
31170, 의왕시,050002, 46세,2018,2593,1297,1296,100.1,2555,1274,1281,99.5
31170, 의왕시,050003, 47세,2018,2736,1291,1445,89.3,2709,1274,1435,88.8
31170, 의왕시,050004, 48세,2018,2717,1272,1445,88,2685,1255,1430,87.8
31170, 의왕시,050005, 49세,2018,2838,1349,1489,90.6,2803,1332,1471,90.6
31170, 의왕시,055,50~54세,2018,13401,6562,6839,95.9,13274,6499,6775,95.9
31170, 의왕시,055001, 50세,2018,2915,1414,1501,94.2,2887,1404,1483,94.7
31170, 의왕시,055002, 51세,2018,2652,1254,1398,89.7,2635,1246,1389,89.7
31170, 의왕시,055003, 52세,2018,2500,1263,1237,102.1,2470,1248,1222,102.1
31170, 의왕시,055004, 53세,2018,2729,1352,1377,98.2,2703,1338,1365,98
31170, 의왕시,055005, 54세,2018,2605,1279,1326,96.5,2579,1263,1316,96
31170, 의왕시,060,55~59세,2018,14232,6961,7271,95.7,14139,6923,7216,95.9
31170, 의왕시,060001, 55세,2018,2758,1364,1394,97.8,2738,1354,1384,97.8
31170, 의왕시,060002, 56세,2018,2768,1312,1456,90.1,2750,1305,1445,90.3
31170, 의왕시,060003, 57세,2018,3069,1460,1609,90.7,3050,1455,1595,91.2
31170, 의왕시,060004, 58세,2018,2956,1481,1475,100.4,2933,1470,1463,100.5
31170, 의왕시,060005, 59세,2018,2681,1344,1337,100.5,2668,1339,1329,100.8
31170, 의왕시,065,60~64세,2018,10758,5449,5309,102.6,10665,5409,5256,102.9
31170, 의왕시,065001, 60세,2018,2489,1251,1238,101.1,2471,1242,1229,101.1
31170, 의왕시,065002, 61세,2018,2327,1194,1133,105.4,2304,1183,1121,105.5
31170, 의왕시,065003, 62세,2018,2097,1049,1048,100.1,2077,1041,1036,100.5
31170, 의왕시,065004, 63세,2018,2123,1068,1055,101.2,2107,1061,1046,101.4
31170, 의왕시,065005, 64세,2018,1722,887,835,106.2,1706,882,824,107
31170, 의왕시,070,65~69세,2018,6261,3161,3100,102,6211,3133,3078,101.8
31170, 의왕시,070001, 65세,2018,1432,717,715,100.3,1421,711,710,100.1
31170, 의왕시,070002, 66세,2018,1535,804,731,110,1522,798,724,110.2
31170, 의왕시,070003, 67세,2018,1026,536,490,109.4,1015,531,484,109.7
31170, 의왕시,070004, 68세,2018,1079,534,545,98,1070,528,542,97.4
31170, 의왕시,070005, 69세,2018,1189,570,619,92.1,1183,565,618,91.4
31170, 의왕시,075,70~74세,2018,4475,2130,2345,90.8,4453,2123,2330,91.1
31170, 의왕시,075001, 70세,2018,1077,503,574,87.6,1073,502,571,87.9
31170, 의왕시,075002, 71세,2018,1028,502,526,95.4,1021,501,520,96.3
31170, 의왕시,075003, 72세,2018,812,389,423,92,806,387,419,92.4
31170, 의왕시,075004, 73세,2018,770,365,405,90.1,767,363,404,89.9
31170, 의왕시,075005, 74세,2018,788,371,417,89,786,370,416,88.9
31170, 의왕시,080,75~79세,2018,3716,1607,2109,76.2,3707,1603,2104,76.2
31170, 의왕시,080001, 75세,2018,774,340,434,78.3,773,339,434,78.1
31170, 의왕시,080002, 76세,2018,938,422,516,81.8,936,422,514,82.1
31170, 의왕시,080003, 77세,2018,709,313,396,79,707,313,394,79.4
31170, 의왕시,080004, 78세,2018,649,260,389,66.8,648,259,389,66.6
31170, 의왕시,080005, 79세,2018,646,272,374,72.7,643,270,373,72.4
31170, 의왕시,085,80~84세,2018,2486,872,1614,54,2485,872,1613,54.1
31170, 의왕시,085001, 80세,2018,597,247,350,70.6,597,247,350,70.6
31170, 의왕시,085002, 81세,2018,555,200,355,56.3,555,200,355,56.3
31170, 의왕시,085003, 82세,2018,460,154,306,50.3,459,154,305,50.5
31170, 의왕시,085004, 83세,2018,464,153,311,49.2,464,153,311,49.2
31170, 의왕시,085005, 84세,2018,410,118,292,40.4,410,118,292,40.4
31170, 의왕시,090,85~89세,2018,1287,382,905,42.2,1287,382,905,42.2
31170, 의왕시,090001, 85세,2018,350,110,240,45.8,350,110,240,45.8
31170, 의왕시,090002, 86세,2018,282,92,190,48.4,282,92,190,48.4
31170, 의왕시,090003, 87세,2018,254,74,180,41.1,254,74,180,41.1
31170, 의왕시,090004, 88세,2018,211,56,155,36.1,211,56,155,36.1
31170, 의왕시,090005, 89세,2018,190,50,140,35.7,190,50,140,35.7
31170, 의왕시,095,90~94세,2018,452,103,349,29.5,451,103,348,29.6
31170, 의왕시,095001, 90세,2018,146,36,110,32.7,146,36,110,32.7
31170, 의왕시,095002, 91세,2018,114,29,85,34.1,114,29,85,34.1
31170, 의왕시,095003, 92세,2018,77,17,60,28.3,76,17,59,28.8
31170, 의왕시,095004, 93세,2018,59,8,51,15.7,59,8,51,15.7
31170, 의왕시,095005, 94세,2018,56,13,43,30.2,56,13,43,30.2
31170, 의왕시,100,95~99세,2018,118,27,91,29.7,118,27,91,29.7
31170, 의왕시,100001, 95세,2018,52,12,40,30,52,12,40,30
31170, 의왕시,100002, 96세,2018,25,6,19,31.6,25,6,19,31.6
31170, 의왕시,100003, 97세,2018,21,X,17,23.5,21,X,17,23.5
31170, 의왕시,100004, 98세,2018,11,X,7,57.1,11,X,7,57.1
31170, 의왕시,100005, 99세,2018,9,X,8,12.5,9,X,8,12.5
31170, 의왕시,101,100세이상,2018,16,X,12,33.3,16,X,12,33.3
31170, 의왕시,102,15세미만,2018,18733,9633,9100,105.9,18681,9610,9071,105.9
31170, 의왕시,103,15~64세,2018,112055,56650,55405,102.2,110500,55831,54669,102.1
31170, 의왕시,104,65세이상,2018,18811,8286,10525,78.7,18728,8247,10481,78.7
31170, 의왕시,086,85세이상,2018,1873,516,1357,38,1872,516,1356,38.1
31170, 의왕시,126,평균연령,2018,41.6,40.6,42.6,,41.6,40.6,42.6,
31170, 의왕시,127,중위연령,2018,43.2,41.8,44.5,,43.3,41.9,44.6,
31180, 하남시,000,합계,2018,238592,119859,118733,100.9,235363,117889,117474,100.4
31180, 하남시,005,0~4세,2018,13039,6676,6363,104.9,13021,6665,6356,104.9
31180, 하남시,005001, 0세,2018,2054,1059,995,106.4,2051,1056,995,106.1
31180, 하남시,005002, 1세,2018,2321,1201,1120,107.2,2315,1197,1118,107.1
31180, 하남시,005003, 2세,2018,2857,1457,1400,104.1,2853,1455,1398,104.1
31180, 하남시,005004, 3세,2018,2923,1484,1439,103.1,2919,1482,1437,103.1
31180, 하남시,005005, 4세,2018,2884,1475,1409,104.7,2883,1475,1408,104.8
31180, 하남시,010,5~9세,2018,13968,7148,6820,104.8,13946,7141,6805,104.9
31180, 하남시,010001, 5세,2018,2998,1544,1454,106.2,2995,1544,1451,106.4
31180, 하남시,010002, 6세,2018,3015,1581,1434,110.3,3008,1578,1430,110.3
31180, 하남시,010003, 7세,2018,2813,1376,1437,95.8,2807,1373,1434,95.7
31180, 하남시,010004, 8세,2018,2710,1400,1310,106.9,2707,1400,1307,107.1
31180, 하남시,010005, 9세,2018,2432,1247,1185,105.2,2429,1246,1183,105.3
31180, 하남시,015,10~14세,2018,10823,5540,5283,104.9,10808,5532,5276,104.9
31180, 하남시,015001, 10세,2018,2436,1196,1240,96.5,2433,1195,1238,96.5
31180, 하남시,015002, 11세,2018,2448,1285,1163,110.5,2445,1284,1161,110.6
31180, 하남시,015003, 12세,2018,2000,1027,973,105.5,1998,1026,972,105.6
31180, 하남시,015004, 13세,2018,1913,999,914,109.3,1910,998,912,109.4
31180, 하남시,015005, 14세,2018,2026,1033,993,104,2022,1029,993,103.6
31180, 하남시,020,15~19세,2018,10112,5116,4996,102.4,10080,5103,4977,102.5
31180, 하남시,020001, 15세,2018,1920,975,945,103.2,1919,975,944,103.3
31180, 하남시,020002, 16세,2018,1937,980,957,102.4,1933,977,956,102.2
31180, 하남시,020003, 17세,2018,2195,1129,1066,105.9,2192,1127,1065,105.8
31180, 하남시,020004, 18세,2018,2121,1078,1043,103.4,2116,1077,1039,103.7
31180, 하남시,020005, 19세,2018,1939,954,985,96.9,1920,947,973,97.3
31180, 하남시,025,20~24세,2018,12113,6559,5554,118.1,11824,6363,5461,116.5
31180, 하남시,025001, 20세,2018,2109,1162,947,122.7,2085,1147,938,122.3
31180, 하남시,025002, 21세,2018,2412,1372,1040,131.9,2371,1344,1027,130.9
31180, 하남시,025003, 22세,2018,2413,1311,1102,119,2346,1266,1080,117.2
31180, 하남시,025004, 23세,2018,2508,1327,1181,112.4,2445,1283,1162,110.4
31180, 하남시,025005, 24세,2018,2671,1387,1284,108,2577,1323,1254,105.5
31180, 하남시,030,25~29세,2018,14426,7514,6912,108.7,13841,7087,6754,104.9
31180, 하남시,030001, 25세,2018,2765,1473,1292,114,2664,1394,1270,109.8
31180, 하남시,030002, 26세,2018,2996,1542,1454,106.1,2887,1458,1429,102
31180, 하남시,030003, 27세,2018,2893,1502,1391,108,2788,1433,1355,105.8
31180, 하남시,030004, 28세,2018,2898,1506,1392,108.2,2758,1402,1356,103.4
31180, 하남시,030005, 29세,2018,2874,1491,1383,107.8,2744,1400,1344,104.2
31180, 하남시,035,30~34세,2018,16579,8388,8191,102.4,15982,7947,8035,98.9
31180, 하남시,035001, 30세,2018,2875,1418,1457,97.3,2760,1335,1425,93.7
31180, 하남시,035002, 31세,2018,3159,1640,1519,108,3021,1536,1485,103.4
31180, 하남시,035003, 32세,2018,3330,1698,1632,104,3198,1605,1593,100.8
31180, 하남시,035004, 33세,2018,3465,1744,1721,101.3,3353,1658,1695,97.8
31180, 하남시,035005, 34세,2018,3750,1888,1862,101.4,3650,1813,1837,98.7
31180, 하남시,040,35~39세,2018,24601,12341,12260,100.7,24147,12058,12089,99.7
31180, 하남시,040001, 35세,2018,4420,2219,2201,100.8,4309,2144,2165,99
31180, 하남시,040002, 36세,2018,4853,2416,2437,99.1,4763,2361,2402,98.3
31180, 하남시,040003, 37세,2018,5224,2588,2636,98.2,5127,2526,2601,97.1
31180, 하남시,040004, 38세,2018,5198,2611,2587,100.9,5116,2561,2555,100.2
31180, 하남시,040005, 39세,2018,4906,2507,2399,104.5,4832,2466,2366,104.2
31180, 하남시,045,40~44세,2018,20984,11064,9920,111.5,20701,10906,9795,111.3
31180, 하남시,045001, 40세,2018,4283,2240,2043,109.6,4216,2198,2018,108.9
31180, 하남시,045002, 41세,2018,4394,2313,2081,111.1,4333,2279,2054,111
31180, 하남시,045003, 42세,2018,4097,2168,1929,112.4,4043,2135,1908,111.9
31180, 하남시,045004, 43세,2018,3942,2068,1874,110.4,3895,2045,1850,110.5
31180, 하남시,045005, 44세,2018,4268,2275,1993,114.1,4214,2249,1965,114.5
31180, 하남시,050,45~49세,2018,19674,10253,9421,108.8,19432,10128,9304,108.9
31180, 하남시,050001, 45세,2018,3874,2057,1817,113.2,3834,2035,1799,113.1
31180, 하남시,050002, 46세,2018,4032,2154,1878,114.7,3977,2124,1853,114.6
31180, 하남시,050003, 47세,2018,4158,2184,1974,110.6,4116,2162,1954,110.6
31180, 하남시,050004, 48세,2018,3738,1906,1832,104,3680,1877,1803,104.1
31180, 하남시,050005, 49세,2018,3872,1952,1920,101.7,3825,1930,1895,101.8
31180, 하남시,055,50~54세,2018,17626,8709,8917,97.7,17396,8608,8788,98
31180, 하남시,055001, 50세,2018,3804,1840,1964,93.7,3765,1822,1943,93.8
31180, 하남시,055002, 51세,2018,3501,1732,1769,97.9,3459,1712,1747,98
31180, 하남시,055003, 52세,2018,3422,1702,1720,99,3371,1684,1687,99.8
31180, 하남시,055004, 53세,2018,3517,1757,1760,99.8,3474,1735,1739,99.8
31180, 하남시,055005, 54세,2018,3382,1678,1704,98.5,3327,1655,1672,99
31180, 하남시,060,55~59세,2018,19374,9267,10107,91.7,19207,9197,10010,91.9
31180, 하남시,060001, 55세,2018,3588,1696,1892,89.6,3542,1676,1866,89.8
31180, 하남시,060002, 56세,2018,3742,1830,1912,95.7,3706,1814,1892,95.9
31180, 하남시,060003, 57세,2018,4174,1970,2204,89.4,4150,1960,2190,89.5
31180, 하남시,060004, 58세,2018,4123,1978,2145,92.2,4089,1966,2123,92.6
31180, 하남시,060005, 59세,2018,3747,1793,1954,91.8,3720,1781,1939,91.9
31180, 하남시,065,60~64세,2018,16573,8055,8518,94.6,16403,7983,8420,94.8
31180, 하남시,065001, 60세,2018,3619,1772,1847,95.9,3583,1758,1825,96.3
31180, 하남시,065002, 61세,2018,3558,1741,1817,95.8,3530,1726,1804,95.7
31180, 하남시,065003, 62세,2018,3233,1559,1674,93.1,3195,1543,1652,93.4
31180, 하남시,065004, 63세,2018,3296,1578,1718,91.9,3263,1564,1699,92.1
31180, 하남시,065005, 64세,2018,2867,1405,1462,96.1,2832,1392,1440,96.7
31180, 하남시,070,65~69세,2018,10901,5439,5462,99.6,10832,5404,5428,99.6
31180, 하남시,070001, 65세,2018,2483,1210,1273,95.1,2462,1198,1264,94.8
31180, 하남시,070002, 66세,2018,2655,1326,1329,99.8,2639,1319,1320,99.9
31180, 하남시,070003, 67세,2018,1783,871,912,95.5,1767,866,901,96.1
31180, 하남시,070004, 68세,2018,1975,994,981,101.3,1965,987,978,100.9
31180, 하남시,070005, 69세,2018,2005,1038,967,107.3,1999,1034,965,107.2
31180, 하남시,075,70~74세,2018,7640,3933,3707,106.1,7615,3920,3695,106.1
31180, 하남시,075001, 70세,2018,1934,1001,933,107.3,1926,996,930,107.1
31180, 하남시,075002, 71세,2018,1826,947,879,107.7,1818,943,875,107.8
31180, 하남시,075003, 72세,2018,1344,678,666,101.8,1340,677,663,102.1
31180, 하남시,075004, 73세,2018,1276,667,609,109.5,1274,666,608,109.5
31180, 하남시,075005, 74세,2018,1260,640,620,103.2,1257,638,619,103.1
31180, 하남시,080,75~79세,2018,5009,2237,2772,80.7,4994,2233,2761,80.9
31180, 하남시,080001, 75세,2018,1110,546,564,96.8,1105,545,560,97.3
31180, 하남시,080002, 76세,2018,1206,526,680,77.4,1199,523,676,77.4
31180, 하남시,080003, 77세,2018,988,444,544,81.6,987,444,543,81.8
31180, 하남시,080004, 78세,2018,864,375,489,76.7,863,375,488,76.8
31180, 하남시,080005, 79세,2018,841,346,495,69.9,840,346,494,70
31180, 하남시,085,80~84세,2018,2929,1082,1847,58.6,2918,1078,1840,58.6
31180, 하남시,085001, 80세,2018,731,315,416,75.7,728,314,414,75.8
31180, 하남시,085002, 81세,2018,623,249,374,66.6,618,248,370,67
31180, 하남시,085003, 82세,2018,613,227,386,58.8,613,227,386,58.8
31180, 하남시,085004, 83세,2018,530,168,362,46.4,529,168,361,46.5
31180, 하남시,085005, 84세,2018,432,123,309,39.8,430,121,309,39.2
31180, 하남시,090,85~89세,2018,1456,380,1076,35.3,1451,378,1073,35.2
31180, 하남시,090001, 85세,2018,402,121,281,43.1,401,121,280,43.2
31180, 하남시,090002, 86세,2018,324,80,244,32.8,323,80,243,32.9
31180, 하남시,090003, 87세,2018,281,78,203,38.4,280,77,203,37.9
31180, 하남시,090004, 88세,2018,249,56,193,29,248,56,192,29.2
31180, 하남시,090005, 89세,2018,200,45,155,29,199,44,155,28.4
31180, 하남시,095,90~94세,2018,580,123,457,26.9,580,123,457,26.9
31180, 하남시,095001, 90세,2018,188,37,151,24.5,188,37,151,24.5
31180, 하남시,095002, 91세,2018,147,33,114,28.9,147,33,114,28.9
31180, 하남시,095003, 92세,2018,95,18,77,23.4,95,18,77,23.4
31180, 하남시,095004, 93세,2018,91,17,74,23,91,17,74,23
31180, 하남시,095005, 94세,2018,59,18,41,43.9,59,18,41,43.9
31180, 하남시,100,95~99세,2018,169,32,137,23.4,169,32,137,23.4
31180, 하남시,100001, 95세,2018,66,13,53,24.5,66,13,53,24.5
31180, 하남시,100002, 96세,2018,47,5,42,11.9,47,5,42,11.9
31180, 하남시,100003, 97세,2018,25,6,19,31.6,25,6,19,31.6
31180, 하남시,100004, 98세,2018,25,7,18,38.9,25,7,18,38.9
31180, 하남시,100005, 99세,2018,6,X,5,20,6,X,5,20
31180, 하남시,101,100세이상,2018,16,X,13,23.1,16,X,13,23.1
31180, 하남시,102,15세미만,2018,37830,19364,18466,104.9,37775,19338,18437,104.9
31180, 하남시,103,15~64세,2018,172062,87266,84796,102.9,169013,85380,83633,102.1
31180, 하남시,104,65세이상,2018,28700,13229,15471,85.5,28575,13171,15404,85.5
31180, 하남시,086,85세이상,2018,2221,538,1683,32,2216,536,1680,31.9
31180, 하남시,126,평균연령,2018,40.2,39.5,41,,40.2,39.5,41,
31180, 하남시,127,중위연령,2018,40.8,40.3,41.5,,41,40.5,41.5,
31190, 용인시,000,합계,2018,1026126,512175,513951,99.7,1000419,497497,502922,98.9
31190, 용인시,005,0~4세,2018,46942,24024,22918,104.8,46416,23763,22653,104.9
31190, 용인시,005001, 0세,2018,7143,3586,3557,100.8,7062,3550,3512,101.1
31190, 용인시,005002, 1세,2018,8404,4404,4000,110.1,8278,4334,3944,109.9
31190, 용인시,005003, 2세,2018,9881,5056,4825,104.8,9742,4988,4754,104.9
31190, 용인시,005004, 3세,2018,10638,5437,5201,104.5,10552,5393,5159,104.5
31190, 용인시,005005, 4세,2018,10876,5541,5335,103.9,10782,5498,5284,104
31190, 용인시,010,5~9세,2018,58204,29844,28360,105.2,57915,29703,28212,105.3
31190, 용인시,010001, 5세,2018,11058,5621,5437,103.4,10986,5595,5391,103.8
31190, 용인시,010002, 6세,2018,12137,6259,5878,106.5,12072,6224,5848,106.4
31190, 용인시,010003, 7세,2018,11950,6113,5837,104.7,11902,6088,5814,104.7
31190, 용인시,010004, 8세,2018,11652,5967,5685,105,11600,5941,5659,105
31190, 용인시,010005, 9세,2018,11407,5884,5523,106.5,11355,5855,5500,106.5
31190, 용인시,015,10~14세,2018,57836,29681,28155,105.4,57664,29589,28075,105.4
31190, 용인시,015001, 10세,2018,12204,6221,5983,104,12159,6199,5960,104
31190, 용인시,015002, 11세,2018,12353,6295,6058,103.9,12314,6268,6046,103.7
31190, 용인시,015003, 12세,2018,11130,5791,5339,108.5,11099,5774,5325,108.4
31190, 용인시,015004, 13세,2018,10797,5584,5213,107.1,10769,5574,5195,107.3
31190, 용인시,015005, 14세,2018,11352,5790,5562,104.1,11323,5774,5549,104.1
31190, 용인시,020,15~19세,2018,62384,32080,30304,105.9,61592,31723,29869,106.2
31190, 용인시,020001, 15세,2018,10994,5638,5356,105.3,10969,5625,5344,105.3
31190, 용인시,020002, 16세,2018,10732,5544,5188,106.9,10692,5521,5171,106.8
31190, 용인시,020003, 17세,2018,11760,6058,5702,106.2,11711,6035,5676,106.3
31190, 용인시,020004, 18세,2018,13606,6998,6608,105.9,13427,6913,6514,106.1
31190, 용인시,020005, 19세,2018,15292,7842,7450,105.3,14793,7629,7164,106.5
31190, 용인시,025,20~24세,2018,71180,37257,33923,109.8,67421,35146,32275,108.9
31190, 용인시,025001, 20세,2018,14714,7456,7258,102.7,14074,7167,6907,103.8
31190, 용인시,025002, 21세,2018,14058,7232,6826,105.9,13350,6864,6486,105.8
31190, 용인시,025003, 22세,2018,14409,7562,6847,110.4,13641,7123,6518,109.3
31190, 용인시,025004, 23세,2018,13962,7478,6484,115.3,13161,6996,6165,113.5
31190, 용인시,025005, 24세,2018,14037,7529,6508,115.7,13195,6996,6199,112.9
31190, 용인시,030,25~29세,2018,62720,33266,29454,112.9,58688,30655,28033,109.4
31190, 용인시,030001, 25세,2018,13848,7253,6595,110,13050,6745,6305,107
31190, 용인시,030002, 26세,2018,13421,7204,6217,115.9,12637,6703,5934,113
31190, 용인시,030003, 27세,2018,12430,6707,5723,117.2,11637,6179,5458,113.2
31190, 용인시,030004, 28세,2018,11654,6063,5591,108.4,10840,5542,5298,104.6
31190, 용인시,030005, 29세,2018,11367,6039,5328,113.3,10524,5486,5038,108.9
31190, 용인시,035,30~34세,2018,61086,30963,30123,102.8,57358,28555,28803,99.1
31190, 용인시,035001, 30세,2018,11458,6002,5456,110,10637,5453,5184,105.2
31190, 용인시,035002, 31세,2018,11373,5731,5642,101.6,10566,5215,5351,97.5
31190, 용인시,035003, 32세,2018,11867,6085,5782,105.2,11129,5623,5506,102.1
31190, 용인시,035004, 33세,2018,12713,6386,6327,100.9,11999,5931,6068,97.7
31190, 용인시,035005, 34세,2018,13675,6759,6916,97.7,13027,6333,6694,94.6
31190, 용인시,040,35~39세,2018,89402,44014,45388,97,86594,42239,44355,95.2
31190, 용인시,040001, 35세,2018,15718,7712,8006,96.3,15091,7308,7783,93.9
31190, 용인시,040002, 36세,2018,17584,8729,8855,98.6,16948,8311,8637,96.2
31190, 용인시,040003, 37세,2018,18405,9172,9233,99.3,17835,8819,9016,97.8
31190, 용인시,040004, 38세,2018,19104,9363,9741,96.1,18611,9059,9552,94.8
31190, 용인시,040005, 39세,2018,18591,9038,9553,94.6,18109,8742,9367,93.3
31190, 용인시,045,40~44세,2018,92765,45851,46914,97.7,90806,44720,46086,97
31190, 용인시,045001, 40세,2018,16966,8270,8696,95.1,16532,8000,8532,93.8
31190, 용인시,045002, 41세,2018,18471,9006,9465,95.2,18036,8750,9286,94.2
31190, 용인시,045003, 42세,2018,18043,8989,9054,99.3,17664,8772,8892,98.7
31190, 용인시,045004, 43세,2018,18799,9297,9502,97.8,18450,9103,9347,97.4
31190, 용인시,045005, 44세,2018,20486,10289,10197,100.9,20124,10095,10029,100.7
31190, 용인시,050,45~49세,2018,99952,50360,49592,101.5,97967,49287,48680,101.2
31190, 용인시,050001, 45세,2018,20025,9974,10051,99.2,19623,9747,9876,98.7
31190, 용인시,050002, 46세,2018,20093,10203,9890,103.2,19697,9969,9728,102.5
31190, 용인시,050003, 47세,2018,21001,10667,10334,103.2,20587,10449,10138,103.1
31190, 용인시,050004, 48세,2018,19738,9906,9832,100.8,19328,9692,9636,100.6
31190, 용인시,050005, 49세,2018,19095,9610,9485,101.3,18732,9430,9302,101.4
31190, 용인시,055,50~54세,2018,78851,40295,38556,104.5,77081,39391,37690,104.5
31190, 용인시,055001, 50세,2018,18311,9201,9110,101,17942,8991,8951,100.4
31190, 용인시,055002, 51세,2018,16186,8146,8040,101.3,15870,7999,7871,101.6
31190, 용인시,055003, 52세,2018,14963,7676,7287,105.3,14621,7503,7118,105.4
31190, 용인시,055004, 53세,2018,15366,7973,7393,107.8,14990,7778,7212,107.8
31190, 용인시,055005, 54세,2018,14025,7299,6726,108.5,13658,7120,6538,108.9
31190, 용인시,060,55~59세,2018,68121,34660,33461,103.6,66516,33895,32621,103.9
31190, 용인시,060001, 55세,2018,14300,7409,6891,107.5,13861,7209,6652,108.4
31190, 용인시,060002, 56세,2018,13617,6994,6623,105.6,13261,6829,6432,106.2
31190, 용인시,060003, 57세,2018,14338,7233,7105,101.8,14093,7118,6975,102.1
31190, 용인시,060004, 58세,2018,13539,6819,6720,101.5,13234,6672,6562,101.7
31190, 용인시,060005, 59세,2018,12327,6205,6122,101.4,12067,6067,6000,101.1
31190, 용인시,065,60~64세,2018,52506,25039,27467,91.2,51232,24427,26805,91.1
31190, 용인시,065001, 60세,2018,11414,5674,5740,98.9,11134,5530,5604,98.7
31190, 용인시,065002, 61세,2018,10973,5230,5743,91.1,10693,5099,5594,91.2
31190, 용인시,065003, 62세,2018,10222,4856,5366,90.5,9958,4731,5227,90.5
31190, 용인시,065004, 63세,2018,10687,5046,5641,89.5,10456,4935,5521,89.4
31190, 용인시,065005, 64세,2018,9210,4233,4977,85.1,8991,4132,4859,85
31190, 용인시,070,65~69세,2018,38519,17606,20913,84.2,37911,17312,20599,84
31190, 용인시,070001, 65세,2018,8451,3854,4597,83.8,8280,3774,4506,83.8
31190, 용인시,070002, 66세,2018,9104,4204,4900,85.8,8964,4135,4829,85.6
31190, 용인시,070003, 67세,2018,6344,2837,3507,80.9,6228,2776,3452,80.4
31190, 용인시,070004, 68세,2018,7280,3332,3948,84.4,7181,3287,3894,84.4
31190, 용인시,070005, 69세,2018,7340,3379,3961,85.3,7258,3340,3918,85.2
31190, 용인시,075,70~74세,2018,33161,15112,18049,83.7,32967,15037,17930,83.9
31190, 용인시,075001, 70세,2018,7484,3408,4076,83.6,7426,3384,4042,83.7
31190, 용인시,075002, 71세,2018,7797,3466,4331,80,7744,3438,4306,79.8
31190, 용인시,075003, 72세,2018,6335,2892,3443,84,6302,2885,3417,84.4
31190, 용인시,075004, 73세,2018,5895,2747,3148,87.3,5874,2741,3133,87.5
31190, 용인시,075005, 74세,2018,5650,2599,3051,85.2,5621,2589,3032,85.4
31190, 용인시,080,75~79세,2018,26254,12284,13970,87.9,26156,12249,13907,88.1
31190, 용인시,080001, 75세,2018,5629,2589,3040,85.2,5610,2586,3024,85.5
31190, 용인시,080002, 76세,2018,6329,2977,3352,88.8,6300,2970,3330,89.2
31190, 용인시,080003, 77세,2018,5353,2564,2789,91.9,5337,2555,2782,91.8
31190, 용인시,080004, 78세,2018,4566,2166,2400,90.3,4549,2159,2390,90.3
31190, 용인시,080005, 79세,2018,4377,1988,2389,83.2,4360,1979,2381,83.1
31190, 용인시,085,80~84세,2018,15511,6589,8922,73.9,15451,6567,8884,73.9
31190, 용인시,085001, 80세,2018,3860,1766,2094,84.3,3842,1756,2086,84.2
31190, 용인시,085002, 81세,2018,3518,1539,1979,77.8,3509,1536,1973,77.9
31190, 용인시,085003, 82세,2018,2951,1203,1748,68.8,2942,1200,1742,68.9
31190, 용인시,085004, 83세,2018,2792,1150,1642,70,2782,1149,1633,70.4
31190, 용인시,085005, 84세,2018,2390,931,1459,63.8,2376,926,1450,63.9
31190, 용인시,090,85~89세,2018,7314,2426,4888,49.6,7280,2418,4862,49.7
31190, 용인시,090001, 85세,2018,1967,722,1245,58,1958,719,1239,58
31190, 용인시,090002, 86세,2018,1703,615,1088,56.5,1695,614,1081,56.8
31190, 용인시,090003, 87세,2018,1316,396,920,43,1312,395,917,43.1
31190, 용인시,090004, 88세,2018,1233,387,846,45.7,1228,386,842,45.8
31190, 용인시,090005, 89세,2018,1095,306,789,38.8,1087,304,783,38.8
31190, 용인시,095,90~94세,2018,2638,647,1991,32.5,2625,645,1980,32.6
31190, 용인시,095001, 90세,2018,817,208,609,34.2,812,208,604,34.4
31190, 용인시,095002, 91세,2018,661,168,493,34.1,660,168,492,34.1
31190, 용인시,095003, 92세,2018,496,126,370,34.1,492,124,368,33.7
31190, 용인시,095004, 93세,2018,396,82,314,26.1,395,82,313,26.2
31190, 용인시,095005, 94세,2018,268,63,205,30.7,266,63,203,31
31190, 용인시,100,95~99세,2018,693,169,524,32.3,693,169,524,32.3
31190, 용인시,100001, 95세,2018,254,74,180,41.1,254,74,180,41.1
31190, 용인시,100002, 96세,2018,181,38,143,26.6,181,38,143,26.6
31190, 용인시,100003, 97세,2018,117,27,90,30,117,27,90,30
31190, 용인시,100004, 98세,2018,91,16,75,21.3,91,16,75,21.3
31190, 용인시,100005, 99세,2018,50,14,36,38.9,50,14,36,38.9
31190, 용인시,101,100세이상,2018,87,8,79,10.1,86,7,79,8.9
31190, 용인시,102,15세미만,2018,162982,83549,79433,105.2,161995,83055,78940,105.2
31190, 용인시,103,15~64세,2018,738967,373785,365182,102.4,715255,360038,355217,101.4
31190, 용인시,104,65세이상,2018,124177,54841,69336,79.1,123169,54404,68765,79.1
31190, 용인시,086,85세이상,2018,10732,3250,7482,43.4,10684,3239,7445,43.5
31190, 용인시,126,평균연령,2018,39.3,38.5,40.1,,39.4,38.5,40.2,
31190, 용인시,127,중위연령,2018,40.2,39.4,41,,40.4,39.7,41.1,
31191, 처인구,000,합계,2018,259524,135040,124484,108.5,246268,126620,119648,105.8
31191, 처인구,005,0~4세,2018,10475,5440,5035,108,10298,5347,4951,108
31191, 처인구,005001, 0세,2018,1723,880,843,104.4,1690,865,825,104.8
31191, 처인구,005002, 1세,2018,1938,1012,926,109.3,1899,987,912,108.2
31191, 처인구,005003, 2세,2018,2234,1148,1086,105.7,2191,1125,1066,105.5
31191, 처인구,005004, 3세,2018,2314,1206,1108,108.8,2281,1190,1091,109.1
31191, 처인구,005005, 4세,2018,2266,1194,1072,111.4,2237,1180,1057,111.6
31191, 처인구,010,5~9세,2018,12028,6138,5890,104.2,11944,6092,5852,104.1
31191, 처인구,010001, 5세,2018,2302,1176,1126,104.4,2282,1169,1113,105
31191, 처인구,010002, 6세,2018,2562,1281,1281,100,2542,1268,1274,99.5
31191, 처인구,010003, 7세,2018,2481,1277,1204,106.1,2471,1270,1201,105.7
31191, 처인구,010004, 8세,2018,2353,1187,1166,101.8,2334,1176,1158,101.6
31191, 처인구,010005, 9세,2018,2330,1217,1113,109.3,2315,1209,1106,109.3
31191, 처인구,015,10~14세,2018,11494,6009,5485,109.6,11440,5983,5457,109.6
31191, 처인구,015001, 10세,2018,2427,1220,1207,101.1,2411,1214,1197,101.4
31191, 처인구,015002, 11세,2018,2450,1253,1197,104.7,2438,1245,1193,104.4
31191, 처인구,015003, 12세,2018,2213,1209,1004,120.4,2205,1204,1001,120.3
31191, 처인구,015004, 13세,2018,2152,1123,1029,109.1,2144,1122,1022,109.8
31191, 처인구,015005, 14세,2018,2252,1204,1048,114.9,2242,1198,1044,114.8
31191, 처인구,020,15~19세,2018,16850,8938,7912,113,16513,8780,7733,113.5
31191, 처인구,020001, 15세,2018,2348,1210,1138,106.3,2340,1206,1134,106.3
31191, 처인구,020002, 16세,2018,2534,1317,1217,108.2,2526,1312,1214,108.1
31191, 처인구,020003, 17세,2018,2587,1350,1237,109.1,2576,1342,1234,108.8
31191, 처인구,020004, 18세,2018,3899,2070,1829,113.2,3810,2031,1779,114.2
31191, 처인구,020005, 19세,2018,5482,2991,2491,120.1,5261,2889,2372,121.8
31191, 처인구,025,20~24세,2018,21821,11962,9859,121.3,20087,10854,9233,117.6
31191, 처인구,025001, 20세,2018,4734,2421,2313,104.7,4474,2301,2173,105.9
31191, 처인구,025002, 21세,2018,4205,2190,2015,108.7,3891,2008,1883,106.6
31191, 처인구,025003, 22세,2018,4436,2421,2015,120.1,4109,2199,1910,115.1
31191, 처인구,025004, 23세,2018,4216,2432,1784,136.3,3840,2175,1665,130.6
31191, 처인구,025005, 24세,2018,4230,2498,1732,144.2,3773,2171,1602,135.5
31191, 처인구,030,25~29세,2018,18123,10677,7446,143.4,15661,8916,6745,132.2
31191, 처인구,030001, 25세,2018,4020,2361,1659,142.3,3564,2035,1529,133.1
31191, 처인구,030002, 26세,2018,3980,2347,1633,143.7,3493,2009,1484,135.4
31191, 처인구,030003, 27세,2018,3558,2100,1458,144,3077,1744,1333,130.8
31191, 처인구,030004, 28세,2018,3317,1917,1400,136.9,2788,1558,1230,126.7
31191, 처인구,030005, 29세,2018,3248,1952,1296,150.6,2739,1570,1169,134.3
31191, 처인구,035,30~34세,2018,16941,9535,7406,128.7,14633,7903,6730,117.4
31191, 처인구,035001, 30세,2018,3246,1843,1403,131.4,2733,1465,1268,115.5
31191, 처인구,035002, 31세,2018,3252,1834,1418,129.3,2757,1492,1265,117.9
31191, 처인구,035003, 32세,2018,3353,1894,1459,129.8,2908,1595,1313,121.5
31191, 처인구,035004, 33세,2018,3451,1982,1469,134.9,2989,1657,1332,124.4
31191, 처인구,035005, 34세,2018,3639,1982,1657,119.6,3246,1694,1552,109.1
31191, 처인구,040,35~39세,2018,21500,11534,9966,115.7,19893,10383,9510,109.2
31191, 처인구,040001, 35세,2018,4011,2149,1862,115.4,3628,1865,1763,105.8
31191, 처인구,040002, 36세,2018,4319,2303,2016,114.2,3953,2040,1913,106.6
31191, 처인구,040003, 37세,2018,4388,2369,2019,117.3,4090,2156,1934,111.5
31191, 처인구,040004, 38세,2018,4449,2368,2081,113.8,4171,2171,2000,108.6
31191, 처인구,040005, 39세,2018,4333,2345,1988,118,4051,2151,1900,113.2
31191, 처인구,045,40~44세,2018,20271,10816,9455,114.4,19249,10186,9063,112.4
31191, 처인구,045001, 40세,2018,3777,1993,1784,111.7,3546,1841,1705,108
31191, 처인구,045002, 41세,2018,4008,2096,1912,109.6,3777,1951,1826,106.8
31191, 처인구,045003, 42세,2018,3996,2157,1839,117.3,3794,2037,1757,115.9
31191, 처인구,045004, 43세,2018,4054,2160,1894,114,3879,2058,1821,113
31191, 처인구,045005, 44세,2018,4436,2410,2026,119,4253,2299,1954,117.7
31191, 처인구,050,45~49세,2018,22119,11392,10727,106.2,21186,10867,10319,105.3
31191, 처인구,050001, 45세,2018,4353,2232,2121,105.2,4177,2130,2047,104.1
31191, 처인구,050002, 46세,2018,4371,2341,2030,115.3,4166,2218,1948,113.9
31191, 처인구,050003, 47세,2018,4533,2322,2211,105,4343,2215,2128,104.1
31191, 처인구,050004, 48세,2018,4321,2199,2122,103.6,4134,2100,2034,103.2
31191, 처인구,050005, 49세,2018,4541,2298,2243,102.5,4366,2204,2162,101.9
31191, 처인구,055,50~54세,2018,20369,10500,9869,106.4,19559,10061,9498,105.9
31191, 처인구,055001, 50세,2018,4432,2286,2146,106.5,4262,2179,2083,104.6
31191, 처인구,055002, 51세,2018,3980,1998,1982,100.8,3846,1939,1907,101.7
31191, 처인구,055003, 52세,2018,4023,2090,1933,108.1,3862,2001,1861,107.5
31191, 처인구,055004, 53세,2018,4227,2156,2071,104.1,4039,2055,1984,103.6
31191, 처인구,055005, 54세,2018,3707,1970,1737,113.4,3550,1887,1663,113.5
31191, 처인구,060,55~59세,2018,20164,10416,9748,106.9,19467,10073,9394,107.2
31191, 처인구,060001, 55세,2018,3997,2079,1918,108.4,3795,1981,1814,109.2
31191, 처인구,060002, 56세,2018,3971,2007,1964,102.2,3816,1941,1875,103.5
31191, 처인구,060003, 57세,2018,4419,2272,2147,105.8,4314,2218,2096,105.8
31191, 처인구,060004, 58세,2018,4111,2141,1970,108.7,3978,2068,1910,108.3
31191, 처인구,060005, 59세,2018,3666,1917,1749,109.6,3564,1865,1699,109.8
31191, 처인구,065,60~64세,2018,15312,7603,7709,98.6,14757,7313,7444,98.2
31191, 처인구,065001, 60세,2018,3393,1758,1635,107.5,3271,1686,1585,106.4
31191, 처인구,065002, 61세,2018,3192,1536,1656,92.8,3078,1481,1597,92.7
31191, 처인구,065003, 62세,2018,3068,1547,1521,101.7,2948,1485,1463,101.5
31191, 처인구,065004, 63세,2018,3057,1521,1536,99,2957,1464,1493,98.1
31191, 처인구,065005, 64세,2018,2602,1241,1361,91.2,2503,1197,1306,91.7
31191, 처인구,070,65~69세,2018,10340,5061,5279,95.9,10027,4897,5130,95.5
31191, 처인구,070001, 65세,2018,2352,1147,1205,95.2,2271,1109,1162,95.4
31191, 처인구,070002, 66세,2018,2569,1293,1276,101.3,2494,1250,1244,100.5
31191, 처인구,070003, 67세,2018,1750,818,932,87.8,1684,784,900,87.1
31191, 처인구,070004, 68세,2018,1868,908,960,94.6,1816,882,934,94.4
31191, 처인구,070005, 69세,2018,1801,895,906,98.8,1762,872,890,98
31191, 처인구,075,70~74세,2018,7919,3765,4154,90.6,7834,3733,4101,91
31191, 처인구,075001, 70세,2018,1834,889,945,94.1,1805,877,928,94.5
31191, 처인구,075002, 71세,2018,1797,856,941,91,1778,845,933,90.6
31191, 처인구,075003, 72세,2018,1475,714,761,93.8,1457,710,747,95
31191, 처인구,075004, 73세,2018,1432,672,760,88.4,1423,670,753,89
31191, 처인구,075005, 74세,2018,1381,634,747,84.9,1371,631,740,85.3
31191, 처인구,080,75~79세,2018,6460,2770,3690,75.1,6422,2758,3664,75.3
31191, 처인구,080001, 75세,2018,1372,589,783,75.2,1365,588,777,75.7
31191, 처인구,080002, 76세,2018,1501,648,853,76,1492,647,845,76.6
31191, 처인구,080003, 77세,2018,1311,564,747,75.5,1303,559,744,75.1
31191, 처인구,080004, 78세,2018,1136,496,640,77.5,1128,493,635,77.6
31191, 처인구,080005, 79세,2018,1140,473,667,70.9,1134,471,663,71
31191, 처인구,085,80~84세,2018,4345,1694,2651,63.9,4317,1686,2631,64.1
31191, 처인구,085001, 80세,2018,1033,406,627,64.8,1024,403,621,64.9
31191, 처인구,085002, 81세,2018,958,391,567,69,953,390,563,69.3
31191, 처인구,085003, 82세,2018,821,320,501,63.9,817,319,498,64.1
31191, 처인구,085004, 83세,2018,827,315,512,61.5,821,314,507,61.9
31191, 처인구,085005, 84세,2018,706,262,444,59,702,260,442,58.8
31191, 처인구,090,85~89세,2018,2057,589,1468,40.1,2046,587,1459,40.2
31191, 처인구,090001, 85세,2018,553,187,366,51.1,552,187,365,51.2
31191, 처인구,090002, 86세,2018,479,146,333,43.8,476,146,330,44.2
31191, 처인구,090003, 87세,2018,366,98,268,36.6,366,98,268,36.6
31191, 처인구,090004, 88세,2018,358,85,273,31.1,353,84,269,31.2
31191, 처인구,090005, 89세,2018,301,73,228,32,299,72,227,31.7
31191, 처인구,095,90~94세,2018,742,159,583,27.3,741,159,582,27.3
31191, 처인구,095001, 90세,2018,244,42,202,20.8,243,42,201,20.9
31191, 처인구,095002, 91세,2018,191,50,141,35.5,191,50,141,35.5
31191, 처인구,095003, 92세,2018,134,29,105,27.6,134,29,105,27.6
31191, 처인구,095004, 93세,2018,106,24,82,29.3,106,24,82,29.3
31191, 처인구,095005, 94세,2018,67,14,53,26.4,67,14,53,26.4
31191, 처인구,100,95~99세,2018,170,40,130,30.8,170,40,130,30.8
31191, 처인구,100001, 95세,2018,74,19,55,34.5,74,19,55,34.5
31191, 처인구,100002, 96세,2018,38,6,32,18.8,38,6,32,18.8
31191, 처인구,100003, 97세,2018,28,7,21,33.3,28,7,21,33.3
31191, 처인구,100004, 98세,2018,20,6,14,42.9,20,6,14,42.9
31191, 처인구,100005, 99세,2018,10,X,8,25,10,X,8,25
31191, 처인구,101,100세이상,2018,24,X,22,9.1,24,X,22,9.1
31191, 처인구,102,15세미만,2018,33997,17587,16410,107.2,33682,17422,16260,107.1
31191, 처인구,103,15~64세,2018,193470,103373,90097,114.7,181005,95336,85669,111.3
31191, 처인구,104,65세이상,2018,32057,14080,17977,78.3,31581,13862,17719,78.2
31191, 처인구,086,85세이상,2018,2993,790,2203,35.9,2981,788,2193,35.9
31191, 처인구,126,평균연령,2018,40.1,39,41.2,,40.2,39.2,41.3,
31191, 처인구,127,중위연령,2018,40.1,38.8,41.8,,40.8,39.6,42,
31192, 기흥구,000,합계,2018,422583,209139,213444,98,415067,205239,209828,97.8
31192, 기흥구,005,0~4세,2018,20704,10610,10094,105.1,20524,10530,9994,105.4
31192, 기흥구,005001, 0세,2018,3059,1558,1501,103.8,3034,1551,1483,104.6
31192, 기흥구,005002, 1세,2018,3624,1913,1711,111.8,3583,1896,1687,112.4
31192, 기흥구,005003, 2세,2018,4387,2247,2140,105,4336,2221,2115,105
31192, 기흥구,005004, 3세,2018,4779,2441,2338,104.4,4751,2425,2326,104.3
31192, 기흥구,005005, 4세,2018,4855,2451,2404,102,4820,2437,2383,102.3
31192, 기흥구,010,5~9세,2018,25871,13281,12590,105.5,25767,13231,12536,105.5
31192, 기흥구,010001, 5세,2018,4923,2474,2449,101,4897,2466,2431,101.4
31192, 기흥구,010002, 6세,2018,5480,2856,2624,108.8,5454,2843,2611,108.9
31192, 기흥구,010003, 7세,2018,5292,2714,2578,105.3,5272,2702,2570,105.1
31192, 기흥구,010004, 8세,2018,5219,2678,2541,105.4,5205,2672,2533,105.5
31192, 기흥구,010005, 9세,2018,4957,2559,2398,106.7,4939,2548,2391,106.6
31192, 기흥구,015,10~14세,2018,25313,12981,12332,105.3,25257,12947,12310,105.2
31192, 기흥구,015001, 10세,2018,5418,2752,2666,103.2,5409,2747,2662,103.2
31192, 기흥구,015002, 11세,2018,5561,2863,2698,106.1,5544,2850,2694,105.8
31192, 기흥구,015003, 12세,2018,4791,2504,2287,109.5,4778,2496,2282,109.4
31192, 기흥구,015004, 13세,2018,4691,2424,2267,106.9,4681,2419,2262,106.9
31192, 기흥구,015005, 14세,2018,4852,2438,2414,101,4845,2435,2410,101
31192, 기흥구,020,15~19세,2018,24438,12458,11980,104,24194,12344,11850,104.2
31192, 기흥구,020001, 15세,2018,4544,2317,2227,104,4536,2314,2222,104.1
31192, 기흥구,020002, 16세,2018,4260,2178,2082,104.6,4245,2172,2073,104.8
31192, 기흥구,020003, 17세,2018,4855,2528,2327,108.6,4838,2520,2318,108.7
31192, 기흥구,020004, 18세,2018,5191,2675,2516,106.3,5137,2643,2494,106
31192, 기흥구,020005, 19세,2018,5588,2760,2828,97.6,5438,2695,2743,98.3
31192, 기흥구,025,20~24세,2018,27956,14394,13562,106.1,26858,13828,13030,106.1
31192, 기흥구,025001, 20세,2018,5634,2810,2824,99.5,5453,2724,2729,99.8
31192, 기흥구,025002, 21세,2018,5521,2807,2714,103.4,5318,2711,2607,104
31192, 기흥구,025003, 22세,2018,5702,2944,2758,106.7,5457,2819,2638,106.9
31192, 기흥구,025004, 23세,2018,5572,2959,2613,113.2,5336,2836,2500,113.4
31192, 기흥구,025005, 24세,2018,5527,2874,2653,108.3,5294,2738,2556,107.1
31192, 기흥구,030,25~29세,2018,25164,12905,12259,105.3,24173,12348,11825,104.4
31192, 기흥구,030001, 25세,2018,5600,2774,2826,98.2,5384,2651,2733,97
31192, 기흥구,030002, 26세,2018,5310,2759,2551,108.2,5133,2660,2473,107.6
31192, 기흥구,030003, 27세,2018,5022,2660,2362,112.6,4816,2543,2273,111.9
31192, 기흥구,030004, 28세,2018,4708,2364,2344,100.9,4534,2263,2271,99.6
31192, 기흥구,030005, 29세,2018,4524,2348,2176,107.9,4306,2231,2075,107.5
31192, 기흥구,035,30~34세,2018,24581,12173,12408,98.1,23651,11669,11982,97.4
31192, 기흥구,035001, 30세,2018,4540,2367,2173,108.9,4347,2252,2095,107.5
31192, 기흥구,035002, 31세,2018,4491,2168,2323,93.3,4279,2055,2224,92.4
31192, 기흥구,035003, 32세,2018,4746,2393,2353,101.7,4559,2287,2272,100.7
31192, 기흥구,035004, 33세,2018,5173,2519,2654,94.9,4995,2426,2569,94.4
31192, 기흥구,035005, 34세,2018,5631,2726,2905,93.8,5471,2649,2822,93.9
31192, 기흥구,040,35~39세,2018,38358,18562,19796,93.8,37650,18188,19462,93.5
31192, 기흥구,040001, 35세,2018,6617,3168,3449,91.9,6472,3098,3374,91.8
31192, 기흥구,040002, 36세,2018,7534,3656,3878,94.3,7379,3563,3816,93.4
31192, 기흥구,040003, 37세,2018,7872,3837,4035,95.1,7717,3758,3959,94.9
31192, 기흥구,040004, 38세,2018,8344,4057,4287,94.6,8212,3985,4227,94.3
31192, 기흥구,040005, 39세,2018,7991,3844,4147,92.7,7870,3784,4086,92.6
31192, 기흥구,045,40~44세,2018,39845,19540,20305,96.2,39302,19247,20055,96
31192, 기흥구,045001, 40세,2018,7389,3555,3834,92.7,7263,3485,3778,92.2
31192, 기흥구,045002, 41세,2018,7953,3879,4074,95.2,7831,3809,4022,94.7
31192, 기흥구,045003, 42세,2018,7646,3782,3864,97.9,7543,3725,3818,97.6
31192, 기흥구,045004, 43세,2018,8079,3940,4139,95.2,7980,3892,4088,95.2
31192, 기흥구,045005, 44세,2018,8778,4384,4394,99.8,8685,4336,4349,99.7
31192, 기흥구,050,45~49세,2018,42287,21412,20875,102.6,41616,21045,20571,102.3
31192, 기흥구,050001, 45세,2018,8760,4394,4366,100.6,8618,4310,4308,100
31192, 기흥구,050002, 46세,2018,8518,4329,4189,103.3,8392,4252,4140,102.7
31192, 기흥구,050003, 47세,2018,8850,4527,4323,104.7,8698,4453,4245,104.9
31192, 기흥구,050004, 48세,2018,8403,4248,4155,102.2,8266,4173,4093,102
31192, 기흥구,050005, 49세,2018,7756,3914,3842,101.9,7642,3857,3785,101.9
31192, 기흥구,055,50~54세,2018,31878,16259,15619,104.1,31275,15952,15323,104.1
31192, 기흥구,055001, 50세,2018,7554,3757,3797,98.9,7434,3689,3745,98.5
31192, 기흥구,055002, 51세,2018,6702,3386,3316,102.1,6596,3334,3262,102.2
31192, 기흥구,055003, 52세,2018,5995,3069,2926,104.9,5879,3010,2869,104.9
31192, 기흥구,055004, 53세,2018,6121,3197,2924,109.3,5998,3129,2869,109.1
31192, 기흥구,055005, 54세,2018,5506,2850,2656,107.3,5368,2790,2578,108.2
31192, 기흥구,060,55~59세,2018,26423,13265,13158,100.8,25849,12989,12860,101
31192, 기흥구,060001, 55세,2018,5581,2875,2706,106.2,5435,2806,2629,106.7
31192, 기흥구,060002, 56세,2018,5344,2717,2627,103.4,5213,2655,2558,103.8
31192, 기흥구,060003, 57세,2018,5483,2739,2744,99.8,5401,2699,2702,99.9
31192, 기흥구,060004, 58세,2018,5171,2529,2642,95.7,5059,2480,2579,96.2
31192, 기흥구,060005, 59세,2018,4844,2405,2439,98.6,4741,2349,2392,98.2
31192, 기흥구,065,60~64세,2018,20508,9665,10843,89.1,20030,9437,10593,89.1
31192, 기흥구,065001, 60세,2018,4450,2134,2316,92.1,4345,2080,2265,91.8
31192, 기흥구,065002, 61세,2018,4298,2032,2266,89.7,4190,1980,2210,89.6
31192, 기흥구,065003, 62세,2018,3995,1913,2082,91.9,3899,1865,2034,91.7
31192, 기흥구,065004, 63세,2018,4133,1930,2203,87.6,4045,1893,2152,88
31192, 기흥구,065005, 64세,2018,3632,1656,1976,83.8,3551,1619,1932,83.8
31192, 기흥구,070,65~69세,2018,15070,6754,8316,81.2,14885,6662,8223,81
31192, 기흥구,070001, 65세,2018,3259,1473,1786,82.5,3202,1442,1760,81.9
31192, 기흥구,070002, 66세,2018,3571,1599,1972,81.1,3540,1583,1957,80.9
31192, 기흥구,070003, 67세,2018,2523,1120,1403,79.8,2485,1099,1386,79.3
31192, 기흥구,070004, 68세,2018,2829,1279,1550,82.5,2797,1265,1532,82.6
31192, 기흥구,070005, 69세,2018,2888,1283,1605,79.9,2861,1273,1588,80.2
31192, 기흥구,075,70~74세,2018,13283,6015,7268,82.8,13209,5984,7225,82.8
31192, 기흥구,075001, 70세,2018,2974,1339,1635,81.9,2952,1330,1622,82
31192, 기흥구,075002, 71세,2018,3185,1413,1772,79.7,3164,1401,1763,79.5
31192, 기흥구,075003, 72세,2018,2596,1179,1417,83.2,2584,1177,1407,83.7
31192, 기흥구,075004, 73세,2018,2292,1066,1226,86.9,2283,1062,1221,87
31192, 기흥구,075005, 74세,2018,2236,1018,1218,83.6,2226,1014,1212,83.7
31192, 기흥구,080,75~79세,2018,10495,4905,5590,87.7,10454,4887,5567,87.8
31192, 기흥구,080001, 75세,2018,2259,1026,1233,83.2,2251,1024,1227,83.5
31192, 기흥구,080002, 76세,2018,2521,1208,1313,92,2509,1203,1306,92.1
31192, 기흥구,080003, 77세,2018,2149,1045,1104,94.7,2143,1042,1101,94.6
31192, 기흥구,080004, 78세,2018,1828,857,971,88.3,1820,854,966,88.4
31192, 기흥구,080005, 79세,2018,1738,769,969,79.4,1731,764,967,79
31192, 기흥구,085,80~84세,2018,6032,2586,3446,75,6016,2581,3435,75.1
31192, 기흥구,085001, 80세,2018,1506,703,803,87.5,1503,702,801,87.6
31192, 기흥구,085002, 81세,2018,1351,597,754,79.2,1349,596,753,79.2
31192, 기흥구,085003, 82세,2018,1174,489,685,71.4,1171,488,683,71.4
31192, 기흥구,085004, 83세,2018,1067,442,625,70.7,1065,442,623,70.9
31192, 기흥구,085005, 84세,2018,934,355,579,61.3,928,353,575,61.4
31192, 기흥구,090,85~89세,2018,2948,1025,1923,53.3,2935,1023,1912,53.5
31192, 기흥구,090001, 85세,2018,785,294,491,59.9,780,293,487,60.2
31192, 기흥구,090002, 86세,2018,672,251,421,59.6,669,251,418,60
31192, 기흥구,090003, 87세,2018,526,168,358,46.9,523,168,355,47.3
31192, 기흥구,090004, 88세,2018,513,177,336,52.7,513,177,336,52.7
31192, 기흥구,090005, 89세,2018,452,135,317,42.6,450,134,316,42.4
31192, 기흥구,095,90~94세,2018,1081,262,819,32,1075,261,814,32.1
31192, 기흥구,095001, 90세,2018,312,85,227,37.4,309,85,224,37.9
31192, 기흥구,095002, 91세,2018,290,69,221,31.2,290,69,221,31.2
31192, 기흥구,095003, 92세,2018,202,52,150,34.7,201,51,150,34
31192, 기흥구,095004, 93세,2018,155,32,123,26,154,32,122,26.2
31192, 기흥구,095005, 94세,2018,122,24,98,24.5,121,24,97,24.7
31192, 기흥구,100,95~99세,2018,305,82,223,36.8,305,82,223,36.8
31192, 기흥구,100001, 95세,2018,106,38,68,55.9,106,38,68,55.9
31192, 기흥구,100002, 96세,2018,80,15,65,23.1,80,15,65,23.1
31192, 기흥구,100003, 97세,2018,50,11,39,28.2,50,11,39,28.2
31192, 기흥구,100004, 98세,2018,42,7,35,20,42,7,35,20
31192, 기흥구,100005, 99세,2018,27,11,16,68.8,27,11,16,68.8
31192, 기흥구,101,100세이상,2018,43,5,38,13.2,42,X,38,10.5
31192, 기흥구,102,15세미만,2018,71888,36872,35016,105.3,71548,36708,34840,105.4
31192, 기흥구,103,15~64세,2018,301438,150633,150805,99.9,294598,147047,147551,99.7
31192, 기흥구,104,65세이상,2018,49257,21634,27623,78.3,48921,21484,27437,78.3
31192, 기흥구,086,85세이상,2018,4377,1374,3003,45.8,4357,1370,2987,45.9
31192, 기흥구,126,평균연령,2018,38.8,38,39.6,,38.8,38,39.6,
31192, 기흥구,127,중위연령,2018,39.9,39.3,40.4,,39.9,39.3,40.5,
31193, 수지구,000,합계,2018,344019,167996,176023,95.4,339084,165638,173446,95.5
31193, 수지구,005,0~4세,2018,15763,7974,7789,102.4,15594,7886,7708,102.3
31193, 수지구,005001, 0세,2018,2361,1148,1213,94.6,2338,1134,1204,94.2
31193, 수지구,005002, 1세,2018,2842,1479,1363,108.5,2796,1451,1345,107.9
31193, 수지구,005003, 2세,2018,3260,1661,1599,103.9,3215,1642,1573,104.4
31193, 수지구,005004, 3세,2018,3545,1790,1755,102,3520,1778,1742,102.1
31193, 수지구,005005, 4세,2018,3755,1896,1859,102,3725,1881,1844,102
31193, 수지구,010,5~9세,2018,20305,10425,9880,105.5,20204,10380,9824,105.7
31193, 수지구,010001, 5세,2018,3833,1971,1862,105.9,3807,1960,1847,106.1
31193, 수지구,010002, 6세,2018,4095,2122,1973,107.6,4076,2113,1963,107.6
31193, 수지구,010003, 7세,2018,4177,2122,2055,103.3,4159,2116,2043,103.6
31193, 수지구,010004, 8세,2018,4080,2102,1978,106.3,4061,2093,1968,106.4
31193, 수지구,010005, 9세,2018,4120,2108,2012,104.8,4101,2098,2003,104.7
31193, 수지구,015,10~14세,2018,21029,10691,10338,103.4,20967,10659,10308,103.4
31193, 수지구,015001, 10세,2018,4359,2249,2110,106.6,4339,2238,2101,106.5
31193, 수지구,015002, 11세,2018,4342,2179,2163,100.7,4332,2173,2159,100.6
31193, 수지구,015003, 12세,2018,4126,2078,2048,101.5,4116,2074,2042,101.6
31193, 수지구,015004, 13세,2018,3954,2037,1917,106.3,3944,2033,1911,106.4
31193, 수지구,015005, 14세,2018,4248,2148,2100,102.3,4236,2141,2095,102.2
31193, 수지구,020,15~19세,2018,21096,10684,10412,102.6,20885,10599,10286,103
31193, 수지구,020001, 15세,2018,4102,2111,1991,106,4093,2105,1988,105.9
31193, 수지구,020002, 16세,2018,3938,2049,1889,108.5,3921,2037,1884,108.1
31193, 수지구,020003, 17세,2018,4318,2180,2138,102,4297,2173,2124,102.3
31193, 수지구,020004, 18세,2018,4516,2253,2263,99.6,4480,2239,2241,99.9
31193, 수지구,020005, 19세,2018,4222,2091,2131,98.1,4094,2045,2049,99.8
31193, 수지구,025,20~24세,2018,21403,10901,10502,103.8,20476,10464,10012,104.5
31193, 수지구,025001, 20세,2018,4346,2225,2121,104.9,4147,2142,2005,106.8
31193, 수지구,025002, 21세,2018,4332,2235,2097,106.6,4141,2145,1996,107.5
31193, 수지구,025003, 22세,2018,4271,2197,2074,105.9,4075,2105,1970,106.9
31193, 수지구,025004, 23세,2018,4174,2087,2087,100,3985,1985,2000,99.3
31193, 수지구,025005, 24세,2018,4280,2157,2123,101.6,4128,2087,2041,102.3
31193, 수지구,030,25~29세,2018,19433,9684,9749,99.3,18854,9391,9463,99.2
31193, 수지구,030001, 25세,2018,4228,2118,2110,100.4,4102,2059,2043,100.8
31193, 수지구,030002, 26세,2018,4131,2098,2033,103.2,4011,2034,1977,102.9
31193, 수지구,030003, 27세,2018,3850,1947,1903,102.3,3744,1892,1852,102.2
31193, 수지구,030004, 28세,2018,3629,1782,1847,96.5,3518,1721,1797,95.8
31193, 수지구,030005, 29세,2018,3595,1739,1856,93.7,3479,1685,1794,93.9
31193, 수지구,035,30~34세,2018,19564,9255,10309,89.8,19074,8983,10091,89
31193, 수지구,035001, 30세,2018,3672,1792,1880,95.3,3557,1736,1821,95.3
31193, 수지구,035002, 31세,2018,3630,1729,1901,91,3530,1668,1862,89.6
31193, 수지구,035003, 32세,2018,3768,1798,1970,91.3,3662,1741,1921,90.6
31193, 수지구,035004, 33세,2018,4089,1885,2204,85.5,4015,1848,2167,85.3
31193, 수지구,035005, 34세,2018,4405,2051,2354,87.1,4310,1990,2320,85.8
31193, 수지구,040,35~39세,2018,29544,13918,15626,89.1,29051,13668,15383,88.9
31193, 수지구,040001, 35세,2018,5090,2395,2695,88.9,4991,2345,2646,88.6
31193, 수지구,040002, 36세,2018,5731,2770,2961,93.5,5616,2708,2908,93.1
31193, 수지구,040003, 37세,2018,6145,2966,3179,93.3,6028,2905,3123,93
31193, 수지구,040004, 38세,2018,6311,2938,3373,87.1,6228,2903,3325,87.3
31193, 수지구,040005, 39세,2018,6267,2849,3418,83.4,6188,2807,3381,83
31193, 수지구,045,40~44세,2018,32649,15495,17154,90.3,32255,15287,16968,90.1
31193, 수지구,045001, 40세,2018,5800,2722,3078,88.4,5723,2674,3049,87.7
31193, 수지구,045002, 41세,2018,6510,3031,3479,87.1,6428,2990,3438,87
31193, 수지구,045003, 42세,2018,6401,3050,3351,91,6327,3010,3317,90.7
31193, 수지구,045004, 43세,2018,6666,3197,3469,92.2,6591,3153,3438,91.7
31193, 수지구,045005, 44세,2018,7272,3495,3777,92.5,7186,3460,3726,92.9
31193, 수지구,050,45~49세,2018,35546,17556,17990,97.6,35165,17375,17790,97.7
31193, 수지구,050001, 45세,2018,6912,3348,3564,93.9,6828,3307,3521,93.9
31193, 수지구,050002, 46세,2018,7204,3533,3671,96.2,7139,3499,3640,96.1
31193, 수지구,050003, 47세,2018,7618,3818,3800,100.5,7546,3781,3765,100.4
31193, 수지구,050004, 48세,2018,7014,3459,3555,97.3,6928,3419,3509,97.4
31193, 수지구,050005, 49세,2018,6798,3398,3400,99.9,6724,3369,3355,100.4
31193, 수지구,055,50~54세,2018,26604,13536,13068,103.6,26247,13378,12869,104
31193, 수지구,055001, 50세,2018,6325,3158,3167,99.7,6246,3123,3123,100
31193, 수지구,055002, 51세,2018,5504,2762,2742,100.7,5428,2726,2702,100.9
31193, 수지구,055003, 52세,2018,4945,2517,2428,103.7,4880,2492,2388,104.4
31193, 수지구,055004, 53세,2018,5018,2620,2398,109.3,4953,2594,2359,110
31193, 수지구,055005, 54세,2018,4812,2479,2333,106.3,4740,2443,2297,106.4
31193, 수지구,060,55~59세,2018,21534,10979,10555,104,21200,10833,10367,104.5
31193, 수지구,060001, 55세,2018,4722,2455,2267,108.3,4631,2422,2209,109.6
31193, 수지구,060002, 56세,2018,4302,2270,2032,111.7,4232,2233,1999,111.7
31193, 수지구,060003, 57세,2018,4436,2222,2214,100.4,4378,2201,2177,101.1
31193, 수지구,060004, 58세,2018,4257,2149,2108,101.9,4197,2124,2073,102.5
31193, 수지구,060005, 59세,2018,3817,1883,1934,97.4,3762,1853,1909,97.1
31193, 수지구,065,60~64세,2018,16686,7771,8915,87.2,16445,7677,8768,87.6
31193, 수지구,065001, 60세,2018,3571,1782,1789,99.6,3518,1764,1754,100.6
31193, 수지구,065002, 61세,2018,3483,1662,1821,91.3,3425,1638,1787,91.7
31193, 수지구,065003, 62세,2018,3159,1396,1763,79.2,3111,1381,1730,79.8
31193, 수지구,065004, 63세,2018,3497,1595,1902,83.9,3454,1578,1876,84.1
31193, 수지구,065005, 64세,2018,2976,1336,1640,81.5,2937,1316,1621,81.2
31193, 수지구,070,65~69세,2018,13109,5791,7318,79.1,12999,5753,7246,79.4
31193, 수지구,070001, 65세,2018,2840,1234,1606,76.8,2807,1223,1584,77.2
31193, 수지구,070002, 66세,2018,2964,1312,1652,79.4,2930,1302,1628,80
31193, 수지구,070003, 67세,2018,2071,899,1172,76.7,2059,893,1166,76.6
31193, 수지구,070004, 68세,2018,2583,1145,1438,79.6,2568,1140,1428,79.8
31193, 수지구,070005, 69세,2018,2651,1201,1450,82.8,2635,1195,1440,83
31193, 수지구,075,70~74세,2018,11959,5332,6627,80.5,11924,5320,6604,80.6
31193, 수지구,075001, 70세,2018,2676,1180,1496,78.9,2669,1177,1492,78.9
31193, 수지구,075002, 71세,2018,2815,1197,1618,74,2802,1192,1610,74
31193, 수지구,075003, 72세,2018,2264,999,1265,79,2261,998,1263,79
31193, 수지구,075004, 73세,2018,2171,1009,1162,86.8,2168,1009,1159,87.1
31193, 수지구,075005, 74세,2018,2033,947,1086,87.2,2024,944,1080,87.4
31193, 수지구,080,75~79세,2018,9299,4609,4690,98.3,9280,4604,4676,98.5
31193, 수지구,080001, 75세,2018,1998,974,1024,95.1,1994,974,1020,95.5
31193, 수지구,080002, 76세,2018,2307,1121,1186,94.5,2299,1120,1179,95
31193, 수지구,080003, 77세,2018,1893,955,938,101.8,1891,954,937,101.8
31193, 수지구,080004, 78세,2018,1602,813,789,103,1601,812,789,102.9
31193, 수지구,080005, 79세,2018,1499,746,753,99.1,1495,744,751,99.1
31193, 수지구,085,80~84세,2018,5134,2309,2825,81.7,5118,2300,2818,81.6
31193, 수지구,085001, 80세,2018,1321,657,664,98.9,1315,651,664,98
31193, 수지구,085002, 81세,2018,1209,551,658,83.7,1207,550,657,83.7
31193, 수지구,085003, 82세,2018,956,394,562,70.1,954,393,561,70.1
31193, 수지구,085004, 83세,2018,898,393,505,77.8,896,393,503,78.1
31193, 수지구,085005, 84세,2018,750,314,436,72,746,313,433,72.3
31193, 수지구,090,85~89세,2018,2309,812,1497,54.2,2299,808,1491,54.2
31193, 수지구,090001, 85세,2018,629,241,388,62.1,626,239,387,61.8
31193, 수지구,090002, 86세,2018,552,218,334,65.3,550,217,333,65.2
31193, 수지구,090003, 87세,2018,424,130,294,44.2,423,129,294,43.9
31193, 수지구,090004, 88세,2018,362,125,237,52.7,362,125,237,52.7
31193, 수지구,090005, 89세,2018,342,98,244,40.2,338,98,240,40.8
31193, 수지구,095,90~94세,2018,815,226,589,38.4,809,225,584,38.5
31193, 수지구,095001, 90세,2018,261,81,180,45,260,81,179,45.3
31193, 수지구,095002, 91세,2018,180,49,131,37.4,179,49,130,37.7
31193, 수지구,095003, 92세,2018,160,45,115,39.1,157,44,113,38.9
31193, 수지구,095004, 93세,2018,135,26,109,23.9,135,26,109,23.9
31193, 수지구,095005, 94세,2018,79,25,54,46.3,78,25,53,47.2
31193, 수지구,100,95~99세,2018,218,47,171,27.5,218,47,171,27.5
31193, 수지구,100001, 95세,2018,74,17,57,29.8,74,17,57,29.8
31193, 수지구,100002, 96세,2018,63,17,46,37,63,17,46,37
31193, 수지구,100003, 97세,2018,39,9,30,30,39,9,30,30
31193, 수지구,100004, 98세,2018,29,X,26,11.5,29,X,26,11.5
31193, 수지구,100005, 99세,2018,13,X,12,8.3,13,X,12,8.3
31193, 수지구,101,100세이상,2018,20,X,19,5.3,20,X,19,5.3
31193, 수지구,102,15세미만,2018,57097,29090,28007,103.9,56765,28925,27840,103.9
31193, 수지구,103,15~64세,2018,244059,119779,124280,96.4,239652,117655,121997,96.4
31193, 수지구,104,65세이상,2018,42863,19127,23736,80.6,42667,19058,23609,80.7
31193, 수지구,086,85세이상,2018,3362,1086,2276,47.7,3346,1081,2265,47.7
31193, 수지구,126,평균연령,2018,39.3,38.6,40,,39.4,38.7,40,
31193, 수지구,127,중위연령,2018,40.7,40.2,41.1,,40.8,40.3,41.2,
31200, 파주시,000,합계,2018,447906,229834,218072,105.4,432738,219259,213479,102.7
31200, 파주시,005,0~4세,2018,21538,10981,10557,104,21405,10907,10498,103.9
31200, 파주시,005001, 0세,2018,3418,1749,1669,104.8,3390,1732,1658,104.5
31200, 파주시,005002, 1세,2018,3874,1947,1927,101,3844,1931,1913,100.9
31200, 파주시,005003, 2세,2018,4528,2351,2177,108,4490,2334,2156,108.3
31200, 파주시,005004, 3세,2018,4829,2430,2399,101.3,4807,2416,2391,101
31200, 파주시,005005, 4세,2018,4889,2504,2385,105,4874,2494,2380,104.8
31200, 파주시,010,5~9세,2018,24894,12674,12220,103.7,24829,12640,12189,103.7
31200, 파주시,010001, 5세,2018,4829,2429,2400,101.2,4810,2420,2390,101.3
31200, 파주시,010002, 6세,2018,5269,2703,2566,105.3,5261,2700,2561,105.4
31200, 파주시,010003, 7세,2018,5080,2592,2488,104.2,5072,2587,2485,104.1
31200, 파주시,010004, 8세,2018,5024,2499,2525,99,5009,2492,2517,99
31200, 파주시,010005, 9세,2018,4692,2451,2241,109.4,4677,2441,2236,109.2
31200, 파주시,015,10~14세,2018,23186,11900,11286,105.4,23128,11869,11259,105.4
31200, 파주시,015001, 10세,2018,4953,2559,2394,106.9,4941,2552,2389,106.8
31200, 파주시,015002, 11세,2018,4988,2534,2454,103.3,4981,2532,2449,103.4
31200, 파주시,015003, 12세,2018,4442,2244,2198,102.1,4425,2234,2191,102
31200, 파주시,015004, 13세,2018,4283,2218,2065,107.4,4271,2209,2062,107.1
31200, 파주시,015005, 14세,2018,4520,2345,2175,107.8,4510,2342,2168,108
31200, 파주시,020,15~19세,2018,24129,12459,11670,106.8,24007,12386,11621,106.6
31200, 파주시,020001, 15세,2018,4606,2398,2208,108.6,4596,2391,2205,108.4
31200, 파주시,020002, 16세,2018,4683,2440,2243,108.8,4674,2434,2240,108.7
31200, 파주시,020003, 17세,2018,5206,2665,2541,104.9,5192,2658,2534,104.9
31200, 파주시,020004, 18세,2018,5333,2725,2608,104.5,5307,2710,2597,104.4
31200, 파주시,020005, 19세,2018,4301,2231,2070,107.8,4238,2193,2045,107.2
31200, 파주시,025,20~24세,2018,25390,14038,11352,123.7,23629,12602,11027,114.3
31200, 파주시,025001, 20세,2018,4496,2492,2004,124.4,4388,2418,1970,122.7
31200, 파주시,025002, 21세,2018,4694,2611,2083,125.3,4507,2468,2039,121
31200, 파주시,025003, 22세,2018,4840,2751,2089,131.7,4485,2459,2026,121.4
31200, 파주시,025004, 23세,2018,5360,2961,2399,123.4,4840,2526,2314,109.2
31200, 파주시,025005, 24세,2018,6000,3223,2777,116.1,5409,2731,2678,102
31200, 파주시,030,25~29세,2018,31222,16998,14224,119.5,28053,14569,13484,108
31200, 파주시,030001, 25세,2018,6284,3300,2984,110.6,5633,2783,2850,97.6
31200, 파주시,030002, 26세,2018,6499,3488,3011,115.8,5891,3007,2884,104.3
31200, 파주시,030003, 27세,2018,6352,3418,2934,116.5,5699,2914,2785,104.6
31200, 파주시,030004, 28세,2018,6032,3314,2718,121.9,5388,2838,2550,111.3
31200, 파주시,030005, 29세,2018,6055,3478,2577,135,5442,3027,2415,125.3
31200, 파주시,035,30~34세,2018,33274,18845,14429,130.6,30429,16787,13642,123.1
31200, 파주시,035001, 30세,2018,6325,3591,2734,131.3,5736,3154,2582,122.2
31200, 파주시,035002, 31세,2018,6602,3783,2819,134.2,6008,3361,2647,127
31200, 파주시,035003, 32세,2018,6637,3818,2819,135.4,6090,3428,2662,128.8
31200, 파주시,035004, 33세,2018,6871,3921,2950,132.9,6321,3520,2801,125.7
31200, 파주시,035005, 34세,2018,6839,3732,3107,120.1,6274,3324,2950,112.7
31200, 파주시,040,35~39세,2018,39927,21416,18511,115.7,37689,19782,17907,110.5
31200, 파주시,040001, 35세,2018,7586,4151,3435,120.8,7081,3782,3299,114.6
31200, 파주시,040002, 36세,2018,8167,4440,3727,119.1,7662,4074,3588,113.5
31200, 파주시,040003, 37세,2018,8146,4382,3764,116.4,7674,4020,3654,110
31200, 파주시,040004, 38세,2018,8354,4464,3890,114.8,7960,4183,3777,110.7
31200, 파주시,040005, 39세,2018,7674,3979,3695,107.7,7312,3723,3589,103.7
31200, 파주시,045,40~44세,2018,36902,18987,17915,106,35515,18036,17479,103.2
31200, 파주시,045001, 40세,2018,7089,3686,3403,108.3,6744,3427,3317,103.3
31200, 파주시,045002, 41세,2018,7427,3838,3589,106.9,7109,3617,3492,103.6
31200, 파주시,045003, 42세,2018,7203,3722,3481,106.9,6913,3531,3382,104.4
31200, 파주시,045004, 43세,2018,7253,3668,3585,102.3,7030,3524,3506,100.5
31200, 파주시,045005, 44세,2018,7930,4073,3857,105.6,7719,3937,3782,104.1
31200, 파주시,050,45~49세,2018,40742,21307,19435,109.6,39602,20618,18984,108.6
31200, 파주시,050001, 45세,2018,8176,4204,3972,105.8,7960,4061,3899,104.2
31200, 파주시,050002, 46세,2018,8282,4363,3919,111.3,8061,4218,3843,109.8
31200, 파주시,050003, 47세,2018,8659,4523,4136,109.4,8408,4376,4032,108.5
31200, 파주시,050004, 48세,2018,8006,4236,3770,112.4,7762,4088,3674,111.3
31200, 파주시,050005, 49세,2018,7619,3981,3638,109.4,7411,3875,3536,109.6
31200, 파주시,055,50~54세,2018,33816,17706,16110,109.9,32929,17202,15727,109.4
31200, 파주시,055001, 50세,2018,7614,3972,3642,109.1,7418,3861,3557,108.5
31200, 파주시,055002, 51세,2018,6735,3494,3241,107.8,6575,3408,3167,107.6
31200, 파주시,055003, 52세,2018,6644,3571,3073,116.2,6464,3469,2995,115.8
31200, 파주시,055004, 53세,2018,6647,3473,3174,109.4,6458,3355,3103,108.1
31200, 파주시,055005, 54세,2018,6176,3196,2980,107.2,6014,3109,2905,107
31200, 파주시,060,55~59세,2018,31980,16430,15550,105.7,31395,16147,15248,105.9
31200, 파주시,060001, 55세,2018,6512,3391,3121,108.7,6351,3312,3039,109
31200, 파주시,060002, 56세,2018,6566,3449,3117,110.7,6434,3388,3046,111.2
31200, 파주시,060003, 57세,2018,6779,3449,3330,103.6,6692,3401,3291,103.3
31200, 파주시,060004, 58세,2018,6316,3229,3087,104.6,6203,3179,3024,105.1
31200, 파주시,060005, 59세,2018,5807,2912,2895,100.6,5715,2867,2848,100.7
31200, 파주시,065,60~64세,2018,24602,12266,12336,99.4,24201,12051,12150,99.2
31200, 파주시,065001, 60세,2018,5639,2878,2761,104.2,5536,2824,2712,104.1
31200, 파주시,065002, 61세,2018,5402,2715,2687,101,5316,2667,2649,100.7
31200, 파주시,065003, 62세,2018,4749,2353,2396,98.2,4677,2312,2365,97.8
31200, 파주시,065004, 63세,2018,4830,2353,2477,95,4755,2313,2442,94.7
31200, 파주시,065005, 64세,2018,3982,1967,2015,97.6,3917,1935,1982,97.6
31200, 파주시,070,65~69세,2018,15960,7483,8477,88.3,15755,7385,8370,88.2
31200, 파주시,070001, 65세,2018,3543,1734,1809,95.9,3484,1709,1775,96.3
31200, 파주시,070002, 66세,2018,3772,1812,1960,92.4,3719,1783,1936,92.1
31200, 파주시,070003, 67세,2018,2507,1133,1374,82.5,2477,1115,1362,81.9
31200, 파주시,070004, 68세,2018,2966,1343,1623,82.7,2931,1328,1603,82.8
31200, 파주시,070005, 69세,2018,3172,1461,1711,85.4,3144,1450,1694,85.6
31200, 파주시,075,70~74세,2018,14024,6314,7710,81.9,13944,6277,7667,81.9
31200, 파주시,075001, 70세,2018,3168,1443,1725,83.7,3143,1430,1713,83.5
31200, 파주시,075002, 71세,2018,3191,1491,1700,87.7,3168,1481,1687,87.8
31200, 파주시,075003, 72세,2018,2583,1172,1411,83.1,2569,1166,1403,83.1
31200, 파주시,075004, 73세,2018,2555,1133,1422,79.7,2545,1129,1416,79.7
31200, 파주시,075005, 74세,2018,2527,1075,1452,74,2519,1071,1448,74
31200, 파주시,080,75~79세,2018,12719,5363,7356,72.9,12668,5348,7320,73.1
31200, 파주시,080001, 75세,2018,2679,1103,1576,70,2667,1101,1566,70.3
31200, 파주시,080002, 76세,2018,3011,1338,1673,80,2996,1332,1664,80
31200, 파주시,080003, 77세,2018,2543,1063,1480,71.8,2533,1059,1474,71.8
31200, 파주시,080004, 78세,2018,2313,964,1349,71.5,2307,962,1345,71.5
31200, 파주시,080005, 79세,2018,2173,895,1278,70,2165,894,1271,70.3
31200, 파주시,085,80~84세,2018,8115,3104,5011,61.9,8087,3094,4993,62
31200, 파주시,085001, 80세,2018,2051,770,1281,60.1,2046,769,1277,60.2
31200, 파주시,085002, 81세,2018,1786,738,1048,70.4,1780,737,1043,70.7
31200, 파주시,085003, 82세,2018,1621,628,993,63.2,1616,627,989,63.4
31200, 파주시,085004, 83세,2018,1480,558,922,60.5,1474,553,921,60
31200, 파주시,085005, 84세,2018,1177,410,767,53.5,1171,408,763,53.5
31200, 파주시,090,85~89세,2018,3786,1175,2611,45,3776,1171,2605,45
31200, 파주시,090001, 85세,2018,1019,336,683,49.2,1017,335,682,49.1
31200, 파주시,090002, 86세,2018,907,293,614,47.7,906,292,614,47.6
31200, 파주시,090003, 87세,2018,705,211,494,42.7,703,210,493,42.6
31200, 파주시,090004, 88세,2018,624,188,436,43.1,623,187,436,42.9
31200, 파주시,090005, 89세,2018,531,147,384,38.3,527,147,380,38.7
31200, 파주시,095,90~94세,2018,1323,283,1040,27.2,1321,283,1038,27.3
31200, 파주시,095001, 90세,2018,426,107,319,33.5,426,107,319,33.5
31200, 파주시,095002, 91세,2018,333,65,268,24.3,333,65,268,24.3
31200, 파주시,095003, 92세,2018,243,53,190,27.9,243,53,190,27.9
31200, 파주시,095004, 93세,2018,187,29,158,18.4,185,29,156,18.6
31200, 파주시,095005, 94세,2018,134,29,105,27.6,134,29,105,27.6
31200, 파주시,100,95~99세,2018,329,96,233,41.2,328,96,232,41.4
31200, 파주시,100001, 95세,2018,124,34,90,37.8,123,34,89,38.2
31200, 파주시,100002, 96세,2018,88,22,66,33.3,88,22,66,33.3
31200, 파주시,100003, 97세,2018,49,14,35,40,49,14,35,40
31200, 파주시,100004, 98세,2018,39,16,23,69.6,39,16,23,69.6
31200, 파주시,100005, 99세,2018,29,10,19,52.6,29,10,19,52.6
31200, 파주시,101,100세이상,2018,48,9,39,23.1,48,9,39,23.1
31200, 파주시,102,15세미만,2018,69618,35555,34063,104.4,69362,35416,33946,104.3
31200, 파주시,103,15~64세,2018,321984,170452,151532,112.5,307449,160180,147269,108.8
31200, 파주시,104,65세이상,2018,56304,23827,32477,73.4,55927,23663,32264,73.3
31200, 파주시,086,85세이상,2018,5486,1563,3923,39.8,5473,1559,3914,39.8
31200, 파주시,126,평균연령,2018,39.8,38.8,40.9,,40,39,41,
31200, 파주시,127,중위연령,2018,40.1,38.9,41.4,,40.5,39.5,41.5,
31210, 이천시,000,합계,2018,220599,113933,106666,106.8,210461,107850,102611,105.1
31210, 이천시,005,0~4세,2018,9763,5081,4682,108.5,9678,5040,4638,108.7
31210, 이천시,005001, 0세,2018,1562,788,774,101.8,1551,782,769,101.7
31210, 이천시,005002, 1세,2018,1846,975,871,111.9,1821,963,858,112.2
31210, 이천시,005003, 2세,2018,2030,1062,968,109.7,2014,1054,960,109.8
31210, 이천시,005004, 3세,2018,2200,1132,1068,106,2185,1125,1060,106.1
31210, 이천시,005005, 4세,2018,2125,1124,1001,112.3,2107,1116,991,112.6
31210, 이천시,010,5~9세,2018,10950,5648,5302,106.5,10879,5610,5269,106.5
31210, 이천시,010001, 5세,2018,2143,1081,1062,101.8,2124,1073,1051,102.1
31210, 이천시,010002, 6세,2018,2309,1167,1142,102.2,2295,1158,1137,101.8
31210, 이천시,010003, 7세,2018,2282,1191,1091,109.2,2269,1184,1085,109.1
31210, 이천시,010004, 8세,2018,2165,1146,1019,112.5,2158,1140,1018,112
31210, 이천시,010005, 9세,2018,2051,1063,988,107.6,2033,1055,978,107.9
31210, 이천시,015,10~14세,2018,10760,5553,5207,106.6,10728,5537,5191,106.7
31210, 이천시,015001, 10세,2018,2233,1153,1080,106.8,2227,1149,1078,106.6
31210, 이천시,015002, 11세,2018,2217,1119,1098,101.9,2211,1116,1095,101.9
31210, 이천시,015003, 12세,2018,2106,1110,996,111.4,2097,1104,993,111.2
31210, 이천시,015004, 13세,2018,2025,1055,970,108.8,2018,1054,964,109.3
31210, 이천시,015005, 14세,2018,2179,1116,1063,105,2175,1114,1061,105
31210, 이천시,020,15~19세,2018,13182,6935,6247,111,13100,6874,6226,110.4
31210, 이천시,020001, 15세,2018,2107,1076,1031,104.4,2102,1074,1028,104.5
31210, 이천시,020002, 16세,2018,2273,1190,1083,109.9,2264,1183,1081,109.4
31210, 이천시,020003, 17세,2018,2503,1266,1237,102.3,2490,1255,1235,101.6
31210, 이천시,020004, 18세,2018,2915,1517,1398,108.5,2909,1515,1394,108.7
31210, 이천시,020005, 19세,2018,3384,1886,1498,125.9,3335,1847,1488,124.1
31210, 이천시,025,20~24세,2018,14282,7723,6559,117.7,13127,7023,6104,115.1
31210, 이천시,025001, 20세,2018,2830,1538,1292,119,2762,1497,1265,118.3
31210, 이천시,025002, 21세,2018,2636,1431,1205,118.8,2482,1345,1137,118.3
31210, 이천시,025003, 22세,2018,2807,1501,1306,114.9,2551,1343,1208,111.2
31210, 이천시,025004, 23세,2018,2865,1572,1293,121.6,2550,1369,1181,115.9
31210, 이천시,025005, 24세,2018,3144,1681,1463,114.9,2782,1469,1313,111.9
31210, 이천시,030,25~29세,2018,17742,10120,7622,132.8,15216,8533,6683,127.7
31210, 이천시,030001, 25세,2018,3514,1985,1529,129.8,3040,1693,1347,125.7
31210, 이천시,030002, 26세,2018,3811,2188,1623,134.8,3275,1873,1402,133.6
31210, 이천시,030003, 27세,2018,3418,1982,1436,138,2922,1662,1260,131.9
31210, 이천시,030004, 28세,2018,3510,1998,1512,132.1,2985,1664,1321,126
31210, 이천시,030005, 29세,2018,3489,1967,1522,129.2,2994,1641,1353,121.3
31210, 이천시,035,30~34세,2018,16104,8575,7529,113.9,14182,7335,6847,107.1
31210, 이천시,035001, 30세,2018,3239,1725,1514,113.9,2778,1440,1338,107.6
31210, 이천시,035002, 31세,2018,3219,1716,1503,114.2,2814,1452,1362,106.6
31210, 이천시,035003, 32세,2018,3165,1692,1473,114.9,2772,1426,1346,105.9
31210, 이천시,035004, 33세,2018,3236,1662,1574,105.6,2893,1444,1449,99.7
31210, 이천시,035005, 34세,2018,3245,1780,1465,121.5,2925,1573,1352,116.3
31210, 이천시,040,35~39세,2018,17955,9710,8245,117.8,16750,9000,7750,116.1
31210, 이천시,040001, 35세,2018,3401,1838,1563,117.6,3128,1670,1458,114.5
31210, 이천시,040002, 36세,2018,3815,2120,1695,125.1,3547,1965,1582,124.2
31210, 이천시,040003, 37세,2018,3569,1978,1591,124.3,3341,1844,1497,123.2
31210, 이천시,040004, 38세,2018,3629,1946,1683,115.6,3419,1828,1591,114.9
31210, 이천시,040005, 39세,2018,3541,1828,1713,106.7,3315,1693,1622,104.4
31210, 이천시,045,40~44세,2018,17252,8766,8486,103.3,16435,8263,8172,101.1
31210, 이천시,045001, 40세,2018,3501,1794,1707,105.1,3300,1667,1633,102.1
31210, 이천시,045002, 41세,2018,3388,1666,1722,96.7,3227,1562,1665,93.8
31210, 이천시,045003, 42세,2018,3413,1711,1702,100.5,3250,1609,1641,98
31210, 이천시,045004, 43세,2018,3309,1706,1603,106.4,3175,1626,1549,105
31210, 이천시,045005, 44세,2018,3641,1889,1752,107.8,3483,1799,1684,106.8
31210, 이천시,050,45~49세,2018,18185,9556,8629,110.7,17483,9183,8300,110.6
31210, 이천시,050001, 45세,2018,3556,1825,1731,105.4,3419,1758,1661,105.8
31210, 이천시,050002, 46세,2018,3529,1894,1635,115.8,3394,1818,1576,115.4
31210, 이천시,050003, 47세,2018,3672,1944,1728,112.5,3529,1871,1658,112.8
31210, 이천시,050004, 48세,2018,3709,1999,1710,116.9,3569,1920,1649,116.4
31210, 이천시,050005, 49세,2018,3719,1894,1825,103.8,3572,1816,1756,103.4
31210, 이천시,055,50~54세,2018,16933,8695,8238,105.5,16342,8376,7966,105.1
31210, 이천시,055001, 50세,2018,3633,1832,1801,101.7,3507,1761,1746,100.9
31210, 이천시,055002, 51세,2018,3327,1688,1639,103,3211,1628,1583,102.8
31210, 이천시,055003, 52세,2018,3338,1762,1576,111.8,3227,1702,1525,111.6
31210, 이천시,055004, 53세,2018,3422,1769,1653,107,3309,1702,1607,105.9
31210, 이천시,055005, 54세,2018,3213,1644,1569,104.8,3088,1583,1505,105.2
31210, 이천시,060,55~59세,2018,17159,8929,8230,108.5,16697,8685,8012,108.4
31210, 이천시,060001, 55세,2018,3200,1682,1518,110.8,3054,1600,1454,110
31210, 이천시,060002, 56세,2018,3397,1794,1603,111.9,3304,1747,1557,112.2
31210, 이천시,060003, 57세,2018,3892,2043,1849,110.5,3825,2009,1816,110.6
31210, 이천시,060004, 58세,2018,3521,1778,1743,102,3427,1727,1700,101.6
31210, 이천시,060005, 59세,2018,3149,1632,1517,107.6,3087,1602,1485,107.9
31210, 이천시,065,60~64세,2018,12970,6743,6227,108.3,12676,6583,6093,108
31210, 이천시,065001, 60세,2018,3035,1612,1423,113.3,2970,1582,1388,114
31210, 이천시,065002, 61세,2018,2757,1406,1351,104.1,2667,1355,1312,103.3
31210, 이천시,065003, 62세,2018,2562,1377,1185,116.2,2514,1351,1163,116.2
31210, 이천시,065004, 63세,2018,2535,1267,1268,99.9,2480,1237,1243,99.5
31210, 이천시,065005, 64세,2018,2081,1081,1000,108.1,2045,1058,987,107.2
31210, 이천시,070,65~69세,2018,8391,4102,4289,95.6,8272,4039,4233,95.4
31210, 이천시,070001, 65세,2018,1812,897,915,98,1786,888,898,98.9
31210, 이천시,070002, 66세,2018,2238,1135,1103,102.9,2215,1122,1093,102.7
31210, 이천시,070003, 67세,2018,1380,647,733,88.3,1344,627,717,87.4
31210, 이천시,070004, 68세,2018,1457,684,773,88.5,1437,670,767,87.4
31210, 이천시,070005, 69세,2018,1504,739,765,96.6,1490,732,758,96.6
31210, 이천시,075,70~74세,2018,6437,3088,3349,92.2,6393,3069,3324,92.3
31210, 이천시,075001, 70세,2018,1474,725,749,96.8,1463,720,743,96.9
31210, 이천시,075002, 71세,2018,1484,711,773,92,1473,709,764,92.8
31210, 이천시,075003, 72세,2018,1229,624,605,103.1,1220,620,600,103.3
31210, 이천시,075004, 73세,2018,1158,533,625,85.3,1149,528,621,85
31210, 이천시,075005, 74세,2018,1092,495,597,82.9,1088,492,596,82.6
31210, 이천시,080,75~79세,2018,5878,2493,3385,73.6,5861,2488,3373,73.8
31210, 이천시,080001, 75세,2018,1197,524,673,77.9,1196,524,672,78
31210, 이천시,080002, 76세,2018,1404,593,811,73.1,1397,590,807,73.1
31210, 이천시,080003, 77세,2018,1157,494,663,74.5,1152,492,660,74.5
31210, 이천시,080004, 78세,2018,1110,473,637,74.3,1108,473,635,74.5
31210, 이천시,080005, 79세,2018,1010,409,601,68.1,1008,409,599,68.3
31210, 이천시,085,80~84세,2018,4022,1498,2524,59.4,4016,1496,2520,59.4
31210, 이천시,085001, 80세,2018,967,397,570,69.6,965,397,568,69.9
31210, 이천시,085002, 81세,2018,894,334,560,59.6,893,334,559,59.7
31210, 이천시,085003, 82세,2018,774,293,481,60.9,773,292,481,60.7
31210, 이천시,085004, 83세,2018,744,254,490,51.8,743,253,490,51.6
31210, 이천시,085005, 84세,2018,643,220,423,52,642,220,422,52.1
31210, 이천시,090,85~89세,2018,1847,547,1300,42.1,1840,545,1295,42.1
31210, 이천시,090001, 85세,2018,531,172,359,47.9,530,171,359,47.6
31210, 이천시,090002, 86세,2018,430,127,303,41.9,428,127,301,42.2
31210, 이천시,090003, 87세,2018,315,87,228,38.2,314,86,228,37.7
31210, 이천시,090004, 88세,2018,301,90,211,42.7,298,90,208,43.3
31210, 이천시,090005, 89세,2018,270,71,199,35.7,270,71,199,35.7
31210, 이천시,095,90~94세,2018,619,136,483,28.2,618,136,482,28.2
31210, 이천시,095001, 90세,2018,200,42,158,26.6,200,42,158,26.6
31210, 이천시,095002, 91세,2018,146,32,114,28.1,145,32,113,28.3
31210, 이천시,095003, 92세,2018,104,25,79,31.6,104,25,79,31.6
31210, 이천시,095004, 93세,2018,106,24,82,29.3,106,24,82,29.3
31210, 이천시,095005, 94세,2018,63,13,50,26,63,13,50,26
31210, 이천시,100,95~99세,2018,148,32,116,27.6,148,32,116,27.6
31210, 이천시,100001, 95세,2018,60,12,48,25,60,12,48,25
31210, 이천시,100002, 96세,2018,36,7,29,24.1,36,7,29,24.1
31210, 이천시,100003, 97세,2018,28,7,21,33.3,28,7,21,33.3
31210, 이천시,100004, 98세,2018,16,X,14,14.3,16,X,14,14.3
31210, 이천시,100005, 99세,2018,8,X,X,100,8,X,X,100
31210, 이천시,101,100세이상,2018,20,X,17,17.6,20,X,17,17.6
31210, 이천시,102,15세미만,2018,31473,16282,15191,107.2,31285,16187,15098,107.2
31210, 이천시,103,15~64세,2018,161764,85752,76012,112.8,152008,79855,72153,110.7
31210, 이천시,104,65세이상,2018,27362,11899,15463,77,27168,11808,15360,76.9
31210, 이천시,086,85세이상,2018,2634,718,1916,37.5,2626,716,1910,37.5
31210, 이천시,126,평균연령,2018,40,39,41,,40.2,39.2,41.2,
31210, 이천시,127,중위연령,2018,39.9,38.7,41.1,,40.5,39.4,41.6,
31220, 안성시,000,합계,2018,201135,104916,96219,109,184605,94266,90339,104.3
31220, 안성시,005,0~4세,2018,7221,3662,3559,102.9,6930,3516,3414,103
31220, 안성시,005001, 0세,2018,1148,580,568,102.1,1091,549,542,101.3
31220, 안성시,005002, 1세,2018,1309,642,667,96.3,1247,622,625,99.5
31220, 안성시,005003, 2세,2018,1520,780,740,105.4,1472,751,721,104.2
31220, 안성시,005004, 3세,2018,1634,861,773,111.4,1576,824,752,109.6
31220, 안성시,005005, 4세,2018,1610,799,811,98.5,1544,770,774,99.5
31220, 안성시,010,5~9세,2018,9005,4653,4352,106.9,8801,4560,4241,107.5
31220, 안성시,010001, 5세,2018,1714,913,801,114,1663,890,773,115.1
31220, 안성시,010002, 6세,2018,1822,911,911,100,1766,886,880,100.7
31220, 안성시,010003, 7세,2018,1878,982,896,109.6,1841,965,876,110.2
31220, 안성시,010004, 8세,2018,1786,918,868,105.8,1758,906,852,106.3
31220, 안성시,010005, 9세,2018,1805,929,876,106.1,1773,913,860,106.2
31220, 안성시,015,10~14세,2018,8636,4456,4180,106.6,8519,4402,4117,106.9
31220, 안성시,015001, 10세,2018,1846,943,903,104.4,1822,934,888,105.2
31220, 안성시,015002, 11세,2018,1843,944,899,105,1808,926,882,105
31220, 안성시,015003, 12세,2018,1644,850,794,107.1,1624,842,782,107.7
31220, 안성시,015004, 13세,2018,1634,861,773,111.4,1610,850,760,111.8
31220, 안성시,015005, 14세,2018,1669,858,811,105.8,1655,850,805,105.6
31220, 안성시,020,15~19세,2018,12090,6298,5792,108.7,11817,6154,5663,108.7
31220, 안성시,020001, 15세,2018,1784,937,847,110.6,1775,933,842,110.8
31220, 안성시,020002, 16세,2018,2036,1080,956,113,2018,1075,943,114
31220, 안성시,020003, 17세,2018,2221,1192,1029,115.8,2197,1179,1018,115.8
31220, 안성시,020004, 18세,2018,2654,1338,1316,101.7,2580,1301,1279,101.7
31220, 안성시,020005, 19세,2018,3395,1751,1644,106.5,3247,1666,1581,105.4
31220, 안성시,025,20~24세,2018,15511,8243,7268,113.4,13707,6988,6719,104
31220, 안성시,025001, 20세,2018,3211,1509,1702,88.7,2997,1384,1613,85.8
31220, 안성시,025002, 21세,2018,3046,1469,1577,93.2,2755,1274,1481,86
31220, 안성시,025003, 22세,2018,3161,1711,1450,118,2799,1461,1338,109.2
31220, 안성시,025004, 23세,2018,3130,1761,1369,128.6,2681,1447,1234,117.3
31220, 안성시,025005, 24세,2018,2963,1793,1170,153.2,2475,1422,1053,135
31220, 안성시,030,25~29세,2018,13584,8161,5423,150.5,10603,6036,4567,132.2
31220, 안성시,030001, 25세,2018,3010,1839,1171,157,2405,1401,1004,139.5
31220, 안성시,030002, 26세,2018,2813,1705,1108,153.9,2214,1281,933,137.3
31220, 안성시,030003, 27세,2018,2610,1526,1084,140.8,2065,1145,920,124.5
31220, 안성시,030004, 28세,2018,2543,1524,1019,149.6,1939,1110,829,133.9
31220, 안성시,030005, 29세,2018,2608,1567,1041,150.5,1980,1099,881,124.7
31220, 안성시,035,30~34세,2018,13331,7801,5530,141.1,10349,5737,4612,124.4
31220, 안성시,035001, 30세,2018,2579,1507,1072,140.6,1927,1069,858,124.6
31220, 안성시,035002, 31세,2018,2607,1536,1071,143.4,1958,1081,877,123.3
31220, 안성시,035003, 32세,2018,2586,1491,1095,136.2,2018,1093,925,118.2
31220, 안성시,035004, 33세,2018,2723,1600,1123,142.5,2157,1202,955,125.9
31220, 안성시,035005, 34세,2018,2836,1667,1169,142.6,2289,1292,997,129.6
31220, 안성시,040,35~39세,2018,16571,9197,7374,124.7,14238,7571,6667,113.6
31220, 안성시,040001, 35세,2018,3104,1709,1395,122.5,2577,1343,1234,108.8
31220, 안성시,040002, 36세,2018,3263,1835,1428,128.5,2778,1495,1283,116.5
31220, 안성시,040003, 37세,2018,3399,1899,1500,126.6,2927,1564,1363,114.7
31220, 안성시,040004, 38세,2018,3473,1927,1546,124.6,3041,1628,1413,115.2
31220, 안성시,040005, 39세,2018,3332,1827,1505,121.4,2915,1541,1374,112.2
31220, 안성시,045,40~44세,2018,15296,8348,6948,120.1,13748,7339,6409,114.5
31220, 안성시,045001, 40세,2018,3018,1649,1369,120.5,2665,1416,1249,113.4
31220, 안성시,045002, 41세,2018,3027,1655,1372,120.6,2725,1454,1271,114.4
31220, 안성시,045003, 42세,2018,2968,1647,1321,124.7,2623,1416,1207,117.3
31220, 안성시,045004, 43세,2018,3002,1625,1377,118,2724,1447,1277,113.3
31220, 안성시,045005, 44세,2018,3281,1772,1509,117.4,3011,1606,1405,114.3
31220, 안성시,050,45~49세,2018,16787,9004,7783,115.7,15518,8280,7238,114.4
31220, 안성시,050001, 45세,2018,3312,1743,1569,111.1,3079,1605,1474,108.9
31220, 안성시,050002, 46세,2018,3222,1758,1464,120.1,2957,1605,1352,118.7
31220, 안성시,050003, 47세,2018,3442,1843,1599,115.3,3196,1698,1498,113.4
31220, 안성시,050004, 48세,2018,3333,1778,1555,114.3,3053,1627,1426,114.1
31220, 안성시,050005, 49세,2018,3478,1882,1596,117.9,3233,1745,1488,117.3
31220, 안성시,055,50~54세,2018,15169,8027,7142,112.4,14164,7480,6684,111.9
31220, 안성시,055001, 50세,2018,3296,1737,1559,111.4,3049,1605,1444,111.1
31220, 안성시,055002, 51세,2018,2956,1514,1442,105,2784,1418,1366,103.8
31220, 안성시,055003, 52세,2018,3003,1650,1353,122,2813,1546,1267,122
31220, 안성시,055004, 53세,2018,3031,1629,1402,116.2,2840,1517,1323,114.7
31220, 안성시,055005, 54세,2018,2883,1497,1386,108,2678,1394,1284,108.6
31220, 안성시,060,55~59세,2018,15761,8172,7589,107.7,14936,7742,7194,107.6
31220, 안성시,060001, 55세,2018,3052,1613,1439,112.1,2831,1497,1334,112.2
31220, 안성시,060002, 56세,2018,2968,1576,1392,113.2,2783,1483,1300,114.1
31220, 안성시,060003, 57세,2018,3425,1788,1637,109.2,3300,1724,1576,109.4
31220, 안성시,060004, 58세,2018,3310,1681,1629,103.2,3157,1601,1556,102.9
31220, 안성시,060005, 59세,2018,3006,1514,1492,101.5,2865,1437,1428,100.6
31220, 안성시,065,60~64세,2018,12661,6361,6300,101,12138,6102,6036,101.1
31220, 안성시,065001, 60세,2018,2841,1419,1422,99.8,2713,1367,1346,101.6
31220, 안성시,065002, 61세,2018,2634,1347,1287,104.7,2506,1276,1230,103.7
31220, 안성시,065003, 62세,2018,2515,1241,1274,97.4,2410,1188,1222,97.2
31220, 안성시,065004, 63세,2018,2496,1246,1250,99.7,2409,1196,1213,98.6
31220, 안성시,065005, 64세,2018,2175,1108,1067,103.8,2100,1075,1025,104.9
31220, 안성시,070,65~69세,2018,8612,4270,4342,98.3,8369,4149,4220,98.3
31220, 안성시,070001, 65세,2018,1896,947,949,99.8,1809,901,908,99.2
31220, 안성시,070002, 66세,2018,2209,1126,1083,104,2168,1106,1062,104.1
31220, 안성시,070003, 67세,2018,1447,697,750,92.9,1409,677,732,92.5
31220, 안성시,070004, 68세,2018,1588,783,805,97.3,1544,764,780,97.9
31220, 안성시,070005, 69세,2018,1472,717,755,95,1439,701,738,95
31220, 안성시,075,70~74세,2018,6865,3230,3635,88.9,6802,3199,3603,88.8
31220, 안성시,075001, 70세,2018,1535,751,784,95.8,1518,743,775,95.9
31220, 안성시,075002, 71세,2018,1642,771,871,88.5,1626,761,865,88
31220, 안성시,075003, 72세,2018,1227,594,633,93.8,1212,587,625,93.9
31220, 안성시,075004, 73세,2018,1240,564,676,83.4,1234,562,672,83.6
31220, 안성시,075005, 74세,2018,1221,550,671,82,1212,546,666,82
31220, 안성시,080,75~79세,2018,6188,2556,3632,70.4,6150,2543,3607,70.5
31220, 안성시,080001, 75세,2018,1202,512,690,74.2,1198,510,688,74.1
31220, 안성시,080002, 76세,2018,1429,575,854,67.3,1421,573,848,67.6
31220, 안성시,080003, 77세,2018,1211,530,681,77.8,1204,527,677,77.8
31220, 안성시,080004, 78세,2018,1179,479,700,68.4,1168,475,693,68.5
31220, 안성시,080005, 79세,2018,1167,460,707,65.1,1159,458,701,65.3
31220, 안성시,085,80~84세,2018,4608,1680,2928,57.4,4585,1672,2913,57.4
31220, 안성시,085001, 80세,2018,1049,393,656,59.9,1040,390,650,60
31220, 안성시,085002, 81세,2018,1051,409,642,63.7,1044,405,639,63.4
31220, 안성시,085003, 82세,2018,952,360,592,60.8,949,360,589,61.1
31220, 안성시,085004, 83세,2018,795,260,535,48.6,793,260,533,48.8
31220, 안성시,085005, 84세,2018,761,258,503,51.3,759,257,502,51.2
31220, 안성시,090,85~89세,2018,2220,609,1611,37.8,2213,608,1605,37.9
31220, 안성시,090001, 85세,2018,603,184,419,43.9,600,184,416,44.2
31220, 안성시,090002, 86세,2018,543,155,388,39.9,543,155,388,39.9
31220, 안성시,090003, 87세,2018,423,121,302,40.1,421,121,300,40.3
31220, 안성시,090004, 88세,2018,376,93,283,32.9,375,92,283,32.5
31220, 안성시,090005, 89세,2018,275,56,219,25.6,274,56,218,25.7
31220, 안성시,095,90~94세,2018,789,144,645,22.3,788,144,644,22.4
31220, 안성시,095001, 90세,2018,240,42,198,21.2,240,42,198,21.2
31220, 안성시,095002, 91세,2018,165,26,139,18.7,164,26,138,18.8
31220, 안성시,095003, 92세,2018,161,28,133,21.1,161,28,133,21.1
31220, 안성시,095004, 93세,2018,116,23,93,24.7,116,23,93,24.7
31220, 안성시,095005, 94세,2018,107,25,82,30.5,107,25,82,30.5
31220, 안성시,100,95~99세,2018,205,42,163,25.8,205,42,163,25.8
31220, 안성시,100001, 95세,2018,72,15,57,26.3,72,15,57,26.3
31220, 안성시,100002, 96세,2018,55,12,43,27.9,55,12,43,27.9
31220, 안성시,100003, 97세,2018,35,7,28,25,35,7,28,25
31220, 안성시,100004, 98세,2018,23,X,20,15,23,X,20,15
31220, 안성시,100005, 99세,2018,20,5,15,33.3,20,5,15,33.3
31220, 안성시,101,100세이상,2018,25,X,23,8.7,25,X,23,8.7
31220, 안성시,102,15세미만,2018,24862,12771,12091,105.6,24250,12478,11772,106
31220, 안성시,103,15~64세,2018,146761,79612,67149,118.6,131218,69429,61789,112.4
31220, 안성시,104,65세이상,2018,29512,12533,16979,73.8,29137,12359,16778,73.7
31220, 안성시,086,85세이상,2018,3239,797,2442,32.6,3231,796,2435,32.7
31220, 안성시,126,평균연령,2018,41.5,40.2,42.9,,42,40.8,43.3,
31220, 안성시,127,중위연령,2018,41.5,40,43.4,,42.7,41.5,44.1,
31230, 김포시,000,합계,2018,424865,219676,205189,107.1,398565,199424,199141,100.1
31230, 김포시,005,0~4세,2018,24235,12335,11900,103.7,23954,12193,11761,103.7
31230, 김포시,005001, 0세,2018,3747,1881,1866,100.8,3695,1854,1841,100.7
31230, 김포시,005002, 1세,2018,4354,2221,2133,104.1,4284,2190,2094,104.6
31230, 김포시,005003, 2세,2018,5201,2644,2557,103.4,5129,2604,2525,103.1
31230, 김포시,005004, 3세,2018,5559,2833,2726,103.9,5512,2810,2702,104
31230, 김포시,005005, 4세,2018,5374,2756,2618,105.3,5334,2735,2599,105.2
31230, 김포시,010,5~9세,2018,26663,13640,13023,104.7,26510,13554,12956,104.6
31230, 김포시,010001, 5세,2018,5324,2711,2613,103.8,5284,2692,2592,103.9
31230, 김포시,010002, 6세,2018,5906,2946,2960,99.5,5870,2927,2943,99.5
31230, 김포시,010003, 7세,2018,5498,2840,2658,106.8,5461,2816,2645,106.5
31230, 김포시,010004, 8세,2018,5173,2712,2461,110.2,5156,2700,2456,109.9
31230, 김포시,010005, 9세,2018,4762,2431,2331,104.3,4739,2419,2320,104.3
31230, 김포시,015,10~14세,2018,21605,10958,10647,102.9,21508,10904,10604,102.8
31230, 김포시,015001, 10세,2018,4880,2483,2397,103.6,4857,2467,2390,103.2
31230, 김포시,015002, 11세,2018,4609,2303,2306,99.9,4588,2290,2298,99.7
31230, 김포시,015003, 12세,2018,4207,2191,2016,108.7,4192,2184,2008,108.8
31230, 김포시,015004, 13세,2018,3927,1954,1973,99,3903,1944,1959,99.2
31230, 김포시,015005, 14세,2018,3982,2027,1955,103.7,3968,2019,1949,103.6
31230, 김포시,020,15~19세,2018,19728,10100,9628,104.9,19498,9958,9540,104.4
31230, 김포시,020001, 15세,2018,3996,2052,1944,105.6,3984,2043,1941,105.3
31230, 김포시,020002, 16세,2018,4009,2029,1980,102.5,3989,2020,1969,102.6
31230, 김포시,020003, 17세,2018,4211,2129,2082,102.3,4184,2114,2070,102.1
31230, 김포시,020004, 18세,2018,4239,2195,2044,107.4,4175,2161,2014,107.3
31230, 김포시,020005, 19세,2018,3273,1695,1578,107.4,3166,1620,1546,104.8
31230, 김포시,025,20~24세,2018,21251,12219,9032,135.3,18721,10079,8642,116.6
31230, 김포시,025001, 20세,2018,3675,2151,1524,141.1,3486,2003,1483,135.1
31230, 김포시,025002, 21세,2018,3942,2348,1594,147.3,3650,2113,1537,137.5
31230, 김포시,025003, 22세,2018,4234,2429,1805,134.6,3719,1991,1728,115.2
31230, 김포시,025004, 23세,2018,4506,2488,2018,123.3,3829,1918,1911,100.4
31230, 김포시,025005, 24세,2018,4894,2803,2091,134.1,4037,2054,1983,103.6
31230, 김포시,030,25~29세,2018,27240,16015,11225,142.7,21148,10743,10405,103.2
31230, 김포시,030001, 25세,2018,5304,3113,2191,142.1,4209,2162,2047,105.6
31230, 김포시,030002, 26세,2018,5593,3337,2256,147.9,4355,2246,2109,106.5
31230, 김포시,030003, 27세,2018,5385,3119,2266,137.6,4226,2111,2115,99.8
31230, 김포시,030004, 28세,2018,5447,3231,2216,145.8,4110,2081,2029,102.6
31230, 김포시,030005, 29세,2018,5511,3215,2296,140,4248,2143,2105,101.8
31230, 김포시,035,30~34세,2018,31526,16922,14604,115.9,26091,12392,13699,90.5
31230, 김포시,035001, 30세,2018,5367,3001,2366,126.8,4229,2039,2190,93.1
31230, 김포시,035002, 31세,2018,5897,3137,2760,113.7,4735,2164,2571,84.2
31230, 김포시,035003, 32세,2018,6261,3406,2855,119.3,5101,2447,2654,92.2
31230, 김포시,035004, 33세,2018,6676,3528,3148,112.1,5638,2662,2976,89.4
31230, 김포시,035005, 34세,2018,7325,3850,3475,110.8,6388,3080,3308,93.1
31230, 김포시,040,35~39세,2018,45636,23763,21873,108.6,41918,20786,21132,98.4
31230, 김포시,040001, 35세,2018,8426,4368,4058,107.6,7563,3658,3905,93.7
31230, 김포시,040002, 36세,2018,9254,4841,4413,109.7,8415,4171,4244,98.3
31230, 김포시,040003, 37세,2018,9321,4898,4423,110.7,8590,4308,4282,100.6
31230, 김포시,040004, 38세,2018,9610,4976,4634,107.4,8924,4435,4489,98.8
31230, 김포시,040005, 39세,2018,9025,4680,4345,107.7,8426,4214,4212,100
31230, 김포시,045,40~44세,2018,39863,21262,18601,114.3,37794,19703,18091,108.9
31230, 김포시,045001, 40세,2018,8177,4348,3829,113.6,7665,3946,3719,106.1
31230, 김포시,045002, 41세,2018,8188,4335,3853,112.5,7719,3971,3748,105.9
31230, 김포시,045003, 42세,2018,7722,4134,3588,115.2,7325,3825,3500,109.3
31230, 김포시,045004, 43세,2018,7778,4189,3589,116.7,7420,3929,3491,112.5
31230, 김포시,045005, 44세,2018,7998,4256,3742,113.7,7665,4032,3633,111
31230, 김포시,050,45~49세,2018,36346,19226,17120,112.3,34672,18137,16535,109.7
31230, 김포시,050001, 45세,2018,7534,4086,3448,118.5,7187,3847,3340,115.2
31230, 김포시,050002, 46세,2018,7583,4075,3508,116.2,7234,3840,3394,113.1
31230, 김포시,050003, 47세,2018,7386,3902,3484,112,7067,3694,3373,109.5
31230, 김포시,050004, 48세,2018,7025,3654,3371,108.4,6654,3420,3234,105.8
31230, 김포시,050005, 49세,2018,6818,3509,3309,106,6530,3336,3194,104.4
31230, 김포시,055,50~54세,2018,30368,15524,14844,104.6,28895,14632,14263,102.6
31230, 김포시,055001, 50세,2018,6625,3402,3223,105.6,6278,3182,3096,102.8
31230, 김포시,055002, 51세,2018,6129,3119,3010,103.6,5855,2957,2898,102
31230, 김포시,055003, 52세,2018,5978,3073,2905,105.8,5706,2903,2803,103.6
31230, 김포시,055004, 53세,2018,5967,2977,2990,99.6,5675,2799,2876,97.3
31230, 김포시,055005, 54세,2018,5669,2953,2716,108.7,5381,2791,2590,107.8
31230, 김포시,060,55~59세,2018,29733,15256,14477,105.4,28551,14592,13959,104.5
31230, 김포시,060001, 55세,2018,5943,3088,2855,108.2,5603,2903,2700,107.5
31230, 김포시,060002, 56세,2018,6069,3189,2880,110.7,5804,3023,2781,108.7
31230, 김포시,060003, 57세,2018,6070,3047,3023,100.8,5916,2963,2953,100.3
31230, 김포시,060004, 58세,2018,6133,3157,2976,106.1,5903,3027,2876,105.3
31230, 김포시,060005, 59세,2018,5518,2775,2743,101.2,5325,2676,2649,101
31230, 김포시,065,60~64세,2018,23702,11560,12142,95.2,22931,11124,11807,94.2
31230, 김포시,065001, 60세,2018,5288,2616,2672,97.9,5116,2525,2591,97.5
31230, 김포시,065002, 61세,2018,5180,2569,2611,98.4,4982,2455,2527,97.2
31230, 김포시,065003, 62세,2018,4537,2194,2343,93.6,4392,2113,2279,92.7
31230, 김포시,065004, 63세,2018,4748,2259,2489,90.8,4605,2178,2427,89.7
31230, 김포시,065005, 64세,2018,3949,1922,2027,94.8,3836,1853,1983,93.4
31230, 김포시,070,65~69세,2018,15862,7602,8260,92,15521,7430,8091,91.8
31230, 김포시,070001, 65세,2018,3563,1690,1873,90.2,3462,1635,1827,89.5
31230, 김포시,070002, 66세,2018,3720,1811,1909,94.9,3661,1775,1886,94.1
31230, 김포시,070003, 67세,2018,2552,1229,1323,92.9,2489,1199,1290,92.9
31230, 김포시,070004, 68세,2018,2946,1372,1574,87.2,2885,1347,1538,87.6
31230, 김포시,070005, 69세,2018,3081,1500,1581,94.9,3024,1474,1550,95.1
31230, 김포시,075,70~74세,2018,12214,5843,6371,91.7,12082,5787,6295,91.9
31230, 김포시,075001, 70세,2018,2940,1444,1496,96.5,2899,1427,1472,96.9
31230, 김포시,075002, 71세,2018,2802,1352,1450,93.2,2765,1333,1432,93.1
31230, 김포시,075003, 72세,2018,2294,1111,1183,93.9,2268,1100,1168,94.2
31230, 김포시,075004, 73세,2018,2195,1038,1157,89.7,2180,1035,1145,90.4
31230, 김포시,075005, 74세,2018,1983,898,1085,82.8,1970,892,1078,82.7
31230, 김포시,080,75~79세,2018,9474,4161,5313,78.3,9406,4142,5264,78.7
31230, 김포시,080001, 75세,2018,2081,950,1131,84,2061,945,1116,84.7
31230, 김포시,080002, 76세,2018,2323,1005,1318,76.3,2307,999,1308,76.4
31230, 김포시,080003, 77세,2018,1849,815,1034,78.8,1841,814,1027,79.3
31230, 김포시,080004, 78세,2018,1634,727,907,80.2,1620,722,898,80.4
31230, 김포시,080005, 79세,2018,1587,664,923,71.9,1577,662,915,72.3
31230, 김포시,085,80~84세,2018,5727,2241,3486,64.3,5691,2227,3464,64.3
31230, 김포시,085001, 80세,2018,1421,595,826,72,1413,591,822,71.9
31230, 김포시,085002, 81세,2018,1286,511,775,65.9,1279,509,770,66.1
31230, 김포시,085003, 82세,2018,1095,446,649,68.7,1086,444,642,69.2
31230, 김포시,085004, 83세,2018,1065,392,673,58.2,1056,387,669,57.8
31230, 김포시,085005, 84세,2018,860,297,563,52.8,857,296,561,52.8
31230, 김포시,090,85~89세,2018,2581,774,1807,42.8,2567,769,1798,42.8
31230, 김포시,090001, 85세,2018,675,219,456,48,672,219,453,48.3
31230, 김포시,090002, 86세,2018,622,198,424,46.7,618,196,422,46.4
31230, 김포시,090003, 87세,2018,521,159,362,43.9,517,157,360,43.6
31230, 김포시,090004, 88세,2018,402,103,299,34.4,402,103,299,34.4
31230, 김포시,090005, 89세,2018,361,95,266,35.7,358,94,264,35.6
31230, 김포시,095,90~94세,2018,887,218,669,32.6,883,215,668,32.2
31230, 김포시,095001, 90세,2018,267,67,200,33.5,266,66,200,33
31230, 김포시,095002, 91세,2018,256,65,191,34,255,64,191,33.5
31230, 김포시,095003, 92세,2018,151,33,118,28,149,32,117,27.4
31230, 김포시,095004, 93세,2018,126,38,88,43.2,126,38,88,43.2
31230, 김포시,095005, 94세,2018,87,15,72,20.8,87,15,72,20.8
31230, 김포시,100,95~99세,2018,205,52,153,34,205,52,153,34
31230, 김포시,100001, 95세,2018,86,23,63,36.5,86,23,63,36.5
31230, 김포시,100002, 96세,2018,53,11,42,26.2,53,11,42,26.2
31230, 김포시,100003, 97세,2018,30,8,22,36.4,30,8,22,36.4
31230, 김포시,100004, 98세,2018,24,6,18,33.3,24,6,18,33.3
31230, 김포시,100005, 99세,2018,12,X,8,50,12,X,8,50
31230, 김포시,101,100세이상,2018,19,5,14,35.7,19,5,14,35.7
31230, 김포시,102,15세미만,2018,72503,36933,35570,103.8,71972,36651,35321,103.8
31230, 김포시,103,15~64세,2018,305393,161847,143546,112.7,280219,142146,138073,102.9
31230, 김포시,104,65세이상,2018,46969,20896,26073,80.1,46374,20627,25747,80.1
31230, 김포시,086,85세이상,2018,3692,1049,2643,39.7,3674,1041,2633,39.5
31230, 김포시,126,평균연령,2018,38.9,38.1,39.8,,39.1,38.4,39.8,
31230, 김포시,127,중위연령,2018,39.4,38.7,40.2,,40,39.8,40.2,
31240, 화성시,000,합계,2018,777295,411255,366040,112.4,724773,373995,350778,106.6
31240, 화성시,005,0~4세,2018,47537,24270,23267,104.3,46808,23905,22903,104.4
31240, 화성시,005001, 0세,2018,7877,4040,3837,105.3,7730,3965,3765,105.3
31240, 화성시,005002, 1세,2018,8805,4506,4299,104.8,8641,4427,4214,105.1
31240, 화성시,005003, 2세,2018,9948,5070,4878,103.9,9781,4988,4793,104.1
31240, 화성시,005004, 3세,2018,10473,5380,5093,105.6,10350,5317,5033,105.6
31240, 화성시,005005, 4세,2018,10434,5274,5160,102.2,10306,5208,5098,102.2
31240, 화성시,010,5~9세,2018,52761,27008,25753,104.9,52347,26800,25547,104.9
31240, 화성시,010001, 5세,2018,10428,5396,5032,107.2,10309,5338,4971,107.4
31240, 화성시,010002, 6세,2018,11215,5688,5527,102.9,11122,5641,5481,102.9
31240, 화성시,010003, 7세,2018,10979,5609,5370,104.5,10901,5569,5332,104.4
31240, 화성시,010004, 8세,2018,10181,5237,4944,105.9,10119,5206,4913,106
31240, 화성시,010005, 9세,2018,9958,5078,4880,104.1,9896,5046,4850,104
31240, 화성시,015,10~14세,2018,44735,22742,21993,103.4,44481,22636,21845,103.6
31240, 화성시,015001, 10세,2018,10069,5115,4954,103.2,9998,5079,4919,103.3
31240, 화성시,015002, 11세,2018,9716,4929,4787,103,9657,4905,4752,103.2
31240, 화성시,015003, 12세,2018,8651,4421,4230,104.5,8606,4404,4202,104.8
31240, 화성시,015004, 13세,2018,7962,4021,3941,102,7928,4007,3921,102.2
31240, 화성시,015005, 14세,2018,8337,4256,4081,104.3,8292,4241,4051,104.7
31240, 화성시,020,15~19세,2018,40011,20504,19507,105.1,39542,20238,19304,104.8
31240, 화성시,020001, 15세,2018,7859,4082,3777,108.1,7823,4062,3761,108
31240, 화성시,020002, 16세,2018,7711,3935,3776,104.2,7672,3916,3756,104.3
31240, 화성시,020003, 17세,2018,8393,4292,4101,104.7,8346,4262,4084,104.4
31240, 화성시,020004, 18세,2018,8602,4436,4166,106.5,8489,4370,4119,106.1
31240, 화성시,020005, 19세,2018,7446,3759,3687,102,7212,3628,3584,101.2
31240, 화성시,025,20~24세,2018,42727,24080,18647,129.1,37374,19963,17411,114.7
31240, 화성시,025001, 20세,2018,7824,4160,3664,113.5,7338,3847,3491,110.2
31240, 화성시,025002, 21세,2018,8272,4645,3627,128.1,7538,4117,3421,120.3
31240, 화성시,025003, 22세,2018,8381,4768,3613,132,7303,3916,3387,115.6
31240, 화성시,025004, 23세,2018,8946,5152,3794,135.8,7533,4037,3496,115.5
31240, 화성시,025005, 24세,2018,9304,5355,3949,135.6,7662,4046,3616,111.9
31240, 화성시,030,25~29세,2018,55444,32739,22705,144.2,44532,24203,20329,119.1
31240, 화성시,030001, 25세,2018,10312,6047,4265,141.8,8428,4567,3861,118.3
31240, 화성시,030002, 26세,2018,10869,6568,4301,152.7,8704,4850,3854,125.8
31240, 화성시,030003, 27세,2018,10927,6538,4389,149,8718,4811,3907,123.1
31240, 화성시,030004, 28세,2018,11392,6744,4648,145.1,8969,4875,4094,119.1
31240, 화성시,030005, 29세,2018,11944,6842,5102,134.1,9713,5100,4613,110.6
31240, 화성시,035,30~34세,2018,67629,37715,29914,126.1,56647,29340,27307,107.4
31240, 화성시,035001, 30세,2018,12527,7076,5451,129.8,10178,5269,4909,107.3
31240, 화성시,035002, 31세,2018,12982,7331,5651,129.7,10637,5565,5072,109.7
31240, 화성시,035003, 32세,2018,13537,7460,6077,122.8,11303,5750,5553,103.5
31240, 화성시,035004, 33세,2018,13896,7740,6156,125.7,11815,6149,5666,108.5
31240, 화성시,035005, 34세,2018,14687,8108,6579,123.2,12714,6607,6107,108.2
31240, 화성시,040,35~39세,2018,88792,47713,41079,116.1,81134,41999,39135,107.3
31240, 화성시,040001, 35세,2018,16492,8810,7682,114.7,14676,7423,7253,102.3
31240, 화성시,040002, 36세,2018,18216,9744,8472,115,16502,8455,8047,105.1
31240, 화성시,040003, 37세,2018,18249,9858,8391,117.5,16762,8757,8005,109.4
31240, 화성시,040004, 38세,2018,18544,10004,8540,117.1,17141,8959,8182,109.5
31240, 화성시,040005, 39세,2018,17291,9297,7994,116.3,16053,8405,7648,109.9
31240, 화성시,045,40~44세,2018,76360,41199,35161,117.2,71780,37977,33803,112.3
31240, 화성시,045001, 40세,2018,15802,8595,7207,119.3,14646,7777,6869,113.2
31240, 화성시,045002, 41세,2018,15823,8532,7291,117,14881,7839,7042,111.3
31240, 화성시,045003, 42세,2018,14842,8059,6783,118.8,13924,7414,6510,113.9
31240, 화성시,045004, 43세,2018,14810,7946,6864,115.8,14009,7405,6604,112.1
31240, 화성시,045005, 44세,2018,15083,8067,7016,115,14320,7542,6778,111.3
31240, 화성시,050,45~49세,2018,68465,37429,31036,120.6,64757,35114,29643,118.5
31240, 화성시,050001, 45세,2018,14649,7917,6732,117.6,13884,7414,6470,114.6
31240, 화성시,050002, 46세,2018,13717,7595,6122,124.1,12968,7119,5849,121.7
31240, 화성시,050003, 47세,2018,14074,7782,6292,123.7,13306,7306,6000,121.8
31240, 화성시,050004, 48세,2018,13261,7265,5996,121.2,12490,6803,5687,119.6
31240, 화성시,050005, 49세,2018,12764,6870,5894,116.6,12109,6472,5637,114.8
31240, 화성시,055,50~54세,2018,52127,28119,24008,117.1,49136,26447,22689,116.6
31240, 화성시,055001, 50세,2018,11998,6387,5611,113.8,11354,6018,5336,112.8
31240, 화성시,055002, 51세,2018,10478,5598,4880,114.7,9930,5293,4637,114.1
31240, 화성시,055003, 52세,2018,10002,5474,4528,120.9,9396,5134,4262,120.5
31240, 화성시,055004, 53세,2018,10419,5713,4706,121.4,9815,5379,4436,121.3
31240, 화성시,055005, 54세,2018,9230,4947,4283,115.5,8641,4623,4018,115.1
31240, 화성시,060,55~59세,2018,46112,24353,21759,111.9,43909,23111,20798,111.1
31240, 화성시,060001, 55세,2018,9455,5088,4367,116.5,8804,4717,4087,115.4
31240, 화성시,060002, 56세,2018,9291,4976,4315,115.3,8781,4688,4093,114.5
31240, 화성시,060003, 57세,2018,9936,5240,4696,111.6,9611,5064,4547,111.4
31240, 화성시,060004, 58세,2018,9249,4829,4420,109.3,8840,4600,4240,108.5
31240, 화성시,060005, 59세,2018,8181,4220,3961,106.5,7873,4042,3831,105.5
31240, 화성시,065,60~64세,2018,32680,16323,16357,99.8,31349,15626,15723,99.4
31240, 화성시,065001, 60세,2018,7523,3835,3688,104,7206,3664,3542,103.4
31240, 화성시,065002, 61세,2018,6843,3364,3479,96.7,6535,3199,3336,95.9
31240, 화성시,065003, 62세,2018,6574,3341,3233,103.3,6307,3200,3107,103
31240, 화성시,065004, 63세,2018,6357,3152,3205,98.3,6125,3025,3100,97.6
31240, 화성시,065005, 64세,2018,5383,2631,2752,95.6,5176,2538,2638,96.2
31240, 화성시,070,65~69세,2018,20986,10285,10701,96.1,20413,9989,10424,95.8
31240, 화성시,070001, 65세,2018,4788,2422,2366,102.4,4623,2331,2292,101.7
31240, 화성시,070002, 66세,2018,5215,2526,2689,93.9,5087,2472,2615,94.5
31240, 화성시,070003, 67세,2018,3334,1647,1687,97.6,3227,1584,1643,96.4
31240, 화성시,070004, 68세,2018,3826,1832,1994,91.9,3740,1789,1951,91.7
31240, 화성시,070005, 69세,2018,3823,1858,1965,94.6,3736,1813,1923,94.3
31240, 화성시,075,70~74세,2018,15353,7357,7996,92,15169,7277,7892,92.2
31240, 화성시,075001, 70세,2018,3631,1785,1846,96.7,3576,1757,1819,96.6
31240, 화성시,075002, 71세,2018,3621,1749,1872,93.4,3571,1726,1845,93.6
31240, 화성시,075003, 72세,2018,2865,1404,1461,96.1,2843,1395,1448,96.3
31240, 화성시,075004, 73세,2018,2655,1279,1376,93,2626,1266,1360,93.1
31240, 화성시,075005, 74세,2018,2581,1140,1441,79.1,2553,1133,1420,79.8
31240, 화성시,080,75~79세,2018,12045,5038,7007,71.9,11956,5010,6946,72.1
31240, 화성시,080001, 75세,2018,2535,1080,1455,74.2,2513,1075,1438,74.8
31240, 화성시,080002, 76세,2018,2843,1225,1618,75.7,2824,1218,1606,75.8
31240, 화성시,080003, 77세,2018,2443,1042,1401,74.4,2424,1033,1391,74.3
31240, 화성시,080004, 78세,2018,2109,855,1254,68.2,2093,851,1242,68.5
31240, 화성시,080005, 79세,2018,2115,836,1279,65.4,2102,833,1269,65.6
31240, 화성시,085,80~84세,2018,8155,3022,5133,58.9,8087,3005,5082,59.1
31240, 화성시,085001, 80세,2018,1972,785,1187,66.1,1952,782,1170,66.8
31240, 화성시,085002, 81세,2018,1839,712,1127,63.2,1825,708,1117,63.4
31240, 화성시,085003, 82세,2018,1637,621,1016,61.1,1619,618,1001,61.7
31240, 화성시,085004, 83세,2018,1452,470,982,47.9,1441,464,977,47.5
31240, 화성시,085005, 84세,2018,1255,434,821,52.9,1250,433,817,53
31240, 화성시,090,85~89세,2018,3799,1035,2764,37.4,3779,1033,2746,37.6
31240, 화성시,090001, 85세,2018,1092,338,754,44.8,1087,337,750,44.9
31240, 화성시,090002, 86세,2018,938,259,679,38.1,934,259,675,38.4
31240, 화성시,090003, 87세,2018,664,173,491,35.2,658,173,485,35.7
31240, 화성시,090004, 88세,2018,622,148,474,31.2,619,147,472,31.1
31240, 화성시,090005, 89세,2018,483,117,366,32,481,117,364,32.1
31240, 화성시,095,90~94세,2018,1239,268,971,27.6,1236,267,969,27.6
31240, 화성시,095001, 90세,2018,413,85,328,25.9,410,84,326,25.8
31240, 화성시,095002, 91세,2018,306,64,242,26.4,306,64,242,26.4
31240, 화성시,095003, 92세,2018,207,58,149,38.9,207,58,149,38.9
31240, 화성시,095004, 93세,2018,191,34,157,21.7,191,34,157,21.7
31240, 화성시,095005, 94세,2018,122,27,95,28.4,122,27,95,28.4
31240, 화성시,100,95~99세,2018,308,51,257,19.8,307,50,257,19.5
31240, 화성시,100001, 95세,2018,119,25,94,26.6,118,24,94,25.5
31240, 화성시,100002, 96세,2018,71,14,57,24.6,71,14,57,24.6
31240, 화성시,100003, 97세,2018,60,8,52,15.4,60,8,52,15.4
31240, 화성시,100004, 98세,2018,35,X,34,2.9,35,X,34,2.9
31240, 화성시,100005, 99세,2018,23,X,20,15,23,X,20,15
31240, 화성시,101,100세이상,2018,30,5,25,20,30,5,25,20
31240, 화성시,102,15세미만,2018,145033,74020,71013,104.2,143636,73341,70295,104.3
31240, 화성시,103,15~64세,2018,570347,310174,260173,119.2,520160,274018,246142,111.3
31240, 화성시,104,65세이상,2018,61915,27061,34854,77.6,60977,26636,34341,77.6
31240, 화성시,086,85세이상,2018,5376,1359,4017,33.8,5352,1355,3997,33.9
31240, 화성시,126,평균연령,2018,36.4,35.9,37,,36.5,36,37,
31240, 화성시,127,중위연령,2018,37.2,36.8,37.6,,37.6,37.5,37.7,
31250, 광주시,000,합계,2018,364178,188618,175560,107.4,346616,176796,169820,104.1
31250, 광주시,005,0~4세,2018,18424,9451,8973,105.3,18242,9358,8884,105.3
31250, 광주시,005001, 0세,2018,3141,1585,1556,101.9,3111,1573,1538,102.3
31250, 광주시,005002, 1세,2018,3456,1726,1730,99.8,3415,1701,1714,99.2
31250, 광주시,005003, 2세,2018,3957,2032,1925,105.6,3916,2012,1904,105.7
31250, 광주시,005004, 3세,2018,3993,2079,1914,108.6,3956,2062,1894,108.9
31250, 광주시,005005, 4세,2018,3877,2029,1848,109.8,3844,2010,1834,109.6
31250, 광주시,010,5~9세,2018,17736,9087,8649,105.1,17589,9013,8576,105.1
31250, 광주시,010001, 5세,2018,3638,1841,1797,102.4,3602,1823,1779,102.5
31250, 광주시,010002, 6세,2018,3909,2035,1874,108.6,3869,2011,1858,108.2
31250, 광주시,010003, 7세,2018,3737,1924,1813,106.1,3704,1910,1794,106.5
31250, 광주시,010004, 8세,2018,3347,1708,1639,104.2,3324,1697,1627,104.3
31250, 광주시,010005, 9세,2018,3105,1579,1526,103.5,3090,1572,1518,103.6
31250, 광주시,015,10~14세,2018,15494,7856,7638,102.9,15408,7806,7602,102.7
31250, 광주시,015001, 10세,2018,3292,1661,1631,101.8,3271,1648,1623,101.5
31250, 광주시,015002, 11세,2018,3275,1641,1634,100.4,3253,1625,1628,99.8
31250, 광주시,015003, 12세,2018,3028,1539,1489,103.4,3018,1538,1480,103.9
31250, 광주시,015004, 13세,2018,2836,1432,1404,102,2818,1420,1398,101.6
31250, 광주시,015005, 14세,2018,3063,1583,1480,107,3048,1575,1473,106.9
31250, 광주시,020,15~19세,2018,17163,8890,8273,107.5,16953,8771,8182,107.2
31250, 광주시,020001, 15세,2018,2951,1468,1483,99,2941,1463,1478,99
31250, 광주시,020002, 16세,2018,3213,1634,1579,103.5,3200,1626,1574,103.3
31250, 광주시,020003, 17세,2018,3317,1715,1602,107.1,3301,1706,1595,107
31250, 광주시,020004, 18세,2018,3768,1933,1835,105.3,3731,1913,1818,105.2
31250, 광주시,020005, 19세,2018,3914,2140,1774,120.6,3780,2063,1717,120.2
31250, 광주시,025,20~24세,2018,21375,11859,9516,124.6,19239,10321,8918,115.7
31250, 광주시,025001, 20세,2018,4059,2207,1852,119.2,3816,2058,1758,117.1
31250, 광주시,025002, 21세,2018,4144,2320,1824,127.2,3793,2080,1713,121.4
31250, 광주시,025003, 22세,2018,4232,2395,1837,130.4,3783,2074,1709,121.4
31250, 광주시,025004, 23세,2018,4377,2414,1963,123,3866,2029,1837,110.5
31250, 광주시,025005, 24세,2018,4563,2523,2040,123.7,3981,2080,1901,109.4
31250, 광주시,030,25~29세,2018,24162,13359,10803,123.7,20725,10775,9950,108.3
31250, 광주시,030001, 25세,2018,4629,2589,2040,126.9,3963,2065,1898,108.8
31250, 광주시,030002, 26세,2018,5124,2807,2317,121.1,4436,2282,2154,105.9
31250, 광주시,030003, 27세,2018,4785,2648,2137,123.9,4130,2161,1969,109.8
31250, 광주시,030004, 28세,2018,4782,2646,2136,123.9,4034,2100,1934,108.6
31250, 광주시,030005, 29세,2018,4842,2669,2173,122.8,4162,2167,1995,108.6
31250, 광주시,035,30~34세,2018,27459,14889,12570,118.4,24166,12470,11696,106.6
31250, 광주시,035001, 30세,2018,4865,2629,2236,117.6,4145,2116,2029,104.3
31250, 광주시,035002, 31세,2018,5191,2819,2372,118.8,4497,2289,2208,103.7
31250, 광주시,035003, 32세,2018,5389,2928,2461,119,4759,2474,2285,108.3
31250, 광주시,035004, 33세,2018,5862,3192,2670,119.6,5216,2723,2493,109.2
31250, 광주시,035005, 34세,2018,6152,3321,2831,117.3,5549,2868,2681,107
31250, 광주시,040,35~39세,2018,36536,19716,16820,117.2,34003,17909,16094,111.3
31250, 광주시,040001, 35세,2018,7037,3855,3182,121.2,6441,3406,3035,112.2
31250, 광주시,040002, 36세,2018,7568,4045,3523,114.8,7000,3640,3360,108.3
31250, 광주시,040003, 37세,2018,7494,4094,3400,120.4,6982,3733,3249,114.9
31250, 광주시,040004, 38세,2018,7716,4103,3613,113.6,7278,3804,3474,109.5
31250, 광주시,040005, 39세,2018,6721,3619,3102,116.7,6302,3326,2976,111.8
31250, 광주시,045,40~44세,2018,30284,16326,13958,117,28826,15339,13487,113.7
31250, 광주시,045001, 40세,2018,6023,3190,2833,112.6,5666,2948,2718,108.5
31250, 광주시,045002, 41세,2018,6008,3308,2700,122.5,5704,3095,2609,118.6
31250, 광주시,045003, 42세,2018,5953,3237,2716,119.2,5672,3040,2632,115.5
31250, 광주시,045004, 43세,2018,6039,3244,2795,116.1,5775,3068,2707,113.3
31250, 광주시,045005, 44세,2018,6261,3347,2914,114.9,6009,3188,2821,113
31250, 광주시,050,45~49세,2018,31794,16789,15005,111.9,30553,16061,14492,110.8
31250, 광주시,050001, 45세,2018,6235,3276,2959,110.7,5975,3125,2850,109.6
31250, 광주시,050002, 46세,2018,6347,3442,2905,118.5,6095,3293,2802,117.5
31250, 광주시,050003, 47세,2018,6590,3445,3145,109.5,6347,3300,3047,108.3
31250, 광주시,050004, 48세,2018,6269,3325,2944,112.9,6008,3172,2836,111.8
31250, 광주시,050005, 49세,2018,6353,3301,3052,108.2,6128,3171,2957,107.2
31250, 광주시,055,50~54세,2018,28685,14533,14152,102.7,27684,14016,13668,102.5
31250, 광주시,055001, 50세,2018,6275,3203,3072,104.3,6077,3097,2980,103.9
31250, 광주시,055002, 51세,2018,5615,2761,2854,96.7,5430,2664,2766,96.3
31250, 광주시,055003, 52세,2018,5541,2848,2693,105.8,5351,2748,2603,105.6
31250, 광주시,055004, 53세,2018,5842,2979,2863,104.1,5614,2864,2750,104.1
31250, 광주시,055005, 54세,2018,5412,2742,2670,102.7,5212,2643,2569,102.9
31250, 광주시,060,55~59세,2018,29379,14655,14724,99.5,28598,14255,14343,99.4
31250, 광주시,060001, 55세,2018,5579,2851,2728,104.5,5362,2738,2624,104.3
31250, 광주시,060002, 56세,2018,5984,3042,2942,103.4,5809,2954,2855,103.5
31250, 광주시,060003, 57세,2018,6088,2974,3114,95.5,5984,2930,3054,95.9
31250, 광주시,060004, 58세,2018,6131,3031,3100,97.8,5980,2948,3032,97.2
31250, 광주시,060005, 59세,2018,5597,2757,2840,97.1,5463,2685,2778,96.7
31250, 광주시,065,60~64세,2018,23900,12008,11892,101,23324,11719,11605,101
31250, 광주시,065001, 60세,2018,5450,2748,2702,101.7,5293,2672,2621,101.9
31250, 광주시,065002, 61세,2018,5155,2606,2549,102.2,5029,2538,2491,101.9
31250, 광주시,065003, 62세,2018,4600,2305,2295,100.4,4502,2261,2241,100.9
31250, 광주시,065004, 63세,2018,4745,2359,2386,98.9,4638,2302,2336,98.5
31250, 광주시,065005, 64세,2018,3950,1990,1960,101.5,3862,1946,1916,101.6
31250, 광주시,070,65~69세,2018,15112,7524,7588,99.2,14815,7375,7440,99.1
31250, 광주시,070001, 65세,2018,3426,1709,1717,99.5,3344,1671,1673,99.9
31250, 광주시,070002, 66세,2018,3711,1888,1823,103.6,3630,1850,1780,103.9
31250, 광주시,070003, 67세,2018,2539,1251,1288,97.1,2491,1229,1262,97.4
31250, 광주시,070004, 68세,2018,2702,1325,1377,96.2,2650,1294,1356,95.4
31250, 광주시,070005, 69세,2018,2734,1351,1383,97.7,2700,1331,1369,97.2
31250, 광주시,075,70~74세,2018,10841,5360,5481,97.8,10740,5319,5421,98.1
31250, 광주시,075001, 70세,2018,2590,1304,1286,101.4,2564,1294,1270,101.9
31250, 광주시,075002, 71세,2018,2632,1313,1319,99.5,2602,1298,1304,99.5
31250, 광주시,075003, 72세,2018,1972,943,1029,91.6,1948,934,1014,92.1
31250, 광주시,075004, 73세,2018,1847,928,919,101,1838,923,915,100.9
31250, 광주시,075005, 74세,2018,1800,872,928,94,1788,870,918,94.8
31250, 광주시,080,75~79세,2018,8042,3670,4372,83.9,7996,3651,4345,84
31250, 광주시,080001, 75세,2018,1749,846,903,93.7,1735,839,896,93.6
31250, 광주시,080002, 76세,2018,1991,937,1054,88.9,1981,933,1048,89
31250, 광주시,080003, 77세,2018,1605,727,878,82.8,1600,725,875,82.9
31250, 광주시,080004, 78세,2018,1413,604,809,74.7,1403,600,803,74.7
31250, 광주시,080005, 79세,2018,1284,556,728,76.4,1277,554,723,76.6
31250, 광주시,085,80~84세,2018,4656,1834,2822,65,4633,1830,2803,65.3
31250, 광주시,085001, 80세,2018,1161,480,681,70.5,1153,479,674,71.1
31250, 광주시,085002, 81세,2018,1019,425,594,71.5,1014,424,590,71.9
31250, 광주시,085003, 82세,2018,903,376,527,71.3,901,376,525,71.6
31250, 광주시,085004, 83세,2018,894,306,588,52,892,306,586,52.2
31250, 광주시,085005, 84세,2018,679,247,432,57.2,673,245,428,57.2
31250, 광주시,090,85~89세,2018,2132,628,1504,41.8,2121,624,1497,41.7
31250, 광주시,090001, 85세,2018,596,197,399,49.4,594,196,398,49.2
31250, 광주시,090002, 86세,2018,485,147,338,43.5,482,146,336,43.5
31250, 광주시,090003, 87세,2018,355,99,256,38.7,354,99,255,38.8
31250, 광주시,090004, 88세,2018,379,100,279,35.8,377,99,278,35.6
31250, 광주시,090005, 89세,2018,317,85,232,36.6,314,84,230,36.5
31250, 광주시,095,90~94세,2018,772,142,630,22.5,769,142,627,22.6
31250, 광주시,095001, 90세,2018,244,49,195,25.1,244,49,195,25.1
31250, 광주시,095002, 91세,2018,199,32,167,19.2,197,32,165,19.4
31250, 광주시,095003, 92세,2018,143,28,115,24.3,142,28,114,24.6
31250, 광주시,095004, 93세,2018,100,16,84,19,100,16,84,19
31250, 광주시,095005, 94세,2018,86,17,69,24.6,86,17,69,24.6
31250, 광주시,100,95~99세,2018,206,40,166,24.1,206,40,166,24.1
31250, 광주시,100001, 95세,2018,77,18,59,30.5,77,18,59,30.5
31250, 광주시,100002, 96세,2018,66,6,60,10,66,6,60,10
31250, 광주시,100003, 97세,2018,26,11,15,73.3,26,11,15,73.3
31250, 광주시,100004, 98세,2018,23,X,19,21.1,23,X,19,21.1
31250, 광주시,100005, 99세,2018,14,X,13,7.7,14,X,13,7.7
31250, 광주시,101,100세이상,2018,26,X,24,8.3,26,X,24,8.3
31250, 광주시,102,15세미만,2018,51654,26394,25260,104.5,51239,26177,25062,104.4
31250, 광주시,103,15~64세,2018,270737,143024,127713,112,254071,131636,122435,107.5
31250, 광주시,104,65세이상,2018,41787,19200,22587,85,41306,18983,22323,85
31250, 광주시,086,85세이상,2018,3136,812,2324,34.9,3122,808,2314,34.9
31250, 광주시,126,평균연령,2018,40.2,39.5,41,,40.4,39.8,41.1,
31250, 광주시,127,중위연령,2018,40.6,39.8,41.6,,41.2,40.7,41.9,
31260, 양주시,000,합계,2018,217776,111825,105951,105.5,207662,104514,103148,101.3
31260, 양주시,005,0~4세,2018,8697,4506,4191,107.5,8623,4463,4160,107.3
31260, 양주시,005001, 0세,2018,1348,687,661,103.9,1333,678,655,103.5
31260, 양주시,005002, 1세,2018,1621,846,775,109.2,1600,838,762,110
31260, 양주시,005003, 2세,2018,1803,942,861,109.4,1792,935,857,109.1
31260, 양주시,005004, 3세,2018,1968,1039,929,111.8,1957,1031,926,111.3
31260, 양주시,005005, 4세,2018,1957,992,965,102.8,1941,981,960,102.2
31260, 양주시,010,5~9세,2018,10923,5516,5407,102,10873,5484,5389,101.8
31260, 양주시,010001, 5세,2018,2023,1025,998,102.7,2017,1021,996,102.5
31260, 양주시,010002, 6세,2018,2341,1187,1154,102.9,2333,1182,1151,102.7
31260, 양주시,010003, 7세,2018,2245,1117,1128,99,2232,1109,1123,98.8
31260, 양주시,010004, 8세,2018,2155,1074,1081,99.4,2138,1062,1076,98.7
31260, 양주시,010005, 9세,2018,2159,1113,1046,106.4,2153,1110,1043,106.4
31260, 양주시,015,10~14세,2018,11131,5772,5359,107.7,11097,5752,5345,107.6
31260, 양주시,015001, 10세,2018,2258,1172,1086,107.9,2248,1164,1084,107.4
31260, 양주시,015002, 11세,2018,2335,1192,1143,104.3,2324,1186,1138,104.2
31260, 양주시,015003, 12세,2018,2147,1099,1048,104.9,2140,1095,1045,104.8
31260, 양주시,015004, 13세,2018,2107,1126,981,114.8,2104,1125,979,114.9
31260, 양주시,015005, 14세,2018,2284,1183,1101,107.4,2281,1182,1099,107.6
31260, 양주시,020,15~19세,2018,12021,6114,5907,103.5,11936,6059,5877,103.1
31260, 양주시,020001, 15세,2018,2254,1095,1159,94.5,2246,1090,1156,94.3
31260, 양주시,020002, 16세,2018,2305,1205,1100,109.5,2298,1201,1097,109.5
31260, 양주시,020003, 17세,2018,2449,1246,1203,103.6,2443,1243,1200,103.6
31260, 양주시,020004, 18세,2018,2528,1289,1239,104,2501,1270,1231,103.2
31260, 양주시,020005, 19세,2018,2485,1279,1206,106.1,2448,1255,1193,105.2
31260, 양주시,025,20~24세,2018,12975,7085,5890,120.3,11875,6232,5643,110.4
31260, 양주시,025001, 20세,2018,2463,1292,1171,110.3,2370,1223,1147,106.6
31260, 양주시,025002, 21세,2018,2616,1400,1216,115.1,2462,1285,1177,109.2
31260, 양주시,025003, 22세,2018,2540,1442,1098,131.3,2304,1258,1046,120.3
31260, 양주시,025004, 23세,2018,2649,1445,1204,120,2363,1227,1136,108
31260, 양주시,025005, 24세,2018,2707,1506,1201,125.4,2376,1239,1137,109
31260, 양주시,030,25~29세,2018,13412,7760,5652,137.3,11160,5973,5187,115.2
31260, 양주시,030001, 25세,2018,2714,1545,1169,132.2,2350,1256,1094,114.8
31260, 양주시,030002, 26세,2018,2854,1636,1218,134.3,2394,1261,1133,111.3
31260, 양주시,030003, 27세,2018,2764,1594,1170,136.2,2306,1236,1070,115.5
31260, 양주시,030004, 28세,2018,2670,1587,1083,146.5,2174,1190,984,120.9
31260, 양주시,030005, 29세,2018,2410,1398,1012,138.1,1936,1030,906,113.7
31260, 양주시,035,30~34세,2018,12846,7194,5652,127.3,10798,5586,5212,107.2
31260, 양주시,035001, 30세,2018,2488,1439,1049,137.2,2016,1072,944,113.6
31260, 양주시,035002, 31세,2018,2497,1456,1041,139.9,2049,1080,969,111.5
31260, 양주시,035003, 32세,2018,2579,1438,1141,126,2197,1150,1047,109.8
31260, 양주시,035004, 33세,2018,2504,1358,1146,118.5,2125,1074,1051,102.2
31260, 양주시,035005, 34세,2018,2778,1503,1275,117.9,2411,1210,1201,100.7
31260, 양주시,040,35~39세,2018,16928,8893,8035,110.7,15493,7838,7655,102.4
31260, 양주시,040001, 35세,2018,3051,1682,1369,122.9,2716,1440,1276,112.9
31260, 양주시,040002, 36세,2018,3334,1748,1586,110.2,3035,1529,1506,101.5
31260, 양주시,040003, 37세,2018,3419,1758,1661,105.8,3171,1582,1589,99.6
31260, 양주시,040004, 38세,2018,3729,1956,1773,110.3,3438,1733,1705,101.6
31260, 양주시,040005, 39세,2018,3395,1749,1646,106.3,3133,1554,1579,98.4
31260, 양주시,045,40~44세,2018,17940,9224,8716,105.8,17009,8594,8415,102.1
31260, 양주시,045001, 40세,2018,3311,1720,1591,108.1,3088,1560,1528,102.1
31260, 양주시,045002, 41세,2018,3368,1697,1671,101.6,3170,1571,1599,98.2
31260, 양주시,045003, 42세,2018,3509,1800,1709,105.3,3328,1676,1652,101.5
31260, 양주시,045004, 43세,2018,3739,1946,1793,108.5,3570,1831,1739,105.3
31260, 양주시,045005, 44세,2018,4013,2061,1952,105.6,3853,1956,1897,103.1
31260, 양주시,050,45~49세,2018,20373,10628,9745,109.1,19616,10154,9462,107.3
31260, 양주시,050001, 45세,2018,4235,2205,2030,108.6,4081,2115,1966,107.6
31260, 양주시,050002, 46세,2018,4080,2180,1900,114.7,3910,2071,1839,112.6
31260, 양주시,050003, 47세,2018,4131,2186,1945,112.4,3999,2096,1903,110.1
31260, 양주시,050004, 48세,2018,3934,2031,1903,106.7,3792,1941,1851,104.9
31260, 양주시,050005, 49세,2018,3993,2026,1967,103,3834,1931,1903,101.5
31260, 양주시,055,50~54세,2018,17583,9317,8266,112.7,17061,8981,8080,111.2
31260, 양주시,055001, 50세,2018,3840,2009,1831,109.7,3712,1926,1786,107.8
31260, 양주시,055002, 51세,2018,3495,1865,1630,114.4,3372,1780,1592,111.8
31260, 양주시,055003, 52세,2018,3482,1824,1658,110,3388,1766,1622,108.9
31260, 양주시,055004, 53세,2018,3534,1882,1652,113.9,3438,1818,1620,112.2
31260, 양주시,055005, 54세,2018,3232,1737,1495,116.2,3151,1691,1460,115.8
31260, 양주시,060,55~59세,2018,17395,8971,8424,106.5,17064,8793,8271,106.3
31260, 양주시,060001, 55세,2018,3420,1779,1641,108.4,3329,1732,1597,108.5
31260, 양주시,060002, 56세,2018,3452,1836,1616,113.6,3398,1805,1593,113.3
31260, 양주시,060003, 57세,2018,3573,1812,1761,102.9,3522,1784,1738,102.6
31260, 양주시,060004, 58세,2018,3674,1859,1815,102.4,3599,1818,1781,102.1
31260, 양주시,060005, 59세,2018,3276,1685,1591,105.9,3216,1654,1562,105.9
31260, 양주시,065,60~64세,2018,14409,7228,7181,100.7,14149,7101,7048,100.8
31260, 양주시,065001, 60세,2018,3163,1623,1540,105.4,3098,1582,1516,104.4
31260, 양주시,065002, 61세,2018,3132,1572,1560,100.8,3080,1547,1533,100.9
31260, 양주시,065003, 62세,2018,2851,1447,1404,103.1,2796,1425,1371,103.9
31260, 양주시,065004, 63세,2018,2841,1371,1470,93.3,2796,1350,1446,93.4
31260, 양주시,065005, 64세,2018,2422,1215,1207,100.7,2379,1197,1182,101.3
31260, 양주시,070,65~69세,2018,9233,4414,4819,91.6,9106,4344,4762,91.2
31260, 양주시,070001, 65세,2018,2031,974,1057,92.1,2003,960,1043,92
31260, 양주시,070002, 66세,2018,2169,1044,1125,92.8,2141,1027,1114,92.2
31260, 양주시,070003, 67세,2018,1509,737,772,95.5,1479,719,760,94.6
31260, 양주시,070004, 68세,2018,1710,805,905,89,1692,797,895,89.1
31260, 양주시,070005, 69세,2018,1814,854,960,89,1791,841,950,88.5
31260, 양주시,075,70~74세,2018,8110,3876,4234,91.5,8056,3853,4203,91.7
31260, 양주시,075001, 70세,2018,1806,878,928,94.6,1793,873,920,94.9
31260, 양주시,075002, 71세,2018,1904,926,978,94.7,1889,918,971,94.5
31260, 양주시,075003, 72세,2018,1468,702,766,91.6,1458,698,760,91.8
31260, 양주시,075004, 73세,2018,1499,720,779,92.4,1489,716,773,92.6
31260, 양주시,075005, 74세,2018,1433,650,783,83,1427,648,779,83.2
31260, 양주시,080,75~79세,2018,6578,2886,3692,78.2,6551,2875,3676,78.2
31260, 양주시,080001, 75세,2018,1425,656,769,85.3,1418,654,764,85.6
31260, 양주시,080002, 76세,2018,1624,717,907,79.1,1619,715,904,79.1
31260, 양주시,080003, 77세,2018,1324,562,762,73.8,1320,560,760,73.7
31260, 양주시,080004, 78세,2018,1123,505,618,81.7,1118,503,615,81.8
31260, 양주시,080005, 79세,2018,1082,446,636,70.1,1076,443,633,70
31260, 양주시,085,80~84세,2018,4269,1675,2594,64.6,4247,1668,2579,64.7
31260, 양주시,085001, 80세,2018,1063,435,628,69.3,1056,432,624,69.2
31260, 양주시,085002, 81세,2018,972,405,567,71.4,965,403,562,71.7
31260, 양주시,085003, 82세,2018,807,319,488,65.4,805,318,487,65.3
31260, 양주시,085004, 83세,2018,802,302,500,60.4,798,301,497,60.6
31260, 양주시,085005, 84세,2018,625,214,411,52.1,623,214,409,52.3
31260, 양주시,090,85~89세,2018,1997,565,1432,39.5,1992,563,1429,39.4
31260, 양주시,090001, 85세,2018,554,172,382,45,551,171,380,45
31260, 양주시,090002, 86세,2018,471,159,312,51,470,158,312,50.6
31260, 양주시,090003, 87세,2018,361,91,270,33.7,361,91,270,33.7
31260, 양주시,090004, 88세,2018,319,71,248,28.6,319,71,248,28.6
31260, 양주시,090005, 89세,2018,292,72,220,32.7,291,72,219,32.9
31260, 양주시,095,90~94세,2018,740,163,577,28.2,740,163,577,28.2
31260, 양주시,095001, 90세,2018,242,58,184,31.5,242,58,184,31.5
31260, 양주시,095002, 91세,2018,165,39,126,31,165,39,126,31
31260, 양주시,095003, 92세,2018,132,21,111,18.9,132,21,111,18.9
31260, 양주시,095004, 93세,2018,104,23,81,28.4,104,23,81,28.4
31260, 양주시,095005, 94세,2018,97,22,75,29.3,97,22,75,29.3
31260, 양주시,100,95~99세,2018,194,37,157,23.6,194,37,157,23.6
31260, 양주시,100001, 95세,2018,76,15,61,24.6,76,15,61,24.6
31260, 양주시,100002, 96세,2018,46,8,38,21.1,46,8,38,21.1
31260, 양주시,100003, 97세,2018,34,7,27,25.9,34,7,27,25.9
31260, 양주시,100004, 98세,2018,22,X,18,22.2,22,X,18,22.2
31260, 양주시,100005, 99세,2018,16,X,13,23.1,16,X,13,23.1
31260, 양주시,101,100세이상,2018,22,X,21,4.8,22,X,21,4.8
31260, 양주시,102,15세미만,2018,30751,15794,14957,105.6,30593,15699,14894,105.4
31260, 양주시,103,15~64세,2018,155882,82414,73468,112.2,146161,75311,70850,106.3
31260, 양주시,104,65세이상,2018,31143,13617,17526,77.7,30908,13504,17404,77.6
31260, 양주시,086,85세이상,2018,2953,766,2187,35,2948,764,2184,35
31260, 양주시,126,평균연령,2018,41.6,40.5,42.7,,41.8,40.9,42.8,
31260, 양주시,127,중위연령,2018,42.9,41.8,44.1,,43.7,43,44.3,
31270, 포천시,000,합계,2018,161564,87854,73710,119.2,144058,74798,69260,108
31270, 포천시,005,0~4세,2018,4713,2445,2268,107.8,4633,2410,2223,108.4
31270, 포천시,005001, 0세,2018,824,413,411,100.5,805,402,403,99.8
31270, 포천시,005002, 1세,2018,874,462,412,112.1,863,458,405,113.1
31270, 포천시,005003, 2세,2018,973,521,452,115.3,951,513,438,117.1
31270, 포천시,005004, 3세,2018,1048,538,510,105.5,1031,533,498,107
31270, 포천시,005005, 4세,2018,994,511,483,105.8,983,504,479,105.2
31270, 포천시,010,5~9세,2018,5562,2843,2719,104.6,5495,2810,2685,104.7
31270, 포천시,010001, 5세,2018,1029,520,509,102.2,1012,511,501,102
31270, 포천시,010002, 6세,2018,1163,571,592,96.5,1152,566,586,96.6
31270, 포천시,010003, 7세,2018,1120,620,500,124,1101,609,492,123.8
31270, 포천시,010004, 8세,2018,1134,575,559,102.9,1124,571,553,103.3
31270, 포천시,010005, 9세,2018,1116,557,559,99.6,1106,553,553,100
31270, 포천시,015,10~14세,2018,5862,3095,2767,111.9,5829,3083,2746,112.3
31270, 포천시,015001, 10세,2018,1176,615,561,109.6,1168,612,556,110.1
31270, 포천시,015002, 11세,2018,1230,672,558,120.4,1221,669,552,121.2
31270, 포천시,015003, 12세,2018,1181,602,579,104,1175,600,575,104.3
31270, 포천시,015004, 13세,2018,1120,601,519,115.8,1115,599,516,116.1
31270, 포천시,015005, 14세,2018,1155,605,550,110,1150,603,547,110.2
31270, 포천시,020,15~19세,2018,8128,4203,3925,107.1,7938,4067,3871,105.1
31270, 포천시,020001, 15세,2018,1390,696,694,100.3,1379,691,688,100.4
31270, 포천시,020002, 16세,2018,1391,746,645,115.7,1376,735,641,114.7
31270, 포천시,020003, 17세,2018,1567,840,727,115.5,1553,830,723,114.8
31270, 포천시,020004, 18세,2018,1783,894,889,100.6,1735,859,876,98.1
31270, 포천시,020005, 19세,2018,1997,1027,970,105.9,1895,952,943,101
31270, 포천시,025,20~24세,2018,12316,7215,5101,141.4,9867,5333,4534,117.6
31270, 포천시,025001, 20세,2018,2261,1239,1022,121.2,2055,1099,956,115
31270, 포천시,025002, 21세,2018,2420,1290,1130,114.2,2040,1017,1023,99.4
31270, 포천시,025003, 22세,2018,2441,1461,980,149.1,1901,1046,855,122.3
31270, 포천시,025004, 23세,2018,2593,1588,1005,158,1966,1084,882,122.9
31270, 포천시,025005, 24세,2018,2601,1637,964,169.8,1905,1087,818,132.9
31270, 포천시,030,25~29세,2018,12807,8306,4501,184.5,8532,4867,3665,132.8
31270, 포천시,030001, 25세,2018,2664,1723,941,183.1,1850,1080,770,140.3
31270, 포천시,030002, 26세,2018,2638,1709,929,184,1814,1050,764,137.4
31270, 포천시,030003, 27세,2018,2595,1731,864,200.3,1709,1005,704,142.8
31270, 포천시,030004, 28세,2018,2574,1625,949,171.2,1667,902,765,117.9
31270, 포천시,030005, 29세,2018,2336,1518,818,185.6,1492,830,662,125.4
31270, 포천시,035,30~34세,2018,10686,6804,3882,175.3,7017,3906,3111,125.6
31270, 포천시,035001, 30세,2018,2300,1468,832,176.4,1479,820,659,124.4
31270, 포천시,035002, 31세,2018,2209,1444,765,188.8,1388,790,598,132.1
31270, 포천시,035003, 32세,2018,2151,1383,768,180.1,1389,784,605,129.6
31270, 포천시,035004, 33세,2018,2030,1274,756,168.5,1365,736,629,117
31270, 포천시,035005, 34세,2018,1996,1235,761,162.3,1396,776,620,125.2
31270, 포천시,040,35~39세,2018,10616,6262,4354,143.8,8248,4457,3791,117.6
31270, 포천시,040001, 35세,2018,2120,1286,834,154.2,1550,849,701,121.1
31270, 포천시,040002, 36세,2018,2152,1290,862,149.7,1623,888,735,120.8
31270, 포천시,040003, 37세,2018,2108,1236,872,141.7,1671,907,764,118.7
31270, 포천시,040004, 38세,2018,2161,1261,900,140.1,1746,940,806,116.6
31270, 포천시,040005, 39세,2018,2075,1189,886,134.2,1658,873,785,111.2
31270, 포천시,045,40~44세,2018,10689,5907,4782,123.5,9218,4860,4358,111.5
31270, 포천시,045001, 40세,2018,1999,1104,895,123.4,1669,856,813,105.3
31270, 포천시,045002, 41세,2018,2083,1170,913,128.1,1759,942,817,115.3
31270, 포천시,045003, 42세,2018,2050,1141,909,125.5,1746,920,826,111.4
31270, 포천시,045004, 43세,2018,2180,1164,1016,114.6,1917,986,931,105.9
31270, 포천시,045005, 44세,2018,2377,1328,1049,126.6,2127,1156,971,119.1
31270, 포천시,050,45~49세,2018,13098,7141,5957,119.9,12058,6463,5595,115.5
31270, 포천시,050001, 45세,2018,2452,1315,1137,115.7,2237,1173,1064,110.2
31270, 포천시,050002, 46세,2018,2601,1437,1164,123.5,2334,1258,1076,116.9
31270, 포천시,050003, 47세,2018,2772,1548,1224,126.5,2568,1408,1160,121.4
31270, 포천시,050004, 48세,2018,2568,1387,1181,117.4,2368,1265,1103,114.7
31270, 포천시,050005, 49세,2018,2705,1454,1251,116.2,2551,1359,1192,114
31270, 포천시,055,50~54세,2018,14195,7772,6423,121,13402,7291,6111,119.3
31270, 포천시,055001, 50세,2018,2948,1580,1368,115.5,2756,1465,1291,113.5
31270, 포천시,055002, 51세,2018,2677,1424,1253,113.6,2522,1339,1183,113.2
31270, 포천시,055003, 52세,2018,2844,1588,1256,126.4,2697,1495,1202,124.4
31270, 포천시,055004, 53세,2018,2968,1658,1310,126.6,2818,1568,1250,125.4
31270, 포천시,055005, 54세,2018,2758,1522,1236,123.1,2609,1424,1185,120.2
31270, 포천시,060,55~59세,2018,15134,8141,6993,116.4,14588,7823,6765,115.6
31270, 포천시,060001, 55세,2018,2949,1640,1309,125.3,2795,1556,1239,125.6
31270, 포천시,060002, 56세,2018,2913,1569,1344,116.7,2798,1503,1295,116.1
31270, 포천시,060003, 57세,2018,3127,1663,1464,113.6,3043,1613,1430,112.8
31270, 포천시,060004, 58세,2018,3227,1755,1472,119.2,3115,1684,1431,117.7
31270, 포천시,060005, 59세,2018,2918,1514,1404,107.8,2837,1467,1370,107.1
31270, 포천시,065,60~64세,2018,12374,6658,5716,116.5,12078,6485,5593,115.9
31270, 포천시,065001, 60세,2018,2929,1581,1348,117.3,2847,1529,1318,116
31270, 포천시,065002, 61세,2018,2681,1443,1238,116.6,2607,1401,1206,116.2
31270, 포천시,065003, 62세,2018,2460,1343,1117,120.2,2412,1313,1099,119.5
31270, 포천시,065004, 63세,2018,2308,1265,1043,121.3,2267,1242,1025,121.2
31270, 포천시,065005, 64세,2018,1996,1026,970,105.8,1945,1000,945,105.8
31270, 포천시,070,65~69세,2018,7175,3704,3471,106.7,7050,3629,3421,106.1
31270, 포천시,070001, 65세,2018,1668,870,798,109,1624,846,778,108.7
31270, 포천시,070002, 66세,2018,1704,897,807,111.2,1672,876,796,110.1
31270, 포천시,070003, 67세,2018,1086,581,505,115,1069,572,497,115.1
31270, 포천시,070004, 68세,2018,1272,616,656,93.9,1255,605,650,93.1
31270, 포천시,070005, 69세,2018,1445,740,705,105,1430,730,700,104.3
31270, 포천시,075,70~74세,2018,6156,2891,3265,88.5,6101,2861,3240,88.3
31270, 포천시,075001, 70세,2018,1377,698,679,102.8,1356,684,672,101.8
31270, 포천시,075002, 71세,2018,1426,640,786,81.4,1416,634,782,81.1
31270, 포천시,075003, 72세,2018,1145,540,605,89.3,1136,535,601,89
31270, 포천시,075004, 73세,2018,1149,535,614,87.1,1142,533,609,87.5
31270, 포천시,075005, 74세,2018,1059,478,581,82.3,1051,475,576,82.5
31270, 포천시,080,75~79세,2018,5635,2317,3318,69.8,5606,2307,3299,69.9
31270, 포천시,080001, 75세,2018,1089,460,629,73.1,1080,457,623,73.4
31270, 포천시,080002, 76세,2018,1266,521,745,69.9,1258,519,739,70.2
31270, 포천시,080003, 77세,2018,1127,471,656,71.8,1122,468,654,71.6
31270, 포천시,080004, 78세,2018,1091,443,648,68.4,1090,443,647,68.5
31270, 포천시,080005, 79세,2018,1062,422,640,65.9,1056,420,636,66
31270, 포천시,085,80~84세,2018,3824,1441,2383,60.5,3812,1437,2375,60.5
31270, 포천시,085001, 80세,2018,906,342,564,60.6,903,341,562,60.7
31270, 포천시,085002, 81세,2018,843,340,503,67.6,840,339,501,67.7
31270, 포천시,085003, 82세,2018,753,283,470,60.2,751,282,469,60.1
31270, 포천시,085004, 83세,2018,750,273,477,57.2,747,272,475,57.3
31270, 포천시,085005, 84세,2018,572,203,369,55,571,203,368,55.2
31270, 포천시,090,85~89세,2018,1754,516,1238,41.7,1749,516,1233,41.8
31270, 포천시,090001, 85세,2018,463,156,307,50.8,463,156,307,50.8
31270, 포천시,090002, 86세,2018,383,115,268,42.9,382,115,267,43.1
31270, 포천시,090003, 87세,2018,308,102,206,49.5,305,102,203,50.2
31270, 포천시,090004, 88세,2018,316,75,241,31.1,315,75,240,31.3
31270, 포천시,090005, 89세,2018,284,68,216,31.5,284,68,216,31.5
31270, 포천시,095,90~94세,2018,624,138,486,28.4,621,138,483,28.6
31270, 포천시,095001, 90세,2018,186,39,147,26.5,185,39,146,26.7
31270, 포천시,095002, 91세,2018,153,32,121,26.4,152,32,120,26.7
31270, 포천시,095003, 92세,2018,110,24,86,27.9,110,24,86,27.9
31270, 포천시,095004, 93세,2018,102,23,79,29.1,101,23,78,29.5
31270, 포천시,095005, 94세,2018,73,20,53,37.7,73,20,53,37.7
31270, 포천시,100,95~99세,2018,198,50,148,33.8,198,50,148,33.8
31270, 포천시,100001, 95세,2018,73,14,59,23.7,73,14,59,23.7
31270, 포천시,100002, 96세,2018,43,14,29,48.3,43,14,29,48.3
31270, 포천시,100003, 97세,2018,38,6,32,18.8,38,6,32,18.8
31270, 포천시,100004, 98세,2018,26,11,15,73.3,26,11,15,73.3
31270, 포천시,100005, 99세,2018,18,5,13,38.5,18,5,13,38.5
31270, 포천시,101,100세이상,2018,18,5,13,38.5,18,5,13,38.5
31270, 포천시,102,15세미만,2018,16137,8383,7754,108.1,15957,8303,7654,108.5
31270, 포천시,103,15~64세,2018,120043,68409,51634,132.5,102946,55552,47394,117.2
31270, 포천시,104,65세이상,2018,25384,11062,14322,77.2,25155,10943,14212,77
31270, 포천시,086,85세이상,2018,2594,709,1885,37.6,2586,709,1877,37.8
31270, 포천시,126,평균연령,2018,43.5,42,45.2,,44.5,43.4,45.8,
31270, 포천시,127,중위연령,2018,44.7,42.4,47.2,,47.3,46.3,48.3,
31280, 여주시,000,합계,2018,112096,57035,55061,103.6,107025,53964,53061,101.7
31280, 여주시,005,0~4세,2018,3634,1880,1754,107.2,3610,1869,1741,107.4
31280, 여주시,005001, 0세,2018,643,340,303,112.2,639,338,301,112.3
31280, 여주시,005002, 1세,2018,631,322,309,104.2,627,319,308,103.6
31280, 여주시,005003, 2세,2018,750,380,370,102.7,745,378,367,103
31280, 여주시,005004, 3세,2018,804,426,378,112.7,797,424,373,113.7
31280, 여주시,005005, 4세,2018,806,412,394,104.6,802,410,392,104.6
31280, 여주시,010,5~9세,2018,4503,2376,2127,111.7,4487,2369,2118,111.9
31280, 여주시,010001, 5세,2018,850,471,379,124.3,848,470,378,124.3
31280, 여주시,010002, 6세,2018,893,478,415,115.2,891,477,414,115.2
31280, 여주시,010003, 7세,2018,963,491,472,104,956,486,470,103.4
31280, 여주시,010004, 8세,2018,889,445,444,100.2,886,445,441,100.9
31280, 여주시,010005, 9세,2018,908,491,417,117.7,906,491,415,118.3
31280, 여주시,015,10~14세,2018,4570,2373,2197,108,4559,2370,2189,108.3
31280, 여주시,015001, 10세,2018,871,465,406,114.5,867,464,403,115.1
31280, 여주시,015002, 11세,2018,969,486,483,100.6,968,486,482,100.8
31280, 여주시,015003, 12세,2018,876,446,430,103.7,873,445,428,104
31280, 여주시,015004, 13세,2018,898,463,435,106.4,896,463,433,106.9
31280, 여주시,015005, 14세,2018,956,513,443,115.8,955,512,443,115.6
31280, 여주시,020,15~19세,2018,5928,3038,2890,105.1,5875,3009,2866,105
31280, 여주시,020001, 15세,2018,954,455,499,91.2,951,454,497,91.3
31280, 여주시,020002, 16세,2018,1070,560,510,109.8,1064,557,507,109.9
31280, 여주시,020003, 17세,2018,1223,626,597,104.9,1219,625,594,105.2
31280, 여주시,020004, 18세,2018,1355,685,670,102.2,1347,680,667,101.9
31280, 여주시,020005, 19세,2018,1326,712,614,116,1294,693,601,115.3
31280, 여주시,025,20~24세,2018,6810,3685,3125,117.9,5989,3181,2808,113.3
31280, 여주시,025001, 20세,2018,1393,738,655,112.7,1268,664,604,109.9
31280, 여주시,025002, 21세,2018,1404,752,652,115.3,1270,666,604,110.3
31280, 여주시,025003, 22세,2018,1276,680,596,114.1,1122,590,532,110.9
31280, 여주시,025004, 23세,2018,1370,774,596,129.9,1177,653,524,124.6
31280, 여주시,025005, 24세,2018,1367,741,626,118.4,1152,608,544,111.8
31280, 여주시,030,25~29세,2018,6886,3933,2953,133.2,5642,3119,2523,123.6
31280, 여주시,030001, 25세,2018,1429,799,630,126.8,1175,641,534,120
31280, 여주시,030002, 26세,2018,1478,830,648,128.1,1210,660,550,120
31280, 여주시,030003, 27세,2018,1407,808,599,134.9,1139,627,512,122.5
31280, 여주시,030004, 28세,2018,1310,749,561,133.5,1074,589,485,121.4
31280, 여주시,030005, 29세,2018,1262,747,515,145,1044,602,442,136.2
31280, 여주시,035,30~34세,2018,6091,3369,2722,123.8,5093,2709,2384,113.6
31280, 여주시,035001, 30세,2018,1232,675,557,121.2,1004,532,472,112.7
31280, 여주시,035002, 31세,2018,1131,655,476,137.6,924,514,410,125.4
31280, 여주시,035003, 32세,2018,1253,706,547,129.1,1050,568,482,117.8
31280, 여주시,035004, 33세,2018,1193,635,558,113.8,1003,512,491,104.3
31280, 여주시,035005, 34세,2018,1282,698,584,119.5,1112,583,529,110.2
31280, 여주시,040,35~39세,2018,7523,3847,3676,104.7,6937,3501,3436,101.9
31280, 여주시,040001, 35세,2018,1338,669,669,100,1191,576,615,93.7
31280, 여주시,040002, 36세,2018,1513,768,745,103.1,1386,689,697,98.9
31280, 여주시,040003, 37세,2018,1545,804,741,108.5,1438,749,689,108.7
31280, 여주시,040004, 38세,2018,1637,848,789,107.5,1526,783,743,105.4
31280, 여주시,040005, 39세,2018,1490,758,732,103.6,1396,704,692,101.7
31280, 여주시,045,40~44세,2018,7535,3858,3677,104.9,7186,3664,3522,104
31280, 여주시,045001, 40세,2018,1411,726,685,106,1335,680,655,103.8
31280, 여주시,045002, 41세,2018,1470,764,706,108.2,1385,717,668,107.3
31280, 여주시,045003, 42세,2018,1456,732,724,101.1,1393,695,698,99.6
31280, 여주시,045004, 43세,2018,1500,761,739,103,1443,733,710,103.2
31280, 여주시,045005, 44세,2018,1698,875,823,106.3,1630,839,791,106.1
31280, 여주시,050,45~49세,2018,8946,4733,4213,112.3,8654,4571,4083,112
31280, 여주시,050001, 45세,2018,1739,901,838,107.5,1670,863,807,106.9
31280, 여주시,050002, 46세,2018,1654,908,746,121.7,1608,881,727,121.2
31280, 여주시,050003, 47세,2018,1836,970,866,112,1764,931,833,111.8
31280, 여주시,050004, 48세,2018,1782,956,826,115.7,1732,927,805,115.2
31280, 여주시,050005, 49세,2018,1935,998,937,106.5,1880,969,911,106.4
31280, 여주시,055,50~54세,2018,9190,4801,4389,109.4,8951,4690,4261,110.1
31280, 여주시,055001, 50세,2018,1861,972,889,109.3,1809,949,860,110.3
31280, 여주시,055002, 51세,2018,1806,918,888,103.4,1750,890,860,103.5
31280, 여주시,055003, 52세,2018,1812,971,841,115.5,1769,953,816,116.8
31280, 여주시,055004, 53세,2018,1897,1007,890,113.1,1842,980,862,113.7
31280, 여주시,055005, 54세,2018,1814,933,881,105.9,1781,918,863,106.4
31280, 여주시,060,55~59세,2018,10215,5282,4933,107.1,10003,5176,4827,107.2
31280, 여주시,060001, 55세,2018,1888,986,902,109.3,1837,960,877,109.5
31280, 여주시,060002, 56세,2018,2017,1056,961,109.9,1973,1031,942,109.4
31280, 여주시,060003, 57세,2018,2215,1148,1067,107.6,2172,1129,1043,108.2
31280, 여주시,060004, 58세,2018,2156,1088,1068,101.9,2116,1068,1048,101.9
31280, 여주시,060005, 59세,2018,1939,1004,935,107.4,1905,988,917,107.7
31280, 여주시,065,60~64세,2018,9025,4521,4504,100.4,8902,4446,4456,99.8
31280, 여주시,065001, 60세,2018,1976,998,978,102,1945,982,963,102
31280, 여주시,065002, 61세,2018,1826,908,918,98.9,1795,890,905,98.3
31280, 여주시,065003, 62세,2018,1830,936,894,104.7,1813,924,889,103.9
31280, 여주시,065004, 63세,2018,1831,925,906,102.1,1810,910,900,101.1
31280, 여주시,065005, 64세,2018,1562,754,808,93.3,1539,740,799,92.6
31280, 여주시,070,65~69세,2018,6216,3131,3085,101.5,6165,3108,3057,101.7
31280, 여주시,070001, 65세,2018,1401,696,705,98.7,1389,689,700,98.4
31280, 여주시,070002, 66세,2018,1700,878,822,106.8,1690,875,815,107.4
31280, 여주시,070003, 67세,2018,1028,530,498,106.4,1017,528,489,108
31280, 여주시,070004, 68세,2018,1004,496,508,97.6,996,491,505,97.2
31280, 여주시,070005, 69세,2018,1083,531,552,96.2,1073,525,548,95.8
31280, 여주시,075,70~74세,2018,4962,2378,2584,92,4934,2362,2572,91.8
31280, 여주시,075001, 70세,2018,1077,554,523,105.9,1069,550,519,106
31280, 여주시,075002, 71세,2018,1138,572,566,101.1,1131,566,565,100.2
31280, 여주시,075003, 72세,2018,893,433,460,94.1,889,432,457,94.5
31280, 여주시,075004, 73세,2018,928,425,503,84.5,923,423,500,84.6
31280, 여주시,075005, 74세,2018,926,394,532,74.1,922,391,531,73.6
31280, 여주시,080,75~79세,2018,4633,2013,2620,76.8,4618,2005,2613,76.7
31280, 여주시,080001, 75세,2018,895,410,485,84.5,892,409,483,84.7
31280, 여주시,080002, 76세,2018,1095,488,607,80.4,1089,485,604,80.3
31280, 여주시,080003, 77세,2018,1022,445,577,77.1,1018,441,577,76.4
31280, 여주시,080004, 78세,2018,803,327,476,68.7,801,327,474,69
31280, 여주시,080005, 79세,2018,818,343,475,72.2,818,343,475,72.2
31280, 여주시,085,80~84세,2018,3226,1241,1985,62.5,3220,1240,1980,62.6
31280, 여주시,085001, 80세,2018,750,310,440,70.5,750,310,440,70.5
31280, 여주시,085002, 81세,2018,724,282,442,63.8,721,281,440,63.9
31280, 여주시,085003, 82세,2018,655,231,424,54.5,655,231,424,54.5
31280, 여주시,085004, 83세,2018,579,213,366,58.2,579,213,366,58.2
31280, 여주시,085005, 84세,2018,518,205,313,65.5,515,205,310,66.1
31280, 여주시,090,85~89세,2018,1515,444,1071,41.5,1512,443,1069,41.4
31280, 여주시,090001, 85세,2018,413,123,290,42.4,413,123,290,42.4
31280, 여주시,090002, 86세,2018,331,96,235,40.9,330,96,234,41
31280, 여주시,090003, 87세,2018,293,96,197,48.7,291,95,196,48.5
31280, 여주시,090004, 88세,2018,262,75,187,40.1,262,75,187,40.1
31280, 여주시,090005, 89세,2018,216,54,162,33.3,216,54,162,33.3
31280, 여주시,095,90~94세,2018,542,107,435,24.6,542,107,435,24.6
31280, 여주시,095001, 90세,2018,187,42,145,29,187,42,145,29
31280, 여주시,095002, 91세,2018,121,25,96,26,121,25,96,26
31280, 여주시,095003, 92세,2018,99,15,84,17.9,99,15,84,17.9
31280, 여주시,095004, 93세,2018,72,11,61,18,72,11,61,18
31280, 여주시,095005, 94세,2018,63,14,49,28.6,63,14,49,28.6
31280, 여주시,100,95~99세,2018,136,24,112,21.4,136,24,112,21.4
31280, 여주시,100001, 95세,2018,53,10,43,23.3,53,10,43,23.3
31280, 여주시,100002, 96세,2018,36,7,29,24.1,36,7,29,24.1
31280, 여주시,100003, 97세,2018,30,X,26,15.4,30,X,26,15.4
31280, 여주시,100004, 98세,2018,13,X,10,30,13,X,10,30
31280, 여주시,100005, 99세,2018,X,X,X,0,X,X,X,0
31280, 여주시,101,100세이상,2018,10,X,9,11.1,10,X,9,11.1
31280, 여주시,102,15세미만,2018,12707,6629,6078,109.1,12656,6608,6048,109.3
31280, 여주시,103,15~64세,2018,78149,41067,37082,110.7,73232,38066,35166,108.2
31280, 여주시,104,65세이상,2018,21240,9339,11901,78.5,21137,9290,11847,78.4
31280, 여주시,086,85세이상,2018,2203,576,1627,35.4,2200,575,1625,35.4
31280, 여주시,126,평균연령,2018,44.7,43.3,46,,45.1,43.8,46.4,
31280, 여주시,127,중위연령,2018,46.5,45.2,48,,47.5,46.4,48.7,
31350, 연천군,000,합계,2018,43383,22888,20495,111.7,42048,21951,20097,109.2
31350, 연천군,005,0~4세,2018,1592,803,789,101.8,1589,801,788,101.6
31350, 연천군,005001, 0세,2018,317,167,150,111.3,316,167,149,112.1
31350, 연천군,005002, 1세,2018,298,175,123,142.3,298,175,123,142.3
31350, 연천군,005003, 2세,2018,350,175,175,100,349,174,175,99.4
31350, 연천군,005004, 3세,2018,317,149,168,88.7,316,148,168,88.1
31350, 연천군,005005, 4세,2018,310,137,173,79.2,310,137,173,79.2
31350, 연천군,010,5~9세,2018,1542,802,740,108.4,1539,800,739,108.3
31350, 연천군,010001, 5세,2018,339,174,165,105.5,339,174,165,105.5
31350, 연천군,010002, 6세,2018,300,163,137,119,300,163,137,119
31350, 연천군,010003, 7세,2018,296,153,143,107,293,151,142,106.3
31350, 연천군,010004, 8세,2018,321,168,153,109.8,321,168,153,109.8
31350, 연천군,010005, 9세,2018,286,144,142,101.4,286,144,142,101.4
31350, 연천군,015,10~14세,2018,1502,802,700,114.6,1502,802,700,114.6
31350, 연천군,015001, 10세,2018,314,169,145,116.6,314,169,145,116.6
31350, 연천군,015002, 11세,2018,291,149,142,104.9,291,149,142,104.9
31350, 연천군,015003, 12세,2018,282,163,119,137,282,163,119,137
31350, 연천군,015004, 13세,2018,308,158,150,105.3,308,158,150,105.3
31350, 연천군,015005, 14세,2018,307,163,144,113.2,307,163,144,113.2
31350, 연천군,020,15~19세,2018,1842,998,844,118.2,1828,987,841,117.4
31350, 연천군,020001, 15세,2018,297,165,132,125,297,165,132,125
31350, 연천군,020002, 16세,2018,372,205,167,122.8,371,204,167,122.2
31350, 연천군,020003, 17세,2018,457,259,198,130.8,456,258,198,130.3
31350, 연천군,020004, 18세,2018,425,211,214,98.6,418,205,213,96.2
31350, 연천군,020005, 19세,2018,291,158,133,118.8,286,155,131,118.3
31350, 연천군,025,20~24세,2018,2390,1580,810,195.1,2188,1410,778,181.2
31350, 연천군,025001, 20세,2018,325,207,118,175.4,311,195,116,168.1
31350, 연천군,025002, 21세,2018,382,225,157,143.3,364,209,155,134.8
31350, 연천군,025003, 22세,2018,449,295,154,191.6,409,262,147,178.2
31350, 연천군,025004, 23세,2018,571,402,169,237.9,499,339,160,211.9
31350, 연천군,025005, 24세,2018,663,451,212,212.7,605,405,200,202.5
31350, 연천군,030,25~29세,2018,3123,2074,1049,197.7,2799,1831,968,189.2
31350, 연천군,030001, 25세,2018,676,456,220,207.3,607,408,199,205
31350, 연천군,030002, 26세,2018,716,484,232,208.6,651,432,219,197.3
31350, 연천군,030003, 27세,2018,644,426,218,195.4,572,373,199,187.4
31350, 연천군,030004, 28세,2018,551,362,189,191.5,492,316,176,179.5
31350, 연천군,030005, 29세,2018,536,346,190,182.1,477,302,175,172.6
31350, 연천군,035,30~34세,2018,2339,1378,961,143.4,2124,1226,898,136.5
31350, 연천군,035001, 30세,2018,503,306,197,155.3,451,268,183,146.4
31350, 연천군,035002, 31세,2018,487,275,212,129.7,429,234,195,120
31350, 연천군,035003, 32세,2018,460,288,172,167.4,421,257,164,156.7
31350, 연천군,035004, 33세,2018,432,243,189,128.6,392,218,174,125.3
31350, 연천군,035005, 34세,2018,457,266,191,139.3,431,249,182,136.8
31350, 연천군,040,35~39세,2018,2384,1281,1103,116.1,2227,1172,1055,111.1
31350, 연천군,040001, 35세,2018,446,241,205,117.6,418,224,194,115.5
31350, 연천군,040002, 36세,2018,497,267,230,116.1,455,236,219,107.8
31350, 연천군,040003, 37세,2018,518,295,223,132.3,493,279,214,130.4
31350, 연천군,040004, 38세,2018,464,239,225,106.2,439,219,220,99.5
31350, 연천군,040005, 39세,2018,459,239,220,108.6,422,214,208,102.9
31350, 연천군,045,40~44세,2018,2398,1316,1082,121.6,2281,1238,1043,118.7
31350, 연천군,045001, 40세,2018,447,252,195,129.2,411,225,186,121
31350, 연천군,045002, 41세,2018,461,247,214,115.4,444,235,209,112.4
31350, 연천군,045003, 42세,2018,427,243,184,132.1,400,224,176,127.3
31350, 연천군,045004, 43세,2018,479,267,212,125.9,462,257,205,125.4
31350, 연천군,045005, 44세,2018,584,307,277,110.8,564,297,267,111.2
31350, 연천군,050,45~49세,2018,2874,1601,1273,125.8,2784,1546,1238,124.9
31350, 연천군,050001, 45세,2018,530,311,219,142,516,301,215,140
31350, 연천군,050002, 46세,2018,576,337,239,141,565,329,236,139.4
31350, 연천군,050003, 47세,2018,589,348,241,144.4,567,335,232,144.4
31350, 연천군,050004, 48세,2018,530,253,277,91.3,507,239,268,89.2
31350, 연천군,050005, 49세,2018,649,352,297,118.5,629,342,287,119.2
31350, 연천군,055,50~54세,2018,3279,1765,1514,116.6,3211,1727,1484,116.4
31350, 연천군,055001, 50세,2018,600,309,291,106.2,586,304,282,107.8
31350, 연천군,055002, 51세,2018,606,328,278,118,594,320,274,116.8
31350, 연천군,055003, 52세,2018,662,359,303,118.5,646,350,296,118.2
31350, 연천군,055004, 53세,2018,723,393,330,119.1,708,385,323,119.2
31350, 연천군,055005, 54세,2018,688,376,312,120.5,677,368,309,119.1
31350, 연천군,060,55~59세,2018,3995,2062,1933,106.7,3937,2035,1902,107
31350, 연천군,060001, 55세,2018,757,386,371,104,741,381,360,105.8
31350, 연천군,060002, 56세,2018,738,410,328,125,727,404,323,125.1
31350, 연천군,060003, 57세,2018,805,414,391,105.9,796,408,388,105.2
31350, 연천군,060004, 58세,2018,871,428,443,96.6,857,421,436,96.6
31350, 연천군,060005, 59세,2018,824,424,400,106,816,421,395,106.6
31350, 연천군,065,60~64세,2018,3941,2062,1879,109.7,3902,2042,1860,109.8
31350, 연천군,065001, 60세,2018,820,434,386,112.4,813,430,383,112.3
31350, 연천군,065002, 61세,2018,851,452,399,113.3,840,446,394,113.2
31350, 연천군,065003, 62세,2018,753,368,385,95.6,749,368,381,96.6
31350, 연천군,065004, 63세,2018,823,435,388,112.1,811,429,382,112.3
31350, 연천군,065005, 64세,2018,694,373,321,116.2,689,369,320,115.3
31350, 연천군,070,65~69세,2018,2538,1228,1310,93.7,2512,1208,1304,92.6
31350, 연천군,070001, 65세,2018,521,257,264,97.3,516,252,264,95.5
31350, 연천군,070002, 66세,2018,599,290,309,93.9,592,286,306,93.5
31350, 연천군,070003, 67세,2018,410,196,214,91.6,403,190,213,89.2
31350, 연천군,070004, 68세,2018,467,228,239,95.4,463,225,238,94.5
31350, 연천군,070005, 69세,2018,541,257,284,90.5,538,255,283,90.1
31350, 연천군,075,70~74세,2018,2577,1202,1375,87.4,2569,1197,1372,87.2
31350, 연천군,075001, 70세,2018,566,269,297,90.6,563,266,297,89.6
31350, 연천군,075002, 71세,2018,596,268,328,81.7,595,268,327,82
31350, 연천군,075003, 72세,2018,478,225,253,88.9,476,224,252,88.9
31350, 연천군,075004, 73세,2018,468,220,248,88.7,467,219,248,88.3
31350, 연천군,075005, 74세,2018,469,220,249,88.4,468,220,248,88.7
31350, 연천군,080,75~79세,2018,2391,982,1409,69.7,2380,977,1403,69.6
31350, 연천군,080001, 75세,2018,458,185,273,67.8,456,184,272,67.6
31350, 연천군,080002, 76세,2018,555,238,317,75.1,550,235,315,74.6
31350, 연천군,080003, 77세,2018,496,229,267,85.8,494,228,266,85.7
31350, 연천군,080004, 78세,2018,456,170,286,59.4,455,170,285,59.6
31350, 연천군,080005, 79세,2018,426,160,266,60.2,425,160,265,60.4
31350, 연천군,085,80~84세,2018,1666,636,1030,61.7,1666,636,1030,61.7
31350, 연천군,085001, 80세,2018,431,180,251,71.7,431,180,251,71.7
31350, 연천군,085002, 81세,2018,389,135,254,53.1,389,135,254,53.1
31350, 연천군,085003, 82세,2018,297,116,181,64.1,297,116,181,64.1
31350, 연천군,085004, 83세,2018,325,119,206,57.8,325,119,206,57.8
31350, 연천군,085005, 84세,2018,224,86,138,62.3,224,86,138,62.3
31350, 연천군,090,85~89세,2018,712,245,467,52.5,712,245,467,52.5
31350, 연천군,090001, 85세,2018,196,74,122,60.7,196,74,122,60.7
31350, 연천군,090002, 86세,2018,190,64,126,50.8,190,64,126,50.8
31350, 연천군,090003, 87세,2018,105,38,67,56.7,105,38,67,56.7
31350, 연천군,090004, 88세,2018,120,43,77,55.8,120,43,77,55.8
31350, 연천군,090005, 89세,2018,101,26,75,34.7,101,26,75,34.7
31350, 연천군,095,90~94세,2018,232,50,182,27.5,232,50,182,27.5
31350, 연천군,095001, 90세,2018,63,12,51,23.5,63,12,51,23.5
31350, 연천군,095002, 91세,2018,71,16,55,29.1,71,16,55,29.1
31350, 연천군,095003, 92세,2018,36,9,27,33.3,36,9,27,33.3
31350, 연천군,095004, 93세,2018,35,7,28,25,35,7,28,25
31350, 연천군,095005, 94세,2018,27,6,21,28.6,27,6,21,28.6
31350, 연천군,100,95~99세,2018,57,21,36,58.3,57,21,36,58.3
31350, 연천군,100001, 95세,2018,19,8,11,72.7,19,8,11,72.7
31350, 연천군,100002, 96세,2018,10,5,5,100,10,5,5,100
31350, 연천군,100003, 97세,2018,9,X,6,50,9,X,6,50
31350, 연천군,100004, 98세,2018,12,X,9,33.3,12,X,9,33.3
31350, 연천군,100005, 99세,2018,7,X,5,40,7,X,5,40
31350, 연천군,101,100세이상,2018,9,X,9,0,9,X,9,0
31350, 연천군,102,15세미만,2018,4636,2407,2229,108,4630,2403,2227,107.9
31350, 연천군,103,15~64세,2018,28565,16117,12448,129.5,27281,15214,12067,126.1
31350, 연천군,104,65세이상,2018,10182,4364,5818,75,10137,4334,5803,74.7
31350, 연천군,086,85세이상,2018,1010,316,694,45.5,1010,316,694,45.5
31350, 연천군,126,평균연령,2018,46.8,44.5,49.3,,47.1,45,49.4,
31350, 연천군,127,중위연령,2018,49.5,46.3,53.1,,50.3,47.2,53.5,
31370, 가평군,000,합계,2018,59957,30404,29553,102.9,58533,29783,28750,103.6
31370, 가평군,005,0~4세,2018,1740,886,854,103.7,1707,862,845,102
31370, 가평군,005001, 0세,2018,306,146,160,91.3,301,143,158,90.5
31370, 가평군,005002, 1세,2018,344,176,168,104.8,336,170,166,102.4
31370, 가평군,005003, 2세,2018,375,196,179,109.5,364,189,175,108
31370, 가평군,005004, 3세,2018,368,189,179,105.6,365,186,179,103.9
31370, 가평군,005005, 4세,2018,347,179,168,106.5,341,174,167,104.2
31370, 가평군,010,5~9세,2018,2043,1019,1024,99.5,2019,1009,1010,99.9
31370, 가평군,010001, 5세,2018,352,186,166,112,349,185,164,112.8
31370, 가평군,010002, 6세,2018,437,209,228,91.7,432,208,224,92.9
31370, 가평군,010003, 7세,2018,418,191,227,84.1,414,191,223,85.7
31370, 가평군,010004, 8세,2018,428,226,202,111.9,421,221,200,110.5
31370, 가평군,010005, 9세,2018,408,207,201,103,403,204,199,102.5
31370, 가평군,015,10~14세,2018,2157,1132,1025,110.4,2130,1123,1007,111.5
31370, 가평군,015001, 10세,2018,426,227,199,114.1,418,224,194,115.5
31370, 가평군,015002, 11세,2018,442,229,213,107.5,438,228,210,108.6
31370, 가평군,015003, 12세,2018,408,221,187,118.2,405,221,184,120.1
31370, 가평군,015004, 13세,2018,433,220,213,103.3,426,217,209,103.8
31370, 가평군,015005, 14세,2018,448,235,213,110.3,443,233,210,111
31370, 가평군,020,15~19세,2018,2939,1455,1484,98,2909,1442,1467,98.3
31370, 가평군,020001, 15세,2018,449,244,205,119,445,243,202,120.3
31370, 가평군,020002, 16세,2018,550,289,261,110.7,543,285,258,110.5
31370, 가평군,020003, 17세,2018,704,318,386,82.4,700,316,384,82.3
31370, 가평군,020004, 18세,2018,663,312,351,88.9,660,311,349,89.1
31370, 가평군,020005, 19세,2018,573,292,281,103.9,561,287,274,104.7
31370, 가평군,025,20~24세,2018,2881,1661,1220,136.1,2748,1589,1159,137.1
31370, 가평군,025001, 20세,2018,549,301,248,121.4,531,293,238,123.1
31370, 가평군,025002, 21세,2018,543,336,207,162.3,528,327,201,162.7
31370, 가평군,025003, 22세,2018,570,334,236,141.5,545,319,226,141.2
31370, 가평군,025004, 23세,2018,612,337,275,122.5,578,321,257,124.9
31370, 가평군,025005, 24세,2018,607,353,254,139,566,329,237,138.8
31370, 가평군,030,25~29세,2018,3050,1729,1321,130.9,2858,1638,1220,134.3
31370, 가평군,030001, 25세,2018,651,367,284,129.2,612,347,265,130.9
31370, 가평군,030002, 26세,2018,659,364,295,123.4,621,346,275,125.8
31370, 가평군,030003, 27세,2018,597,342,255,134.1,569,328,241,136.1
31370, 가평군,030004, 28세,2018,585,346,239,144.8,538,321,217,147.9
31370, 가평군,030005, 29세,2018,558,310,248,125,518,296,222,133.3
31370, 가평군,035,30~34세,2018,2839,1529,1310,116.7,2661,1458,1203,121.2
31370, 가평군,035001, 30세,2018,582,327,255,128.2,550,309,241,128.2
31370, 가평군,035002, 31세,2018,578,306,272,112.5,550,293,257,114
31370, 가평군,035003, 32세,2018,576,305,271,112.5,529,291,238,122.3
31370, 가평군,035004, 33세,2018,539,285,254,112.2,505,273,232,117.7
31370, 가평군,035005, 34세,2018,564,306,258,118.6,527,292,235,124.3
31370, 가평군,040,35~39세,2018,3323,1724,1599,107.8,3202,1670,1532,109
31370, 가평군,040001, 35세,2018,593,311,282,110.3,563,296,267,110.9
31370, 가평군,040002, 36세,2018,670,332,338,98.2,646,321,325,98.8
31370, 가평군,040003, 37세,2018,702,366,336,108.9,675,356,319,111.6
31370, 가평군,040004, 38세,2018,690,356,334,106.6,671,349,322,108.4
31370, 가평군,040005, 39세,2018,668,359,309,116.2,647,348,299,116.4
31370, 가평군,045,40~44세,2018,3607,1896,1711,110.8,3490,1854,1636,113.3
31370, 가평군,045001, 40세,2018,665,337,328,102.7,636,329,307,107.2
31370, 가평군,045002, 41세,2018,671,369,302,122.2,649,358,291,123
31370, 가평군,045003, 42세,2018,704,355,349,101.7,682,345,337,102.4
31370, 가평군,045004, 43세,2018,747,395,352,112.2,724,389,335,116.1
31370, 가평군,045005, 44세,2018,820,440,380,115.8,799,433,366,118.3
31370, 가평군,050,45~49세,2018,4476,2418,2058,117.5,4345,2366,1979,119.6
31370, 가평군,050001, 45세,2018,770,442,328,134.8,750,433,317,136.6
31370, 가평군,050002, 46세,2018,889,496,393,126.2,861,481,380,126.6
31370, 가평군,050003, 47세,2018,875,461,414,111.4,848,451,397,113.6
31370, 가평군,050004, 48세,2018,939,473,466,101.5,912,466,446,104.5
31370, 가평군,050005, 49세,2018,1003,546,457,119.5,974,535,439,121.9
31370, 가평군,055,50~54세,2018,5028,2614,2414,108.3,4876,2559,2317,110.4
31370, 가평군,055001, 50세,2018,951,495,456,108.6,922,484,438,110.5
31370, 가평군,055002, 51세,2018,945,472,473,99.8,918,464,454,102.2
31370, 가평군,055003, 52세,2018,1002,531,471,112.7,970,519,451,115.1
31370, 가평군,055004, 53세,2018,1053,547,506,108.1,1017,535,482,111
31370, 가평군,055005, 54세,2018,1077,569,508,112,1049,557,492,113.2
31370, 가평군,060,55~59세,2018,6096,3118,2978,104.7,5996,3081,2915,105.7
31370, 가평군,060001, 55세,2018,1096,581,515,112.8,1069,570,499,114.2
31370, 가평군,060002, 56세,2018,1148,591,557,106.1,1129,584,545,107.2
31370, 가평군,060003, 57세,2018,1281,662,619,106.9,1264,656,608,107.9
31370, 가평군,060004, 58세,2018,1335,649,686,94.6,1308,641,667,96.1
31370, 가평군,060005, 59세,2018,1236,635,601,105.7,1226,630,596,105.7
31370, 가평군,065,60~64세,2018,5969,3070,2899,105.9,5868,3019,2849,106
31370, 가평군,065001, 60세,2018,1235,639,596,107.2,1208,622,586,106.1
31370, 가평군,065002, 61세,2018,1204,639,565,113.1,1179,630,549,114.8
31370, 가평군,065003, 62세,2018,1245,646,599,107.8,1224,632,592,106.8
31370, 가평군,065004, 63세,2018,1209,605,604,100.2,1193,600,593,101.2
31370, 가평군,065005, 64세,2018,1076,541,535,101.1,1064,535,529,101.1
31370, 가평군,070,65~69세,2018,3869,1926,1943,99.1,3825,1908,1917,99.5
31370, 가평군,070001, 65세,2018,943,497,446,111.4,927,490,437,112.1
31370, 가평군,070002, 66세,2018,1017,513,504,101.8,1006,508,498,102
31370, 가평군,070003, 67세,2018,588,300,288,104.2,585,299,286,104.5
31370, 가평군,070004, 68세,2018,657,296,361,82,649,294,355,82.8
31370, 가평군,070005, 69세,2018,664,320,344,93,658,317,341,93
31370, 가평군,075,70~74세,2018,3370,1637,1733,94.5,3350,1624,1726,94.1
31370, 가평군,075001, 70세,2018,718,369,349,105.7,715,367,348,105.5
31370, 가평군,075002, 71세,2018,732,350,382,91.6,729,349,380,91.8
31370, 가평군,075003, 72세,2018,621,301,320,94.1,619,300,319,94
31370, 가평군,075004, 73세,2018,690,319,371,86,683,314,369,85.1
31370, 가평군,075005, 74세,2018,609,298,311,95.8,604,294,310,94.8
31370, 가평군,080,75~79세,2018,3116,1350,1766,76.4,3107,1346,1761,76.4
31370, 가평군,080001, 75세,2018,645,276,369,74.8,643,275,368,74.7
31370, 가평군,080002, 76세,2018,715,326,389,83.8,714,325,389,83.5
31370, 가평군,080003, 77세,2018,583,250,333,75.1,582,249,333,74.8
31370, 가평군,080004, 78세,2018,581,251,330,76.1,579,251,328,76.5
31370, 가평군,080005, 79세,2018,592,247,345,71.6,589,246,343,71.7
31370, 가평군,085,80~84세,2018,2072,831,1241,67,2065,827,1238,66.8
31370, 가평군,085001, 80세,2018,473,188,285,66,470,187,283,66.1
31370, 가평군,085002, 81세,2018,460,204,256,79.7,460,204,256,79.7
31370, 가평군,085003, 82세,2018,434,185,249,74.3,433,184,249,73.9
31370, 가평군,085004, 83세,2018,391,144,247,58.3,389,143,246,58.1
31370, 가평군,085005, 84세,2018,314,110,204,53.9,313,109,204,53.4
31370, 가평군,090,85~89세,2018,959,300,659,45.5,955,300,655,45.8
31370, 가평군,090001, 85세,2018,260,88,172,51.2,259,88,171,51.5
31370, 가평군,090002, 86세,2018,258,85,173,49.1,256,85,171,49.7
31370, 가평군,090003, 87세,2018,155,54,101,53.5,154,54,100,54
31370, 가평군,090004, 88세,2018,144,36,108,33.3,144,36,108,33.3
31370, 가평군,090005, 89세,2018,142,37,105,35.2,142,37,105,35.2
31370, 가평군,095,90~94세,2018,336,86,250,34.4,335,85,250,34
31370, 가평군,095001, 90세,2018,105,31,74,41.9,104,30,74,40.5
31370, 가평군,095002, 91세,2018,73,20,53,37.7,73,20,53,37.7
31370, 가평군,095003, 92세,2018,60,15,45,33.3,60,15,45,33.3
31370, 가평군,095004, 93세,2018,61,12,49,24.5,61,12,49,24.5
31370, 가평군,095005, 94세,2018,37,8,29,27.6,37,8,29,27.6
31370, 가평군,100,95~99세,2018,78,21,57,36.8,78,21,57,36.8
31370, 가평군,100001, 95세,2018,24,5,19,26.3,24,5,19,26.3
31370, 가평군,100002, 96세,2018,26,6,20,30,26,6,20,30
31370, 가평군,100003, 97세,2018,14,7,7,100,14,7,7,100
31370, 가평군,100004, 98세,2018,10,X,8,25,10,X,8,25
31370, 가평군,100005, 99세,2018,X,X,X,33.3,X,X,X,33.3
31370, 가평군,101,100세이상,2018,9,X,7,28.6,9,X,7,28.6
31370, 가평군,102,15세미만,2018,5940,3037,2903,104.6,5856,2994,2862,104.6
31370, 가평군,103,15~64세,2018,40208,21214,18994,111.7,38953,20676,18277,113.1
31370, 가평군,104,65세이상,2018,13809,6153,7656,80.4,13724,6113,7611,80.3
31370, 가평군,086,85세이상,2018,1382,409,973,42,1377,408,969,42.1
31370, 가평군,126,평균연령,2018,47.7,46.4,49,,47.9,46.5,49.2,
31370, 가평군,127,중위연령,2018,51,49.5,52.5,,51.3,49.8,52.9,
31380, 양평군,000,합계,2018,111094,55715,55379,100.6,108781,54695,54086,101.1
31380, 양평군,005,0~4세,2018,3363,1740,1623,107.2,3352,1733,1619,107
31380, 양평군,005001, 0세,2018,534,269,265,101.5,532,267,265,100.8
31380, 양평군,005002, 1세,2018,637,330,307,107.5,636,329,307,107.2
31380, 양평군,005003, 2세,2018,706,361,345,104.6,702,359,343,104.7
31380, 양평군,005004, 3세,2018,714,367,347,105.8,713,366,347,105.5
31380, 양평군,005005, 4세,2018,772,413,359,115,769,412,357,115.4
31380, 양평군,010,5~9세,2018,4299,2208,2091,105.6,4295,2207,2088,105.7
31380, 양평군,010001, 5세,2018,744,362,382,94.8,744,362,382,94.8
31380, 양평군,010002, 6세,2018,910,476,434,109.7,909,476,433,109.9
31380, 양평군,010003, 7세,2018,896,468,428,109.3,896,468,428,109.3
31380, 양평군,010004, 8세,2018,871,448,423,105.9,869,448,421,106.4
31380, 양평군,010005, 9세,2018,878,454,424,107.1,877,453,424,106.8
31380, 양평군,015,10~14세,2018,4521,2358,2163,109,4518,2358,2160,109.2
31380, 양평군,015001, 10세,2018,909,465,444,104.7,908,465,443,105
31380, 양평군,015002, 11세,2018,948,465,483,96.3,948,465,483,96.3
31380, 양평군,015003, 12세,2018,905,483,422,114.5,905,483,422,114.5
31380, 양평군,015004, 13세,2018,822,456,366,124.6,822,456,366,124.6
31380, 양평군,015005, 14세,2018,937,489,448,109.2,935,489,446,109.6
31380, 양평군,020,15~19세,2018,5609,2996,2613,114.7,5582,2980,2602,114.5
31380, 양평군,020001, 15세,2018,891,480,411,116.8,888,479,409,117.1
31380, 양평군,020002, 16세,2018,1066,580,486,119.3,1064,579,485,119.4
31380, 양평군,020003, 17세,2018,1225,620,605,102.5,1223,619,604,102.5
31380, 양평군,020004, 18세,2018,1387,710,677,104.9,1382,708,674,105
31380, 양평군,020005, 19세,2018,1040,606,434,139.6,1025,595,430,138.4
31380, 양평군,025,20~24세,2018,5109,2865,2244,127.7,4813,2739,2074,132.1
31380, 양평군,025001, 20세,2018,985,583,402,145,956,571,385,148.3
31380, 양평군,025002, 21세,2018,1006,579,427,135.6,968,563,405,139
31380, 양평군,025003, 22세,2018,1001,557,444,125.5,940,531,409,129.8
31380, 양평군,025004, 23세,2018,1054,587,467,125.7,984,558,426,131
31380, 양평군,025005, 24세,2018,1063,559,504,110.9,965,516,449,114.9
31380, 양평군,030,25~29세,2018,5284,2919,2365,123.4,4754,2659,2095,126.9
31380, 양평군,030001, 25세,2018,1104,600,504,119,993,546,447,122.1
31380, 양평군,030002, 26세,2018,1203,670,533,125.7,1083,615,468,131.4
31380, 양평군,030003, 27세,2018,1017,553,464,119.2,905,495,410,120.7
31380, 양평군,030004, 28세,2018,1035,574,461,124.5,928,526,402,130.8
31380, 양평군,030005, 29세,2018,925,522,403,129.5,845,477,368,129.6
31380, 양평군,035,30~34세,2018,4958,2570,2388,107.6,4571,2388,2183,109.4
31380, 양평군,035001, 30세,2018,979,502,477,105.2,890,461,429,107.5
31380, 양평군,035002, 31세,2018,948,508,440,115.5,870,472,398,118.6
31380, 양평군,035003, 32세,2018,978,503,475,105.9,891,458,433,105.8
31380, 양평군,035004, 33세,2018,1026,524,502,104.4,963,495,468,105.8
31380, 양평군,035005, 34세,2018,1027,533,494,107.9,957,502,455,110.3
31380, 양평군,040,35~39세,2018,6438,3199,3239,98.8,6190,3104,3086,100.6
31380, 양평군,040001, 35세,2018,1152,614,538,114.1,1091,589,502,117.3
31380, 양평군,040002, 36세,2018,1300,659,641,102.8,1237,630,607,103.8
31380, 양평군,040003, 37세,2018,1277,616,661,93.2,1219,597,622,96
31380, 양평군,040004, 38세,2018,1399,654,745,87.8,1366,643,723,88.9
31380, 양평군,040005, 39세,2018,1310,656,654,100.3,1277,645,632,102.1
31380, 양평군,045,40~44세,2018,7032,3587,3445,104.1,6853,3512,3341,105.1
31380, 양평군,045001, 40세,2018,1289,636,653,97.4,1247,619,628,98.6
31380, 양평군,045002, 41세,2018,1299,643,656,98,1257,625,632,98.9
31380, 양평군,045003, 42세,2018,1387,718,669,107.3,1358,705,653,108
31380, 양평군,045004, 43세,2018,1450,754,696,108.3,1418,741,677,109.5
31380, 양평군,045005, 44세,2018,1607,836,771,108.4,1573,822,751,109.5
31380, 양평군,050,45~49세,2018,8528,4473,4055,110.3,8361,4407,3954,111.5
31380, 양평군,050001, 45세,2018,1712,885,827,107,1674,867,807,107.4
31380, 양평군,050002, 46세,2018,1691,926,765,121,1659,915,744,123
31380, 양평군,050003, 47세,2018,1711,877,834,105.2,1678,863,815,105.9
31380, 양평군,050004, 48세,2018,1695,864,831,104,1659,854,805,106.1
31380, 양평군,050005, 49세,2018,1719,921,798,115.4,1691,908,783,116
31380, 양평군,055,50~54세,2018,8804,4545,4259,106.7,8672,4492,4180,107.5
31380, 양평군,055001, 50세,2018,1700,903,797,113.3,1671,894,777,115.1
31380, 양평군,055002, 51세,2018,1683,853,830,102.8,1662,843,819,102.9
31380, 양평군,055003, 52세,2018,1762,882,880,100.2,1732,870,862,100.9
31380, 양평군,055004, 53세,2018,1868,992,876,113.2,1842,982,860,114.2
31380, 양평군,055005, 54세,2018,1791,915,876,104.5,1765,903,862,104.8
31380, 양평군,060,55~59세,2018,11044,5472,5572,98.2,10921,5430,5491,98.9
31380, 양평군,060001, 55세,2018,1936,996,940,106,1901,987,914,108
31380, 양평군,060002, 56세,2018,2063,1021,1042,98,2034,1013,1021,99.2
31380, 양평군,060003, 57세,2018,2456,1219,1237,98.5,2436,1211,1225,98.9
31380, 양평군,060004, 58세,2018,2352,1142,1210,94.4,2330,1133,1197,94.7
31380, 양평군,060005, 59세,2018,2237,1094,1143,95.7,2220,1086,1134,95.8
31380, 양평군,065,60~64세,2018,10597,5232,5365,97.5,10488,5182,5306,97.7
31380, 양평군,065001, 60세,2018,2287,1160,1127,102.9,2263,1150,1113,103.3
31380, 양평군,065002, 61세,2018,2108,1048,1060,98.9,2080,1033,1047,98.7
31380, 양평군,065003, 62세,2018,2121,1047,1074,97.5,2103,1041,1062,98
31380, 양평군,065004, 63세,2018,2189,1060,1129,93.9,2167,1050,1117,94
31380, 양평군,065005, 64세,2018,1892,917,975,94.1,1875,908,967,93.9
31380, 양평군,070,65~69세,2018,7656,3765,3891,96.8,7603,3738,3865,96.7
31380, 양평군,070001, 65세,2018,1753,855,898,95.2,1733,845,888,95.2
31380, 양평군,070002, 66세,2018,2019,1017,1002,101.5,2007,1009,998,101.1
31380, 양평군,070003, 67세,2018,1203,589,614,95.9,1192,584,608,96.1
31380, 양평군,070004, 68세,2018,1320,641,679,94.4,1315,639,676,94.5
31380, 양평군,070005, 69세,2018,1361,663,698,95,1356,661,695,95.1
31380, 양평군,075,70~74세,2018,6338,3211,3127,102.7,6315,3198,3117,102.6
31380, 양평군,075001, 70세,2018,1380,729,651,112,1365,722,643,112.3
31380, 양평군,075002, 71세,2018,1471,735,736,99.9,1469,734,735,99.9
31380, 양평군,075003, 72세,2018,1157,600,557,107.7,1154,597,557,107.2
31380, 양평군,075004, 73세,2018,1164,569,595,95.6,1162,568,594,95.6
31380, 양평군,075005, 74세,2018,1166,578,588,98.3,1165,577,588,98.1
31380, 양평군,080,75~79세,2018,5321,2420,2901,83.4,5311,2418,2893,83.6
31380, 양평군,080001, 75세,2018,1119,503,616,81.7,1119,503,616,81.7
31380, 양평군,080002, 76세,2018,1293,614,679,90.4,1290,614,676,90.8
31380, 양평군,080003, 77세,2018,1068,483,585,82.6,1066,483,583,82.8
31380, 양평군,080004, 78세,2018,882,414,468,88.5,878,412,466,88.4
31380, 양평군,080005, 79세,2018,959,406,553,73.4,958,406,552,73.6
31380, 양평군,085,80~84세,2018,3678,1452,2226,65.2,3673,1451,2222,65.3
31380, 양평군,085001, 80세,2018,869,366,503,72.8,868,366,502,72.9
31380, 양평군,085002, 81세,2018,797,333,464,71.8,797,333,464,71.8
31380, 양평군,085003, 82세,2018,762,314,448,70.1,760,313,447,70
31380, 양평군,085004, 83세,2018,659,222,437,50.8,658,222,436,50.9
31380, 양평군,085005, 84세,2018,591,217,374,58,590,217,373,58.2
31380, 양평군,090,85~89세,2018,1726,505,1221,41.4,1721,502,1219,41.2
31380, 양평군,090001, 85세,2018,480,164,316,51.9,480,164,316,51.9
31380, 양평군,090002, 86세,2018,365,106,259,40.9,364,106,258,41.1
31380, 양평군,090003, 87세,2018,325,90,235,38.3,324,89,235,37.9
31380, 양평군,090004, 88세,2018,310,80,230,34.8,309,79,230,34.3
31380, 양평군,090005, 89세,2018,246,65,181,35.9,244,64,180,35.6
31380, 양평군,095,90~94세,2018,619,156,463,33.7,618,155,463,33.5
31380, 양평군,095001, 90세,2018,197,45,152,29.6,196,44,152,28.9
31380, 양평군,095002, 91세,2018,155,40,115,34.8,155,40,115,34.8
31380, 양평군,095003, 92세,2018,119,28,91,30.8,119,28,91,30.8
31380, 양평군,095004, 93세,2018,87,22,65,33.8,87,22,65,33.8
31380, 양평군,095005, 94세,2018,61,21,40,52.5,61,21,40,52.5
31380, 양평군,100,95~99세,2018,156,37,119,31.1,156,37,119,31.1
31380, 양평군,100001, 95세,2018,46,10,36,27.8,46,10,36,27.8
31380, 양평군,100002, 96세,2018,45,10,35,28.6,45,10,35,28.6
31380, 양평군,100003, 97세,2018,30,8,22,36.4,30,8,22,36.4
31380, 양평군,100004, 98세,2018,25,6,19,31.6,25,6,19,31.6
31380, 양평군,100005, 99세,2018,10,X,7,42.9,10,X,7,42.9
31380, 양평군,101,100세이상,2018,14,5,9,55.6,14,5,9,55.6
31380, 양평군,102,15세미만,2018,12183,6306,5877,107.3,12165,6298,5867,107.3
31380, 양평군,103,15~64세,2018,73403,37858,35545,106.5,71205,36893,34312,107.5
31380, 양평군,104,65세이상,2018,25508,11551,13957,82.8,25411,11504,13907,82.7
31380, 양평군,086,85세이상,2018,2515,703,1812,38.8,2509,699,1810,38.6
31380, 양평군,126,평균연령,2018,47.1,45.8,48.5,,47.3,46,48.7,
31380, 양평군,127,중위연령,2018,50.2,48.8,51.8,,50.7,49.2,52.3,
32,강원도,000,합계,2018,1520391,768604,751787,102.2,1496242,755527,740715,102
32,강원도,005,0~4세,2018,50189,25640,24549,104.4,50042,25567,24475,104.5
32,강원도,005001, 0세,2018,8522,4349,4173,104.2,8492,4337,4155,104.4
32,강원도,005002, 1세,2018,9279,4761,4518,105.4,9249,4746,4503,105.4
32,강원도,005003, 2세,2018,10425,5372,5053,106.3,10388,5350,5038,106.2
32,강원도,005004, 3세,2018,10965,5548,5417,102.4,10943,5537,5406,102.4
32,강원도,005005, 4세,2018,10998,5610,5388,104.1,10970,5597,5373,104.2
32,강원도,010,5~9세,2018,61506,31536,29970,105.2,61403,31487,29916,105.3
32,강원도,010001, 5세,2018,11268,5753,5515,104.3,11252,5743,5509,104.2
32,강원도,010002, 6세,2018,12829,6541,6288,104,12804,6529,6275,104
32,강원도,010003, 7세,2018,12726,6566,6160,106.6,12698,6553,6145,106.6
32,강원도,010004, 8세,2018,12486,6425,6061,106,12471,6418,6053,106
32,강원도,010005, 9세,2018,12197,6251,5946,105.1,12178,6244,5934,105.2
32,강원도,015,10~14세,2018,64623,33589,31034,108.2,64521,33540,30981,108.3
32,강원도,015001, 10세,2018,12767,6577,6190,106.3,12748,6570,6178,106.3
32,강원도,015002, 11세,2018,13285,6919,6366,108.7,13264,6911,6353,108.8
32,강원도,015003, 12세,2018,12357,6421,5936,108.2,12331,6409,5922,108.2
32,강원도,015004, 13세,2018,12586,6576,6010,109.4,12570,6565,6005,109.3
32,강원도,015005, 14세,2018,13628,7096,6532,108.6,13608,7085,6523,108.6
32,강원도,020,15~19세,2018,85220,45359,39861,113.8,84452,44940,39512,113.7
32,강원도,020001, 15세,2018,13903,7221,6682,108.1,13887,7216,6671,108.2
32,강원도,020002, 16세,2018,14876,7786,7090,109.8,14856,7774,7082,109.8
32,강원도,020003, 17세,2018,17056,9050,8006,113,17006,9027,7979,113.1
32,강원도,020004, 18세,2018,19052,10216,8836,115.6,18878,10135,8743,115.9
32,강원도,020005, 19세,2018,20333,11086,9247,119.9,19825,10788,9037,119.4
32,강원도,025,20~24세,2018,105492,60397,45095,133.9,100643,57582,43061,133.7
32,강원도,025001, 20세,2018,20853,11383,9470,120.2,19974,10923,9051,120.7
32,강원도,025002, 21세,2018,20913,11378,9535,119.3,20017,10887,9130,119.2
32,강원도,025003, 22세,2018,21465,12029,9436,127.5,20455,11414,9041,126.2
32,강원도,025004, 23세,2018,21224,12663,8561,147.9,20198,12039,8159,147.6
32,강원도,025005, 24세,2018,21037,12944,8093,159.9,19999,12319,7680,160.4
32,강원도,030,25~29세,2018,86744,49825,36919,135,82242,47198,35044,134.7
32,강원도,030001, 25세,2018,19685,11898,7787,152.8,18663,11284,7379,152.9
32,강원도,030002, 26세,2018,18772,10846,7926,136.8,17844,10321,7523,137.2
32,강원도,030003, 27세,2018,17017,9605,7412,129.6,16122,9092,7030,129.3
32,강원도,030004, 28세,2018,15918,8900,7018,126.8,15065,8409,6656,126.3
32,강원도,030005, 29세,2018,15352,8576,6776,126.6,14548,8092,6456,125.3
32,강원도,035,30~34세,2018,76859,41343,35516,116.4,73190,39284,33906,115.9
32,강원도,035001, 30세,2018,15134,8227,6907,119.1,14357,7798,6559,118.9
32,강원도,035002, 31세,2018,14954,8062,6892,117,14172,7601,6571,115.7
32,강원도,035003, 32세,2018,15216,8193,7023,116.7,14488,7803,6685,116.7
32,강원도,035004, 33세,2018,15444,8299,7145,116.2,14696,7886,6810,115.8
32,강원도,035005, 34세,2018,16111,8562,7549,113.4,15477,8196,7281,112.6
32,강원도,040,35~39세,2018,98178,50306,47872,105.1,95467,48778,46689,104.5
32,강원도,040001, 35세,2018,18026,9405,8621,109.1,17390,9045,8345,108.4
32,강원도,040002, 36세,2018,19855,10120,9735,104,19275,9796,9479,103.3
32,강원도,040003, 37세,2018,20049,10446,9603,108.8,19554,10147,9407,107.9
32,강원도,040004, 38세,2018,20495,10317,10178,101.4,19957,10024,9933,100.9
32,강원도,040005, 39세,2018,19753,10018,9735,102.9,19291,9766,9525,102.5
32,강원도,045,40~44세,2018,103412,52901,50511,104.7,101603,51922,49681,104.5
32,강원도,045001, 40세,2018,19237,9810,9427,104.1,18833,9580,9253,103.5
32,강원도,045002, 41세,2018,19743,10097,9646,104.7,19358,9886,9472,104.4
32,강원도,045003, 42세,2018,19727,10100,9627,104.9,19386,9906,9480,104.5
32,강원도,045004, 43세,2018,21004,10754,10250,104.9,20634,10569,10065,105
32,강원도,045005, 44세,2018,23701,12140,11561,105,23392,11981,11411,105
32,강원도,050,45~49세,2018,123948,64550,59398,108.7,122288,63742,58546,108.9
32,강원도,050001, 45세,2018,24117,12552,11565,108.5,23786,12375,11411,108.4
32,강원도,050002, 46세,2018,23401,12359,11042,111.9,23077,12200,10877,112.2
32,강원도,050003, 47세,2018,25443,13142,12301,106.8,25115,12978,12137,106.9
32,강원도,050004, 48세,2018,24971,13062,11909,109.7,24616,12891,11725,109.9
32,강원도,050005, 49세,2018,26016,13435,12581,106.8,25694,13298,12396,107.3
32,강원도,055,50~54세,2018,122446,63047,59399,106.1,121053,62461,58592,106.6
32,강원도,055001, 50세,2018,26312,13680,12632,108.3,26001,13546,12455,108.8
32,강원도,055002, 51세,2018,24067,12298,11769,104.5,23814,12189,11625,104.9
32,강원도,055003, 52세,2018,24607,12888,11719,110,24313,12764,11549,110.5
32,강원도,055004, 53세,2018,23628,11819,11809,100.1,23343,11700,11643,100.5
32,강원도,055005, 54세,2018,23832,12362,11470,107.8,23582,12262,11320,108.3
32,강원도,060,55~59세,2018,139915,70108,69807,100.4,138897,69679,69218,100.7
32,강원도,060001, 55세,2018,25595,13133,12462,105.4,25333,13033,12300,106
32,강원도,060002, 56세,2018,27218,13907,13311,104.5,27016,13818,13198,104.7
32,강원도,060003, 57세,2018,30185,15003,15182,98.8,30013,14934,15079,99
32,강원도,060004, 58세,2018,29726,14534,15192,95.7,29531,14448,15083,95.8
32,강원도,060005, 59세,2018,27191,13531,13660,99.1,27004,13446,13558,99.2
32,강원도,065,60~64세,2018,121823,61442,60381,101.8,121149,61125,60024,101.8
32,강원도,065001, 60세,2018,26776,13435,13341,100.7,26623,13370,13253,100.9
32,강원도,065002, 61세,2018,26398,13496,12902,104.6,26240,13423,12817,104.7
32,강원도,065003, 62세,2018,23866,12050,11816,102,23734,11990,11744,102.1
32,강원도,065004, 63세,2018,23839,11975,11864,100.9,23725,11919,11806,101
32,강원도,065005, 64세,2018,20944,10486,10458,100.3,20827,10423,10404,100.2
32,강원도,070,65~69세,2018,77594,37366,40228,92.9,77199,37191,40008,93
32,강원도,070001, 65세,2018,17305,8521,8784,97,17208,8478,8730,97.1
32,강원도,070002, 66세,2018,20884,10246,10638,96.3,20793,10203,10590,96.3
32,강원도,070003, 67세,2018,12252,5787,6465,89.5,12170,5749,6421,89.5
32,강원도,070004, 68세,2018,13176,6100,7076,86.2,13112,6072,7040,86.3
32,강원도,070005, 69세,2018,13977,6712,7265,92.4,13916,6689,7227,92.6
32,강원도,075,70~74세,2018,68572,31587,36985,85.4,68413,31503,36910,85.4
32,강원도,075001, 70세,2018,14744,6925,7819,88.6,14710,6906,7804,88.5
32,강원도,075002, 71세,2018,14798,7005,7793,89.9,14761,6991,7770,90
32,강원도,075003, 72세,2018,12396,5748,6648,86.5,12356,5725,6631,86.3
32,강원도,075004, 73세,2018,13442,6142,7300,84.1,13414,6126,7288,84.1
32,강원도,075005, 74세,2018,13192,5767,7425,77.7,13172,5755,7417,77.6
32,강원도,080,75~79세,2018,64655,27142,37513,72.4,64557,27097,37460,72.3
32,강원도,080001, 75세,2018,13183,5713,7470,76.5,13156,5699,7457,76.4
32,강원도,080002, 76세,2018,14593,6272,8321,75.4,14571,6264,8307,75.4
32,강원도,080003, 77세,2018,13027,5479,7548,72.6,13006,5472,7534,72.6
32,강원도,080004, 78세,2018,12252,5012,7240,69.2,12238,5002,7236,69.1
32,강원도,080005, 79세,2018,11600,4666,6934,67.3,11586,4660,6926,67.3
32,강원도,085,80~84세,2018,41514,15260,26254,58.1,41455,15235,26220,58.1
32,강원도,085001, 80세,2018,10759,4278,6481,66,10747,4275,6472,66.1
32,강원도,085002, 81세,2018,9173,3578,5595,63.9,9156,3568,5588,63.9
32,강원도,085003, 82세,2018,8225,3074,5151,59.7,8218,3072,5146,59.7
32,강원도,085004, 83세,2018,7311,2442,4869,50.2,7303,2440,4863,50.2
32,강원도,085005, 84세,2018,6046,1888,4158,45.4,6031,1880,4151,45.3
32,강원도,090,85~89세,2018,18843,5151,13692,37.6,18820,5144,13676,37.6
32,강원도,090001, 85세,2018,5061,1534,3527,43.5,5050,1530,3520,43.5
32,강원도,090002, 86세,2018,4200,1173,3027,38.8,4195,1172,3023,38.8
32,강원도,090003, 87세,2018,3485,951,2534,37.5,3484,950,2534,37.5
32,강원도,090004, 88세,2018,3333,833,2500,33.3,3328,832,2496,33.3
32,강원도,090005, 89세,2018,2764,660,2104,31.4,2763,660,2103,31.4
32,강원도,095,90~94세,2018,6971,1589,5382,29.5,6966,1587,5379,29.5
32,강원도,095001, 90세,2018,2132,474,1658,28.6,2131,473,1658,28.5
32,강원도,095002, 91세,2018,1724,387,1337,28.9,1722,386,1336,28.9
32,강원도,095003, 92세,2018,1279,266,1013,26.3,1277,266,1011,26.3
32,강원도,095004, 93세,2018,1063,266,797,33.4,1063,266,797,33.4
32,강원도,095005, 94세,2018,773,196,577,34,773,196,577,34
32,강원도,100,95~99세,2018,1687,430,1257,34.2,1682,429,1253,34.2
32,강원도,100001, 95세,2018,665,191,474,40.3,665,191,474,40.3
32,강원도,100002, 96세,2018,438,115,323,35.6,435,115,320,35.9
32,강원도,100003, 97세,2018,277,53,224,23.7,277,53,224,23.7
32,강원도,100004, 98세,2018,166,40,126,31.7,165,40,125,32
32,강원도,100005, 99세,2018,141,31,110,28.2,140,30,110,27.3
32,강원도,101,100세이상,2018,200,36,164,22,200,36,164,22
32,강원도,102,15세미만,2018,176318,90765,85553,106.1,175966,90594,85372,106.1
32,강원도,103,15~64세,2018,1064037,559278,504759,110.8,1040984,546711,494273,110.6
32,강원도,104,65세이상,2018,280036,118561,161475,73.4,279292,118222,161070,73.4
32,강원도,086,85세이상,2018,27701,7206,20495,35.2,27668,7196,20472,35.2
32,강원도,126,평균연령,2018,44.3,42.6,45.9,,44.4,42.8,46.1,
32,강원도,127,중위연령,2018,46.2,44.5,48,,46.5,44.8,48.2,
32004, 읍부,000,합계,2018,259555,133133,126422,105.3,255141,130673,124468,105
32004, 읍부,005,0~4세,2018,8719,4442,4277,103.9,8694,4428,4266,103.8
32004, 읍부,005001, 0세,2018,1519,766,753,101.7,1516,765,751,101.9
32004, 읍부,005002, 1세,2018,1677,843,834,101.1,1671,840,831,101.1
32004, 읍부,005003, 2세,2018,1791,929,862,107.8,1787,925,862,107.3
32004, 읍부,005004, 3세,2018,1894,965,929,103.9,1889,962,927,103.8
32004, 읍부,005005, 4세,2018,1838,939,899,104.4,1831,936,895,104.6
32004, 읍부,010,5~9세,2018,10319,5272,5047,104.5,10308,5269,5039,104.6
32004, 읍부,010001, 5세,2018,1867,913,954,95.7,1865,912,953,95.7
32004, 읍부,010002, 6세,2018,2152,1101,1051,104.8,2150,1100,1050,104.8
32004, 읍부,010003, 7세,2018,2143,1115,1028,108.5,2142,1115,1027,108.6
32004, 읍부,010004, 8세,2018,2131,1106,1025,107.9,2131,1106,1025,107.9
32004, 읍부,010005, 9세,2018,2026,1037,989,104.9,2020,1036,984,105.3
32004, 읍부,015,10~14세,2018,10719,5578,5141,108.5,10708,5571,5137,108.4
32004, 읍부,015001, 10세,2018,2186,1141,1045,109.2,2184,1140,1044,109.2
32004, 읍부,015002, 11세,2018,2157,1116,1041,107.2,2154,1115,1039,107.3
32004, 읍부,015003, 12세,2018,2093,1097,996,110.1,2090,1094,996,109.8
32004, 읍부,015004, 13세,2018,2120,1116,1004,111.2,2119,1115,1004,111.1
32004, 읍부,015005, 14세,2018,2163,1108,1055,105,2161,1107,1054,105
32004, 읍부,020,15~19세,2018,14293,7533,6760,111.4,14247,7512,6735,111.5
32004, 읍부,020001, 15세,2018,2291,1184,1107,107,2287,1183,1104,107.2
32004, 읍부,020002, 16세,2018,2695,1400,1295,108.1,2692,1398,1294,108
32004, 읍부,020003, 17세,2018,3096,1665,1431,116.4,3090,1662,1428,116.4
32004, 읍부,020004, 18세,2018,3200,1682,1518,110.8,3186,1679,1507,111.4
32004, 읍부,020005, 19세,2018,3011,1602,1409,113.7,2992,1590,1402,113.4
32004, 읍부,025,20~24세,2018,16204,9646,6558,147.1,15597,9276,6321,146.7
32004, 읍부,025001, 20세,2018,3102,1745,1357,128.6,3058,1716,1342,127.9
32004, 읍부,025002, 21세,2018,3232,1799,1433,125.5,3148,1758,1390,126.5
32004, 읍부,025003, 22세,2018,3219,1853,1366,135.7,3108,1780,1328,134
32004, 읍부,025004, 23세,2018,3303,2078,1225,169.6,3139,1978,1161,170.4
32004, 읍부,025005, 24세,2018,3348,2171,1177,184.5,3144,2044,1100,185.8
32004, 읍부,030,25~29세,2018,14771,8971,5800,154.7,13842,8377,5465,153.3
32004, 읍부,030001, 25세,2018,3128,2004,1124,178.3,2911,1862,1049,177.5
32004, 읍부,030002, 26세,2018,3161,1963,1198,163.9,2974,1834,1140,160.9
32004, 읍부,030003, 27세,2018,3041,1788,1253,142.7,2849,1681,1168,143.9
32004, 읍부,030004, 28세,2018,2779,1635,1144,142.9,2610,1530,1080,141.7
32004, 읍부,030005, 29세,2018,2662,1581,1081,146.3,2498,1470,1028,143
32004, 읍부,035,30~34세,2018,13091,7304,5787,126.2,12303,6827,5476,124.7
32004, 읍부,035001, 30세,2018,2557,1441,1116,129.1,2408,1345,1063,126.5
32004, 읍부,035002, 31세,2018,2653,1522,1131,134.6,2504,1429,1075,132.9
32004, 읍부,035003, 32세,2018,2591,1437,1154,124.5,2425,1345,1080,124.5
32004, 읍부,035004, 33세,2018,2571,1452,1119,129.8,2404,1354,1050,129
32004, 읍부,035005, 34세,2018,2719,1452,1267,114.6,2562,1354,1208,112.1
32004, 읍부,040,35~39세,2018,16110,8395,7715,108.8,15547,8065,7482,107.8
32004, 읍부,040001, 35세,2018,2937,1515,1422,106.5,2816,1439,1377,104.5
32004, 읍부,040002, 36세,2018,3246,1679,1567,107.1,3126,1609,1517,106.1
32004, 읍부,040003, 37세,2018,3328,1742,1586,109.8,3237,1691,1546,109.4
32004, 읍부,040004, 38세,2018,3391,1763,1628,108.3,3266,1691,1575,107.4
32004, 읍부,040005, 39세,2018,3208,1696,1512,112.2,3102,1635,1467,111.5
32004, 읍부,045,40~44세,2018,17133,9127,8006,114,16785,8936,7849,113.8
32004, 읍부,045001, 40세,2018,3231,1701,1530,111.2,3150,1655,1495,110.7
32004, 읍부,045002, 41세,2018,3324,1749,1575,111,3251,1702,1549,109.9
32004, 읍부,045003, 42세,2018,3274,1758,1516,116,3202,1712,1490,114.9
32004, 읍부,045004, 43세,2018,3448,1815,1633,111.1,3379,1789,1590,112.5
32004, 읍부,045005, 44세,2018,3856,2104,1752,120.1,3803,2078,1725,120.5
32004, 읍부,050,45~49세,2018,20080,10826,9254,117,19720,10661,9059,117.7
32004, 읍부,050001, 45세,2018,3892,2119,1773,119.5,3827,2084,1743,119.6
32004, 읍부,050002, 46세,2018,3805,2031,1774,114.5,3744,2003,1741,115
32004, 읍부,050003, 47세,2018,4091,2191,1900,115.3,4016,2155,1861,115.8
32004, 읍부,050004, 48세,2018,4040,2197,1843,119.2,3964,2161,1803,119.9
32004, 읍부,050005, 49세,2018,4252,2288,1964,116.5,4169,2258,1911,118.2
32004, 읍부,055,50~54세,2018,20388,10877,9511,114.4,20081,10761,9320,115.5
32004, 읍부,055001, 50세,2018,4327,2374,1953,121.6,4258,2352,1906,123.4
32004, 읍부,055002, 51세,2018,3860,2017,1843,109.4,3806,1995,1811,110.2
32004, 읍부,055003, 52세,2018,4112,2216,1896,116.9,4043,2185,1858,117.6
32004, 읍부,055004, 53세,2018,3989,2039,1950,104.6,3923,2015,1908,105.6
32004, 읍부,055005, 54세,2018,4100,2231,1869,119.4,4051,2214,1837,120.5
32004, 읍부,060,55~59세,2018,23958,12466,11492,108.5,23773,12389,11384,108.8
32004, 읍부,060001, 55세,2018,4402,2360,2042,115.6,4362,2345,2017,116.3
32004, 읍부,060002, 56세,2018,4667,2465,2202,111.9,4628,2445,2183,112
32004, 읍부,060003, 57세,2018,5161,2678,2483,107.9,5125,2665,2460,108.3
32004, 읍부,060004, 58세,2018,5140,2588,2552,101.4,5103,2573,2530,101.7
32004, 읍부,060005, 59세,2018,4588,2375,2213,107.3,4555,2361,2194,107.6
32004, 읍부,065,60~64세,2018,21383,10829,10554,102.6,21268,10778,10490,102.7
32004, 읍부,065001, 60세,2018,4709,2432,2277,106.8,4684,2424,2260,107.3
32004, 읍부,065002, 61세,2018,4498,2343,2155,108.7,4457,2326,2131,109.2
32004, 읍부,065003, 62세,2018,4259,2120,2139,99.1,4238,2111,2127,99.2
32004, 읍부,065004, 63세,2018,4165,2103,2062,102,4152,2095,2057,101.8
32004, 읍부,065005, 64세,2018,3752,1831,1921,95.3,3737,1822,1915,95.1
32004, 읍부,070,65~69세,2018,14032,6663,7369,90.4,13962,6635,7327,90.6
32004, 읍부,070001, 65세,2018,3006,1445,1561,92.6,2988,1439,1549,92.9
32004, 읍부,070002, 66세,2018,3615,1768,1847,95.7,3594,1759,1835,95.9
32004, 읍부,070003, 67세,2018,2297,1079,1218,88.6,2284,1075,1209,88.9
32004, 읍부,070004, 68세,2018,2431,1122,1309,85.7,2420,1116,1304,85.6
32004, 읍부,070005, 69세,2018,2683,1249,1434,87.1,2676,1246,1430,87.1
32004, 읍부,075,70~74세,2018,12977,5873,7104,82.7,12953,5865,7088,82.7
32004, 읍부,075001, 70세,2018,2689,1230,1459,84.3,2686,1230,1456,84.5
32004, 읍부,075002, 71세,2018,2838,1297,1541,84.2,2831,1295,1536,84.3
32004, 읍부,075003, 72세,2018,2361,1077,1284,83.9,2355,1075,1280,84
32004, 읍부,075004, 73세,2018,2589,1184,1405,84.3,2583,1180,1403,84.1
32004, 읍부,075005, 74세,2018,2500,1085,1415,76.7,2498,1085,1413,76.8
32004, 읍부,080,75~79세,2018,12620,5235,7385,70.9,12607,5230,7377,70.9
32004, 읍부,080001, 75세,2018,2549,1079,1470,73.4,2545,1077,1468,73.4
32004, 읍부,080002, 76세,2018,2869,1232,1637,75.3,2866,1232,1634,75.4
32004, 읍부,080003, 77세,2018,2545,1058,1487,71.1,2543,1058,1485,71.2
32004, 읍부,080004, 78세,2018,2400,957,1443,66.3,2398,955,1443,66.2
32004, 읍부,080005, 79세,2018,2257,909,1348,67.4,2255,908,1347,67.4
32004, 읍부,085,80~84세,2018,7608,2714,4894,55.5,7597,2711,4886,55.5
32004, 읍부,085001, 80세,2018,1973,764,1209,63.2,1971,764,1207,63.3
32004, 읍부,085002, 81세,2018,1743,647,1096,59,1740,645,1095,58.9
32004, 읍부,085003, 82세,2018,1484,559,925,60.4,1482,558,924,60.4
32004, 읍부,085004, 83세,2018,1308,431,877,49.1,1305,431,874,49.3
32004, 읍부,085005, 84세,2018,1100,313,787,39.8,1099,313,786,39.8
32004, 읍부,090,85~89세,2018,3509,990,2519,39.3,3509,990,2519,39.3
32004, 읍부,090001, 85세,2018,953,301,652,46.2,953,301,652,46.2
32004, 읍부,090002, 86세,2018,770,229,541,42.3,770,229,541,42.3
32004, 읍부,090003, 87세,2018,622,165,457,36.1,622,165,457,36.1
32004, 읍부,090004, 88세,2018,637,155,482,32.2,637,155,482,32.2
32004, 읍부,090005, 89세,2018,527,140,387,36.2,527,140,387,36.2
32004, 읍부,095,90~94세,2018,1299,303,996,30.4,1298,303,995,30.5
32004, 읍부,095001, 90세,2018,396,86,310,27.7,396,86,310,27.7
32004, 읍부,095002, 91세,2018,317,77,240,32.1,317,77,240,32.1
32004, 읍부,095003, 92세,2018,225,41,184,22.3,224,41,183,22.4
32004, 읍부,095004, 93세,2018,206,58,148,39.2,206,58,148,39.2
32004, 읍부,095005, 94세,2018,155,41,114,36,155,41,114,36
32004, 읍부,100,95~99세,2018,304,81,223,36.3,304,81,223,36.3
32004, 읍부,100001, 95세,2018,125,32,93,34.4,125,32,93,34.4
32004, 읍부,100002, 96세,2018,73,20,53,37.7,73,20,53,37.7
32004, 읍부,100003, 97세,2018,56,14,42,33.3,56,14,42,33.3
32004, 읍부,100004, 98세,2018,27,10,17,58.8,27,10,17,58.8
32004, 읍부,100005, 99세,2018,23,5,18,27.8,23,5,18,27.8
32004, 읍부,101,100세이상,2018,38,8,30,26.7,38,8,30,26.7
32004, 읍부,102,15세미만,2018,29757,15292,14465,105.7,29710,15268,14442,105.7
32004, 읍부,103,15~64세,2018,177411,95974,81437,117.9,173163,93582,79581,117.6
32004, 읍부,104,65세이상,2018,52387,21867,30520,71.6,52268,21823,30445,71.7
32004, 읍부,086,85세이상,2018,5150,1382,3768,36.7,5149,1382,3767,36.7
32004, 읍부,126,평균연령,2018,45.1,43.3,47,,45.2,43.4,47.1,
32004, 읍부,127,중위연령,2018,47.2,45.1,49.4,,47.5,45.5,49.7,
32005, 면부,000,합계,2018,342341,177964,164377,108.3,334944,173722,161222,107.8
32005, 면부,005,0~4세,2018,8539,4370,4169,104.8,8528,4362,4166,104.7
32005, 면부,005001, 0세,2018,1490,741,749,98.9,1487,739,748,98.8
32005, 면부,005002, 1세,2018,1617,839,778,107.8,1615,837,778,107.6
32005, 면부,005003, 2세,2018,1771,902,869,103.8,1766,899,867,103.7
32005, 면부,005004, 3세,2018,1802,941,861,109.3,1801,940,861,109.2
32005, 면부,005005, 4세,2018,1859,947,912,103.8,1859,947,912,103.8
32005, 면부,010,5~9세,2018,10210,5317,4893,108.7,10184,5304,4880,108.7
32005, 면부,010001, 5세,2018,1916,1018,898,113.4,1911,1014,897,113
32005, 면부,010002, 6세,2018,2104,1066,1038,102.7,2096,1062,1034,102.7
32005, 면부,010003, 7세,2018,2071,1121,950,118,2065,1119,946,118.3
32005, 면부,010004, 8세,2018,2100,1087,1013,107.3,2095,1085,1010,107.4
32005, 면부,010005, 9세,2018,2019,1025,994,103.1,2017,1024,993,103.1
32005, 면부,015,10~14세,2018,10051,5215,4836,107.8,10021,5201,4820,107.9
32005, 면부,015001, 10세,2018,2093,1080,1013,106.6,2091,1080,1011,106.8
32005, 면부,015002, 11세,2018,2082,1047,1035,101.2,2074,1043,1031,101.2
32005, 면부,015003, 12세,2018,1930,1016,914,111.2,1922,1012,910,111.2
32005, 면부,015004, 13세,2018,1886,986,900,109.6,1880,983,897,109.6
32005, 면부,015005, 14세,2018,2060,1086,974,111.5,2054,1083,971,111.5
32005, 면부,020,15~19세,2018,14293,7738,6555,118,14107,7642,6465,118.2
32005, 면부,020001, 15세,2018,2106,1109,997,111.2,2102,1108,994,111.5
32005, 면부,020002, 16세,2018,2295,1206,1089,110.7,2292,1205,1087,110.9
32005, 면부,020003, 17세,2018,2739,1420,1319,107.7,2727,1414,1313,107.7
32005, 면부,020004, 18세,2018,3183,1718,1465,117.3,3132,1693,1439,117.7
32005, 면부,020005, 19세,2018,3970,2285,1685,135.6,3854,2222,1632,136.2
32005, 면부,025,20~24세,2018,22083,13575,8508,159.6,20614,12621,7993,157.9
32005, 면부,025001, 20세,2018,4223,2376,1847,128.6,3992,2254,1738,129.7
32005, 면부,025002, 21세,2018,4135,2261,1874,120.7,3851,2075,1776,116.8
32005, 면부,025003, 22세,2018,4460,2694,1766,152.5,4117,2444,1673,146.1
32005, 면부,025004, 23세,2018,4539,2982,1557,191.5,4216,2767,1449,191
32005, 면부,025005, 24세,2018,4726,3262,1464,222.8,4438,3081,1357,227
32005, 면부,030,25~29세,2018,18458,11697,6761,173,17011,10771,6240,172.6
32005, 면부,030001, 25세,2018,4352,2979,1373,217,4037,2767,1270,217.9
32005, 면부,030002, 26세,2018,3995,2525,1470,171.8,3694,2345,1349,173.8
32005, 면부,030003, 27세,2018,3705,2305,1400,164.6,3413,2109,1304,161.7
32005, 면부,030004, 28세,2018,3318,2016,1302,154.8,3056,1849,1207,153.2
32005, 면부,030005, 29세,2018,3088,1872,1216,153.9,2811,1701,1110,153.2
32005, 면부,035,30~34세,2018,15170,8740,6430,135.9,13972,8033,5939,135.3
32005, 면부,035001, 30세,2018,3066,1821,1245,146.3,2817,1676,1141,146.9
32005, 면부,035002, 31세,2018,2991,1739,1252,138.9,2720,1579,1141,138.4
32005, 면부,035003, 32세,2018,3072,1771,1301,136.1,2839,1637,1202,136.2
32005, 면부,035004, 33세,2018,2994,1699,1295,131.2,2751,1554,1197,129.8
32005, 면부,035005, 34세,2018,3047,1710,1337,127.9,2845,1587,1258,126.2
32005, 면부,040,35~39세,2018,17552,9664,7888,122.5,16640,9134,7506,121.7
32005, 면부,040001, 35세,2018,3324,1860,1464,127,3107,1728,1379,125.3
32005, 면부,040002, 36세,2018,3574,1954,1620,120.6,3370,1843,1527,120.7
32005, 면부,040003, 37세,2018,3538,2012,1526,131.8,3383,1910,1473,129.7
32005, 면부,040004, 38세,2018,3591,1925,1666,115.5,3418,1837,1581,116.2
32005, 면부,040005, 39세,2018,3525,1913,1612,118.7,3362,1816,1546,117.5
32005, 면부,045,40~44세,2018,17736,9994,7742,129.1,17204,9699,7505,129.2
32005, 면부,045001, 40세,2018,3349,1871,1478,126.6,3224,1802,1422,126.7
32005, 면부,045002, 41세,2018,3394,1896,1498,126.6,3272,1826,1446,126.3
32005, 면부,045003, 42세,2018,3421,1976,1445,136.7,3325,1916,1409,136
32005, 면부,045004, 43세,2018,3537,2004,1533,130.7,3447,1959,1488,131.7
32005, 면부,045005, 44세,2018,4035,2247,1788,125.7,3936,2196,1740,126.2
32005, 면부,050,45~49세,2018,22178,12447,9731,127.9,21716,12223,9493,128.8
32005, 면부,050001, 45세,2018,4138,2367,1771,133.7,4044,2319,1725,134.4
32005, 면부,050002, 46세,2018,4091,2378,1713,138.8,3985,2318,1667,139.1
32005, 면부,050003, 47세,2018,4502,2571,1931,133.1,4416,2528,1888,133.9
32005, 면부,050004, 48세,2018,4403,2389,2014,118.6,4308,2348,1960,119.8
32005, 면부,050005, 49세,2018,5044,2742,2302,119.1,4963,2710,2253,120.3
32005, 면부,055,50~54세,2018,26506,14076,12430,113.2,26127,13930,12197,114.2
32005, 면부,055001, 50세,2018,5295,2853,2442,116.8,5207,2820,2387,118.1
32005, 면부,055002, 51세,2018,4985,2681,2304,116.4,4926,2661,2265,117.5
32005, 면부,055003, 52세,2018,5303,2866,2437,117.6,5226,2834,2392,118.5
32005, 면부,055004, 53세,2018,5353,2784,2569,108.4,5280,2756,2524,109.2
32005, 면부,055005, 54세,2018,5570,2892,2678,108,5488,2859,2629,108.7
32005, 면부,060,55~59세,2018,36561,18660,17901,104.2,36250,18532,17718,104.6
32005, 면부,060001, 55세,2018,6212,3210,3002,106.9,6136,3179,2957,107.5
32005, 면부,060002, 56세,2018,6944,3664,3280,111.7,6869,3634,3235,112.3
32005, 면부,060003, 57세,2018,8062,4027,4035,99.8,8014,4009,4005,100.1
32005, 면부,060004, 58세,2018,7936,3969,3967,100.1,7876,3943,3933,100.3
32005, 면부,060005, 59세,2018,7407,3790,3617,104.8,7355,3767,3588,105
32005, 면부,065,60~64세,2018,35221,18385,16836,109.2,34999,18278,16721,109.3
32005, 면부,065001, 60세,2018,7647,3918,3729,105.1,7600,3900,3700,105.4
32005, 면부,065002, 61세,2018,7583,3989,3594,111,7534,3968,3566,111.3
32005, 면부,065003, 62세,2018,6827,3573,3254,109.8,6783,3550,3233,109.8
32005, 면부,065004, 63세,2018,6967,3624,3343,108.4,6928,3605,3323,108.5
32005, 면부,065005, 64세,2018,6197,3281,2916,112.5,6154,3255,2899,112.3
32005, 면부,070,65~69세,2018,22974,11606,11368,102.1,22864,11561,11303,102.3
32005, 면부,070001, 65세,2018,5126,2684,2442,109.9,5099,2674,2425,110.3
32005, 면부,070002, 66세,2018,6365,3318,3047,108.9,6341,3306,3035,108.9
32005, 면부,070003, 67세,2018,3578,1732,1846,93.8,3555,1721,1834,93.8
32005, 면부,070004, 68세,2018,3810,1819,1991,91.4,3791,1811,1980,91.5
32005, 면부,070005, 69세,2018,4095,2053,2042,100.5,4078,2049,2029,101
32005, 면부,075,70~74세,2018,20557,9955,10602,93.9,20510,9928,10582,93.8
32005, 면부,075001, 70세,2018,4322,2141,2181,98.2,4313,2134,2179,97.9
32005, 면부,075002, 71세,2018,4392,2239,2153,104,4379,2234,2145,104.1
32005, 면부,075003, 72세,2018,3800,1877,1923,97.6,3788,1869,1919,97.4
32005, 면부,075004, 73세,2018,4046,1932,2114,91.4,4037,1928,2109,91.4
32005, 면부,075005, 74세,2018,3997,1766,2231,79.2,3993,1763,2230,79.1
32005, 면부,080,75~79세,2018,20694,8948,11746,76.2,20664,8935,11729,76.2
32005, 면부,080001, 75세,2018,4056,1799,2257,79.7,4046,1793,2253,79.6
32005, 면부,080002, 76세,2018,4625,2063,2562,80.5,4618,2061,2557,80.6
32005, 면부,080003, 77세,2018,4227,1817,2410,75.4,4221,1816,2405,75.5
32005, 면부,080004, 78세,2018,3986,1729,2257,76.6,3981,1726,2255,76.5
32005, 면부,080005, 79세,2018,3800,1540,2260,68.1,3798,1539,2259,68.1
32005, 면부,085,80~84세,2018,14084,5178,8906,58.1,14072,5175,8897,58.2
32005, 면부,085001, 80세,2018,3617,1447,2170,66.7,3615,1447,2168,66.7
32005, 면부,085002, 81세,2018,3129,1228,1901,64.6,3123,1225,1898,64.5
32005, 면부,085003, 82세,2018,2803,1075,1728,62.2,2801,1075,1726,62.3
32005, 면부,085004, 83세,2018,2473,820,1653,49.6,2473,820,1653,49.6
32005, 면부,085005, 84세,2018,2062,608,1454,41.8,2060,608,1452,41.9
32005, 면부,090,85~89세,2018,6296,1657,4639,35.7,6288,1653,4635,35.7
32005, 면부,090001, 85세,2018,1660,482,1178,40.9,1657,480,1177,40.8
32005, 면부,090002, 86세,2018,1409,376,1033,36.4,1408,376,1032,36.4
32005, 면부,090003, 87세,2018,1224,330,894,36.9,1223,329,894,36.8
32005, 면부,090004, 88세,2018,1107,265,842,31.5,1104,264,840,31.4
32005, 면부,090005, 89세,2018,896,204,692,29.5,896,204,692,29.5
32005, 면부,095,90~94세,2018,2467,574,1893,30.3,2464,573,1891,30.3
32005, 면부,095001, 90세,2018,716,168,548,30.7,715,167,548,30.5
32005, 면부,095002, 91세,2018,587,109,478,22.8,586,109,477,22.9
32005, 면부,095003, 92세,2018,463,102,361,28.3,462,102,360,28.3
32005, 면부,095004, 93세,2018,397,107,290,36.9,397,107,290,36.9
32005, 면부,095005, 94세,2018,304,88,216,40.7,304,88,216,40.7
32005, 면부,100,95~99세,2018,635,154,481,32,633,153,480,31.9
32005, 면부,100001, 95세,2018,254,69,185,37.3,254,69,185,37.3
32005, 면부,100002, 96세,2018,166,44,122,36.1,165,44,121,36.4
32005, 면부,100003, 97세,2018,96,13,83,15.7,96,13,83,15.7
32005, 면부,100004, 98세,2018,59,11,48,22.9,59,11,48,22.9
32005, 면부,100005, 99세,2018,60,17,43,39.5,59,16,43,37.2
32005, 면부,101,100세이상,2018,76,14,62,22.6,76,14,62,22.6
32005, 면부,102,15세미만,2018,28800,14902,13898,107.2,28733,14867,13866,107.2
32005, 면부,103,15~64세,2018,225758,124976,100782,124,218640,120863,97777,123.6
32005, 면부,104,65세이상,2018,87783,38086,49697,76.6,87571,37992,49579,76.6
32005, 면부,086,85세이상,2018,9474,2399,7075,33.9,9461,2393,7068,33.9
32005, 면부,126,평균연령,2018,49,46.9,51.4,,49.3,47.2,51.6,
32005, 면부,127,중위연령,2018,52.9,50.1,55.7,,53.4,50.7,56.1,
32003, 동부,000,합계,2018,918495,457507,460988,99.2,906157,451132,455025,99.1
32003, 동부,005,0~4세,2018,32931,16828,16103,104.5,32820,16777,16043,104.6
32003, 동부,005001, 0세,2018,5513,2842,2671,106.4,5489,2833,2656,106.7
32003, 동부,005002, 1세,2018,5985,3079,2906,106,5963,3069,2894,106
32003, 동부,005003, 2세,2018,6863,3541,3322,106.6,6835,3526,3309,106.6
32003, 동부,005004, 3세,2018,7269,3642,3627,100.4,7253,3635,3618,100.5
32003, 동부,005005, 4세,2018,7301,3724,3577,104.1,7280,3714,3566,104.2
32003, 동부,010,5~9세,2018,40977,20947,20030,104.6,40911,20914,19997,104.6
32003, 동부,010001, 5세,2018,7485,3822,3663,104.3,7476,3817,3659,104.3
32003, 동부,010002, 6세,2018,8573,4374,4199,104.2,8558,4367,4191,104.2
32003, 동부,010003, 7세,2018,8512,4330,4182,103.5,8491,4319,4172,103.5
32003, 동부,010004, 8세,2018,8255,4232,4023,105.2,8245,4227,4018,105.2
32003, 동부,010005, 9세,2018,8152,4189,3963,105.7,8141,4184,3957,105.7
32003, 동부,015,10~14세,2018,43853,22796,21057,108.3,43792,22768,21024,108.3
32003, 동부,015001, 10세,2018,8488,4356,4132,105.4,8473,4350,4123,105.5
32003, 동부,015002, 11세,2018,9046,4756,4290,110.9,9036,4753,4283,111
32003, 동부,015003, 12세,2018,8334,4308,4026,107,8319,4303,4016,107.1
32003, 동부,015004, 13세,2018,8580,4474,4106,109,8571,4467,4104,108.8
32003, 동부,015005, 14세,2018,9405,4902,4503,108.9,9393,4895,4498,108.8
32003, 동부,020,15~19세,2018,56634,30088,26546,113.3,56098,29786,26312,113.2
32003, 동부,020001, 15세,2018,9506,4928,4578,107.6,9498,4925,4573,107.7
32003, 동부,020002, 16세,2018,9886,5180,4706,110.1,9872,5171,4701,110
32003, 동부,020003, 17세,2018,11221,5965,5256,113.5,11189,5951,5238,113.6
32003, 동부,020004, 18세,2018,12669,6816,5853,116.5,12560,6763,5797,116.7
32003, 동부,020005, 19세,2018,13352,7199,6153,117,12979,6976,6003,116.2
32003, 동부,025,20~24세,2018,67205,37176,30029,123.8,64432,35685,28747,124.1
32003, 동부,025001, 20세,2018,13528,7262,6266,115.9,12924,6953,5971,116.4
32003, 동부,025002, 21세,2018,13546,7318,6228,117.5,13018,7054,5964,118.3
32003, 동부,025003, 22세,2018,13786,7482,6304,118.7,13230,7190,6040,119
32003, 동부,025004, 23세,2018,13382,7603,5779,131.6,12843,7294,5549,131.4
32003, 동부,025005, 24세,2018,12963,7511,5452,137.8,12417,7194,5223,137.7
32003, 동부,030,25~29세,2018,53515,29157,24358,119.7,51389,28050,23339,120.2
32003, 동부,030001, 25세,2018,12205,6915,5290,130.7,11715,6655,5060,131.5
32003, 동부,030002, 26세,2018,11616,6358,5258,120.9,11176,6142,5034,122
32003, 동부,030003, 27세,2018,10271,5512,4759,115.8,9860,5302,4558,116.3
32003, 동부,030004, 28세,2018,9821,5249,4572,114.8,9399,5030,4369,115.1
32003, 동부,030005, 29세,2018,9602,5123,4479,114.4,9239,4921,4318,114
32003, 동부,035,30~34세,2018,48598,25299,23299,108.6,46915,24424,22491,108.6
32003, 동부,035001, 30세,2018,9511,4965,4546,109.2,9132,4777,4355,109.7
32003, 동부,035002, 31세,2018,9310,4801,4509,106.5,8948,4593,4355,105.5
32003, 동부,035003, 32세,2018,9553,4985,4568,109.1,9224,4821,4403,109.5
32003, 동부,035004, 33세,2018,9879,5148,4731,108.8,9541,4978,4563,109.1
32003, 동부,035005, 34세,2018,10345,5400,4945,109.2,10070,5255,4815,109.1
32003, 동부,040,35~39세,2018,64516,32247,32269,99.9,63280,31579,31701,99.6
32003, 동부,040001, 35세,2018,11765,6030,5735,105.1,11467,5878,5589,105.2
32003, 동부,040002, 36세,2018,13035,6487,6548,99.1,12779,6344,6435,98.6
32003, 동부,040003, 37세,2018,13183,6692,6491,103.1,12934,6546,6388,102.5
32003, 동부,040004, 38세,2018,13513,6629,6884,96.3,13273,6496,6777,95.9
32003, 동부,040005, 39세,2018,13020,6409,6611,96.9,12827,6315,6512,97
32003, 동부,045,40~44세,2018,68543,33780,34763,97.2,67614,33287,34327,97
32003, 동부,045001, 40세,2018,12657,6238,6419,97.2,12459,6123,6336,96.6
32003, 동부,045002, 41세,2018,13025,6452,6573,98.2,12835,6358,6477,98.2
32003, 동부,045003, 42세,2018,13032,6366,6666,95.5,12859,6278,6581,95.4
32003, 동부,045004, 43세,2018,14019,6935,7084,97.9,13808,6821,6987,97.6
32003, 동부,045005, 44세,2018,15810,7789,8021,97.1,15653,7707,7946,97
32003, 동부,050,45~49세,2018,81690,41277,40413,102.1,80852,40858,39994,102.2
32003, 동부,050001, 45세,2018,16087,8066,8021,100.6,15915,7972,7943,100.4
32003, 동부,050002, 46세,2018,15505,7950,7555,105.2,15348,7879,7469,105.5
32003, 동부,050003, 47세,2018,16850,8380,8470,98.9,16683,8295,8388,98.9
32003, 동부,050004, 48세,2018,16528,8476,8052,105.3,16344,8382,7962,105.3
32003, 동부,050005, 49세,2018,16720,8405,8315,101.1,16562,8330,8232,101.2
32003, 동부,055,50~54세,2018,75552,38094,37458,101.7,74845,37770,37075,101.9
32003, 동부,055001, 50세,2018,16690,8453,8237,102.6,16536,8374,8162,102.6
32003, 동부,055002, 51세,2018,15222,7600,7622,99.7,15082,7533,7549,99.8
32003, 동부,055003, 52세,2018,15192,7806,7386,105.7,15044,7745,7299,106.1
32003, 동부,055004, 53세,2018,14286,6996,7290,96,14140,6929,7211,96.1
32003, 동부,055005, 54세,2018,14162,7239,6923,104.6,14043,7189,6854,104.9
32003, 동부,060,55~59세,2018,79396,38982,40414,96.5,78874,38758,40116,96.6
32003, 동부,060001, 55세,2018,14981,7563,7418,102,14835,7509,7326,102.5
32003, 동부,060002, 56세,2018,15607,7778,7829,99.3,15519,7739,7780,99.5
32003, 동부,060003, 57세,2018,16962,8298,8664,95.8,16874,8260,8614,95.9
32003, 동부,060004, 58세,2018,16650,7977,8673,92,16552,7932,8620,92
32003, 동부,060005, 59세,2018,15196,7366,7830,94.1,15094,7318,7776,94.1
32003, 동부,065,60~64세,2018,65219,32228,32991,97.7,64882,32069,32813,97.7
32003, 동부,065001, 60세,2018,14420,7085,7335,96.6,14339,7046,7293,96.6
32003, 동부,065002, 61세,2018,14317,7164,7153,100.2,14249,7129,7120,100.1
32003, 동부,065003, 62세,2018,12780,6357,6423,99,12713,6329,6384,99.1
32003, 동부,065004, 63세,2018,12707,6248,6459,96.7,12645,6219,6426,96.8
32003, 동부,065005, 64세,2018,10995,5374,5621,95.6,10936,5346,5590,95.6
32003, 동부,070,65~69세,2018,40588,19097,21491,88.9,40373,18995,21378,88.9
32003, 동부,070001, 65세,2018,9173,4392,4781,91.9,9121,4365,4756,91.8
32003, 동부,070002, 66세,2018,10904,5160,5744,89.8,10858,5138,5720,89.8
32003, 동부,070003, 67세,2018,6377,2976,3401,87.5,6331,2953,3378,87.4
32003, 동부,070004, 68세,2018,6935,3159,3776,83.7,6901,3145,3756,83.7
32003, 동부,070005, 69세,2018,7199,3410,3789,90,7162,3394,3768,90.1
32003, 동부,075,70~74세,2018,35038,15759,19279,81.7,34950,15710,19240,81.7
32003, 동부,075001, 70세,2018,7733,3554,4179,85,7711,3542,4169,85
32003, 동부,075002, 71세,2018,7568,3469,4099,84.6,7551,3462,4089,84.7
32003, 동부,075003, 72세,2018,6235,2794,3441,81.2,6213,2781,3432,81
32003, 동부,075004, 73세,2018,6807,3026,3781,80,6794,3018,3776,79.9
32003, 동부,075005, 74세,2018,6695,2916,3779,77.2,6681,2907,3774,77
32003, 동부,080,75~79세,2018,31341,12959,18382,70.5,31286,12932,18354,70.5
32003, 동부,080001, 75세,2018,6578,2835,3743,75.7,6565,2829,3736,75.7
32003, 동부,080002, 76세,2018,7099,2977,4122,72.2,7087,2971,4116,72.2
32003, 동부,080003, 77세,2018,6255,2604,3651,71.3,6242,2598,3644,71.3
32003, 동부,080004, 78세,2018,5866,2326,3540,65.7,5859,2321,3538,65.6
32003, 동부,080005, 79세,2018,5543,2217,3326,66.7,5533,2213,3320,66.7
32003, 동부,085,80~84세,2018,19822,7368,12454,59.2,19786,7349,12437,59.1
32003, 동부,085001, 80세,2018,5169,2067,3102,66.6,5161,2064,3097,66.6
32003, 동부,085002, 81세,2018,4301,1703,2598,65.6,4293,1698,2595,65.4
32003, 동부,085003, 82세,2018,3938,1440,2498,57.6,3935,1439,2496,57.7
32003, 동부,085004, 83세,2018,3530,1191,2339,50.9,3525,1189,2336,50.9
32003, 동부,085005, 84세,2018,2884,967,1917,50.4,2872,959,1913,50.1
32003, 동부,090,85~89세,2018,9038,2504,6534,38.3,9023,2501,6522,38.3
32003, 동부,090001, 85세,2018,2448,751,1697,44.3,2440,749,1691,44.3
32003, 동부,090002, 86세,2018,2021,568,1453,39.1,2017,567,1450,39.1
32003, 동부,090003, 87세,2018,1639,456,1183,38.5,1639,456,1183,38.5
32003, 동부,090004, 88세,2018,1589,413,1176,35.1,1587,413,1174,35.2
32003, 동부,090005, 89세,2018,1341,316,1025,30.8,1340,316,1024,30.9
32003, 동부,095,90~94세,2018,3205,712,2493,28.6,3204,711,2493,28.5
32003, 동부,095001, 90세,2018,1020,220,800,27.5,1020,220,800,27.5
32003, 동부,095002, 91세,2018,820,201,619,32.5,819,200,619,32.3
32003, 동부,095003, 92세,2018,591,123,468,26.3,591,123,468,26.3
32003, 동부,095004, 93세,2018,460,101,359,28.1,460,101,359,28.1
32003, 동부,095005, 94세,2018,314,67,247,27.1,314,67,247,27.1
32003, 동부,100,95~99세,2018,748,195,553,35.3,745,195,550,35.5
32003, 동부,100001, 95세,2018,286,90,196,45.9,286,90,196,45.9
32003, 동부,100002, 96세,2018,199,51,148,34.5,197,51,146,34.9
32003, 동부,100003, 97세,2018,125,26,99,26.3,125,26,99,26.3
32003, 동부,100004, 98세,2018,80,19,61,31.1,79,19,60,31.7
32003, 동부,100005, 99세,2018,58,9,49,18.4,58,9,49,18.4
32003, 동부,101,100세이상,2018,86,14,72,19.4,86,14,72,19.4
32003, 동부,102,15세미만,2018,117761,60571,57190,105.9,117523,60459,57064,105.9
32003, 동부,103,15~64세,2018,660868,338328,322540,104.9,649181,332266,316915,104.8
32003, 동부,104,65세이상,2018,139866,58608,81258,72.1,139453,58407,81046,72.1
32003, 동부,086,85세이상,2018,13077,3425,9652,35.5,13058,3421,9637,35.5
32003, 동부,126,평균연령,2018,42.3,40.8,43.7,,42.4,40.9,43.8,
32003, 동부,127,중위연령,2018,43.9,42.2,45.3,,44.1,42.5,45.4,
32010, 춘천시,000,합계,2018,284985,140158,144827,96.8,279542,137288,142254,96.5
32010, 춘천시,005,0~4세,2018,10114,5143,4971,103.5,10055,5117,4938,103.6
32010, 춘천시,005001, 0세,2018,1744,872,872,100,1730,867,863,100.5
32010, 춘천시,005002, 1세,2018,1768,894,874,102.3,1756,887,869,102.1
32010, 춘천시,005003, 2세,2018,2146,1108,1038,106.7,2130,1101,1029,107
32010, 춘천시,005004, 3세,2018,2187,1100,1087,101.2,2177,1096,1081,101.4
32010, 춘천시,005005, 4세,2018,2269,1169,1100,106.3,2262,1166,1096,106.4
32010, 춘천시,010,5~9세,2018,12400,6417,5983,107.3,12362,6394,5968,107.1
32010, 춘천시,010001, 5세,2018,2394,1222,1172,104.3,2387,1216,1171,103.8
32010, 춘천시,010002, 6세,2018,2583,1344,1239,108.5,2573,1340,1233,108.7
32010, 춘천시,010003, 7세,2018,2627,1366,1261,108.3,2616,1358,1258,107.9
32010, 춘천시,010004, 8세,2018,2448,1255,1193,105.2,2443,1253,1190,105.3
32010, 춘천시,010005, 9세,2018,2348,1230,1118,110,2343,1227,1116,109.9
32010, 춘천시,015,10~14세,2018,12613,6531,6082,107.4,12587,6520,6067,107.5
32010, 춘천시,015001, 10세,2018,2562,1311,1251,104.8,2557,1309,1248,104.9
32010, 춘천시,015002, 11세,2018,2545,1310,1235,106.1,2541,1309,1232,106.3
32010, 춘천시,015003, 12세,2018,2431,1243,1188,104.6,2424,1241,1183,104.9
32010, 춘천시,015004, 13세,2018,2462,1304,1158,112.6,2458,1301,1157,112.4
32010, 춘천시,015005, 14세,2018,2613,1363,1250,109,2607,1360,1247,109.1
32010, 춘천시,020,15~19세,2018,18356,9352,9004,103.9,18052,9177,8875,103.4
32010, 춘천시,020001, 15세,2018,2772,1425,1347,105.8,2770,1424,1346,105.8
32010, 춘천시,020002, 16세,2018,2828,1513,1315,115.1,2821,1507,1314,114.7
32010, 춘천시,020003, 17세,2018,3402,1765,1637,107.8,3388,1757,1631,107.7
32010, 춘천시,020004, 18세,2018,4112,2141,1971,108.6,4056,2116,1940,109.1
32010, 춘천시,020005, 19세,2018,5242,2508,2734,91.7,5017,2373,2644,89.8
32010, 춘천시,025,20~24세,2018,24044,12361,11683,105.8,22387,11408,10979,103.9
32010, 춘천시,025001, 20세,2018,5092,2434,2658,91.6,4686,2211,2475,89.3
32010, 춘천시,025002, 21세,2018,4843,2309,2534,91.1,4515,2132,2383,89.5
32010, 춘천시,025003, 22세,2018,5054,2558,2496,102.5,4719,2367,2352,100.6
32010, 춘천시,025004, 23세,2018,4755,2634,2121,124.2,4454,2450,2004,122.3
32010, 춘천시,025005, 24세,2018,4300,2426,1874,129.5,4013,2248,1765,127.4
32010, 춘천시,030,25~29세,2018,18122,9735,8387,116.1,17119,9199,7920,116.1
32010, 춘천시,030001, 25세,2018,4113,2278,1835,124.1,3846,2121,1725,123
32010, 춘천시,030002, 26세,2018,3967,2200,1767,124.5,3736,2076,1660,125.1
32010, 춘천시,030003, 27세,2018,3550,1878,1672,112.3,3365,1787,1578,113.2
32010, 춘천시,030004, 28세,2018,3362,1761,1601,110,3180,1669,1511,110.5
32010, 춘천시,030005, 29세,2018,3130,1618,1512,107,2992,1546,1446,106.9
32010, 춘천시,035,30~34세,2018,15951,8217,7734,106.2,15254,7862,7392,106.4
32010, 춘천시,035001, 30세,2018,3207,1655,1552,106.6,3043,1569,1474,106.4
32010, 춘천시,035002, 31세,2018,3079,1555,1524,102,2939,1478,1461,101.2
32010, 춘천시,035003, 32세,2018,3152,1632,1520,107.4,3011,1564,1447,108.1
32010, 춘천시,035004, 33세,2018,3219,1665,1554,107.1,3083,1599,1484,107.7
32010, 춘천시,035005, 34세,2018,3294,1710,1584,108,3178,1652,1526,108.3
32010, 춘천시,040,35~39세,2018,19719,9796,9923,98.7,19301,9586,9715,98.7
32010, 춘천시,040001, 35세,2018,3703,1880,1823,103.1,3603,1825,1778,102.6
32010, 춘천시,040002, 36세,2018,4031,1989,2042,97.4,3940,1942,1998,97.2
32010, 춘천시,040003, 37세,2018,3960,1954,2006,97.4,3889,1917,1972,97.2
32010, 춘천시,040004, 38세,2018,4150,2055,2095,98.1,4058,2011,2047,98.2
32010, 춘천시,040005, 39세,2018,3875,1918,1957,98,3811,1891,1920,98.5
32010, 춘천시,045,40~44세,2018,19484,9541,9943,96,19174,9384,9790,95.9
32010, 춘천시,045001, 40세,2018,3749,1893,1856,102,3681,1861,1820,102.3
32010, 춘천시,045002, 41세,2018,3690,1814,1876,96.7,3619,1781,1838,96.9
32010, 춘천시,045003, 42세,2018,3678,1772,1906,93,3613,1739,1874,92.8
32010, 춘천시,045004, 43세,2018,3974,1887,2087,90.4,3915,1859,2056,90.4
32010, 춘천시,045005, 44세,2018,4393,2175,2218,98.1,4346,2144,2202,97.4
32010, 춘천시,050,45~49세,2018,23454,11781,11673,100.9,23169,11645,11524,101
32010, 춘천시,050001, 45세,2018,4500,2224,2276,97.7,4444,2194,2250,97.5
32010, 춘천시,050002, 46세,2018,4548,2298,2250,102.1,4501,2278,2223,102.5
32010, 춘천시,050003, 47세,2018,4909,2476,2433,101.8,4857,2448,2409,101.6
32010, 춘천시,050004, 48세,2018,4623,2371,2252,105.3,4552,2338,2214,105.6
32010, 춘천시,050005, 49세,2018,4874,2412,2462,98,4815,2387,2428,98.3
32010, 춘천시,055,50~54세,2018,22317,11250,11067,101.7,22059,11138,10921,102
32010, 춘천시,055001, 50세,2018,4886,2433,2453,99.2,4827,2401,2426,99
32010, 춘천시,055002, 51세,2018,4537,2324,2213,105,4488,2297,2191,104.8
32010, 춘천시,055003, 52세,2018,4402,2226,2176,102.3,4342,2201,2141,102.8
32010, 춘천시,055004, 53세,2018,4083,2015,2068,97.4,4030,2001,2029,98.6
32010, 춘천시,055005, 54세,2018,4409,2252,2157,104.4,4372,2238,2134,104.9
32010, 춘천시,060,55~59세,2018,23588,11457,12131,94.4,23415,11381,12034,94.6
32010, 춘천시,060001, 55세,2018,4508,2252,2256,99.8,4463,2227,2236,99.6
32010, 춘천시,060002, 56세,2018,4660,2278,2382,95.6,4630,2271,2359,96.3
32010, 춘천시,060003, 57세,2018,5328,2601,2727,95.4,5298,2587,2711,95.4
32010, 춘천시,060004, 58세,2018,4647,2182,2465,88.5,4612,2167,2445,88.6
32010, 춘천시,060005, 59세,2018,4445,2144,2301,93.2,4412,2129,2283,93.3
32010, 춘천시,065,60~64세,2018,20124,9912,10212,97.1,20011,9859,10152,97.1
32010, 춘천시,065001, 60세,2018,4486,2183,2303,94.8,4461,2173,2288,95
32010, 춘천시,065002, 61세,2018,4329,2124,2205,96.3,4307,2116,2191,96.6
32010, 춘천시,065003, 62세,2018,3980,1963,2017,97.3,3959,1950,2009,97.1
32010, 춘천시,065004, 63세,2018,3987,1959,2028,96.6,3966,1950,2016,96.7
32010, 춘천시,065005, 64세,2018,3342,1683,1659,101.4,3318,1670,1648,101.3
32010, 춘천시,070,65~69세,2018,11851,5538,6313,87.7,11805,5519,6286,87.8
32010, 춘천시,070001, 65세,2018,2835,1349,1486,90.8,2824,1344,1480,90.8
32010, 춘천시,070002, 66세,2018,3351,1603,1748,91.7,3341,1599,1742,91.8
32010, 춘천시,070003, 67세,2018,1796,833,963,86.5,1786,830,956,86.8
32010, 춘천시,070004, 68세,2018,1857,824,1033,79.8,1850,821,1029,79.8
32010, 춘천시,070005, 69세,2018,2012,929,1083,85.8,2004,925,1079,85.7
32010, 춘천시,075,70~74세,2018,10860,4888,5972,81.8,10836,4875,5961,81.8
32010, 춘천시,075001, 70세,2018,2237,991,1246,79.5,2231,988,1243,79.5
32010, 춘천시,075002, 71세,2018,2413,1130,1283,88.1,2405,1126,1279,88
32010, 춘천시,075003, 72세,2018,2085,924,1161,79.6,2080,921,1159,79.5
32010, 춘천시,075004, 73세,2018,2132,978,1154,84.7,2128,976,1152,84.7
32010, 춘천시,075005, 74세,2018,1993,865,1128,76.7,1992,864,1128,76.6
32010, 춘천시,080,75~79세,2018,10412,4339,6073,71.4,10394,4329,6065,71.4
32010, 춘천시,080001, 75세,2018,2071,883,1188,74.3,2064,878,1186,74
32010, 춘천시,080002, 76세,2018,2399,1043,1356,76.9,2396,1041,1355,76.8
32010, 춘천시,080003, 77세,2018,2143,870,1273,68.3,2139,869,1270,68.4
32010, 춘천시,080004, 78세,2018,1950,798,1152,69.3,1950,798,1152,69.3
32010, 춘천시,080005, 79세,2018,1849,745,1104,67.5,1845,743,1102,67.4
32010, 춘천시,085,80~84세,2018,6866,2575,4291,60,6859,2573,4286,60
32010, 춘천시,085001, 80세,2018,1761,702,1059,66.3,1758,702,1056,66.5
32010, 춘천시,085002, 81세,2018,1513,605,908,66.6,1512,605,907,66.7
32010, 춘천시,085003, 82세,2018,1394,516,878,58.8,1393,515,878,58.7
32010, 춘천시,085004, 83세,2018,1231,424,807,52.5,1230,424,806,52.6
32010, 춘천시,085005, 84세,2018,967,328,639,51.3,966,327,639,51.2
32010, 춘천시,090,85~89세,2018,3179,956,2223,43,3174,954,2220,43
32010, 춘천시,090001, 85세,2018,843,263,580,45.3,841,262,579,45.3
32010, 춘천시,090002, 86세,2018,706,210,496,42.3,705,210,495,42.4
32010, 춘천시,090003, 87세,2018,572,173,399,43.4,572,173,399,43.4
32010, 춘천시,090004, 88세,2018,563,167,396,42.2,561,166,395,42
32010, 춘천시,090005, 89세,2018,495,143,352,40.6,495,143,352,40.6
32010, 춘천시,095,90~94세,2018,1206,276,930,29.7,1206,276,930,29.7
32010, 춘천시,095001, 90세,2018,367,75,292,25.7,367,75,292,25.7
32010, 춘천시,095002, 91세,2018,318,72,246,29.3,318,72,246,29.3
32010, 춘천시,095003, 92세,2018,213,42,171,24.6,213,42,171,24.6
32010, 춘천시,095004, 93세,2018,192,52,140,37.1,192,52,140,37.1
32010, 춘천시,095005, 94세,2018,116,35,81,43.2,116,35,81,43.2
32010, 춘천시,100,95~99세,2018,290,86,204,42.2,288,85,203,41.9
32010, 춘천시,100001, 95세,2018,103,37,66,56.1,103,37,66,56.1
32010, 춘천시,100002, 96세,2018,84,31,53,58.5,83,31,52,59.6
32010, 춘천시,100003, 97세,2018,51,9,42,21.4,51,9,42,21.4
32010, 춘천시,100004, 98세,2018,28,X,24,16.7,28,X,24,16.7
32010, 춘천시,100005, 99세,2018,24,5,19,26.3,23,X,19,21.1
32010, 춘천시,101,100세이상,2018,35,7,28,25,35,7,28,25
32010, 춘천시,102,15세미만,2018,35127,18091,17036,106.2,35004,18031,16973,106.2
32010, 춘천시,103,15~64세,2018,205159,103402,101757,101.6,199941,100639,99302,101.3
32010, 춘천시,104,65세이상,2018,44699,18665,26034,71.7,44597,18618,25979,71.7
32010, 춘천시,086,85세이상,2018,4710,1325,3385,39.1,4703,1322,3381,39.1
32010, 춘천시,126,평균연령,2018,42.1,40.8,43.4,,42.3,41,43.6,
32010, 춘천시,127,중위연령,2018,43,41.3,44.4,,43.4,41.9,44.8,
32020, 원주시,000,합계,2018,344168,171818,172350,99.7,339635,169333,170302,99.4
32020, 원주시,005,0~4세,2018,12798,6530,6268,104.2,12765,6513,6252,104.2
32020, 원주시,005001, 0세,2018,2103,1064,1039,102.4,2098,1062,1036,102.5
32020, 원주시,005002, 1세,2018,2418,1254,1164,107.7,2413,1251,1162,107.7
32020, 원주시,005003, 2세,2018,2640,1369,1271,107.7,2631,1363,1268,107.5
32020, 원주시,005004, 3세,2018,2839,1434,1405,102.1,2831,1429,1402,101.9
32020, 원주시,005005, 4세,2018,2798,1409,1389,101.4,2792,1408,1384,101.7
32020, 원주시,010,5~9세,2018,15984,8113,7871,103.1,15965,8108,7857,103.2
32020, 원주시,010001, 5세,2018,2860,1443,1417,101.8,2859,1442,1417,101.8
32020, 원주시,010002, 6세,2018,3331,1676,1655,101.3,3328,1675,1653,101.3
32020, 원주시,010003, 7세,2018,3272,1652,1620,102,3265,1650,1615,102.2
32020, 원주시,010004, 8세,2018,3293,1658,1635,101.4,3290,1657,1633,101.5
32020, 원주시,010005, 9세,2018,3228,1684,1544,109.1,3223,1684,1539,109.4
32020, 원주시,015,10~14세,2018,16893,8742,8151,107.3,16871,8734,8137,107.3
32020, 원주시,015001, 10세,2018,3310,1713,1597,107.3,3305,1711,1594,107.3
32020, 원주시,015002, 11세,2018,3609,1850,1759,105.2,3604,1850,1754,105.5
32020, 원주시,015003, 12세,2018,3169,1636,1533,106.7,3163,1634,1529,106.9
32020, 원주시,015004, 13세,2018,3269,1707,1562,109.3,3267,1706,1561,109.3
32020, 원주시,015005, 14세,2018,3536,1836,1700,108,3532,1833,1699,107.9
32020, 원주시,020,15~19세,2018,21595,11438,10157,112.6,21472,11381,10091,112.8
32020, 원주시,020001, 15세,2018,3516,1839,1677,109.7,3512,1837,1675,109.7
32020, 원주시,020002, 16세,2018,3636,1865,1771,105.3,3632,1863,1769,105.3
32020, 원주시,020003, 17세,2018,4159,2270,1889,120.2,4143,2264,1879,120.5
32020, 원주시,020004, 18세,2018,4691,2503,2188,114.4,4659,2488,2171,114.6
32020, 원주시,020005, 19세,2018,5593,2961,2632,112.5,5526,2929,2597,112.8
32020, 원주시,025,20~24세,2018,25970,13898,12072,115.1,25309,13526,11783,114.8
32020, 원주시,025001, 20세,2018,5465,2799,2666,105,5338,2745,2593,105.9
32020, 원주시,025002, 21세,2018,5348,2765,2583,107,5213,2688,2525,106.5
32020, 원주시,025003, 22세,2018,5247,2783,2464,112.9,5144,2718,2426,112
32020, 원주시,025004, 23세,2018,5028,2784,2244,124.1,4878,2695,2183,123.5
32020, 원주시,025005, 24세,2018,4882,2767,2115,130.8,4736,2680,2056,130.4
32020, 원주시,030,25~29세,2018,21313,11483,9830,116.8,20520,11003,9517,115.6
32020, 원주시,030001, 25세,2018,4725,2655,2070,128.3,4564,2552,2012,126.8
32020, 원주시,030002, 26세,2018,4556,2447,2109,116,4403,2358,2045,115.3
32020, 원주시,030003, 27세,2018,4212,2211,2001,110.5,4052,2115,1937,109.2
32020, 원주시,030004, 28세,2018,3960,2078,1882,110.4,3802,1988,1814,109.6
32020, 원주시,030005, 29세,2018,3860,2092,1768,118.3,3699,1990,1709,116.4
32020, 원주시,035,30~34세,2018,19802,10324,9478,108.9,19054,9878,9176,107.7
32020, 원주시,035001, 30세,2018,3880,2000,1880,106.4,3709,1898,1811,104.8
32020, 원주시,035002, 31세,2018,3747,1945,1802,107.9,3601,1851,1750,105.8
32020, 원주시,035003, 32세,2018,4039,2106,1933,108.9,3887,2020,1867,108.2
32020, 원주시,035004, 33세,2018,3988,2128,1860,114.4,3835,2036,1799,113.2
32020, 원주시,035005, 34세,2018,4148,2145,2003,107.1,4022,2073,1949,106.4
32020, 원주시,040,35~39세,2018,25346,12672,12674,100,24827,12372,12455,99.3
32020, 원주시,040001, 35세,2018,4792,2452,2340,104.8,4671,2382,2289,104.1
32020, 원주시,040002, 36세,2018,5151,2574,2577,99.9,5053,2516,2537,99.2
32020, 원주시,040003, 37세,2018,5195,2630,2565,102.5,5086,2565,2521,101.7
32020, 원주시,040004, 38세,2018,5166,2513,2653,94.7,5077,2462,2615,94.1
32020, 원주시,040005, 39세,2018,5042,2503,2539,98.6,4940,2447,2493,98.2
32020, 원주시,045,40~44세,2018,26278,12886,13392,96.2,25857,12658,13199,95.9
32020, 원주시,045001, 40세,2018,4856,2393,2463,97.2,4759,2332,2427,96.1
32020, 원주시,045002, 41세,2018,5101,2516,2585,97.3,5005,2466,2539,97.1
32020, 원주시,045003, 42세,2018,5044,2468,2576,95.8,4969,2418,2551,94.8
32020, 원주시,045004, 43세,2018,5299,2638,2661,99.1,5212,2597,2615,99.3
32020, 원주시,045005, 44세,2018,5978,2871,3107,92.4,5912,2845,3067,92.8
32020, 원주시,050,45~49세,2018,30540,15316,15224,100.6,30174,15136,15038,100.7
32020, 원주시,050001, 45세,2018,6029,2992,3037,98.5,5960,2951,3009,98.1
32020, 원주시,050002, 46세,2018,5845,2990,2855,104.7,5772,2959,2813,105.2
32020, 원주시,050003, 47세,2018,6266,3125,3141,99.5,6192,3084,3108,99.2
32020, 원주시,050004, 48세,2018,6110,3052,3058,99.8,6027,3014,3013,100
32020, 원주시,050005, 49세,2018,6290,3157,3133,100.8,6223,3128,3095,101.1
32020, 원주시,055,50~54세,2018,28603,14380,14223,101.1,28326,14254,14072,101.3
32020, 원주시,055001, 50세,2018,6241,3184,3057,104.2,6176,3161,3015,104.8
32020, 원주시,055002, 51세,2018,5644,2765,2879,96,5587,2743,2844,96.4
32020, 원주시,055003, 52세,2018,5800,2963,2837,104.4,5752,2940,2812,104.6
32020, 원주시,055004, 53세,2018,5733,2838,2895,98,5686,2807,2879,97.5
32020, 원주시,055005, 54세,2018,5185,2630,2555,102.9,5125,2603,2522,103.2
32020, 원주시,060,55~59세,2018,29716,14920,14796,100.8,29478,14807,14671,100.9
32020, 원주시,060001, 55세,2018,5628,2892,2736,105.7,5572,2873,2699,106.4
32020, 원주시,060002, 56세,2018,5931,2992,2939,101.8,5881,2970,2911,102
32020, 원주시,060003, 57세,2018,6309,3198,3111,102.8,6264,3175,3089,102.8
32020, 원주시,060004, 58세,2018,6270,3090,3180,97.2,6231,3068,3163,97
32020, 원주시,060005, 59세,2018,5578,2748,2830,97.1,5530,2721,2809,96.9
32020, 원주시,065,60~64세,2018,22792,11588,11204,103.4,22653,11515,11138,103.4
32020, 원주시,065001, 60세,2018,5199,2620,2579,101.6,5169,2603,2566,101.4
32020, 원주시,065002, 61세,2018,5102,2623,2479,105.8,5067,2607,2460,106
32020, 원주시,065003, 62세,2018,4576,2330,2246,103.7,4542,2313,2229,103.8
32020, 원주시,065004, 63세,2018,4237,2134,2103,101.5,4217,2121,2096,101.2
32020, 원주시,065005, 64세,2018,3678,1881,1797,104.7,3658,1871,1787,104.7
32020, 원주시,070,65~69세,2018,13340,6397,6943,92.1,13245,6352,6893,92.2
32020, 원주시,070001, 65세,2018,2890,1419,1471,96.5,2869,1412,1457,96.9
32020, 원주시,070002, 66세,2018,4069,1988,2081,95.5,4046,1974,2072,95.3
32020, 원주시,070003, 67세,2018,2096,981,1115,88,2074,969,1105,87.7
32020, 원주시,070004, 68세,2018,2141,1004,1137,88.3,2124,997,1127,88.5
32020, 원주시,070005, 69세,2018,2144,1005,1139,88.2,2132,1000,1132,88.3
32020, 원주시,075,70~74세,2018,10892,5023,5869,85.6,10857,5003,5854,85.5
32020, 원주시,075001, 70세,2018,2346,1118,1228,91,2334,1111,1223,90.8
32020, 원주시,075002, 71세,2018,2437,1141,1296,88,2430,1137,1293,87.9
32020, 원주시,075003, 72세,2018,1989,898,1091,82.3,1979,892,1087,82.1
32020, 원주시,075004, 73세,2018,2046,950,1096,86.7,2043,948,1095,86.6
32020, 원주시,075005, 74세,2018,2074,916,1158,79.1,2071,915,1156,79.2
32020, 원주시,080,75~79세,2018,10574,4299,6275,68.5,10558,4293,6265,68.5
32020, 원주시,080001, 75세,2018,2112,894,1218,73.4,2107,891,1216,73.3
32020, 원주시,080002, 76세,2018,2367,972,1395,69.7,2364,971,1393,69.7
32020, 원주시,080003, 77세,2018,2165,912,1253,72.8,2161,911,1250,72.9
32020, 원주시,080004, 78세,2018,1947,742,1205,61.6,1945,741,1204,61.5
32020, 원주시,080005, 79세,2018,1983,779,1204,64.7,1981,779,1202,64.8
32020, 원주시,085,80~84세,2018,6952,2515,4437,56.7,6935,2508,4427,56.7
32020, 원주시,085001, 80세,2018,1788,700,1088,64.3,1783,699,1084,64.5
32020, 원주시,085002, 81세,2018,1541,613,928,66.1,1537,611,926,66
32020, 원주시,085003, 82세,2018,1362,507,855,59.3,1362,507,855,59.3
32020, 원주시,085004, 83세,2018,1239,391,848,46.1,1236,390,846,46.1
32020, 원주시,085005, 84세,2018,1022,304,718,42.3,1017,301,716,42
32020, 원주시,090,85~89세,2018,3338,935,2403,38.9,3331,934,2397,39
32020, 원주시,090001, 85세,2018,928,301,627,48,926,300,626,47.9
32020, 원주시,090002, 86세,2018,767,213,554,38.4,764,213,551,38.7
32020, 원주시,090003, 87세,2018,632,174,458,38,632,174,458,38
32020, 원주시,090004, 88세,2018,558,144,414,34.8,557,144,413,34.9
32020, 원주시,090005, 89세,2018,453,103,350,29.4,452,103,349,29.5
32020, 원주시,095,90~94세,2018,1158,288,870,33.1,1156,287,869,33
32020, 원주시,095001, 90세,2018,378,83,295,28.1,378,83,295,28.1
32020, 원주시,095002, 91세,2018,281,70,211,33.2,279,69,210,32.9
32020, 원주시,095003, 92세,2018,217,53,164,32.3,217,53,164,32.3
32020, 원주시,095004, 93세,2018,164,54,110,49.1,164,54,110,49.1
32020, 원주시,095005, 94세,2018,118,28,90,31.1,118,28,90,31.1
32020, 원주시,100,95~99세,2018,255,66,189,34.9,253,66,187,35.3
32020, 원주시,100001, 95세,2018,101,34,67,50.7,101,34,67,50.7
32020, 원주시,100002, 96세,2018,69,15,54,27.8,67,15,52,28.8
32020, 원주시,100003, 97세,2018,27,X,23,17.4,27,X,23,17.4
32020, 원주시,100004, 98세,2018,32,10,22,45.5,32,10,22,45.5
32020, 원주시,100005, 99세,2018,26,X,23,13,26,X,23,13
32020, 원주시,101,100세이상,2018,29,5,24,20.8,29,5,24,20.8
32020, 원주시,102,15세미만,2018,45675,23385,22290,104.9,45601,23355,22246,105
32020, 원주시,103,15~64세,2018,251955,128905,123050,104.8,247670,126530,121140,104.4
32020, 원주시,104,65세이상,2018,46538,19528,27010,72.3,46364,19448,26916,72.3
32020, 원주시,086,85세이상,2018,4780,1294,3486,37.1,4769,1292,3477,37.2
32020, 원주시,126,평균연령,2018,41.3,40.1,42.5,,41.4,40.1,42.6,
32020, 원주시,127,중위연령,2018,42.5,41.1,43.8,,42.7,41.3,43.9,
32030, 강릉시,000,합계,2018,215528,108495,107033,101.4,212521,106924,105597,101.3
32030, 강릉시,005,0~4세,2018,6228,3205,3023,106,6210,3200,3010,106.3
32030, 강릉시,005001, 0세,2018,1049,569,480,118.5,1045,568,477,119.1
32030, 강릉시,005002, 1세,2018,1114,574,540,106.3,1109,574,535,107.3
32030, 강릉시,005003, 2세,2018,1287,666,621,107.2,1286,666,620,107.4
32030, 강릉시,005004, 3세,2018,1395,688,707,97.3,1393,687,706,97.3
32030, 강릉시,005005, 4세,2018,1383,708,675,104.9,1377,705,672,104.9
32030, 강릉시,010,5~9세,2018,8060,4175,3885,107.5,8043,4163,3880,107.3
32030, 강릉시,010001, 5세,2018,1422,762,660,115.5,1419,760,659,115.3
32030, 강릉시,010002, 6세,2018,1659,853,806,105.8,1656,850,806,105.5
32030, 강릉시,010003, 7세,2018,1689,879,810,108.5,1684,877,807,108.7
32030, 강릉시,010004, 8세,2018,1636,865,771,112.2,1633,863,770,112.1
32030, 강릉시,010005, 9세,2018,1654,816,838,97.4,1651,813,838,97
32030, 강릉시,015,10~14세,2018,8853,4688,4165,112.6,8827,4671,4156,112.4
32030, 강릉시,015001, 10세,2018,1657,847,810,104.6,1653,846,807,104.8
32030, 강릉시,015002, 11세,2018,1799,996,803,124,1793,992,801,123.8
32030, 강릉시,015003, 12세,2018,1691,932,759,122.8,1686,928,758,122.4
32030, 강릉시,015004, 13세,2018,1735,896,839,106.8,1730,891,839,106.2
32030, 강릉시,015005, 14세,2018,1971,1017,954,106.6,1965,1014,951,106.6
32030, 강릉시,020,15~19세,2018,13709,7373,6336,116.4,13534,7270,6264,116.1
32030, 강릉시,020001, 15세,2018,2007,1044,963,108.4,2005,1043,962,108.4
32030, 강릉시,020002, 16세,2018,2089,1125,964,116.7,2087,1125,962,116.9
32030, 강릉시,020003, 17세,2018,2427,1279,1148,111.4,2420,1276,1144,111.5
32030, 강릉시,020004, 18세,2018,3159,1688,1471,114.8,3112,1665,1447,115.1
32030, 강릉시,020005, 19세,2018,4027,2237,1790,125,3910,2161,1749,123.6
32030, 강릉시,025,20~24세,2018,18306,10575,7731,136.8,17644,10255,7389,138.8
32030, 강릉시,025001, 20세,2018,3869,1987,1882,105.6,3733,1924,1809,106.4
32030, 강릉시,025002, 21세,2018,3612,1895,1717,110.4,3489,1845,1644,112.2
32030, 강릉시,025003, 22세,2018,3678,2124,1554,136.7,3542,2052,1490,137.7
32030, 강릉시,025004, 23세,2018,3670,2326,1344,173.1,3535,2260,1275,177.3
32030, 강릉시,025005, 24세,2018,3477,2243,1234,181.8,3345,2174,1171,185.7
32030, 강릉시,030,25~29세,2018,11817,6939,4878,142.3,11352,6692,4660,143.6
32030, 강릉시,030001, 25세,2018,2988,1878,1110,169.2,2887,1829,1058,172.9
32030, 강릉시,030002, 26세,2018,2657,1581,1076,146.9,2549,1529,1020,149.9
32030, 강릉시,030003, 27세,2018,2222,1249,973,128.4,2135,1198,937,127.9
32030, 강릉시,030004, 28세,2018,1985,1125,860,130.8,1897,1080,817,132.2
32030, 강릉시,030005, 29세,2018,1965,1106,859,128.8,1884,1056,828,127.5
32030, 강릉시,035,30~34세,2018,9638,5218,4420,118.1,9225,4983,4242,117.5
32030, 강릉시,035001, 30세,2018,1888,1030,858,120,1802,981,821,119.5
32030, 강릉시,035002, 31세,2018,1858,1031,827,124.7,1760,981,779,125.9
32030, 강릉시,035003, 32세,2018,1897,1031,866,119.1,1817,984,833,118.1
32030, 강릉시,035004, 33세,2018,1921,1018,903,112.7,1836,967,869,111.3
32030, 강릉시,035005, 34세,2018,2074,1108,966,114.7,2010,1070,940,113.8
32030, 강릉시,040,35~39세,2018,13091,6643,6448,103,12765,6456,6309,102.3
32030, 강릉시,040001, 35세,2018,2296,1182,1114,106.1,2226,1144,1082,105.7
32030, 강릉시,040002, 36세,2018,2548,1256,1292,97.2,2485,1215,1270,95.7
32030, 강릉시,040003, 37세,2018,2694,1419,1275,111.3,2633,1382,1251,110.5
32030, 강릉시,040004, 38세,2018,2782,1383,1399,98.9,2715,1349,1366,98.8
32030, 강릉시,040005, 39세,2018,2771,1403,1368,102.6,2706,1366,1340,101.9
32030, 강릉시,045,40~44세,2018,14754,7452,7302,102.1,14530,7333,7197,101.9
32030, 강릉시,045001, 40세,2018,2615,1298,1317,98.6,2563,1271,1292,98.4
32030, 강릉시,045002, 41세,2018,2778,1437,1341,107.2,2740,1415,1325,106.8
32030, 강릉시,045003, 42세,2018,2857,1415,1442,98.1,2816,1396,1420,98.3
32030, 강릉시,045004, 43세,2018,3063,1549,1514,102.3,3017,1523,1494,101.9
32030, 강릉시,045005, 44세,2018,3441,1753,1688,103.9,3394,1728,1666,103.7
32030, 강릉시,050,45~49세,2018,17705,9146,8559,106.9,17501,9047,8454,107
32030, 강릉시,050001, 45세,2018,3634,1861,1773,105,3589,1837,1752,104.9
32030, 강릉시,050002, 46세,2018,3266,1750,1516,115.4,3232,1734,1498,115.8
32030, 강릉시,050003, 47세,2018,3579,1838,1741,105.6,3539,1820,1719,105.9
32030, 강릉시,050004, 48세,2018,3652,1888,1764,107,3611,1866,1745,106.9
32030, 강릉시,050005, 49세,2018,3574,1809,1765,102.5,3530,1790,1740,102.9
32030, 강릉시,055,50~54세,2018,16847,8497,8350,101.8,16690,8425,8265,101.9
32030, 강릉시,055001, 50세,2018,3680,1852,1828,101.3,3644,1832,1812,101.1
32030, 강릉시,055002, 51세,2018,3353,1691,1662,101.7,3323,1676,1647,101.8
32030, 강릉시,055003, 52세,2018,3414,1767,1647,107.3,3378,1754,1624,108
32030, 강릉시,055004, 53세,2018,3144,1505,1639,91.8,3114,1492,1622,92
32030, 강릉시,055005, 54세,2018,3256,1682,1574,106.9,3231,1671,1560,107.1
32030, 강릉시,060,55~59세,2018,19349,9396,9953,94.4,19221,9339,9882,94.5
32030, 강릉시,060001, 55세,2018,3574,1766,1808,97.7,3539,1753,1786,98.2
32030, 강릉시,060002, 56세,2018,3719,1872,1847,101.4,3696,1860,1836,101.3
32030, 강릉시,060003, 57세,2018,4038,1888,2150,87.8,4012,1875,2137,87.7
32030, 강릉시,060004, 58세,2018,4095,1984,2111,94,4074,1976,2098,94.2
32030, 강릉시,060005, 59세,2018,3923,1886,2037,92.6,3900,1875,2025,92.6
32030, 강릉시,065,60~64세,2018,16890,8189,8701,94.1,16811,8148,8663,94.1
32030, 강릉시,065001, 60세,2018,3679,1815,1864,97.4,3661,1804,1857,97.1
32030, 강릉시,065002, 61세,2018,3687,1831,1856,98.7,3674,1825,1849,98.7
32030, 강릉시,065003, 62세,2018,3289,1596,1693,94.3,3272,1589,1683,94.4
32030, 강릉시,065004, 63세,2018,3289,1569,1720,91.2,3273,1561,1712,91.2
32030, 강릉시,065005, 64세,2018,2946,1378,1568,87.9,2931,1369,1562,87.6
32030, 강릉시,070,65~69세,2018,11567,5440,6127,88.8,11502,5411,6091,88.8
32030, 강릉시,070001, 65세,2018,2559,1207,1352,89.3,2539,1196,1343,89.1
32030, 강릉시,070002, 66세,2018,2941,1406,1535,91.6,2925,1400,1525,91.8
32030, 강릉시,070003, 67세,2018,1899,893,1006,88.8,1887,887,1000,88.7
32030, 강릉시,070004, 68세,2018,1965,902,1063,84.9,1954,899,1055,85.2
32030, 강릉시,070005, 69세,2018,2203,1032,1171,88.1,2197,1029,1168,88.1
32030, 강릉시,075,70~74세,2018,10141,4698,5443,86.3,10125,4690,5435,86.3
32030, 강릉시,075001, 70세,2018,2240,1075,1165,92.3,2239,1074,1165,92.2
32030, 강릉시,075002, 71세,2018,2164,1002,1162,86.2,2162,1002,1160,86.4
32030, 강릉시,075003, 72세,2018,1752,839,913,91.9,1749,837,912,91.8
32030, 강릉시,075004, 73세,2018,2017,907,1110,81.7,2014,906,1108,81.8
32030, 강릉시,075005, 74세,2018,1968,875,1093,80.1,1961,871,1090,79.9
32030, 강릉시,080,75~79세,2018,8811,3736,5075,73.6,8792,3724,5068,73.5
32030, 강릉시,080001, 75세,2018,1831,799,1032,77.4,1829,798,1031,77.4
32030, 강릉시,080002, 76세,2018,1986,873,1113,78.4,1981,871,1110,78.5
32030, 강릉시,080003, 77세,2018,1702,695,1007,69,1698,692,1006,68.8
32030, 강릉시,080004, 78세,2018,1739,729,1010,72.2,1735,725,1010,71.8
32030, 강릉시,080005, 79세,2018,1553,640,913,70.1,1549,638,911,70
32030, 강릉시,085,80~84세,2018,5736,2122,3614,58.7,5725,2115,3610,58.6
32030, 강릉시,085001, 80세,2018,1489,602,887,67.9,1487,601,886,67.8
32030, 강릉시,085002, 81세,2018,1218,465,753,61.8,1214,462,752,61.4
32030, 강릉시,085003, 82세,2018,1133,426,707,60.3,1132,426,706,60.3
32030, 강릉시,085004, 83세,2018,1040,352,688,51.2,1038,351,687,51.1
32030, 강릉시,085005, 84세,2018,856,277,579,47.8,854,275,579,47.5
32030, 강릉시,090,85~89세,2018,2690,740,1950,37.9,2688,739,1949,37.9
32030, 강릉시,090001, 85세,2018,702,219,483,45.3,700,218,482,45.2
32030, 강릉시,090002, 86세,2018,585,175,410,42.7,585,175,410,42.7
32030, 강릉시,090003, 87세,2018,491,128,363,35.3,491,128,363,35.3
32030, 강릉시,090004, 88세,2018,493,123,370,33.2,493,123,370,33.2
32030, 강릉시,090005, 89세,2018,419,95,324,29.3,419,95,324,29.3
32030, 강릉시,095,90~94세,2018,1025,204,821,24.8,1025,204,821,24.8
32030, 강릉시,095001, 90세,2018,297,65,232,28,297,65,232,28
32030, 강릉시,095002, 91세,2018,273,58,215,27,273,58,215,27
32030, 강릉시,095003, 92세,2018,194,36,158,22.8,194,36,158,22.8
32030, 강릉시,095004, 93세,2018,142,28,114,24.6,142,28,114,24.6
32030, 강릉시,095005, 94세,2018,119,17,102,16.7,119,17,102,16.7
32030, 강릉시,100,95~99세,2018,281,55,226,24.3,281,55,226,24.3
32030, 강릉시,100001, 95세,2018,104,20,84,23.8,104,20,84,23.8
32030, 강릉시,100002, 96세,2018,69,12,57,21.1,69,12,57,21.1
32030, 강릉시,100003, 97세,2018,58,15,43,34.9,58,15,43,34.9
32030, 강릉시,100004, 98세,2018,25,5,20,25,25,5,20,25
32030, 강릉시,100005, 99세,2018,25,X,22,13.6,25,X,22,13.6
32030, 강릉시,101,100세이상,2018,30,X,26,15.4,30,X,26,15.4
32030, 강릉시,102,15세미만,2018,23141,12068,11073,109,23080,12034,11046,108.9
32030, 강릉시,103,15~64세,2018,152106,79428,72678,109.3,149273,77948,71325,109.3
32030, 강릉시,104,65세이상,2018,40281,16999,23282,73,40168,16942,23226,72.9
32030, 강릉시,086,85세이상,2018,4026,1003,3023,33.2,4024,1002,3022,33.2
32030, 강릉시,126,평균연령,2018,44.2,42.3,46.1,,44.3,42.4,46.3,
32030, 강릉시,127,중위연령,2018,45.9,43.8,48.2,,46.2,44.1,48.4,
32040, 동해시,000,합계,2018,87830,44573,43257,103,86773,43941,42832,102.6
32040, 동해시,005,0~4세,2018,3218,1648,1570,105,3212,1644,1568,104.8
32040, 동해시,005001, 0세,2018,505,253,252,100.4,503,252,251,100.4
32040, 동해시,005002, 1세,2018,602,294,308,95.5,601,294,307,95.8
32040, 동해시,005003, 2세,2018,711,350,361,97,709,348,361,96.4
32040, 동해시,005004, 3세,2018,681,363,318,114.2,681,363,318,114.2
32040, 동해시,005005, 4세,2018,719,388,331,117.2,718,387,331,116.9
32040, 동해시,010,5~9세,2018,4095,2110,1985,106.3,4091,2109,1982,106.4
32040, 동해시,010001, 5세,2018,775,389,386,100.8,774,389,385,101
32040, 동해시,010002, 6세,2018,866,449,417,107.7,865,448,417,107.4
32040, 동해시,010003, 7세,2018,864,438,426,102.8,864,438,426,102.8
32040, 동해시,010004, 8세,2018,762,408,354,115.3,762,408,354,115.3
32040, 동해시,010005, 9세,2018,828,426,402,106,826,426,400,106.5
32040, 동해시,015,10~14세,2018,4245,2210,2035,108.6,4243,2208,2035,108.5
32040, 동해시,015001, 10세,2018,842,440,402,109.5,841,439,402,109.2
32040, 동해시,015002, 11세,2018,861,450,411,109.5,861,450,411,109.5
32040, 동해시,015003, 12세,2018,802,405,397,102,801,404,397,101.8
32040, 동해시,015004, 13세,2018,832,430,402,107,832,430,402,107
32040, 동해시,015005, 14세,2018,908,485,423,114.7,908,485,423,114.7
32040, 동해시,020,15~19세,2018,4365,2341,2024,115.7,4354,2340,2014,116.2
32040, 동해시,020001, 15세,2018,894,475,419,113.4,893,475,418,113.6
32040, 동해시,020002, 16세,2018,934,469,465,100.9,931,468,463,101.1
32040, 동해시,020003, 17세,2018,1032,525,507,103.6,1031,525,506,103.8
32040, 동해시,020004, 18세,2018,931,508,423,120.1,930,508,422,120.4
32040, 동해시,020005, 19세,2018,574,364,210,173.3,569,364,205,177.6
32040, 동해시,025,20~24세,2018,4342,2711,1631,166.2,4231,2642,1589,166.3
32040, 동해시,025001, 20세,2018,741,510,231,220.8,727,503,224,224.6
32040, 동해시,025002, 21세,2018,935,661,274,241.2,924,655,269,243.5
32040, 동해시,025003, 22세,2018,845,498,347,143.5,829,488,341,143.1
32040, 동해시,025004, 23세,2018,887,488,399,122.3,858,468,390,120
32040, 동해시,025005, 24세,2018,934,554,380,145.8,893,528,365,144.7
32040, 동해시,030,25~29세,2018,4105,2361,1744,135.4,3895,2226,1669,133.4
32040, 동해시,030001, 25세,2018,952,554,398,139.2,907,524,383,136.8
32040, 동해시,030002, 26세,2018,851,488,363,134.4,819,472,347,136
32040, 동해시,030003, 27세,2018,748,440,308,142.9,709,410,299,137.1
32040, 동해시,030004, 28세,2018,781,448,333,134.5,735,420,315,133.3
32040, 동해시,030005, 29세,2018,773,431,342,126,725,400,325,123.1
32040, 동해시,035,30~34세,2018,4108,2215,1893,117,3911,2087,1824,114.4
32040, 동해시,035001, 30세,2018,744,413,331,124.8,701,385,316,121.8
32040, 동해시,035002, 31세,2018,773,414,359,115.3,728,379,349,108.6
32040, 동해시,035003, 32세,2018,795,437,358,122.1,755,415,340,122.1
32040, 동해시,035004, 33세,2018,878,463,415,111.6,842,440,402,109.5
32040, 동해시,035005, 34세,2018,918,488,430,113.5,885,468,417,112.2
32040, 동해시,040,35~39세,2018,6084,3140,2944,106.7,5902,3013,2889,104.3
32040, 동해시,040001, 35세,2018,1046,558,488,114.3,999,524,475,110.3
32040, 동해시,040002, 36세,2018,1201,637,564,112.9,1165,616,549,112.2
32040, 동해시,040003, 37세,2018,1293,697,596,116.9,1263,671,592,113.3
32040, 동해시,040004, 38세,2018,1284,621,663,93.7,1244,596,648,92
32040, 동해시,040005, 39세,2018,1260,627,633,99.1,1231,606,625,97
32040, 동해시,045,40~44세,2018,6874,3558,3316,107.3,6779,3500,3279,106.7
32040, 동해시,045001, 40세,2018,1277,625,652,95.9,1257,607,650,93.4
32040, 동해시,045002, 41세,2018,1304,686,618,111,1289,680,609,111.7
32040, 동해시,045003, 42세,2018,1285,673,612,110,1268,663,605,109.6
32040, 동해시,045004, 43세,2018,1409,752,657,114.5,1387,736,651,113.1
32040, 동해시,045005, 44세,2018,1599,822,777,105.8,1578,814,764,106.5
32040, 동해시,050,45~49세,2018,7982,4190,3792,110.5,7901,4147,3754,110.5
32040, 동해시,050001, 45세,2018,1624,899,725,124,1607,888,719,123.5
32040, 동해시,050002, 46세,2018,1508,825,683,120.8,1492,818,674,121.4
32040, 동해시,050003, 47세,2018,1672,836,836,100,1655,828,827,100.1
32040, 동해시,050004, 48세,2018,1582,835,747,111.8,1566,824,742,111.1
32040, 동해시,050005, 49세,2018,1596,795,801,99.3,1581,789,792,99.6
32040, 동해시,055,50~54세,2018,7227,3795,3432,110.6,7164,3763,3401,110.6
32040, 동해시,055001, 50세,2018,1561,853,708,120.5,1550,846,704,120.2
32040, 동해시,055002, 51세,2018,1479,769,710,108.3,1467,762,705,108.1
32040, 동해시,055003, 52세,2018,1438,728,710,102.5,1422,722,700,103.1
32040, 동해시,055004, 53세,2018,1367,712,655,108.7,1354,705,649,108.6
32040, 동해시,055005, 54세,2018,1382,733,649,112.9,1371,728,643,113.2
32040, 동해시,060,55~59세,2018,8000,3967,4033,98.4,7962,3953,4009,98.6
32040, 동해시,060001, 55세,2018,1450,742,708,104.8,1439,741,698,106.2
32040, 동해시,060002, 56세,2018,1581,805,776,103.7,1571,800,771,103.8
32040, 동해시,060003, 57세,2018,1604,799,805,99.3,1600,797,803,99.3
32040, 동해시,060004, 58세,2018,1815,888,927,95.8,1807,884,923,95.8
32040, 동해시,060005, 59세,2018,1550,733,817,89.7,1545,731,814,89.8
32040, 동해시,065,60~64세,2018,7070,3417,3653,93.5,7038,3407,3631,93.8
32040, 동해시,065001, 60세,2018,1544,718,826,86.9,1533,714,819,87.2
32040, 동해시,065002, 61세,2018,1524,757,767,98.7,1520,755,765,98.7
32040, 동해시,065003, 62세,2018,1305,650,655,99.2,1301,649,652,99.5
32040, 동해시,065004, 63세,2018,1441,701,740,94.7,1432,698,734,95.1
32040, 동해시,065005, 64세,2018,1256,591,665,88.9,1252,591,661,89.4
32040, 동해시,070,65~69세,2018,4772,2309,2463,93.7,4756,2303,2453,93.9
32040, 동해시,070001, 65세,2018,1133,568,565,100.5,1126,565,561,100.7
32040, 동해시,070002, 66세,2018,1160,550,610,90.2,1158,550,608,90.5
32040, 동해시,070003, 67세,2018,733,351,382,91.9,731,349,382,91.4
32040, 동해시,070004, 68세,2018,873,412,461,89.4,873,412,461,89.4
32040, 동해시,070005, 69세,2018,873,428,445,96.2,868,427,441,96.8
32040, 동해시,075,70~74세,2018,4111,1899,2212,85.8,4106,1898,2208,86
32040, 동해시,075001, 70세,2018,1000,484,516,93.8,997,483,514,94
32040, 동해시,075002, 71세,2018,837,396,441,89.8,837,396,441,89.8
32040, 동해시,075003, 72세,2018,645,284,361,78.7,644,284,360,78.9
32040, 동해시,075004, 73세,2018,787,353,434,81.3,787,353,434,81.3
32040, 동해시,075005, 74세,2018,842,382,460,83,841,382,459,83.2
32040, 동해시,080,75~79세,2018,3596,1529,2067,74,3594,1528,2066,74
32040, 동해시,080001, 75세,2018,805,341,464,73.5,805,341,464,73.5
32040, 동해시,080002, 76세,2018,838,363,475,76.4,837,362,475,76.2
32040, 동해시,080003, 77세,2018,707,318,389,81.7,707,318,389,81.7
32040, 동해시,080004, 78세,2018,637,240,397,60.5,636,240,396,60.6
32040, 동해시,080005, 79세,2018,609,267,342,78.1,609,267,342,78.1
32040, 동해시,085,80~84세,2018,2225,854,1371,62.3,2223,854,1369,62.4
32040, 동해시,085001, 80세,2018,590,244,346,70.5,590,244,346,70.5
32040, 동해시,085002, 81세,2018,462,181,281,64.4,462,181,281,64.4
32040, 동해시,085003, 82세,2018,423,160,263,60.8,422,160,262,61.1
32040, 동해시,085004, 83세,2018,400,140,260,53.8,400,140,260,53.8
32040, 동해시,085005, 84세,2018,350,129,221,58.4,349,129,220,58.6
32040, 동해시,090,85~89세,2018,1012,246,766,32.1,1012,246,766,32.1
32040, 동해시,090001, 85세,2018,266,72,194,37.1,266,72,194,37.1
32040, 동해시,090002, 86세,2018,238,56,182,30.8,238,56,182,30.8
32040, 동해시,090003, 87세,2018,212,54,158,34.2,212,54,158,34.2
32040, 동해시,090004, 88세,2018,171,39,132,29.5,171,39,132,29.5
32040, 동해시,090005, 89세,2018,125,25,100,25,125,25,100,25
32040, 동해시,095,90~94세,2018,310,59,251,23.5,310,59,251,23.5
32040, 동해시,095001, 90세,2018,105,23,82,28,105,23,82,28
32040, 동해시,095002, 91세,2018,71,18,53,34,71,18,53,34
32040, 동해시,095003, 92세,2018,51,6,45,13.3,51,6,45,13.3
32040, 동해시,095004, 93세,2018,48,8,40,20,48,8,40,20
32040, 동해시,095005, 94세,2018,35,X,31,12.9,35,X,31,12.9
32040, 동해시,100,95~99세,2018,83,14,69,20.3,83,14,69,20.3
32040, 동해시,100001, 95세,2018,36,5,31,16.1,36,5,31,16.1
32040, 동해시,100002, 96세,2018,24,5,19,26.3,24,5,19,26.3
32040, 동해시,100003, 97세,2018,16,X,14,14.3,16,X,14,14.3
32040, 동해시,100004, 98세,2018,5,X,X,25,5,X,X,25
32040, 동해시,100005, 99세,2018,X,X,X,100,X,X,X,100
32040, 동해시,101,100세이상,2018,6,X,6,0,6,X,6,0
32040, 동해시,102,15세미만,2018,11558,5968,5590,106.8,11546,5961,5585,106.7
32040, 동해시,103,15~64세,2018,60157,31695,28462,111.4,59137,31078,28059,110.8
32040, 동해시,104,65세이상,2018,16115,6910,9205,75.1,16090,6902,9188,75.1
32040, 동해시,086,85세이상,2018,1411,319,1092,29.2,1411,319,1092,29.2
32040, 동해시,126,평균연령,2018,44.4,42.7,46.1,,44.5,42.8,46.2,
32040, 동해시,127,중위연령,2018,46.6,45,48.3,,46.8,45.2,48.5,
32050, 태백시,000,합계,2018,43488,21928,21560,101.7,43148,21816,21332,102.3
32050, 태백시,005,0~4세,2018,1297,662,635,104.3,1296,661,635,104.1
32050, 태백시,005001, 0세,2018,222,104,118,88.1,222,104,118,88.1
32050, 태백시,005002, 1세,2018,225,116,109,106.4,225,116,109,106.4
32050, 태백시,005003, 2세,2018,256,136,120,113.3,255,135,120,112.5
32050, 태백시,005004, 3세,2018,294,149,145,102.8,294,149,145,102.8
32050, 태백시,005005, 4세,2018,300,157,143,109.8,300,157,143,109.8
32050, 태백시,010,5~9세,2018,1838,905,933,97,1838,905,933,97
32050, 태백시,010001, 5세,2018,308,153,155,98.7,308,153,155,98.7
32050, 태백시,010002, 6세,2018,386,191,195,97.9,386,191,195,97.9
32050, 태백시,010003, 7세,2018,386,186,200,93,386,186,200,93
32050, 태백시,010004, 8세,2018,391,196,195,100.5,391,196,195,100.5
32050, 태백시,010005, 9세,2018,367,179,188,95.2,367,179,188,95.2
32050, 태백시,015,10~14세,2018,1845,940,905,103.9,1842,940,902,104.2
32050, 태백시,015001, 10세,2018,380,186,194,95.9,380,186,194,95.9
32050, 태백시,015002, 11세,2018,410,218,192,113.5,409,218,191,114.1
32050, 태백시,015003, 12세,2018,345,169,176,96,344,169,175,96.6
32050, 태백시,015004, 13세,2018,354,189,165,114.5,354,189,165,114.5
32050, 태백시,015005, 14세,2018,356,178,178,100,355,178,177,100.6
32050, 태백시,020,15~19세,2018,2226,1308,918,142.5,2222,1305,917,142.3
32050, 태백시,020001, 15세,2018,381,200,181,110.5,381,200,181,110.5
32050, 태백시,020002, 16세,2018,443,244,199,122.6,443,244,199,122.6
32050, 태백시,020003, 17세,2018,515,328,187,175.4,514,328,186,176.3
32050, 태백시,020004, 18세,2018,533,327,206,158.7,533,327,206,158.7
32050, 태백시,020005, 19세,2018,354,209,145,144.1,351,206,145,142.1
32050, 태백시,025,20~24세,2018,1868,1079,789,136.8,1842,1076,766,140.5
32050, 태백시,025001, 20세,2018,386,235,151,155.6,380,234,146,160.3
32050, 태백시,025002, 21세,2018,384,248,136,182.4,381,248,133,186.5
32050, 태백시,025003, 22세,2018,408,242,166,145.8,403,242,161,150.3
32050, 태백시,025004, 23세,2018,336,167,169,98.8,335,167,168,99.4
32050, 태백시,025005, 24세,2018,354,187,167,112,343,185,158,117.1
32050, 태백시,030,25~29세,2018,1613,850,763,111.4,1551,833,718,116
32050, 태백시,030001, 25세,2018,342,183,159,115.1,332,181,151,119.9
32050, 태백시,030002, 26세,2018,323,164,159,103.1,314,162,152,106.6
32050, 태백시,030003, 27세,2018,284,152,132,115.2,270,148,122,121.3
32050, 태백시,030004, 28세,2018,303,150,153,98,288,147,141,104.3
32050, 태백시,030005, 29세,2018,361,201,160,125.6,347,195,152,128.3
32050, 태백시,035,30~34세,2018,1658,858,800,107.3,1600,845,755,111.9
32050, 태백시,035001, 30세,2018,293,155,138,112.3,278,153,125,122.4
32050, 태백시,035002, 31세,2018,330,165,165,100,321,162,159,101.9
32050, 태백시,035003, 32세,2018,320,179,141,127,308,175,133,131.6
32050, 태백시,035004, 33세,2018,330,175,155,112.9,316,172,144,119.4
32050, 태백시,035005, 34세,2018,385,184,201,91.5,377,183,194,94.3
32050, 태백시,040,35~39세,2018,2877,1467,1410,104,2828,1455,1373,106
32050, 태백시,040001, 35세,2018,489,253,236,107.2,472,251,221,113.6
32050, 태백시,040002, 36세,2018,583,300,283,106,570,296,274,108
32050, 태백시,040003, 37세,2018,547,272,275,98.9,540,270,270,100
32050, 태백시,040004, 38세,2018,640,335,305,109.8,632,332,300,110.7
32050, 태백시,040005, 39세,2018,618,307,311,98.7,614,306,308,99.4
32050, 태백시,045,40~44세,2018,3232,1731,1501,115.3,3207,1720,1487,115.7
32050, 태백시,045001, 40세,2018,647,327,320,102.2,643,324,319,101.6
32050, 태백시,045002, 41세,2018,631,331,300,110.3,624,328,296,110.8
32050, 태백시,045003, 42세,2018,606,325,281,115.7,598,320,278,115.1
32050, 태백시,045004, 43세,2018,661,373,288,129.5,659,373,286,130.4
32050, 태백시,045005, 44세,2018,687,375,312,120.2,683,375,308,121.8
32050, 태백시,050,45~49세,2018,3648,1983,1665,119.1,3607,1961,1646,119.1
32050, 태백시,050001, 45세,2018,696,369,327,112.8,692,367,325,112.9
32050, 태백시,050002, 46세,2018,709,381,328,116.2,697,376,321,117.1
32050, 태백시,050003, 47세,2018,724,378,346,109.2,712,371,341,108.8
32050, 태백시,050004, 48세,2018,771,425,346,122.8,764,422,342,123.4
32050, 태백시,050005, 49세,2018,748,430,318,135.2,742,425,317,134.1
32050, 태백시,055,50~54세,2018,3650,1956,1694,115.5,3624,1945,1679,115.8
32050, 태백시,055001, 50세,2018,801,454,347,130.8,792,450,342,131.6
32050, 태백시,055002, 51세,2018,731,393,338,116.3,726,392,334,117.4
32050, 태백시,055003, 52세,2018,753,398,355,112.1,749,395,354,111.6
32050, 태백시,055004, 53세,2018,718,361,357,101.1,713,360,353,102
32050, 태백시,055005, 54세,2018,647,350,297,117.8,644,348,296,117.6
32050, 태백시,060,55~59세,2018,4264,2187,2077,105.3,4242,2178,2064,105.5
32050, 태백시,060001, 55세,2018,738,415,323,128.5,726,409,317,129
32050, 태백시,060002, 56세,2018,754,390,364,107.1,754,390,364,107.1
32050, 태백시,060003, 57세,2018,894,446,448,99.6,894,446,448,99.6
32050, 태백시,060004, 58세,2018,973,480,493,97.4,966,477,489,97.5
32050, 태백시,060005, 59세,2018,905,456,449,101.6,902,456,446,102.2
32050, 태백시,065,60~64세,2018,3948,1980,1968,100.6,3939,1978,1961,100.9
32050, 태백시,065001, 60세,2018,771,386,385,100.3,769,386,383,100.8
32050, 태백시,065002, 61세,2018,850,443,407,108.8,850,443,407,108.8
32050, 태백시,065003, 62세,2018,798,417,381,109.4,794,415,379,109.5
32050, 태백시,065004, 63세,2018,826,390,436,89.4,824,390,434,89.9
32050, 태백시,065005, 64세,2018,703,344,359,95.8,702,344,358,96.1
32050, 태백시,070,65~69세,2018,3017,1406,1611,87.3,3011,1404,1607,87.4
32050, 태백시,070001, 65세,2018,646,313,333,94,646,313,333,94
32050, 태백시,070002, 66세,2018,707,327,380,86.1,707,327,380,86.1
32050, 태백시,070003, 67세,2018,513,248,265,93.6,512,247,265,93.2
32050, 태백시,070004, 68세,2018,572,245,327,74.9,570,244,326,74.8
32050, 태백시,070005, 69세,2018,579,273,306,89.2,576,273,303,90.1
32050, 태백시,075,70~74세,2018,2492,1087,1405,77.4,2488,1083,1405,77.1
32050, 태백시,075001, 70세,2018,570,256,314,81.5,570,256,314,81.5
32050, 태백시,075002, 71세,2018,543,233,310,75.2,543,233,310,75.2
32050, 태백시,075003, 72세,2018,426,182,244,74.6,425,181,244,74.2
32050, 태백시,075004, 73세,2018,480,216,264,81.8,478,214,264,81.1
32050, 태백시,075005, 74세,2018,473,200,273,73.3,472,199,273,72.9
32050, 태백시,080,75~79세,2018,2224,953,1271,75,2221,951,1270,74.9
32050, 태백시,080001, 75세,2018,483,226,257,87.9,483,226,257,87.9
32050, 태백시,080002, 76세,2018,519,234,285,82.1,519,234,285,82.1
32050, 태백시,080003, 77세,2018,427,192,235,81.7,425,191,234,81.6
32050, 태백시,080004, 78세,2018,400,146,254,57.5,399,145,254,57.1
32050, 태백시,080005, 79세,2018,395,155,240,64.6,395,155,240,64.6
32050, 태백시,085,80~84세,2018,1208,437,771,56.7,1208,437,771,56.7
32050, 태백시,085001, 80세,2018,305,112,193,58,305,112,193,58
32050, 태백시,085002, 81세,2018,275,113,162,69.8,275,113,162,69.8
32050, 태백시,085003, 82세,2018,238,84,154,54.5,238,84,154,54.5
32050, 태백시,085004, 83세,2018,222,74,148,50,222,74,148,50
32050, 태백시,085005, 84세,2018,168,54,114,47.4,168,54,114,47.4
32050, 태백시,090,85~89세,2018,410,106,304,34.9,409,106,303,35
32050, 태백시,090001, 85세,2018,143,51,92,55.4,142,51,91,56
32050, 태백시,090002, 86세,2018,76,20,56,35.7,76,20,56,35.7
32050, 태백시,090003, 87세,2018,67,9,58,15.5,67,9,58,15.5
32050, 태백시,090004, 88세,2018,78,20,58,34.5,78,20,58,34.5
32050, 태백시,090005, 89세,2018,46,6,40,15,46,6,40,15
32050, 태백시,095,90~94세,2018,139,22,117,18.8,139,22,117,18.8
32050, 태백시,095001, 90세,2018,41,10,31,32.3,41,10,31,32.3
32050, 태백시,095002, 91세,2018,34,5,29,17.2,34,5,29,17.2
32050, 태백시,095003, 92세,2018,29,X,25,16,29,X,25,16
32050, 태백시,095004, 93세,2018,16,X,13,23.1,16,X,13,23.1
32050, 태백시,095005, 94세,2018,19,X,19,0,19,X,19,0
32050, 태백시,100,95~99세,2018,30,10,20,50,30,10,20,50
32050, 태백시,100001, 95세,2018,12,6,6,100,12,6,6,100
32050, 태백시,100002, 96세,2018,13,X,9,44.4,13,X,9,44.4
32050, 태백시,100003, 97세,2018,X,X,X,0,X,X,X,0
32050, 태백시,100004, 98세,2018,X,X,X,0,X,X,X,0
32050, 태백시,100005, 99세,2018,X,X,X,0,X,X,X,0
32050, 태백시,101,100세이상,2018,X,X,X,33.3,X,X,X,33.3
32050, 태백시,102,15세미만,2018,4980,2507,2473,101.4,4976,2506,2470,101.5
32050, 태백시,103,15~64세,2018,28984,15399,13585,113.4,28662,15296,13366,114.4
32050, 태백시,104,65세이상,2018,9524,4022,5502,73.1,9510,4014,5496,73
32050, 태백시,086,85세이상,2018,583,139,444,31.3,582,139,443,31.4
32050, 태백시,126,평균연령,2018,46.7,45.1,48.2,,46.7,45.1,48.4,
32050, 태백시,127,중위연령,2018,49.5,48.1,51.3,,49.7,48.1,51.6,
32060, 속초시,000,합계,2018,78312,38834,39478,98.4,76966,38026,38940,97.7
32060, 속초시,005,0~4세,2018,2765,1391,1374,101.2,2758,1385,1373,100.9
32060, 속초시,005001, 0세,2018,434,221,213,103.8,433,220,213,103.3
32060, 속초시,005002, 1세,2018,459,254,205,123.9,458,253,205,123.4
32060, 속초시,005003, 2세,2018,579,303,276,109.8,576,301,275,109.5
32060, 속초시,005004, 3세,2018,672,308,364,84.6,672,308,364,84.6
32060, 속초시,005005, 4세,2018,621,305,316,96.5,619,303,316,95.9
32060, 속초시,010,5~9세,2018,3250,1627,1623,100.2,3246,1627,1619,100.5
32060, 속초시,010001, 5세,2018,609,303,306,99,608,303,305,99.3
32060, 속초시,010002, 6세,2018,677,335,342,98,675,335,340,98.5
32060, 속초시,010003, 7세,2018,667,336,331,101.5,666,336,330,101.8
32060, 속초시,010004, 8세,2018,671,347,324,107.1,671,347,324,107.1
32060, 속초시,010005, 9세,2018,626,306,320,95.6,626,306,320,95.6
32060, 속초시,015,10~14세,2018,3517,1809,1708,105.9,3514,1807,1707,105.9
32060, 속초시,015001, 10세,2018,657,335,322,104,655,334,321,104
32060, 속초시,015002, 11세,2018,698,372,326,114.1,697,371,326,113.8
32060, 속초시,015003, 12세,2018,660,325,335,97,660,325,335,97
32060, 속초시,015004, 13세,2018,666,337,329,102.4,666,337,329,102.4
32060, 속초시,015005, 14세,2018,836,440,396,111.1,836,440,396,111.1
32060, 속초시,020,15~19세,2018,3915,2067,1848,111.9,3907,2064,1843,112
32060, 속초시,020001, 15세,2018,796,422,374,112.8,795,422,373,113.1
32060, 속초시,020002, 16세,2018,847,445,402,110.7,845,444,401,110.7
32060, 속초시,020003, 17세,2018,909,438,471,93,909,438,471,93
32060, 속초시,020004, 18세,2018,941,512,429,119.3,940,511,429,119.1
32060, 속초시,020005, 19세,2018,422,250,172,145.3,418,249,169,147.3
32060, 속초시,025,20~24세,2018,3664,2166,1498,144.6,3457,2047,1410,145.2
32060, 속초시,025001, 20세,2018,648,463,185,250.3,637,459,178,257.9
32060, 속초시,025002, 21세,2018,728,484,244,198.4,704,471,233,202.1
32060, 속초시,025003, 22세,2018,778,424,354,119.8,721,397,324,122.5
32060, 속초시,025004, 23세,2018,716,373,343,108.7,664,343,321,106.9
32060, 속초시,025005, 24세,2018,794,422,372,113.4,731,377,354,106.5
32060, 속초시,030,25~29세,2018,3910,2152,1758,122.4,3642,1990,1652,120.5
32060, 속초시,030001, 25세,2018,742,410,332,123.5,696,382,314,121.7
32060, 속초시,030002, 26세,2018,833,445,388,114.7,784,419,365,114.8
32060, 속초시,030003, 27세,2018,779,423,356,118.8,722,391,331,118.1
32060, 속초시,030004, 28세,2018,767,443,324,136.7,712,404,308,131.2
32060, 속초시,030005, 29세,2018,789,431,358,120.4,728,394,334,118
32060, 속초시,035,30~34세,2018,4011,2195,1816,120.9,3794,2055,1739,118.2
32060, 속초시,035001, 30세,2018,794,451,343,131.5,752,430,322,133.5
32060, 속초시,035002, 31세,2018,777,423,354,119.5,725,385,340,113.2
32060, 속초시,035003, 32세,2018,748,397,351,113.1,711,369,342,107.9
32060, 속초시,035004, 33세,2018,801,430,371,115.9,752,403,349,115.5
32060, 속초시,035005, 34세,2018,891,494,397,124.4,854,468,386,121.2
32060, 속초시,040,35~39세,2018,5370,2745,2625,104.6,5202,2636,2566,102.7
32060, 속초시,040001, 35세,2018,921,487,434,112.2,882,466,416,112
32060, 속초시,040002, 36세,2018,1108,574,534,107.5,1064,543,521,104.2
32060, 속초시,040003, 37세,2018,1135,589,546,107.9,1099,565,534,105.8
32060, 속초시,040004, 38세,2018,1109,549,560,98,1077,527,550,95.8
32060, 속초시,040005, 39세,2018,1097,546,551,99.1,1080,535,545,98.2
32060, 속초시,045,40~44세,2018,5684,2867,2817,101.8,5554,2771,2783,99.6
32060, 속초시,045001, 40세,2018,1040,517,523,98.9,1014,499,515,96.9
32060, 속초시,045002, 41세,2018,1074,544,530,102.6,1048,522,526,99.2
32060, 속초시,045003, 42세,2018,1079,545,534,102.1,1056,530,526,100.8
32060, 속초시,045004, 43세,2018,1152,565,587,96.3,1117,541,576,93.9
32060, 속초시,045005, 44세,2018,1339,696,643,108.2,1319,679,640,106.1
32060, 속초시,050,45~49세,2018,7202,3635,3567,101.9,7109,3572,3537,101
32060, 속초시,050001, 45세,2018,1316,670,646,103.7,1291,654,637,102.7
32060, 속초시,050002, 46세,2018,1342,663,679,97.6,1324,650,674,96.4
32060, 속초시,050003, 47세,2018,1472,717,755,95,1455,708,747,94.8
32060, 속초시,050004, 48세,2018,1532,790,742,106.5,1511,773,738,104.7
32060, 속초시,050005, 49세,2018,1540,795,745,106.7,1528,787,741,106.2
32060, 속초시,055,50~54세,2018,7039,3516,3523,99.8,6964,3484,3480,100.1
32060, 속초시,055001, 50세,2018,1558,747,811,92.1,1544,739,805,91.8
32060, 속초시,055002, 51세,2018,1376,673,703,95.7,1366,669,697,96
32060, 속초시,055003, 52세,2018,1353,730,623,117.2,1338,726,612,118.6
32060, 속초시,055004, 53세,2018,1337,662,675,98.1,1313,650,663,98
32060, 속초시,055005, 54세,2018,1415,704,711,99,1403,700,703,99.6
32060, 속초시,060,55~59세,2018,7752,3770,3982,94.7,7689,3749,3940,95.2
32060, 속초시,060001, 55세,2018,1508,752,756,99.5,1489,746,743,100.4
32060, 속초시,060002, 56세,2018,1459,743,716,103.8,1453,739,714,103.5
32060, 속초시,060003, 57세,2018,1647,778,869,89.5,1640,778,862,90.3
32060, 속초시,060004, 58세,2018,1649,770,879,87.6,1634,766,868,88.2
32060, 속초시,060005, 59세,2018,1489,727,762,95.4,1473,720,753,95.6
32060, 속초시,065,60~64세,2018,6626,3352,3274,102.4,6583,3328,3255,102.2
32060, 속초시,065001, 60세,2018,1477,740,737,100.4,1468,737,731,100.8
32060, 속초시,065002, 61세,2018,1377,709,668,106.1,1363,700,663,105.6
32060, 속초시,065003, 62세,2018,1265,660,605,109.1,1260,657,603,109
32060, 속초시,065004, 63세,2018,1312,670,642,104.4,1307,669,638,104.9
32060, 속초시,065005, 64세,2018,1195,573,622,92.1,1185,565,620,91.1
32060, 속초시,070,65~69세,2018,3910,1839,2071,88.8,3880,1823,2057,88.6
32060, 속초시,070001, 65세,2018,895,441,454,97.1,889,437,452,96.7
32060, 속초시,070002, 66세,2018,942,454,488,93,935,450,485,92.8
32060, 속초시,070003, 67세,2018,633,256,377,67.9,625,253,372,68
32060, 속초시,070004, 68세,2018,699,320,379,84.4,696,318,378,84.1
32060, 속초시,070005, 69세,2018,741,368,373,98.7,735,365,370,98.6
32060, 속초시,075,70~74세,2018,3525,1534,1991,77,3511,1525,1986,76.8
32060, 속초시,075001, 70세,2018,750,337,413,81.6,746,333,413,80.6
32060, 속초시,075002, 71세,2018,764,348,416,83.7,761,347,414,83.8
32060, 속초시,075003, 72세,2018,660,297,363,81.8,656,295,361,81.7
32060, 속초시,075004, 73세,2018,711,301,410,73.4,709,300,409,73.3
32060, 속초시,075005, 74세,2018,640,251,389,64.5,639,250,389,64.3
32060, 속초시,080,75~79세,2018,2951,1217,1734,70.2,2944,1216,1728,70.4
32060, 속초시,080001, 75세,2018,639,297,342,86.8,636,296,340,87.1
32060, 속초시,080002, 76세,2018,665,260,405,64.2,664,260,404,64.4
32060, 속초시,080003, 77세,2018,589,242,347,69.7,588,242,346,69.9
32060, 속초시,080004, 78세,2018,570,238,332,71.7,570,238,332,71.7
32060, 속초시,080005, 79세,2018,488,180,308,58.4,486,180,306,58.8
32060, 속초시,085,80~84세,2018,1869,656,1213,54.1,1864,652,1212,53.8
32060, 속초시,085001, 80세,2018,489,188,301,62.5,488,187,301,62.1
32060, 속초시,085002, 81세,2018,406,142,264,53.8,405,141,264,53.4
32060, 속초시,085003, 82세,2018,392,145,247,58.7,392,145,247,58.7
32060, 속초시,085004, 83세,2018,315,100,215,46.5,315,100,215,46.5
32060, 속초시,085005, 84세,2018,267,81,186,43.5,264,79,185,42.7
32060, 속초시,090,85~89세,2018,880,193,687,28.1,877,192,685,28
32060, 속초시,090001, 85세,2018,224,67,157,42.7,222,67,155,43.2
32060, 속초시,090002, 86세,2018,176,39,137,28.5,175,38,137,27.7
32060, 속초시,090003, 87세,2018,155,27,128,21.1,155,27,128,21.1
32060, 속초시,090004, 88세,2018,155,29,126,23,155,29,126,23
32060, 속초시,090005, 89세,2018,170,31,139,22.3,170,31,139,22.3
32060, 속초시,095,90~94세,2018,387,72,315,22.9,387,72,315,22.9
32060, 속초시,095001, 90세,2018,120,27,93,29,120,27,93,29
32060, 속초시,095002, 91세,2018,103,15,88,17,103,15,88,17
32060, 속초시,095003, 92세,2018,73,17,56,30.4,73,17,56,30.4
32060, 속초시,095004, 93세,2018,61,8,53,15.1,61,8,53,15.1
32060, 속초시,095005, 94세,2018,30,5,25,20,30,5,25,20
32060, 속초시,100,95~99세,2018,77,31,46,67.4,76,31,45,68.9
32060, 속초시,100001, 95세,2018,29,15,14,107.1,29,15,14,107.1
32060, 속초시,100002, 96세,2018,20,8,12,66.7,20,8,12,66.7
32060, 속초시,100003, 97세,2018,15,X,11,36.4,15,X,11,36.4
32060, 속초시,100004, 98세,2018,10,X,6,66.7,9,X,5,80
32060, 속초시,100005, 99세,2018,X,X,X,0,X,X,X,0
32060, 속초시,101,100세이상,2018,8,X,8,0,8,X,8,0
32060, 속초시,102,15세미만,2018,9532,4827,4705,102.6,9518,4819,4699,102.6
32060, 속초시,103,15~64세,2018,55173,28465,26708,106.6,53901,27696,26205,105.7
32060, 속초시,104,65세이상,2018,13607,5542,8065,68.7,13547,5511,8036,68.6
32060, 속초시,086,85세이상,2018,1352,296,1056,28,1348,295,1053,28
32060, 속초시,126,평균연령,2018,44.7,43,46.4,,44.8,43.2,46.5,
32060, 속초시,127,중위연령,2018,47.3,45.6,48.8,,47.5,46,49,
32070, 삼척시,000,합계,2018,67881,35175,32706,107.5,66928,34644,32284,107.3
32070, 삼척시,005,0~4세,2018,1947,1018,929,109.6,1944,1016,928,109.5
32070, 삼척시,005001, 0세,2018,365,199,166,119.9,364,199,165,120.6
32070, 삼척시,005002, 1세,2018,348,191,157,121.7,348,191,157,121.7
32070, 삼척시,005003, 2세,2018,390,188,202,93.1,388,186,202,92.1
32070, 삼척시,005004, 3세,2018,414,215,199,108,414,215,199,108
32070, 삼척시,005005, 4세,2018,430,225,205,109.8,430,225,205,109.8
32070, 삼척시,010,5~9세,2018,2328,1215,1113,109.2,2327,1215,1112,109.3
32070, 삼척시,010001, 5세,2018,428,213,215,99.1,427,213,214,99.5
32070, 삼척시,010002, 6세,2018,506,271,235,115.3,506,271,235,115.3
32070, 삼척시,010003, 7세,2018,466,253,213,118.8,466,253,213,118.8
32070, 삼척시,010004, 8세,2018,444,219,225,97.3,444,219,225,97.3
32070, 삼척시,010005, 9세,2018,484,259,225,115.1,484,259,225,115.1
32070, 삼척시,015,10~14세,2018,2364,1223,1141,107.2,2361,1223,1138,107.5
32070, 삼척시,015001, 10세,2018,478,251,227,110.6,478,251,227,110.6
32070, 삼척시,015002, 11세,2018,485,247,238,103.8,485,247,238,103.8
32070, 삼척시,015003, 12세,2018,458,250,208,120.2,456,250,206,121.4
32070, 삼척시,015004, 13세,2018,473,253,220,115,472,253,219,115.5
32070, 삼척시,015005, 14세,2018,470,222,248,89.5,470,222,248,89.5
32070, 삼척시,020,15~19세,2018,3986,2319,1667,139.1,3967,2310,1657,139.4
32070, 삼척시,020001, 15세,2018,507,252,255,98.8,507,252,255,98.8
32070, 삼척시,020002, 16세,2018,557,303,254,119.3,557,303,254,119.3
32070, 삼척시,020003, 17세,2018,615,343,272,126.1,612,341,271,125.8
32070, 삼척시,020004, 18세,2018,905,535,370,144.6,902,534,368,145.1
32070, 삼척시,020005, 19세,2018,1402,886,516,171.7,1389,880,509,172.9
32070, 삼척시,025,20~24세,2018,6189,3791,2398,158.1,6027,3705,2322,159.6
32070, 삼척시,025001, 20세,2018,1240,683,557,122.6,1216,671,545,123.1
32070, 삼척시,025002, 21세,2018,1238,616,622,99,1205,605,600,100.8
32070, 삼척시,025003, 22세,2018,1343,794,549,144.6,1319,784,535,146.5
32070, 삼척시,025004, 23세,2018,1245,858,387,221.7,1214,835,379,220.3
32070, 삼척시,025005, 24세,2018,1123,840,283,296.8,1073,810,263,308
32070, 삼척시,030,25~29세,2018,3218,1964,1254,156.6,3010,1838,1172,156.8
32070, 삼척시,030001, 25세,2018,856,586,270,217,807,558,249,224.1
32070, 삼척시,030002, 26세,2018,665,385,280,137.5,620,355,265,134
32070, 삼척시,030003, 27세,2018,567,319,248,128.6,523,295,228,129.4
32070, 삼척시,030004, 28세,2018,581,353,228,154.8,544,332,212,156.6
32070, 삼척시,030005, 29세,2018,549,321,228,140.8,516,298,218,136.7
32070, 삼척시,035,30~34세,2018,2868,1572,1296,121.3,2724,1481,1243,119.1
32070, 삼척시,035001, 30세,2018,532,280,252,111.1,501,262,239,109.6
32070, 삼척시,035002, 31세,2018,555,305,250,122,527,284,243,116.9
32070, 삼척시,035003, 32세,2018,537,293,244,120.1,508,275,233,118
32070, 삼척시,035004, 33세,2018,615,337,278,121.2,582,321,261,123
32070, 삼척시,035005, 34세,2018,629,357,272,131.3,606,339,267,127
32070, 삼척시,040,35~39세,2018,3836,2073,1763,117.6,3689,1984,1705,116.4
32070, 삼척시,040001, 35세,2018,695,379,316,119.9,660,364,296,123
32070, 삼척시,040002, 36세,2018,755,406,349,116.3,731,392,339,115.6
32070, 삼척시,040003, 37세,2018,778,431,347,124.2,745,409,336,121.7
32070, 삼척시,040004, 38세,2018,823,427,396,107.8,796,409,387,105.7
32070, 삼척시,040005, 39세,2018,785,430,355,121.1,757,410,347,118.2
32070, 삼척시,045,40~44세,2018,4303,2367,1936,122.3,4219,2318,1901,121.9
32070, 삼척시,045001, 40세,2018,788,423,365,115.9,771,413,358,115.4
32070, 삼척시,045002, 41세,2018,791,441,350,126,778,431,347,124.2
32070, 삼척시,045003, 42세,2018,811,431,380,113.4,797,424,373,113.7
32070, 삼척시,045004, 43세,2018,906,498,408,122.1,880,484,396,122.2
32070, 삼척시,045005, 44세,2018,1007,574,433,132.6,993,566,427,132.6
32070, 삼척시,050,45~49세,2018,4984,2795,2189,127.7,4919,2768,2151,128.7
32070, 삼척시,050001, 45세,2018,984,570,414,137.7,972,564,408,138.2
32070, 삼척시,050002, 46세,2018,880,500,380,131.6,862,492,370,133
32070, 삼척시,050003, 47세,2018,1058,589,469,125.6,1045,585,460,127.2
32070, 삼척시,050004, 48세,2018,1000,556,444,125.2,989,551,438,125.8
32070, 삼척시,050005, 49세,2018,1062,580,482,120.3,1051,576,475,121.3
32070, 삼척시,055,50~54세,2018,5145,2745,2400,114.4,5089,2720,2369,114.8
32070, 삼척시,055001, 50세,2018,1081,601,480,125.2,1071,595,476,125
32070, 삼척시,055002, 51세,2018,995,515,480,107.3,980,508,472,107.6
32070, 삼척시,055003, 52세,2018,1064,579,485,119.4,1052,574,478,120.1
32070, 삼척시,055004, 53세,2018,973,489,484,101,963,485,478,101.5
32070, 삼척시,055005, 54세,2018,1032,561,471,119.1,1023,558,465,120
32070, 삼척시,060,55~59세,2018,6300,3198,3102,103.1,6271,3183,3088,103.1
32070, 삼척시,060001, 55세,2018,1049,552,497,111.1,1038,547,491,111.4
32070, 삼척시,060002, 56세,2018,1172,601,571,105.3,1167,597,570,104.7
32070, 삼척시,060003, 57세,2018,1423,708,715,99,1418,706,712,99.2
32070, 삼척시,060004, 58세,2018,1388,706,682,103.5,1385,705,680,103.7
32070, 삼척시,060005, 59세,2018,1268,631,637,99.1,1263,628,635,98.9
32070, 삼척시,065,60~64세,2018,5571,2781,2790,99.7,5548,2773,2775,99.9
32070, 삼척시,065001, 60세,2018,1170,597,573,104.2,1165,595,570,104.4
32070, 삼척시,065002, 61세,2018,1206,605,601,100.7,1200,603,597,101
32070, 삼척시,065003, 62세,2018,1096,528,568,93,1089,526,563,93.4
32070, 삼척시,065004, 63세,2018,1110,546,564,96.8,1109,545,564,96.6
32070, 삼척시,065005, 64세,2018,989,505,484,104.3,985,504,481,104.8
32070, 삼척시,070,65~69세,2018,4101,2020,2081,97.1,4095,2018,2077,97.2
32070, 삼척시,070001, 65세,2018,910,448,462,97,908,447,461,97
32070, 삼척시,070002, 66세,2018,962,490,472,103.8,961,489,472,103.6
32070, 삼척시,070003, 67세,2018,624,290,334,86.8,622,290,332,87.3
32070, 삼척시,070004, 68세,2018,788,385,403,95.5,788,385,403,95.5
32070, 삼척시,070005, 69세,2018,817,407,410,99.3,816,407,409,99.5
32070, 삼척시,075,70~74세,2018,3544,1610,1934,83.2,3543,1609,1934,83.2
32070, 삼척시,075001, 70세,2018,846,381,465,81.9,846,381,465,81.9
32070, 삼척시,075002, 71세,2018,705,349,356,98,705,349,356,98
32070, 삼척시,075003, 72세,2018,603,283,320,88.4,603,283,320,88.4
32070, 삼척시,075004, 73세,2018,679,304,375,81.1,679,304,375,81.1
32070, 삼척시,075005, 74세,2018,711,293,418,70.1,710,292,418,69.9
32070, 삼척시,080,75~79세,2018,3394,1339,2055,65.2,3392,1338,2054,65.1
32070, 삼척시,080001, 75세,2018,743,308,435,70.8,742,308,434,71
32070, 삼척시,080002, 76세,2018,730,280,450,62.2,730,280,450,62.2
32070, 삼척시,080003, 77세,2018,664,250,414,60.4,663,249,414,60.1
32070, 삼척시,080004, 78세,2018,663,269,394,68.3,663,269,394,68.3
32070, 삼척시,080005, 79세,2018,594,232,362,64.1,594,232,362,64.1
32070, 삼척시,085,80~84세,2018,2308,788,1520,51.8,2308,788,1520,51.8
32070, 삼척시,085001, 80세,2018,547,197,350,56.3,547,197,350,56.3
32070, 삼척시,085002, 81세,2018,485,171,314,54.5,485,171,314,54.5
32070, 삼척시,085003, 82세,2018,460,155,305,50.8,460,155,305,50.8
32070, 삼척시,085004, 83세,2018,433,148,285,51.9,433,148,285,51.9
32070, 삼척시,085005, 84세,2018,383,117,266,44,383,117,266,44
32070, 삼척시,090,85~89세,2018,1074,278,796,34.9,1074,278,796,34.9
32070, 삼척시,090001, 85세,2018,265,77,188,41,265,77,188,41
32070, 삼척시,090002, 86세,2018,277,77,200,38.5,277,77,200,38.5
32070, 삼척시,090003, 87세,2018,201,54,147,36.7,201,54,147,36.7
32070, 삼척시,090004, 88세,2018,182,40,142,28.2,182,40,142,28.2
32070, 삼척시,090005, 89세,2018,149,30,119,25.2,149,30,119,25.2
32070, 삼척시,095,90~94세,2018,357,71,286,24.8,357,71,286,24.8
32070, 삼척시,095001, 90세,2018,110,25,85,29.4,110,25,85,29.4
32070, 삼척시,095002, 91세,2018,78,16,62,25.8,78,16,62,25.8
32070, 삼척시,095003, 92세,2018,73,13,60,21.7,73,13,60,21.7
32070, 삼척시,095004, 93세,2018,61,10,51,19.6,61,10,51,19.6
32070, 삼척시,095005, 94세,2018,35,7,28,25,35,7,28,25
32070, 삼척시,100,95~99세,2018,59,7,52,13.5,59,7,52,13.5
32070, 삼척시,100001, 95세,2018,24,X,21,14.3,24,X,21,14.3
32070, 삼척시,100002, 96세,2018,16,X,14,14.3,16,X,14,14.3
32070, 삼척시,100003, 97세,2018,13,X,13,0,13,X,13,0
32070, 삼척시,100004, 98세,2018,X,X,X,100,X,X,X,100
32070, 삼척시,100005, 99세,2018,X,X,X,33.3,X,X,X,33.3
32070, 삼척시,101,100세이상,2018,5,X,X,25,5,X,X,25
32070, 삼척시,102,15세미만,2018,6639,3456,3183,108.6,6632,3454,3178,108.7
32070, 삼척시,103,15~64세,2018,46400,25605,20795,123.1,45463,25080,20383,123
32070, 삼척시,104,65세이상,2018,14842,6114,8728,70.1,14833,6110,8723,70
32070, 삼척시,086,85세이상,2018,1495,357,1138,31.4,1495,357,1138,31.4
32070, 삼척시,126,평균연령,2018,45.8,43.4,48.4,,45.9,43.5,48.5,
32070, 삼척시,127,중위연령,2018,48,45.1,51.4,,48.3,45.4,51.7,
32310, 홍천군,000,합계,2018,67177,34347,32830,104.6,65842,33599,32243,104.2
32310, 홍천군,005,0~4세,2018,2002,1040,962,108.1,1995,1034,961,107.6
32310, 홍천군,005001, 0세,2018,363,198,165,120,362,197,165,119.4
32310, 홍천군,005002, 1세,2018,386,188,198,94.9,384,187,197,94.9
32310, 홍천군,005003, 2세,2018,409,228,181,126,408,227,181,125.4
32310, 홍천군,005004, 3세,2018,429,221,208,106.3,428,220,208,105.8
32310, 홍천군,005005, 4세,2018,415,205,210,97.6,413,203,210,96.7
32310, 홍천군,010,5~9세,2018,2327,1166,1161,100.4,2323,1165,1158,100.6
32310, 홍천군,010001, 5세,2018,397,202,195,103.6,396,201,195,103.1
32310, 홍천군,010002, 6세,2018,481,231,250,92.4,481,231,250,92.4
32310, 홍천군,010003, 7세,2018,459,221,238,92.9,458,221,237,93.2
32310, 홍천군,010004, 8세,2018,501,252,249,101.2,501,252,249,101.2
32310, 홍천군,010005, 9세,2018,489,260,229,113.5,487,260,227,114.5
32310, 홍천군,015,10~14세,2018,2472,1252,1220,102.6,2468,1250,1218,102.6
32310, 홍천군,015001, 10세,2018,480,226,254,89,480,226,254,89
32310, 홍천군,015002, 11세,2018,514,253,261,96.9,513,253,260,97.3
32310, 홍천군,015003, 12세,2018,447,240,207,115.9,445,239,206,116
32310, 홍천군,015004, 13세,2018,520,267,253,105.5,520,267,253,105.5
32310, 홍천군,015005, 14세,2018,511,266,245,108.6,510,265,245,108.2
32310, 홍천군,020,15~19세,2018,3111,1640,1471,111.5,3101,1635,1466,111.5
32310, 홍천군,020001, 15세,2018,580,306,274,111.7,577,305,272,112.1
32310, 홍천군,020002, 16세,2018,642,336,306,109.8,642,336,306,109.8
32310, 홍천군,020003, 17세,2018,766,398,368,108.2,764,397,367,108.2
32310, 홍천군,020004, 18세,2018,701,350,351,99.7,699,349,350,99.7
32310, 홍천군,020005, 19세,2018,422,250,172,145.3,419,248,171,145
32310, 홍천군,025,20~24세,2018,2948,1729,1219,141.8,2803,1641,1162,141.2
32310, 홍천군,025001, 20세,2018,529,334,195,171.3,512,321,191,168.1
32310, 홍천군,025002, 21세,2018,585,372,213,174.6,564,361,203,177.8
32310, 홍천군,025003, 22세,2018,579,316,263,120.2,556,302,254,118.9
32310, 홍천군,025004, 23세,2018,615,350,265,132.1,576,324,252,128.6
32310, 홍천군,025005, 24세,2018,640,357,283,126.1,595,333,262,127.1
32310, 홍천군,030,25~29세,2018,3509,2088,1421,146.9,3183,1864,1319,141.3
32310, 홍천군,030001, 25세,2018,735,431,304,141.8,665,381,284,134.2
32310, 홍천군,030002, 26세,2018,728,429,299,143.5,660,385,275,140
32310, 홍천군,030003, 27세,2018,711,424,287,147.7,645,380,265,143.4
32310, 홍천군,030004, 28세,2018,661,406,255,159.2,603,365,238,153.4
32310, 홍천군,030005, 29세,2018,674,398,276,144.2,610,353,257,137.4
32310, 홍천군,035,30~34세,2018,3154,1805,1349,133.8,2897,1642,1255,130.8
32310, 홍천군,035001, 30세,2018,637,370,267,138.6,593,337,256,131.6
32310, 홍천군,035002, 31세,2018,645,374,271,138,588,337,251,134.3
32310, 홍천군,035003, 32세,2018,610,354,256,138.3,556,319,237,134.6
32310, 홍천군,035004, 33세,2018,631,347,284,122.2,573,316,257,123
32310, 홍천군,035005, 34세,2018,631,360,271,132.8,587,333,254,131.1
32310, 홍천군,040,35~39세,2018,3631,1910,1721,111,3476,1820,1656,109.9
32310, 홍천군,040001, 35세,2018,666,360,306,117.6,630,334,296,112.8
32310, 홍천군,040002, 36세,2018,767,402,365,110.1,731,384,347,110.7
32310, 홍천군,040003, 37세,2018,755,409,346,118.2,738,399,339,117.7
32310, 홍천군,040004, 38세,2018,746,386,360,107.2,711,365,346,105.5
32310, 홍천군,040005, 39세,2018,697,353,344,102.6,666,338,328,103
32310, 홍천군,045,40~44세,2018,3869,2065,1804,114.5,3788,2033,1755,115.8
32310, 홍천군,045001, 40세,2018,692,375,317,118.3,674,367,307,119.5
32310, 홍천군,045002, 41세,2018,767,394,373,105.6,749,384,365,105.2
32310, 홍천군,045003, 42세,2018,749,395,354,111.6,734,391,343,114
32310, 홍천군,045004, 43세,2018,755,403,352,114.5,742,398,344,115.7
32310, 홍천군,045005, 44세,2018,906,498,408,122.1,889,493,396,124.5
32310, 홍천군,050,45~49세,2018,4785,2544,2241,113.5,4704,2506,2198,114
32310, 홍천군,050001, 45세,2018,911,494,417,118.5,898,490,408,120.1
32310, 홍천군,050002, 46세,2018,898,485,413,117.4,882,473,409,115.6
32310, 홍천군,050003, 47세,2018,949,512,437,117.2,938,505,433,116.6
32310, 홍천군,050004, 48세,2018,944,498,446,111.7,924,490,434,112.9
32310, 홍천군,050005, 49세,2018,1083,555,528,105.1,1062,548,514,106.6
32310, 홍천군,055,50~54세,2018,5518,2914,2604,111.9,5415,2883,2532,113.9
32310, 홍천군,055001, 50세,2018,1097,569,528,107.8,1077,567,510,111.2
32310, 홍천군,055002, 51세,2018,1041,528,513,102.9,1029,523,506,103.4
32310, 홍천군,055003, 52세,2018,1112,593,519,114.3,1088,585,503,116.3
32310, 홍천군,055004, 53세,2018,1055,549,506,108.5,1024,538,486,110.7
32310, 홍천군,055005, 54세,2018,1213,675,538,125.5,1197,670,527,127.1
32310, 홍천군,060,55~59세,2018,7119,3617,3502,103.3,7063,3591,3472,103.4
32310, 홍천군,060001, 55세,2018,1234,636,598,106.4,1223,631,592,106.6
32310, 홍천군,060002, 56세,2018,1407,736,671,109.7,1393,726,667,108.8
32310, 홍천군,060003, 57세,2018,1652,829,823,100.7,1641,826,815,101.3
32310, 홍천군,060004, 58세,2018,1414,674,740,91.1,1400,667,733,91
32310, 홍천군,060005, 59세,2018,1412,742,670,110.7,1406,741,665,111.4
32310, 홍천군,065,60~64세,2018,6981,3638,3343,108.8,6926,3613,3313,109.1
32310, 홍천군,065001, 60세,2018,1547,789,758,104.1,1532,784,748,104.8
32310, 홍천군,065002, 61세,2018,1521,803,718,111.8,1509,797,712,111.9
32310, 홍천군,065003, 62세,2018,1410,736,674,109.2,1404,733,671,109.2
32310, 홍천군,065004, 63세,2018,1345,709,636,111.5,1334,705,629,112.1
32310, 홍천군,065005, 64세,2018,1158,601,557,107.9,1147,594,553,107.4
32310, 홍천군,070,65~69세,2018,4250,2217,2033,109.1,4220,2208,2012,109.7
32310, 홍천군,070001, 65세,2018,948,485,463,104.8,940,482,458,105.2
32310, 홍천군,070002, 66세,2018,1262,686,576,119.1,1254,685,569,120.4
32310, 홍천군,070003, 67세,2018,649,328,321,102.2,645,327,318,102.8
32310, 홍천군,070004, 68세,2018,705,358,347,103.2,700,356,344,103.5
32310, 홍천군,070005, 69세,2018,686,360,326,110.4,681,358,323,110.8
32310, 홍천군,075,70~74세,2018,3658,1773,1885,94.1,3649,1769,1880,94.1
32310, 홍천군,075001, 70세,2018,769,379,390,97.2,768,378,390,96.9
32310, 홍천군,075002, 71세,2018,815,411,404,101.7,812,410,402,102
32310, 홍천군,075003, 72세,2018,726,351,375,93.6,725,351,374,93.9
32310, 홍천군,075004, 73세,2018,693,336,357,94.1,691,336,355,94.6
32310, 홍천군,075005, 74세,2018,655,296,359,82.5,653,294,359,81.9
32310, 홍천군,080,75~79세,2018,3602,1531,2071,73.9,3595,1529,2066,74
32310, 홍천군,080001, 75세,2018,704,311,393,79.1,699,309,390,79.2
32310, 홍천군,080002, 76세,2018,785,319,466,68.5,784,319,465,68.6
32310, 홍천군,080003, 77세,2018,746,336,410,82,745,336,409,82.2
32310, 홍천군,080004, 78세,2018,681,295,386,76.4,681,295,386,76.4
32310, 홍천군,080005, 79세,2018,686,270,416,64.9,686,270,416,64.9
32310, 홍천군,085,80~84세,2018,2613,983,1630,60.3,2609,981,1628,60.3
32310, 홍천군,085001, 80세,2018,660,283,377,75.1,660,283,377,75.1
32310, 홍천군,085002, 81세,2018,584,230,354,65,582,228,354,64.4
32310, 홍천군,085003, 82세,2018,514,208,306,68,512,208,304,68.4
32310, 홍천군,085004, 83세,2018,454,149,305,48.9,454,149,305,48.9
32310, 홍천군,085005, 84세,2018,401,113,288,39.2,401,113,288,39.2
32310, 홍천군,090,85~89세,2018,1118,301,817,36.8,1117,301,816,36.9
32310, 홍천군,090001, 85세,2018,289,86,203,42.4,289,86,203,42.4
32310, 홍천군,090002, 86세,2018,237,63,174,36.2,237,63,174,36.2
32310, 홍천군,090003, 87세,2018,223,50,173,28.9,223,50,173,28.9
32310, 홍천군,090004, 88세,2018,225,61,164,37.2,224,61,163,37.4
32310, 홍천군,090005, 89세,2018,144,41,103,39.8,144,41,103,39.8
32310, 홍천군,095,90~94세,2018,398,108,290,37.2,398,108,290,37.2
32310, 홍천군,095001, 90세,2018,122,33,89,37.1,122,33,89,37.1
32310, 홍천군,095002, 91세,2018,90,22,68,32.4,90,22,68,32.4
32310, 홍천군,095003, 92세,2018,75,16,59,27.1,75,16,59,27.1
32310, 홍천군,095004, 93세,2018,69,22,47,46.8,69,22,47,46.8
32310, 홍천군,095005, 94세,2018,42,15,27,55.6,42,15,27,55.6
32310, 홍천군,100,95~99세,2018,97,23,74,31.1,97,23,74,31.1
32310, 홍천군,100001, 95세,2018,38,12,26,46.2,38,12,26,46.2
32310, 홍천군,100002, 96세,2018,22,5,17,29.4,22,5,17,29.4
32310, 홍천군,100003, 97세,2018,17,X,14,21.4,17,X,14,21.4
32310, 홍천군,100004, 98세,2018,15,X,13,15.4,15,X,13,15.4
32310, 홍천군,100005, 99세,2018,5,X,X,25,5,X,X,25
32310, 홍천군,101,100세이상,2018,15,X,12,25,15,X,12,25
32310, 홍천군,102,15세미만,2018,6801,3458,3343,103.4,6786,3449,3337,103.4
32310, 홍천군,103,15~64세,2018,44625,23950,20675,115.8,43356,23228,20128,115.4
32310, 홍천군,104,65세이상,2018,15751,6939,8812,78.7,15700,6922,8778,78.9
32310, 홍천군,086,85세이상,2018,1628,435,1193,36.5,1627,435,1192,36.5
32310, 홍천군,126,평균연령,2018,48,46.4,49.7,,48.3,46.7,49.9,
32310, 홍천군,127,중위연령,2018,51.7,49.9,53.6,,52.1,50.4,53.9,
32320, 횡성군,000,합계,2018,44116,22417,21699,103.3,43275,21941,21334,102.8
32320, 횡성군,005,0~4세,2018,1013,522,491,106.3,1013,522,491,106.3
32320, 횡성군,005001, 0세,2018,148,88,60,146.7,148,88,60,146.7
32320, 횡성군,005002, 1세,2018,210,106,104,101.9,210,106,104,101.9
32320, 횡성군,005003, 2세,2018,193,107,86,124.4,193,107,86,124.4
32320, 횡성군,005004, 3세,2018,243,114,129,88.4,243,114,129,88.4
32320, 횡성군,005005, 4세,2018,219,107,112,95.5,219,107,112,95.5
32320, 횡성군,010,5~9세,2018,1344,679,665,102.1,1341,679,662,102.6
32320, 횡성군,010001, 5세,2018,232,113,119,95,231,113,118,95.8
32320, 횡성군,010002, 6세,2018,276,137,139,98.6,276,137,139,98.6
32320, 횡성군,010003, 7세,2018,276,152,124,122.6,276,152,124,122.6
32320, 횡성군,010004, 8세,2018,272,139,133,104.5,271,139,132,105.3
32320, 횡성군,010005, 9세,2018,288,138,150,92,287,138,149,92.6
32320, 횡성군,015,10~14세,2018,1455,773,682,113.3,1452,771,681,113.2
32320, 횡성군,015001, 10세,2018,288,168,120,140,287,168,119,141.2
32320, 횡성군,015002, 11세,2018,315,164,151,108.6,314,163,151,107.9
32320, 횡성군,015003, 12세,2018,279,147,132,111.4,278,146,132,110.6
32320, 횡성군,015004, 13세,2018,294,136,158,86.1,294,136,158,86.1
32320, 횡성군,015005, 14세,2018,279,158,121,130.6,279,158,121,130.6
32320, 횡성군,020,15~19세,2018,2209,1162,1047,111,2199,1157,1042,111
32320, 횡성군,020001, 15세,2018,319,171,148,115.5,319,171,148,115.5
32320, 횡성군,020002, 16세,2018,485,251,234,107.3,485,251,234,107.3
32320, 횡성군,020003, 17세,2018,490,257,233,110.3,489,257,232,110.8
32320, 횡성군,020004, 18세,2018,481,245,236,103.8,478,244,234,104.3
32320, 횡성군,020005, 19세,2018,434,238,196,121.4,428,234,194,120.6
32320, 횡성군,025,20~24세,2018,2233,1281,952,134.6,2117,1209,908,133.1
32320, 횡성군,025001, 20세,2018,428,263,165,159.4,415,253,162,156.2
32320, 횡성군,025002, 21세,2018,458,237,221,107.2,439,226,213,106.1
32320, 횡성군,025003, 22세,2018,467,275,192,143.2,441,257,184,139.7
32320, 횡성군,025004, 23세,2018,422,239,183,130.6,395,224,171,131
32320, 횡성군,025005, 24세,2018,458,267,191,139.8,427,249,178,139.9
32320, 횡성군,030,25~29세,2018,1821,1052,769,136.8,1666,948,718,132
32320, 횡성군,030001, 25세,2018,375,228,147,155.1,341,207,134,154.5
32320, 횡성군,030002, 26세,2018,375,208,167,124.6,354,192,162,118.5
32320, 횡성군,030003, 27세,2018,370,217,153,141.8,337,195,142,137.3
32320, 횡성군,030004, 28세,2018,362,204,158,129.1,334,183,151,121.2
32320, 횡성군,030005, 29세,2018,339,195,144,135.4,300,171,129,132.6
32320, 횡성군,035,30~34세,2018,1707,945,762,124,1545,842,703,119.8
32320, 횡성군,035001, 30세,2018,298,160,138,115.9,271,143,128,111.7
32320, 횡성군,035002, 31세,2018,341,185,156,118.6,300,156,144,108.3
32320, 횡성군,035003, 32세,2018,344,183,161,113.7,310,168,142,118.3
32320, 횡성군,035004, 33세,2018,381,219,162,135.2,353,198,155,127.7
32320, 횡성군,035005, 34세,2018,343,198,145,136.6,311,177,134,132.1
32320, 횡성군,040,35~39세,2018,2098,1095,1003,109.2,2002,1036,966,107.2
32320, 횡성군,040001, 35세,2018,411,216,195,110.8,388,197,191,103.1
32320, 횡성군,040002, 36세,2018,398,190,208,91.3,378,177,201,88.1
32320, 횡성군,040003, 37세,2018,438,243,195,124.6,421,237,184,128.8
32320, 횡성군,040004, 38세,2018,441,237,204,116.2,423,226,197,114.7
32320, 횡성군,040005, 39세,2018,410,209,201,104,392,199,193,103.1
32320, 횡성군,045,40~44세,2018,2160,1182,978,120.9,2100,1155,945,122.2
32320, 횡성군,045001, 40세,2018,409,204,205,99.5,393,199,194,102.6
32320, 횡성군,045002, 41세,2018,405,240,165,145.5,388,232,156,148.7
32320, 횡성군,045003, 42세,2018,408,235,173,135.8,395,227,168,135.1
32320, 횡성군,045004, 43세,2018,438,249,189,131.7,427,243,184,132.1
32320, 횡성군,045005, 44세,2018,500,254,246,103.3,497,254,243,104.5
32320, 횡성군,050,45~49세,2018,3021,1622,1399,115.9,2954,1595,1359,117.4
32320, 횡성군,050001, 45세,2018,529,302,227,133,518,297,221,134.4
32320, 횡성군,050002, 46세,2018,530,287,243,118.1,513,280,233,120.2
32320, 횡성군,050003, 47세,2018,629,322,307,104.9,612,319,293,108.9
32320, 횡성군,050004, 48세,2018,610,319,291,109.6,600,311,289,107.6
32320, 횡성군,050005, 49세,2018,723,392,331,118.4,711,388,323,120.1
32320, 횡성군,055,50~54세,2018,3548,1857,1691,109.8,3483,1830,1653,110.7
32320, 횡성군,055001, 50세,2018,695,375,320,117.2,676,366,310,118.1
32320, 횡성군,055002, 51세,2018,686,339,347,97.7,676,336,340,98.8
32320, 횡성군,055003, 52세,2018,699,390,309,126.2,685,383,302,126.8
32320, 횡성군,055004, 53세,2018,732,367,365,100.5,724,363,361,100.6
32320, 횡성군,055005, 54세,2018,736,386,350,110.3,722,382,340,112.4
32320, 횡성군,060,55~59세,2018,4913,2497,2416,103.4,4870,2477,2393,103.5
32320, 횡성군,060001, 55세,2018,799,413,386,107,791,412,379,108.7
32320, 횡성군,060002, 56세,2018,941,499,442,112.9,930,493,437,112.8
32320, 횡성군,060003, 57세,2018,1049,523,526,99.4,1041,519,522,99.4
32320, 횡성군,060004, 58세,2018,1147,559,588,95.1,1139,554,585,94.7
32320, 횡성군,060005, 59세,2018,977,503,474,106.1,969,499,470,106.2
32320, 횡성군,065,60~64세,2018,4842,2472,2370,104.3,4819,2460,2359,104.3
32320, 횡성군,065001, 60세,2018,1096,540,556,97.1,1093,537,556,96.6
32320, 횡성군,065002, 61세,2018,1008,536,472,113.6,998,530,468,113.2
32320, 횡성군,065003, 62세,2018,999,492,507,97,997,492,505,97.4
32320, 횡성군,065004, 63세,2018,897,481,416,115.6,894,478,416,114.9
32320, 횡성군,065005, 64세,2018,842,423,419,101,837,423,414,102.2
32320, 횡성군,070,65~69세,2018,3140,1644,1496,109.9,3118,1635,1483,110.2
32320, 횡성군,070001, 65세,2018,671,356,315,113,667,354,313,113.1
32320, 횡성군,070002, 66세,2018,946,495,451,109.8,941,492,449,109.6
32320, 횡성군,070003, 67세,2018,461,236,225,104.9,457,235,222,105.9
32320, 횡성군,070004, 68세,2018,526,268,258,103.9,521,265,256,103.5
32320, 횡성군,070005, 69세,2018,536,289,247,117,532,289,243,118.9
32320, 횡성군,075,70~74세,2018,2748,1345,1403,95.9,2740,1340,1400,95.7
32320, 횡성군,075001, 70세,2018,586,282,304,92.8,586,282,304,92.8
32320, 횡성군,075002, 71세,2018,625,332,293,113.3,623,331,292,113.4
32320, 횡성군,075003, 72세,2018,500,237,263,90.1,499,236,263,89.7
32320, 횡성군,075004, 73세,2018,521,267,254,105.1,517,264,253,104.3
32320, 횡성군,075005, 74세,2018,516,227,289,78.5,515,227,288,78.8
32320, 횡성군,080,75~79세,2018,2690,1207,1483,81.4,2684,1204,1480,81.4
32320, 횡성군,080001, 75세,2018,519,227,292,77.7,519,227,292,77.7
32320, 횡성군,080002, 76세,2018,592,290,302,96,589,290,299,97
32320, 횡성군,080003, 77세,2018,597,269,328,82,597,269,328,82
32320, 횡성군,080004, 78세,2018,481,221,260,85,480,220,260,84.6
32320, 횡성군,080005, 79세,2018,501,200,301,66.4,499,198,301,65.8
32320, 횡성군,085,80~84세,2018,1898,748,1150,65,1897,748,1149,65.1
32320, 횡성군,085001, 80세,2018,491,221,270,81.9,491,221,270,81.9
32320, 횡성군,085002, 81세,2018,441,191,250,76.4,441,191,250,76.4
32320, 횡성군,085003, 82세,2018,376,151,225,67.1,376,151,225,67.1
32320, 횡성군,085004, 83세,2018,312,97,215,45.1,311,97,214,45.3
32320, 횡성군,085005, 84세,2018,278,88,190,46.3,278,88,190,46.3
32320, 횡성군,090,85~89세,2018,872,231,641,36,871,230,641,35.9
32320, 횡성군,090001, 85세,2018,226,64,162,39.5,226,64,162,39.5
32320, 횡성군,090002, 86세,2018,182,46,136,33.8,182,46,136,33.8
32320, 횡성군,090003, 87세,2018,165,50,115,43.5,164,49,115,42.6
32320, 횡성군,090004, 88세,2018,175,40,135,29.6,175,40,135,29.6
32320, 횡성군,090005, 89세,2018,124,31,93,33.3,124,31,93,33.3
32320, 횡성군,095,90~94세,2018,313,85,228,37.3,313,85,228,37.3
32320, 횡성군,095001, 90세,2018,94,25,69,36.2,94,25,69,36.2
32320, 횡성군,095002, 91세,2018,79,17,62,27.4,79,17,62,27.4
32320, 횡성군,095003, 92세,2018,58,14,44,31.8,58,14,44,31.8
32320, 횡성군,095004, 93세,2018,49,14,35,40,49,14,35,40
32320, 횡성군,095005, 94세,2018,33,15,18,83.3,33,15,18,83.3
32320, 횡성군,100,95~99세,2018,81,17,64,26.6,81,17,64,26.6
32320, 횡성군,100001, 95세,2018,29,8,21,38.1,29,8,21,38.1
32320, 횡성군,100002, 96세,2018,22,6,16,37.5,22,6,16,37.5
32320, 횡성군,100003, 97세,2018,16,X,16,0,16,X,16,0
32320, 횡성군,100004, 98세,2018,5,X,5,0,5,X,5,0
32320, 횡성군,100005, 99세,2018,9,X,6,50,9,X,6,50
32320, 횡성군,101,100세이상,2018,10,X,9,11.1,10,X,9,11.1
32320, 횡성군,102,15세미만,2018,3812,1974,1838,107.4,3806,1972,1834,107.5
32320, 횡성군,103,15~64세,2018,28552,15165,13387,113.3,27755,14709,13046,112.7
32320, 횡성군,104,65세이상,2018,11752,5278,6474,81.5,11714,5260,6454,81.5
32320, 횡성군,086,85세이상,2018,1276,334,942,35.5,1275,333,942,35.4
32320, 횡성군,126,평균연령,2018,49.9,48.3,51.5,,50.1,48.5,51.7,
32320, 횡성군,127,중위연령,2018,54.3,52.5,56.1,,54.7,52.9,56.4,
32330, 영월군,000,합계,2018,36762,18977,17785,106.7,36277,18785,17492,107.4
32330, 영월군,005,0~4세,2018,791,416,375,110.9,788,416,372,111.8
32330, 영월군,005001, 0세,2018,121,68,53,128.3,121,68,53,128.3
32330, 영월군,005002, 1세,2018,143,72,71,101.4,142,72,70,102.9
32330, 영월군,005003, 2세,2018,162,84,78,107.7,162,84,78,107.7
32330, 영월군,005004, 3세,2018,163,85,78,109,162,85,77,110.4
32330, 영월군,005005, 4세,2018,202,107,95,112.6,201,107,94,113.8
32330, 영월군,010,5~9세,2018,1054,558,496,112.5,1054,558,496,112.5
32330, 영월군,010001, 5세,2018,180,101,79,127.8,180,101,79,127.8
32330, 영월군,010002, 6세,2018,201,116,85,136.5,201,116,85,136.5
32330, 영월군,010003, 7세,2018,239,113,126,89.7,239,113,126,89.7
32330, 영월군,010004, 8세,2018,226,118,108,109.3,226,118,108,109.3
32330, 영월군,010005, 9세,2018,208,110,98,112.2,208,110,98,112.2
32330, 영월군,015,10~14세,2018,1223,650,573,113.4,1222,650,572,113.6
32330, 영월군,015001, 10세,2018,214,111,103,107.8,214,111,103,107.8
32330, 영월군,015002, 11세,2018,224,116,108,107.4,224,116,108,107.4
32330, 영월군,015003, 12세,2018,265,140,125,112,265,140,125,112
32330, 영월군,015004, 13세,2018,235,135,100,135,234,135,99,136.4
32330, 영월군,015005, 14세,2018,285,148,137,108,285,148,137,108
32330, 영월군,020,15~19세,2018,1745,989,756,130.8,1737,986,751,131.3
32330, 영월군,020001, 15세,2018,275,147,128,114.8,273,147,126,116.7
32330, 영월군,020002, 16세,2018,323,174,149,116.8,322,173,149,116.1
32330, 영월군,020003, 17세,2018,394,215,179,120.1,394,215,179,120.1
32330, 영월군,020004, 18세,2018,386,231,155,149,384,230,154,149.4
32330, 영월군,020005, 19세,2018,367,222,145,153.1,364,221,143,154.5
32330, 영월군,025,20~24세,2018,1682,1042,640,162.8,1637,1029,608,169.2
32330, 영월군,025001, 20세,2018,391,250,141,177.3,388,249,139,179.1
32330, 영월군,025002, 21세,2018,362,239,123,194.3,357,239,118,202.5
32330, 영월군,025003, 22세,2018,327,210,117,179.5,316,207,109,189.9
32330, 영월군,025004, 23세,2018,296,168,128,131.3,285,165,120,137.5
32330, 영월군,025005, 24세,2018,306,175,131,133.6,291,169,122,138.5
32330, 영월군,030,25~29세,2018,1330,752,578,130.1,1255,729,526,138.6
32330, 영월군,030001, 25세,2018,269,162,107,151.4,259,158,101,156.4
32330, 영월군,030002, 26세,2018,299,158,141,112.1,282,155,127,122
32330, 영월군,030003, 27세,2018,293,179,114,157,271,170,101,168.3
32330, 영월군,030004, 28세,2018,231,121,110,110,215,119,96,124
32330, 영월군,030005, 29세,2018,238,132,106,124.5,228,127,101,125.7
32330, 영월군,035,30~34세,2018,1294,714,580,123.1,1223,689,534,129
32330, 영월군,035001, 30세,2018,259,148,111,133.3,249,146,103,141.7
32330, 영월군,035002, 31세,2018,251,129,122,105.7,236,124,112,110.7
32330, 영월군,035003, 32세,2018,262,156,106,147.2,247,152,95,160
32330, 영월군,035004, 33세,2018,240,127,113,112.4,224,120,104,115.4
32330, 영월군,035005, 34세,2018,282,154,128,120.3,267,147,120,122.5
32330, 영월군,040,35~39세,2018,1652,891,761,117.1,1594,868,726,119.6
32330, 영월군,040001, 35세,2018,297,167,130,128.5,283,164,119,137.8
32330, 영월군,040002, 36세,2018,368,199,169,117.8,349,189,160,118.1
32330, 영월군,040003, 37세,2018,317,181,136,133.1,312,179,133,134.6
32330, 영월군,040004, 38세,2018,340,175,165,106.1,327,170,157,108.3
32330, 영월군,040005, 39세,2018,330,169,161,105,323,166,157,105.7
32330, 영월군,045,40~44세,2018,2069,1117,952,117.3,2022,1093,929,117.7
32330, 영월군,045001, 40세,2018,373,209,164,127.4,362,203,159,127.7
32330, 영월군,045002, 41세,2018,366,198,168,117.9,359,193,166,116.3
32330, 영월군,045003, 42세,2018,400,217,183,118.6,389,210,179,117.3
32330, 영월군,045004, 43세,2018,415,234,181,129.3,406,232,174,133.3
32330, 영월군,045005, 44세,2018,515,259,256,101.2,506,255,251,101.6
32330, 영월군,050,45~49세,2018,2770,1553,1217,127.6,2709,1522,1187,128.2
32330, 영월군,050001, 45세,2018,535,304,231,131.6,525,299,226,132.3
32330, 영월군,050002, 46세,2018,469,261,208,125.5,453,249,204,122.1
32330, 영월군,050003, 47세,2018,607,349,258,135.3,595,342,253,135.2
32330, 영월군,050004, 48세,2018,564,316,248,127.4,548,312,236,132.2
32330, 영월군,050005, 49세,2018,595,323,272,118.8,588,320,268,119.4
32330, 영월군,055,50~54세,2018,3138,1721,1417,121.5,3089,1701,1388,122.6
32330, 영월군,055001, 50세,2018,672,377,295,127.8,662,372,290,128.3
32330, 영월군,055002, 51세,2018,567,324,243,133.3,558,321,237,135.4
32330, 영월군,055003, 52세,2018,656,360,296,121.6,648,357,291,122.7
32330, 영월군,055004, 53세,2018,626,315,311,101.3,616,312,304,102.6
32330, 영월군,055005, 54세,2018,617,345,272,126.8,605,339,266,127.4
32330, 영월군,060,55~59세,2018,4072,2144,1928,111.2,4047,2136,1911,111.8
32330, 영월군,060001, 55세,2018,707,397,310,128.1,699,395,304,129.9
32330, 영월군,060002, 56세,2018,828,446,382,116.8,823,442,381,116
32330, 영월군,060003, 57세,2018,811,442,369,119.8,806,442,364,121.4
32330, 영월군,060004, 58세,2018,884,421,463,90.9,881,420,461,91.1
32330, 영월군,060005, 59세,2018,842,438,404,108.4,838,437,401,109
32330, 영월군,065,60~64세,2018,3902,2063,1839,112.2,3881,2054,1827,112.4
32330, 영월군,065001, 60세,2018,832,436,396,110.1,827,436,391,111.5
32330, 영월군,065002, 61세,2018,810,432,378,114.3,807,432,375,115.2
32330, 영월군,065003, 62세,2018,766,409,357,114.6,761,406,355,114.4
32330, 영월군,065004, 63세,2018,795,419,376,111.4,790,415,375,110.7
32330, 영월군,065005, 64세,2018,699,367,332,110.5,696,365,331,110.3
32330, 영월군,070,65~69세,2018,2840,1409,1431,98.5,2831,1402,1429,98.1
32330, 영월군,070001, 65세,2018,589,293,296,99,587,291,296,98.3
32330, 영월군,070002, 66세,2018,792,418,374,111.8,791,417,374,111.5
32330, 영월군,070003, 67세,2018,456,215,241,89.2,455,214,241,88.8
32330, 영월군,070004, 68세,2018,505,237,268,88.4,502,235,267,88
32330, 영월군,070005, 69세,2018,498,246,252,97.6,496,245,251,97.6
32330, 영월군,075,70~74세,2018,2368,1125,1243,90.5,2361,1122,1239,90.6
32330, 영월군,075001, 70세,2018,517,252,265,95.1,516,252,264,95.5
32330, 영월군,075002, 71세,2018,494,242,252,96,492,241,251,96
32330, 영월군,075003, 72세,2018,427,206,221,93.2,425,204,221,92.3
32330, 영월군,075004, 73세,2018,446,224,222,100.9,445,224,221,101.4
32330, 영월군,075005, 74세,2018,484,201,283,71,483,201,282,71.3
32330, 영월군,080,75~79세,2018,2428,1034,1394,74.2,2424,1031,1393,74
32330, 영월군,080001, 75세,2018,435,184,251,73.3,434,183,251,72.9
32330, 영월군,080002, 76세,2018,571,247,324,76.2,571,247,324,76.2
32330, 영월군,080003, 77세,2018,495,211,284,74.3,494,211,283,74.6
32330, 영월군,080004, 78세,2018,496,214,282,75.9,494,212,282,75.2
32330, 영월군,080005, 79세,2018,431,178,253,70.4,431,178,253,70.4
32330, 영월군,085,80~84세,2018,1539,575,964,59.6,1539,575,964,59.6
32330, 영월군,085001, 80세,2018,413,168,245,68.6,413,168,245,68.6
32330, 영월군,085002, 81세,2018,326,120,206,58.3,326,120,206,58.3
32330, 영월군,085003, 82세,2018,303,128,175,73.1,303,128,175,73.1
32330, 영월군,085004, 83세,2018,259,99,160,61.9,259,99,160,61.9
32330, 영월군,085005, 84세,2018,238,60,178,33.7,238,60,178,33.7
32330, 영월군,090,85~89세,2018,616,161,455,35.4,616,161,455,35.4
32330, 영월군,090001, 85세,2018,168,40,128,31.3,168,40,128,31.3
32330, 영월군,090002, 86세,2018,142,35,107,32.7,142,35,107,32.7
32330, 영월군,090003, 87세,2018,109,38,71,53.5,109,38,71,53.5
32330, 영월군,090004, 88세,2018,100,20,80,25,100,20,80,25
32330, 영월군,090005, 89세,2018,97,28,69,40.6,97,28,69,40.6
32330, 영월군,095,90~94세,2018,193,52,141,36.9,192,52,140,37.1
32330, 영월군,095001, 90세,2018,52,12,40,30,52,12,40,30
32330, 영월군,095002, 91세,2018,54,14,40,35,54,14,40,35
32330, 영월군,095003, 92세,2018,32,6,26,23.1,31,6,25,24
32330, 영월군,095004, 93세,2018,36,12,24,50,36,12,24,50
32330, 영월군,095005, 94세,2018,19,8,11,72.7,19,8,11,72.7
32330, 영월군,100,95~99세,2018,50,10,40,25,50,10,40,25
32330, 영월군,100001, 95세,2018,22,X,19,15.8,22,X,19,15.8
32330, 영월군,100002, 96세,2018,10,X,7,42.9,10,X,7,42.9
32330, 영월군,100003, 97세,2018,8,X,6,33.3,8,X,6,33.3
32330, 영월군,100004, 98세,2018,6,X,5,20,6,X,5,20
32330, 영월군,100005, 99세,2018,X,X,X,33.3,X,X,X,33.3
32330, 영월군,101,100세이상,2018,6,X,5,20,6,X,5,20
32330, 영월군,102,15세미만,2018,3068,1624,1444,112.5,3064,1624,1440,112.8
32330, 영월군,103,15~64세,2018,23654,12986,10668,121.7,23194,12807,10387,123.3
32330, 영월군,104,65세이상,2018,10040,4367,5673,77,10019,4354,5665,76.9
32330, 영월군,086,85세이상,2018,865,224,641,34.9,864,224,640,35
32330, 영월군,126,평균연령,2018,50.4,48.4,52.4,,50.5,48.5,52.7,
32330, 영월군,127,중위연령,2018,54.4,52.3,56.6,,54.7,52.4,56.9,
32340, 평창군,000,합계,2018,40025,20497,19528,105,39465,20260,19205,105.5
32340, 평창군,005,0~4세,2018,907,427,480,89,904,425,479,88.7
32340, 평창군,005001, 0세,2018,153,72,81,88.9,152,71,81,87.7
32340, 평창군,005002, 1세,2018,186,96,90,106.7,185,95,90,105.6
32340, 평창군,005003, 2세,2018,191,88,103,85.4,191,88,103,85.4
32340, 평창군,005004, 3세,2018,181,82,99,82.8,181,82,99,82.8
32340, 평창군,005005, 4세,2018,196,89,107,83.2,195,89,106,84
32340, 평창군,010,5~9세,2018,1280,665,615,108.1,1273,662,611,108.3
32340, 평창군,010001, 5세,2018,230,128,102,125.5,230,128,102,125.5
32340, 평창군,010002, 6세,2018,261,128,133,96.2,258,127,131,96.9
32340, 평창군,010003, 7세,2018,263,140,123,113.8,261,139,122,113.9
32340, 평창군,010004, 8세,2018,266,143,123,116.3,264,142,122,116.4
32340, 평창군,010005, 9세,2018,260,126,134,94,260,126,134,94
32340, 평창군,015,10~14세,2018,1427,764,663,115.2,1421,761,660,115.3
32340, 평창군,015001, 10세,2018,308,161,147,109.5,307,161,146,110.3
32340, 평창군,015002, 11세,2018,290,154,136,113.2,288,153,135,113.3
32340, 평창군,015003, 12세,2018,280,156,124,125.8,279,155,124,125
32340, 평창군,015004, 13세,2018,255,135,120,112.5,254,134,120,111.7
32340, 평창군,015005, 14세,2018,294,158,136,116.2,293,158,135,117
32340, 평창군,020,15~19세,2018,1526,826,700,118,1520,824,696,118.4
32340, 평창군,020001, 15세,2018,325,171,154,111,325,171,154,111
32340, 평창군,020002, 16세,2018,316,163,153,106.5,315,162,153,105.9
32340, 평창군,020003, 17세,2018,343,185,158,117.1,343,185,158,117.1
32340, 평창군,020004, 18세,2018,337,181,156,116,336,181,155,116.8
32340, 평창군,020005, 19세,2018,205,126,79,159.5,201,125,76,164.5
32340, 평창군,025,20~24세,2018,1536,941,595,158.2,1477,921,556,165.6
32340, 평창군,025001, 20세,2018,276,192,84,228.6,266,189,77,245.5
32340, 평창군,025002, 21세,2018,317,198,119,166.4,311,196,115,170.4
32340, 평창군,025003, 22세,2018,303,185,118,156.8,288,179,109,164.2
32340, 평창군,025004, 23세,2018,295,174,121,143.8,281,170,111,153.2
32340, 평창군,025005, 24세,2018,345,192,153,125.5,331,187,144,129.9
32340, 평창군,030,25~29세,2018,1758,986,772,127.7,1673,951,722,131.7
32340, 평창군,030001, 25세,2018,385,214,171,125.1,362,205,157,130.6
32340, 평창군,030002, 26세,2018,377,208,169,123.1,356,202,154,131.2
32340, 평창군,030003, 27세,2018,343,188,155,121.3,333,185,148,125
32340, 평창군,030004, 28세,2018,327,182,145,125.5,313,172,141,122
32340, 평창군,030005, 29세,2018,326,194,132,147,309,187,122,153.3
32340, 평창군,035,30~34세,2018,1536,826,710,116.3,1469,795,674,118
32340, 평창군,035001, 30세,2018,289,158,131,120.6,281,156,125,124.8
32340, 평창군,035002, 31세,2018,293,161,132,122,276,154,122,126.2
32340, 평창군,035003, 32세,2018,311,171,140,122.1,297,164,133,123.3
32340, 평창군,035004, 33세,2018,329,169,160,105.6,311,157,154,101.9
32340, 평창군,035005, 34세,2018,314,167,147,113.6,304,164,140,117.1
32340, 평창군,040,35~39세,2018,2107,1164,943,123.4,2046,1140,906,125.8
32340, 평창군,040001, 35세,2018,354,201,153,131.4,344,198,146,135.6
32340, 평창군,040002, 36세,2018,417,226,191,118.3,400,220,180,122.2
32340, 평창군,040003, 37세,2018,444,257,187,137.4,434,252,182,138.5
32340, 평창군,040004, 38세,2018,449,249,200,124.5,439,246,193,127.5
32340, 평창군,040005, 39세,2018,443,231,212,109,429,224,205,109.3
32340, 평창군,045,40~44세,2018,2378,1282,1096,117,2331,1254,1077,116.4
32340, 평창군,045001, 40세,2018,433,232,201,115.4,423,225,198,113.6
32340, 평창군,045002, 41세,2018,433,212,221,95.9,419,204,215,94.9
32340, 평창군,045003, 42세,2018,459,281,178,157.9,453,276,177,155.9
32340, 평창군,045004, 43세,2018,502,263,239,110,493,260,233,111.6
32340, 평창군,045005, 44세,2018,551,294,257,114.4,543,289,254,113.8
32340, 평창군,050,45~49세,2018,3163,1758,1405,125.1,3109,1736,1373,126.4
32340, 평창군,050001, 45세,2018,624,355,269,132,608,348,260,133.8
32340, 평창군,050002, 46세,2018,602,341,261,130.7,593,339,254,133.5
32340, 평창군,050003, 47세,2018,603,335,268,125,595,331,264,125.4
32340, 평창군,050004, 48세,2018,631,345,286,120.6,623,342,281,121.7
32340, 평창군,050005, 49세,2018,703,382,321,119,690,376,314,119.7
32340, 평창군,055,50~54세,2018,3451,1836,1615,113.7,3393,1814,1579,114.9
32340, 평창군,055001, 50세,2018,745,407,338,120.4,734,405,329,123.1
32340, 평창군,055002, 51세,2018,651,351,300,117,641,348,293,118.8
32340, 평창군,055003, 52세,2018,686,375,311,120.6,675,371,304,122
32340, 평창군,055004, 53세,2018,719,391,328,119.2,710,385,325,118.5
32340, 평창군,055005, 54세,2018,650,312,338,92.3,633,305,328,93
32340, 평창군,060,55~59세,2018,4558,2382,2176,109.5,4527,2370,2157,109.9
32340, 평창군,060001, 55세,2018,758,414,344,120.3,750,409,341,119.9
32340, 평창군,060002, 56세,2018,892,474,418,113.4,887,473,414,114.3
32340, 평창군,060003, 57세,2018,946,482,464,103.9,942,481,461,104.3
32340, 평창군,060004, 58세,2018,1057,525,532,98.7,1050,522,528,98.9
32340, 평창군,060005, 59세,2018,905,487,418,116.5,898,485,413,117.4
32340, 평창군,065,60~64세,2018,4318,2265,2053,110.3,4273,2245,2028,110.7
32340, 평창군,065001, 60세,2018,933,493,440,112,924,489,435,112.4
32340, 평창군,065002, 61세,2018,963,497,466,106.7,953,491,462,106.3
32340, 평창군,065003, 62세,2018,830,434,396,109.6,818,431,387,111.4
32340, 평창군,065004, 63세,2018,879,461,418,110.3,872,458,414,110.6
32340, 평창군,065005, 64세,2018,713,380,333,114.1,706,376,330,113.9
32340, 평창군,070,65~69세,2018,2812,1386,1426,97.2,2795,1378,1417,97.2
32340, 평창군,070001, 65세,2018,600,308,292,105.5,593,305,288,105.9
32340, 평창군,070002, 66세,2018,802,414,388,106.7,799,413,386,107
32340, 평창군,070003, 67세,2018,439,203,236,86,436,201,235,85.5
32340, 평창군,070004, 68세,2018,445,209,236,88.6,443,208,235,88.5
32340, 평창군,070005, 69세,2018,526,252,274,92,524,251,273,91.9
32340, 평창군,075,70~74세,2018,2509,1173,1336,87.8,2503,1169,1334,87.6
32340, 평창군,075001, 70세,2018,540,266,274,97.1,539,266,273,97.4
32340, 평창군,075002, 71세,2018,544,263,281,93.6,544,263,281,93.6
32340, 평창군,075003, 72세,2018,438,212,226,93.8,435,210,225,93.3
32340, 평창군,075004, 73세,2018,513,228,285,80,511,226,285,79.3
32340, 평창군,075005, 74세,2018,474,204,270,75.6,474,204,270,75.6
32340, 평창군,080,75~79세,2018,2351,1045,1306,80,2349,1045,1304,80.1
32340, 평창군,080001, 75세,2018,429,206,223,92.4,429,206,223,92.4
32340, 평창군,080002, 76세,2018,493,222,271,81.9,491,222,269,82.5
32340, 평창군,080003, 77세,2018,480,216,264,81.8,480,216,264,81.8
32340, 평창군,080004, 78세,2018,474,202,272,74.3,474,202,272,74.3
32340, 평창군,080005, 79세,2018,475,199,276,72.1,475,199,276,72.1
32340, 평창군,085,80~84세,2018,1479,545,934,58.4,1474,544,930,58.5
32340, 평창군,085001, 80세,2018,374,146,228,64,373,146,227,64.3
32340, 평창군,085002, 81세,2018,358,142,216,65.7,356,141,215,65.6
32340, 평창군,085003, 82세,2018,308,122,186,65.6,307,122,185,65.9
32340, 평창군,085004, 83세,2018,255,83,172,48.3,255,83,172,48.3
32340, 평창군,085005, 84세,2018,184,52,132,39.4,183,52,131,39.7
32340, 평창군,090,85~89세,2018,627,152,475,32,626,152,474,32.1
32340, 평창군,090001, 85세,2018,171,48,123,39,170,48,122,39.3
32340, 평창군,090002, 86세,2018,142,36,106,34,142,36,106,34
32340, 평창군,090003, 87세,2018,118,23,95,24.2,118,23,95,24.2
32340, 평창군,090004, 88세,2018,102,23,79,29.1,102,23,79,29.1
32340, 평창군,090005, 89세,2018,94,22,72,30.6,94,22,72,30.6
32340, 평창군,095,90~94세,2018,228,55,173,31.8,228,55,173,31.8
32340, 평창군,095001, 90세,2018,60,13,47,27.7,60,13,47,27.7
32340, 평창군,095002, 91세,2018,44,11,33,33.3,44,11,33,33.3
32340, 평창군,095003, 92세,2018,40,11,29,37.9,40,11,29,37.9
32340, 평창군,095004, 93세,2018,40,5,35,14.3,40,5,35,14.3
32340, 평창군,095005, 94세,2018,44,15,29,51.7,44,15,29,51.7
32340, 평창군,100,95~99세,2018,63,16,47,34,63,16,47,34
32340, 평창군,100001, 95세,2018,25,7,18,38.9,25,7,18,38.9
32340, 평창군,100002, 96세,2018,13,X,10,30,13,X,10,30
32340, 평창군,100003, 97세,2018,10,X,10,0,10,X,10,0
32340, 평창군,100004, 98세,2018,8,X,5,60,8,X,5,60
32340, 평창군,100005, 99세,2018,7,X,X,75,7,X,X,75
32340, 평창군,101,100세이상,2018,11,X,8,37.5,11,X,8,37.5
32340, 평창군,102,15세미만,2018,3614,1856,1758,105.6,3598,1848,1750,105.6
32340, 평창군,103,15~64세,2018,26331,14266,12065,118.2,25818,14050,11768,119.4
32340, 평창군,104,65세이상,2018,10080,4375,5705,76.7,10049,4362,5687,76.7
32340, 평창군,086,85세이상,2018,929,226,703,32.1,928,226,702,32.2
32340, 평창군,126,평균연령,2018,49.7,48.1,51.5,,49.9,48.2,51.7,
32340, 평창군,127,중위연령,2018,53.4,51.6,55.5,,53.6,51.7,55.8,
32350, 정선군,000,합계,2018,35580,18582,16998,109.3,35216,18470,16746,110.3
32350, 정선군,005,0~4세,2018,806,432,374,115.5,806,432,374,115.5
32350, 정선군,005001, 0세,2018,134,76,58,131,134,76,58,131
32350, 정선군,005002, 1세,2018,145,82,63,130.2,145,82,63,130.2
32350, 정선군,005003, 2세,2018,150,84,66,127.3,150,84,66,127.3
32350, 정선군,005004, 3세,2018,181,98,83,118.1,181,98,83,118.1
32350, 정선군,005005, 4세,2018,196,92,104,88.5,196,92,104,88.5
32350, 정선군,010,5~9세,2018,1183,624,559,111.6,1183,624,559,111.6
32350, 정선군,010001, 5세,2018,205,104,101,103,205,104,101,103
32350, 정선군,010002, 6세,2018,246,131,115,113.9,246,131,115,113.9
32350, 정선군,010003, 7세,2018,224,119,105,113.3,224,119,105,113.3
32350, 정선군,010004, 8세,2018,260,133,127,104.7,260,133,127,104.7
32350, 정선군,010005, 9세,2018,248,137,111,123.4,248,137,111,123.4
32350, 정선군,015,10~14세,2018,1221,618,603,102.5,1220,617,603,102.3
32350, 정선군,015001, 10세,2018,266,134,132,101.5,266,134,132,101.5
32350, 정선군,015002, 11세,2018,240,120,120,100,240,120,120,100
32350, 정선군,015003, 12세,2018,226,109,117,93.2,226,109,117,93.2
32350, 정선군,015004, 13세,2018,244,124,120,103.3,243,123,120,102.5
32350, 정선군,015005, 14세,2018,245,131,114,114.9,245,131,114,114.9
32350, 정선군,020,15~19세,2018,1295,708,587,120.6,1290,706,584,120.9
32350, 정선군,020001, 15세,2018,237,124,113,109.7,237,124,113,109.7
32350, 정선군,020002, 16세,2018,280,148,132,112.1,280,148,132,112.1
32350, 정선군,020003, 17세,2018,318,169,149,113.4,317,168,149,112.8
32350, 정선군,020004, 18세,2018,293,152,141,107.8,292,152,140,108.6
32350, 정선군,020005, 19세,2018,167,115,52,221.2,164,114,50,228
32350, 정선군,025,20~24세,2018,1245,740,505,146.5,1213,732,481,152.2
32350, 정선군,025001, 20세,2018,240,168,72,233.3,234,167,67,249.3
32350, 정선군,025002, 21세,2018,246,155,91,170.3,240,155,85,182.4
32350, 정선군,025003, 22세,2018,238,131,107,122.4,231,130,101,128.7
32350, 정선군,025004, 23세,2018,252,143,109,131.2,247,142,105,135.2
32350, 정선군,025005, 24세,2018,269,143,126,113.5,261,138,123,112.2
32350, 정선군,030,25~29세,2018,1468,805,663,121.4,1416,792,624,126.9
32350, 정선군,030001, 25세,2018,275,164,111,147.7,263,162,101,160.4
32350, 정선군,030002, 26세,2018,282,148,134,110.4,272,146,126,115.9
32350, 정선군,030003, 27세,2018,287,150,137,109.5,274,145,129,112.4
32350, 정선군,030004, 28세,2018,312,175,137,127.7,304,172,132,130.3
32350, 정선군,030005, 29세,2018,312,168,144,116.7,303,167,136,122.8
32350, 정선군,035,30~34세,2018,1695,947,748,126.6,1628,928,700,132.6
32350, 정선군,035001, 30세,2018,336,187,149,125.5,316,182,134,135.8
32350, 정선군,035002, 31세,2018,340,198,142,139.4,331,195,136,143.4
32350, 정선군,035003, 32세,2018,327,178,149,119.5,318,177,141,125.5
32350, 정선군,035004, 33세,2018,331,207,124,166.9,312,198,114,173.7
32350, 정선군,035005, 34세,2018,361,177,184,96.2,351,176,175,100.6
32350, 정선군,040,35~39세,2018,2213,1250,963,129.8,2165,1234,931,132.5
32350, 정선군,040001, 35세,2018,409,230,179,128.5,399,228,171,133.3
32350, 정선군,040002, 36세,2018,440,239,201,118.9,426,232,194,119.6
32350, 정선군,040003, 37세,2018,417,232,185,125.4,411,232,179,129.6
32350, 정선군,040004, 38세,2018,476,283,193,146.6,468,281,187,150.3
32350, 정선군,040005, 39세,2018,471,266,205,129.8,461,261,200,130.5
32350, 정선군,045,40~44세,2018,2324,1372,952,144.1,2299,1363,936,145.6
32350, 정선군,045001, 40세,2018,435,257,178,144.4,425,252,173,145.7
32350, 정선군,045002, 41세,2018,440,265,175,151.4,436,265,171,155
32350, 정선군,045003, 42세,2018,453,255,198,128.8,449,254,195,130.3
32350, 정선군,045004, 43세,2018,448,277,171,162,444,276,168,164.3
32350, 정선군,045005, 44세,2018,548,318,230,138.3,545,316,229,138
32350, 정선군,050,45~49세,2018,2727,1603,1124,142.6,2689,1596,1093,146
32350, 정선군,050001, 45세,2018,504,300,204,147.1,500,299,201,148.8
32350, 정선군,050002, 46세,2018,495,288,207,139.1,490,288,202,142.6
32350, 정선군,050003, 47세,2018,597,354,243,145.7,588,351,237,148.1
32350, 정선군,050004, 48세,2018,528,313,215,145.6,517,311,206,151
32350, 정선군,050005, 49세,2018,603,348,255,136.5,594,347,247,140.5
32350, 정선군,055,50~54세,2018,2999,1674,1325,126.3,2964,1659,1305,127.1
32350, 정선군,055001, 50세,2018,652,385,267,144.2,641,381,260,146.5
32350, 정선군,055002, 51세,2018,584,321,263,122.1,579,318,261,121.8
32350, 정선군,055003, 52세,2018,608,342,266,128.6,600,337,263,128.1
32350, 정선군,055004, 53세,2018,578,304,274,110.9,572,303,269,112.6
32350, 정선군,055005, 54세,2018,577,322,255,126.3,572,320,252,127
32350, 정선군,060,55~59세,2018,3932,2056,1876,109.6,3897,2045,1852,110.4
32350, 정선군,060001, 55세,2018,679,385,294,131,673,382,291,131.3
32350, 정선군,060002, 56세,2018,744,392,352,111.4,731,390,341,114.4
32350, 정선군,060003, 57세,2018,832,426,406,104.9,829,425,404,105.2
32350, 정선군,060004, 58세,2018,905,451,454,99.3,897,448,449,99.8
32350, 정선군,060005, 59세,2018,772,402,370,108.6,767,400,367,109
32350, 정선군,065,60~64세,2018,3667,1986,1681,118.1,3655,1980,1675,118.2
32350, 정선군,065001, 60세,2018,798,421,377,111.7,796,420,376,111.7
32350, 정선군,065002, 61세,2018,806,429,377,113.8,802,427,375,113.9
32350, 정선군,065003, 62세,2018,735,408,327,124.8,732,407,325,125.2
32350, 정선군,065004, 63세,2018,722,397,325,122.2,720,396,324,122.2
32350, 정선군,065005, 64세,2018,606,331,275,120.4,605,330,275,120
32350, 정선군,070,65~69세,2018,2522,1226,1296,94.6,2516,1223,1293,94.6
32350, 정선군,070001, 65세,2018,520,264,256,103.1,520,264,256,103.1
32350, 정선군,070002, 66세,2018,645,319,326,97.9,644,319,325,98.2
32350, 정선군,070003, 67세,2018,437,215,222,96.8,434,214,220,97.3
32350, 정선군,070004, 68세,2018,453,191,262,72.9,452,190,262,72.5
32350, 정선군,070005, 69세,2018,467,237,230,103,466,236,230,102.6
32350, 정선군,075,70~74세,2018,2184,1030,1154,89.3,2178,1028,1150,89.4
32350, 정선군,075001, 70세,2018,482,242,240,100.8,481,241,240,100.4
32350, 정선군,075002, 71세,2018,450,206,244,84.4,448,206,242,85.1
32350, 정선군,075003, 72세,2018,383,194,189,102.6,382,194,188,103.2
32350, 정선군,075004, 73세,2018,442,199,243,81.9,440,198,242,81.8
32350, 정선군,075005, 74세,2018,427,189,238,79.4,427,189,238,79.4
32350, 정선군,080,75~79세,2018,2138,916,1222,75,2136,916,1220,75.1
32350, 정선군,080001, 75세,2018,460,199,261,76.2,459,199,260,76.5
32350, 정선군,080002, 76세,2018,494,223,271,82.3,494,223,271,82.3
32350, 정선군,080003, 77세,2018,397,166,231,71.9,396,166,230,72.2
32350, 정선군,080004, 78세,2018,426,176,250,70.4,426,176,250,70.4
32350, 정선군,080005, 79세,2018,361,152,209,72.7,361,152,209,72.7
32350, 정선군,085,80~84세,2018,1194,420,774,54.3,1194,420,774,54.3
32350, 정선군,085001, 80세,2018,301,113,188,60.1,301,113,188,60.1
32350, 정선군,085002, 81세,2018,264,100,164,61,264,100,164,61
32350, 정선군,085003, 82세,2018,229,76,153,49.7,229,76,153,49.7
32350, 정선군,085004, 83세,2018,210,69,141,48.9,210,69,141,48.9
32350, 정선군,085005, 84세,2018,190,62,128,48.4,190,62,128,48.4
32350, 정선군,090,85~89세,2018,513,123,390,31.5,513,123,390,31.5
32350, 정선군,090001, 85세,2018,142,34,108,31.5,142,34,108,31.5
32350, 정선군,090002, 86세,2018,132,35,97,36.1,132,35,97,36.1
32350, 정선군,090003, 87세,2018,80,20,60,33.3,80,20,60,33.3
32350, 정선군,090004, 88세,2018,95,22,73,30.1,95,22,73,30.1
32350, 정선군,090005, 89세,2018,64,12,52,23.1,64,12,52,23.1
32350, 정선군,095,90~94세,2018,199,41,158,25.9,199,41,158,25.9
32350, 정선군,095001, 90세,2018,48,11,37,29.7,48,11,37,29.7
32350, 정선군,095002, 91세,2018,44,5,39,12.8,44,5,39,12.8
32350, 정선군,095003, 92세,2018,42,8,34,23.5,42,8,34,23.5
32350, 정선군,095004, 93세,2018,33,11,22,50,33,11,22,50
32350, 정선군,095005, 94세,2018,32,6,26,23.1,32,6,26,23.1
32350, 정선군,100,95~99세,2018,47,11,36,30.6,47,11,36,30.6
32350, 정선군,100001, 95세,2018,25,5,20,25,25,5,20,25
32350, 정선군,100002, 96세,2018,9,X,8,12.5,9,X,8,12.5
32350, 정선군,100003, 97세,2018,X,X,X,100,X,X,X,100
32350, 정선군,100004, 98세,2018,5,X,X,25,5,X,X,25
32350, 정선군,100005, 99세,2018,X,X,X,100,X,X,X,100
32350, 정선군,101,100세이상,2018,8,X,8,0,8,X,8,0
32350, 정선군,102,15세미만,2018,3210,1674,1536,109,3209,1673,1536,108.9
32350, 정선군,103,15~64세,2018,23565,13141,10424,126.1,23216,13035,10181,128
32350, 정선군,104,65세이상,2018,8805,3767,5038,74.8,8791,3762,5029,74.8
32350, 정선군,086,85세이상,2018,767,175,592,29.6,767,175,592,29.6
32350, 정선군,126,평균연령,2018,49.4,47.6,51.3,,49.5,47.7,51.5,
32350, 정선군,127,중위연령,2018,52.6,50.5,55.3,,52.8,50.6,55.6,
32360, 철원군,000,합계,2018,44346,23485,20861,112.6,43314,22860,20454,111.8
32360, 철원군,005,0~4세,2018,1738,875,863,101.4,1737,875,862,101.5
32360, 철원군,005001, 0세,2018,336,156,180,86.7,335,156,179,87.2
32360, 철원군,005002, 1세,2018,359,181,178,101.7,359,181,178,101.7
32360, 철원군,005003, 2세,2018,355,187,168,111.3,355,187,168,111.3
32360, 철원군,005004, 3세,2018,331,172,159,108.2,331,172,159,108.2
32360, 철원군,005005, 4세,2018,357,179,178,100.6,357,179,178,100.6
32360, 철원군,010,5~9세,2018,1726,893,833,107.2,1726,893,833,107.2
32360, 철원군,010001, 5세,2018,323,158,165,95.8,323,158,165,95.8
32360, 철원군,010002, 6세,2018,361,179,182,98.4,361,179,182,98.4
32360, 철원군,010003, 7세,2018,355,192,163,117.8,355,192,163,117.8
32360, 철원군,010004, 8세,2018,361,204,157,129.9,361,204,157,129.9
32360, 철원군,010005, 9세,2018,326,160,166,96.4,326,160,166,96.4
32360, 철원군,015,10~14세,2018,1901,1004,897,111.9,1901,1004,897,111.9
32360, 철원군,015001, 10세,2018,402,210,192,109.4,402,210,192,109.4
32360, 철원군,015002, 11세,2018,363,191,172,111,363,191,172,111
32360, 철원군,015003, 12세,2018,403,214,189,113.2,403,214,189,113.2
32360, 철원군,015004, 13세,2018,349,182,167,109,349,182,167,109
32360, 철원군,015005, 14세,2018,384,207,177,116.9,384,207,177,116.9
32360, 철원군,020,15~19세,2018,1954,1038,916,113.3,1947,1033,914,113
32360, 철원군,020001, 15세,2018,377,180,197,91.4,377,180,197,91.4
32360, 철원군,020002, 16세,2018,410,201,209,96.2,410,201,209,96.2
32360, 철원군,020003, 17세,2018,475,253,222,114,473,251,222,113.1
32360, 철원군,020004, 18세,2018,421,237,184,128.8,420,237,183,129.5
32360, 철원군,020005, 19세,2018,271,167,104,160.6,267,164,103,159.2
32360, 철원군,025,20~24세,2018,2911,2066,845,244.5,2684,1898,786,241.5
32360, 철원군,025001, 20세,2018,387,262,125,209.6,381,257,124,207.3
32360, 철원군,025002, 21세,2018,458,307,151,203.3,419,276,143,193
32360, 철원군,025003, 22세,2018,515,362,153,236.6,464,323,141,229.1
32360, 철원군,025004, 23세,2018,745,538,207,259.9,675,487,188,259
32360, 철원군,025005, 24세,2018,806,597,209,285.6,745,555,190,292.1
32360, 철원군,030,25~29세,2018,3448,2347,1101,213.2,3183,2168,1015,213.6
32360, 철원군,030001, 25세,2018,737,530,207,256,672,490,182,269.2
32360, 철원군,030002, 26세,2018,809,578,231,250.2,750,532,218,244
32360, 철원군,030003, 27세,2018,742,498,244,204.1,680,456,224,203.6
32360, 철원군,030004, 28세,2018,598,381,217,175.6,562,361,201,179.6
32360, 철원군,030005, 29세,2018,562,360,202,178.2,519,329,190,173.2
32360, 철원군,035,30~34세,2018,2417,1381,1036,133.3,2229,1277,952,134.1
32360, 철원군,035001, 30세,2018,528,319,209,152.6,493,295,198,149
32360, 철원군,035002, 31세,2018,507,307,200,153.5,469,291,178,163.5
32360, 철원군,035003, 32세,2018,462,249,213,116.9,422,232,190,122.1
32360, 철원군,035004, 33세,2018,470,267,203,131.5,439,249,190,131.1
32360, 철원군,035005, 34세,2018,450,239,211,113.3,406,210,196,107.1
32360, 철원군,040,35~39세,2018,2649,1390,1259,110.4,2531,1324,1207,109.7
32360, 철원군,040001, 35세,2018,520,293,227,129.1,496,279,217,128.6
32360, 철원군,040002, 36세,2018,543,293,250,117.2,517,278,239,116.3
32360, 철원군,040003, 37세,2018,544,276,268,103,525,264,261,101.1
32360, 철원군,040004, 38세,2018,541,270,271,99.6,512,254,258,98.4
32360, 철원군,040005, 39세,2018,501,258,243,106.2,481,249,232,107.3
32360, 철원군,045,40~44세,2018,2745,1478,1267,116.7,2681,1441,1240,116.2
32360, 철원군,045001, 40세,2018,544,274,270,101.5,528,265,263,100.8
32360, 철원군,045002, 41세,2018,558,298,260,114.6,542,287,255,112.5
32360, 철원군,045003, 42세,2018,505,292,213,137.1,489,281,208,135.1
32360, 철원군,045004, 43세,2018,514,276,238,116,508,273,235,116.2
32360, 철원군,045005, 44세,2018,624,338,286,118.2,614,335,279,120.1
32360, 철원군,050,45~49세,2018,3172,1722,1450,118.8,3120,1697,1423,119.3
32360, 철원군,050001, 45세,2018,618,320,298,107.4,607,316,291,108.6
32360, 철원군,050002, 46세,2018,657,366,291,125.8,655,366,289,126.6
32360, 철원군,050003, 47세,2018,634,347,287,120.9,622,339,283,119.8
32360, 철원군,050004, 48세,2018,622,348,274,127,610,340,270,125.9
32360, 철원군,050005, 49세,2018,641,341,300,113.7,626,336,290,115.9
32360, 철원군,055,50~54세,2018,3294,1735,1559,111.3,3257,1718,1539,111.6
32360, 철원군,055001, 50세,2018,667,347,320,108.4,658,344,314,109.6
32360, 철원군,055002, 51세,2018,628,327,301,108.6,624,327,297,110.1
32360, 철원군,055003, 52세,2018,693,376,317,118.6,684,369,315,117.1
32360, 철원군,055004, 53세,2018,659,334,325,102.8,651,331,320,103.4
32360, 철원군,055005, 54세,2018,647,351,296,118.6,640,347,293,118.4
32360, 철원군,060,55~59세,2018,3892,2045,1847,110.7,3864,2036,1828,111.4
32360, 철원군,060001, 55세,2018,763,396,367,107.9,758,396,362,109.4
32360, 철원군,060002, 56세,2018,753,408,345,118.3,746,405,341,118.8
32360, 철원군,060003, 57세,2018,835,453,382,118.6,830,452,378,119.6
32360, 철원군,060004, 58세,2018,824,425,399,106.5,820,422,398,106
32360, 철원군,060005, 59세,2018,717,363,354,102.5,710,361,349,103.4
32360, 철원군,065,60~64세,2018,3509,1751,1758,99.6,3493,1744,1749,99.7
32360, 철원군,065001, 60세,2018,763,379,384,98.7,759,378,381,99.2
32360, 철원군,065002, 61세,2018,734,383,351,109.1,728,381,347,109.8
32360, 철원군,065003, 62세,2018,662,317,345,91.9,659,315,344,91.6
32360, 철원군,065004, 63세,2018,680,337,343,98.3,679,337,342,98.5
32360, 철원군,065005, 64세,2018,670,335,335,100,668,333,335,99.4
32360, 철원군,070,65~69세,2018,2226,1007,1219,82.6,2210,1003,1207,83.1
32360, 철원군,070001, 65세,2018,491,216,275,78.5,487,215,272,79
32360, 철원군,070002, 66세,2018,454,189,265,71.3,450,187,263,71.1
32360, 철원군,070003, 67세,2018,353,167,186,89.8,350,167,183,91.3
32360, 철원군,070004, 68세,2018,422,197,225,87.6,418,196,222,88.3
32360, 철원군,070005, 69세,2018,506,238,268,88.8,505,238,267,89.1
32360, 철원군,075,70~74세,2018,2373,1081,1292,83.7,2364,1078,1286,83.8
32360, 철원군,075001, 70세,2018,470,206,264,78,467,205,262,78.2
32360, 철원군,075002, 71세,2018,503,246,257,95.7,502,246,256,96.1
32360, 철원군,075003, 72세,2018,404,187,217,86.2,401,186,215,86.5
32360, 철원군,075004, 73세,2018,532,253,279,90.7,530,252,278,90.6
32360, 철원군,075005, 74세,2018,464,189,275,68.7,464,189,275,68.7
32360, 철원군,080,75~79세,2018,2309,963,1346,71.5,2306,962,1344,71.6
32360, 철원군,080001, 75세,2018,483,203,280,72.5,482,202,280,72.1
32360, 철원군,080002, 76세,2018,513,220,293,75.1,512,220,292,75.3
32360, 철원군,080003, 77세,2018,467,201,266,75.6,466,201,265,75.8
32360, 철원군,080004, 78세,2018,428,177,251,70.5,428,177,251,70.5
32360, 철원군,080005, 79세,2018,418,162,256,63.3,418,162,256,63.3
32360, 철원군,085,80~84세,2018,1239,458,781,58.6,1238,458,780,58.7
32360, 철원군,085001, 80세,2018,353,149,204,73,353,149,204,73
32360, 철원군,085002, 81세,2018,312,119,193,61.7,311,119,192,62
32360, 철원군,085003, 82세,2018,223,78,145,53.8,223,78,145,53.8
32360, 철원군,085004, 83세,2018,197,68,129,52.7,197,68,129,52.7
32360, 철원군,085005, 84세,2018,154,44,110,40,154,44,110,40
32360, 철원군,090,85~89세,2018,546,169,377,44.8,546,169,377,44.8
32360, 철원군,090001, 85세,2018,151,49,102,48,151,49,102,48
32360, 철원군,090002, 86세,2018,112,47,65,72.3,112,47,65,72.3
32360, 철원군,090003, 87세,2018,88,28,60,46.7,88,28,60,46.7
32360, 철원군,090004, 88세,2018,100,26,74,35.1,100,26,74,35.1
32360, 철원군,090005, 89세,2018,95,19,76,25,95,19,76,25
32360, 철원군,095,90~94세,2018,232,58,174,33.3,232,58,174,33.3
32360, 철원군,095001, 90세,2018,81,17,64,26.6,81,17,64,26.6
32360, 철원군,095002, 91세,2018,60,16,44,36.4,60,16,44,36.4
32360, 철원군,095003, 92세,2018,38,10,28,35.7,38,10,28,35.7
32360, 철원군,095004, 93세,2018,30,9,21,42.9,30,9,21,42.9
32360, 철원군,095005, 94세,2018,23,6,17,35.3,23,6,17,35.3
32360, 철원군,100,95~99세,2018,54,22,32,68.8,54,22,32,68.8
32360, 철원군,100001, 95세,2018,22,10,12,83.3,22,10,12,83.3
32360, 철원군,100002, 96세,2018,15,5,10,50,15,5,10,50
32360, 철원군,100003, 97세,2018,7,X,6,16.7,7,X,6,16.7
32360, 철원군,100004, 98세,2018,X,X,X,100,X,X,X,100
32360, 철원군,100005, 99세,2018,6,X,X,200,6,X,X,200
32360, 철원군,101,100세이상,2018,11,X,9,22.2,11,X,9,22.2
32360, 철원군,102,15세미만,2018,5365,2772,2593,106.9,5364,2772,2592,106.9
32360, 철원군,103,15~64세,2018,29991,16953,13038,130,28989,16336,12653,129.1
32360, 철원군,104,65세이상,2018,8990,3760,5230,71.9,8961,3752,5209,72
32360, 철원군,086,85세이상,2018,843,251,592,42.4,843,251,592,42.4
32360, 철원군,126,평균연령,2018,44.5,42.2,47.1,,44.8,42.5,47.4,
32360, 철원군,127,중위연령,2018,46.1,42.6,49.9,,46.7,43.5,50.3,
32370, 화천군,000,합계,2018,23950,13041,10909,119.5,23595,12884,10711,120.3
32370, 화천군,005,0~4세,2018,1024,539,485,111.1,1024,539,485,111.1
32370, 화천군,005001, 0세,2018,194,90,104,86.5,194,90,104,86.5
32370, 화천군,005002, 1세,2018,193,108,85,127.1,193,108,85,127.1
32370, 화천군,005003, 2세,2018,202,100,102,98,202,100,102,98
32370, 화천군,005004, 3세,2018,220,122,98,124.5,220,122,98,124.5
32370, 화천군,005005, 4세,2018,215,119,96,124,215,119,96,124
32370, 화천군,010,5~9세,2018,932,449,483,93,932,449,483,93
32370, 화천군,010001, 5세,2018,188,96,92,104.3,188,96,92,104.3
32370, 화천군,010002, 6세,2018,207,92,115,80,207,92,115,80
32370, 화천군,010003, 7세,2018,176,95,81,117.3,176,95,81,117.3
32370, 화천군,010004, 8세,2018,189,92,97,94.8,189,92,97,94.8
32370, 화천군,010005, 9세,2018,172,74,98,75.5,172,74,98,75.5
32370, 화천군,015,10~14세,2018,862,437,425,102.8,862,437,425,102.8
32370, 화천군,015001, 10세,2018,178,89,89,100,178,89,89,100
32370, 화천군,015002, 11세,2018,177,86,91,94.5,177,86,91,94.5
32370, 화천군,015003, 12세,2018,174,90,84,107.1,174,90,84,107.1
32370, 화천군,015004, 13세,2018,149,84,65,129.2,149,84,65,129.2
32370, 화천군,015005, 14세,2018,184,88,96,91.7,184,88,96,91.7
32370, 화천군,020,15~19세,2018,928,500,428,116.8,922,498,424,117.5
32370, 화천군,020001, 15세,2018,169,89,80,111.3,169,89,80,111.3
32370, 화천군,020002, 16세,2018,208,101,107,94.4,208,101,107,94.4
32370, 화천군,020003, 17세,2018,211,112,99,113.1,211,112,99,113.1
32370, 화천군,020004, 18세,2018,204,111,93,119.4,202,111,91,122
32370, 화천군,020005, 19세,2018,136,87,49,177.6,132,85,47,180.9
32370, 화천군,025,20~24세,2018,1617,1152,465,247.7,1570,1127,443,254.4
32370, 화천군,025001, 20세,2018,176,115,61,188.5,174,113,61,185.2
32370, 화천군,025002, 21세,2018,245,162,83,195.2,242,161,81,198.8
32370, 화천군,025003, 22세,2018,263,174,89,195.5,251,169,82,206.1
32370, 화천군,025004, 23세,2018,372,274,98,279.6,358,266,92,289.1
32370, 화천군,025005, 24세,2018,561,427,134,318.7,545,418,127,329.1
32370, 화천군,030,25~29세,2018,2204,1585,619,256.1,2129,1548,581,266.4
32370, 화천군,030001, 25세,2018,549,433,116,373.3,530,421,109,386.2
32370, 화천군,030002, 26세,2018,504,372,132,281.8,495,368,127,289.8
32370, 화천군,030003, 27세,2018,449,316,133,237.6,426,307,119,258
32370, 화천군,030004, 28세,2018,390,253,137,184.7,376,246,130,189.2
32370, 화천군,030005, 29세,2018,312,211,101,208.9,302,206,96,214.6
32370, 화천군,035,30~34세,2018,1579,926,653,141.8,1515,904,611,148
32370, 화천군,035001, 30세,2018,349,221,128,172.7,332,215,117,183.8
32370, 화천군,035002, 31세,2018,331,197,134,147,309,189,120,157.5
32370, 화천군,035003, 32세,2018,341,199,142,140.1,331,195,136,143.4
32370, 화천군,035004, 33세,2018,269,145,124,116.9,264,144,120,120
32370, 화천군,035005, 34세,2018,289,164,125,131.2,279,161,118,136.4
32370, 화천군,040,35~39세,2018,1374,760,614,123.8,1314,729,585,124.6
32370, 화천군,040001, 35세,2018,269,140,129,108.5,256,132,124,106.5
32370, 화천군,040002, 36세,2018,286,169,117,144.4,276,164,112,146.4
32370, 화천군,040003, 37세,2018,296,161,135,119.3,279,152,127,119.7
32370, 화천군,040004, 38세,2018,262,133,129,103.1,250,129,121,106.6
32370, 화천군,040005, 39세,2018,261,157,104,151,253,152,101,150.5
32370, 화천군,045,40~44세,2018,1275,707,568,124.5,1249,692,557,124.2
32370, 화천군,045001, 40세,2018,232,147,85,172.9,227,145,82,176.8
32370, 화천군,045002, 41세,2018,267,139,128,108.6,263,135,128,105.5
32370, 화천군,045003, 42세,2018,255,141,114,123.7,250,139,111,125.2
32370, 화천군,045004, 43세,2018,254,141,113,124.8,248,138,110,125.5
32370, 화천군,045005, 44세,2018,267,139,128,108.6,261,135,126,107.1
32370, 화천군,050,45~49세,2018,1583,863,720,119.9,1564,853,711,120
32370, 화천군,050001, 45세,2018,279,146,133,109.8,278,145,133,109
32370, 화천군,050002, 46세,2018,309,169,140,120.7,302,165,137,120.4
32370, 화천군,050003, 47세,2018,301,164,137,119.7,296,162,134,120.9
32370, 화천군,050004, 48세,2018,316,174,142,122.5,316,174,142,122.5
32370, 화천군,050005, 49세,2018,378,210,168,125,372,207,165,125.5
32370, 화천군,055,50~54세,2018,1750,940,810,116,1728,933,795,117.4
32370, 화천군,055001, 50세,2018,355,194,161,120.5,351,192,159,120.8
32370, 화천군,055002, 51세,2018,319,172,147,117,316,171,145,117.9
32370, 화천군,055003, 52세,2018,333,183,150,122,327,181,146,124
32370, 화천군,055004, 53세,2018,358,198,160,123.8,352,197,155,127.1
32370, 화천군,055005, 54세,2018,385,193,192,100.5,382,192,190,101.1
32370, 화천군,060,55~59세,2018,2103,1139,964,118.2,2084,1135,949,119.6
32370, 화천군,060001, 55세,2018,346,186,160,116.3,343,186,157,118.5
32370, 화천군,060002, 56세,2018,386,226,160,141.3,383,226,157,143.9
32370, 화천군,060003, 57세,2018,509,273,236,115.7,505,271,234,115.8
32370, 화천군,060004, 58세,2018,458,234,224,104.5,452,233,219,106.4
32370, 화천군,060005, 59세,2018,404,220,184,119.6,401,219,182,120.3
32370, 화천군,065,60~64세,2018,1870,1008,862,116.9,1863,1006,857,117.4
32370, 화천군,065001, 60세,2018,377,207,170,121.8,375,207,168,123.2
32370, 화천군,065002, 61세,2018,417,221,196,112.8,415,221,194,113.9
32370, 화천군,065003, 62세,2018,360,192,168,114.3,360,192,168,114.3
32370, 화천군,065004, 63세,2018,364,197,167,118,362,196,166,118.1
32370, 화천군,065005, 64세,2018,352,191,161,118.6,351,190,161,118
32370, 화천군,070,65~69세,2018,1132,536,596,89.9,1126,535,591,90.5
32370, 화천군,070001, 65세,2018,277,148,129,114.7,275,148,127,116.5
32370, 화천군,070002, 66세,2018,273,138,135,102.2,272,138,134,103
32370, 화천군,070003, 67세,2018,155,70,85,82.4,155,70,85,82.4
32370, 화천군,070004, 68세,2018,203,87,116,75,202,87,115,75.7
32370, 화천군,070005, 69세,2018,224,93,131,71,222,92,130,70.8
32370, 화천군,075,70~74세,2018,1163,547,616,88.8,1163,547,616,88.8
32370, 화천군,075001, 70세,2018,240,116,124,93.5,240,116,124,93.5
32370, 화천군,075002, 71세,2018,245,113,132,85.6,245,113,132,85.6
32370, 화천군,075003, 72세,2018,234,117,117,100,234,117,117,100
32370, 화천군,075004, 73세,2018,220,86,134,64.2,220,86,134,64.2
32370, 화천군,075005, 74세,2018,224,115,109,105.5,224,115,109,105.5
32370, 화천군,080,75~79세,2018,1321,546,775,70.5,1319,545,774,70.4
32370, 화천군,080001, 75세,2018,265,124,141,87.9,265,124,141,87.9
32370, 화천군,080002, 76세,2018,286,118,168,70.2,285,117,168,69.6
32370, 화천군,080003, 77세,2018,292,117,175,66.9,291,117,174,67.2
32370, 화천군,080004, 78세,2018,244,90,154,58.4,244,90,154,58.4
32370, 화천군,080005, 79세,2018,234,97,137,70.8,234,97,137,70.8
32370, 화천군,085,80~84세,2018,751,259,492,52.6,750,259,491,52.7
32370, 화천군,085001, 80세,2018,197,67,130,51.5,197,67,130,51.5
32370, 화천군,085002, 81세,2018,192,77,115,67,191,77,114,67.5
32370, 화천군,085003, 82세,2018,144,46,98,46.9,144,46,98,46.9
32370, 화천군,085004, 83세,2018,115,31,84,36.9,115,31,84,36.9
32370, 화천군,085005, 84세,2018,103,38,65,58.5,103,38,65,58.5
32370, 화천군,090,85~89세,2018,325,105,220,47.7,324,105,219,47.9
32370, 화천군,090001, 85세,2018,84,33,51,64.7,84,33,51,64.7
32370, 화천군,090002, 86세,2018,70,24,46,52.2,70,24,46,52.2
32370, 화천군,090003, 87세,2018,58,19,39,48.7,58,19,39,48.7
32370, 화천군,090004, 88세,2018,71,19,52,36.5,70,19,51,37.3
32370, 화천군,090005, 89세,2018,42,10,32,31.3,42,10,32,31.3
32370, 화천군,095,90~94세,2018,116,29,87,33.3,116,29,87,33.3
32370, 화천군,095001, 90세,2018,43,6,37,16.2,43,6,37,16.2
32370, 화천군,095002, 91세,2018,22,7,15,46.7,22,7,15,46.7
32370, 화천군,095003, 92세,2018,17,5,12,41.7,17,5,12,41.7
32370, 화천군,095004, 93세,2018,19,6,13,46.2,19,6,13,46.2
32370, 화천군,095005, 94세,2018,15,5,10,50,15,5,10,50
32370, 화천군,100,95~99세,2018,38,12,26,46.2,38,12,26,46.2
32370, 화천군,100001, 95세,2018,18,6,12,50,18,6,12,50
32370, 화천군,100002, 96세,2018,11,5,6,83.3,11,5,6,83.3
32370, 화천군,100003, 97세,2018,6,X,5,20,6,X,5,20
32370, 화천군,100004, 98세,2018,X,X,X,0,X,X,X,0
32370, 화천군,100005, 99세,2018,X,X,X,0,X,X,X,0
32370, 화천군,101,100세이상,2018,X,X,X,200,X,X,X,200
32370, 화천군,102,15세미만,2018,2818,1425,1393,102.3,2818,1425,1393,102.3
32370, 화천군,103,15~64세,2018,16283,9580,6703,142.9,15938,9425,6513,144.7
32370, 화천군,104,65세이상,2018,4849,2036,2813,72.4,4839,2034,2805,72.5
32370, 화천군,086,85세이상,2018,482,148,334,44.3,481,148,333,44.4
32370, 화천군,126,평균연령,2018,44.4,42.1,47.2,,44.5,42.1,47.4,
32370, 화천군,127,중위연령,2018,45.6,41.2,50,,46,41.5,50.3,
32380, 양구군,000,합계,2018,22101,11761,10340,113.7,21722,11618,10104,115
32380, 양구군,005,0~4세,2018,977,487,490,99.4,976,486,490,99.2
32380, 양구군,005001, 0세,2018,174,86,88,97.7,174,86,88,97.7
32380, 양구군,005002, 1세,2018,213,103,110,93.6,213,103,110,93.6
32380, 양구군,005003, 2세,2018,205,98,107,91.6,205,98,107,91.6
32380, 양구군,005004, 3세,2018,212,112,100,112,212,112,100,112
32380, 양구군,005005, 4세,2018,173,88,85,103.5,172,87,85,102.4
32380, 양구군,010,5~9세,2018,936,476,460,103.5,932,473,459,103.1
32380, 양구군,010001, 5세,2018,178,82,96,85.4,178,82,96,85.4
32380, 양구군,010002, 6세,2018,202,108,94,114.9,200,107,93,115.1
32380, 양구군,010003, 7세,2018,201,113,88,128.4,201,113,88,128.4
32380, 양구군,010004, 8세,2018,204,92,112,82.1,203,91,112,81.3
32380, 양구군,010005, 9세,2018,151,81,70,115.7,150,80,70,114.3
32380, 양구군,015,10~14세,2018,907,456,451,101.1,907,456,451,101.1
32380, 양구군,015001, 10세,2018,183,90,93,96.8,183,90,93,96.8
32380, 양구군,015002, 11세,2018,176,91,85,107.1,176,91,85,107.1
32380, 양구군,015003, 12세,2018,180,82,98,83.7,180,82,98,83.7
32380, 양구군,015004, 13세,2018,179,110,69,159.4,179,110,69,159.4
32380, 양구군,015005, 14세,2018,189,83,106,78.3,189,83,106,78.3
32380, 양구군,020,15~19세,2018,1236,614,622,98.7,1234,614,620,99
32380, 양구군,020001, 15세,2018,166,83,83,100,166,83,83,100
32380, 양구군,020002, 16세,2018,316,154,162,95.1,316,154,162,95.1
32380, 양구군,020003, 17세,2018,319,154,165,93.3,318,154,164,93.9
32380, 양구군,020004, 18세,2018,289,130,159,81.8,288,130,158,82.3
32380, 양구군,020005, 19세,2018,146,93,53,175.5,146,93,53,175.5
32380, 양구군,025,20~24세,2018,1403,1047,356,294.1,1360,1026,334,307.2
32380, 양구군,025001, 20세,2018,156,117,39,300,155,117,38,307.9
32380, 양구군,025002, 21세,2018,196,142,54,263,191,139,52,267.3
32380, 양구군,025003, 22세,2018,221,156,65,240,213,149,64,232.8
32380, 양구군,025004, 23세,2018,364,274,90,304.4,352,269,83,324.1
32380, 양구군,025005, 24세,2018,466,358,108,331.5,449,352,97,362.9
32380, 양구군,030,25~29세,2018,1794,1217,577,210.9,1725,1182,543,217.7
32380, 양구군,030001, 25세,2018,403,308,95,324.2,391,300,91,329.7
32380, 양구군,030002, 26세,2018,398,275,123,223.6,386,270,116,232.8
32380, 양구군,030003, 27세,2018,376,247,129,191.5,368,243,125,194.4
32380, 양구군,030004, 28세,2018,327,211,116,181.9,308,201,107,187.9
32380, 양구군,030005, 29세,2018,290,176,114,154.4,272,168,104,161.5
32380, 양구군,035,30~34세,2018,1334,763,571,133.6,1275,741,534,138.8
32380, 양구군,035001, 30세,2018,295,179,116,154.3,282,175,107,163.6
32380, 양구군,035002, 31세,2018,291,174,117,148.7,278,168,110,152.7
32380, 양구군,035003, 32세,2018,254,144,110,130.9,242,138,104,132.7
32380, 양구군,035004, 33세,2018,244,136,108,125.9,228,131,97,135.1
32380, 양구군,035005, 34세,2018,250,130,120,108.3,245,129,116,111.2
32380, 양구군,040,35~39세,2018,1382,718,664,108.1,1332,700,632,110.8
32380, 양구군,040001, 35세,2018,270,136,134,101.5,259,131,128,102.3
32380, 양구군,040002, 36세,2018,296,149,147,101.4,285,145,140,103.6
32380, 양구군,040003, 37세,2018,272,137,135,101.5,265,137,128,107
32380, 양구군,040004, 38세,2018,287,163,124,131.5,279,158,121,130.6
32380, 양구군,040005, 39세,2018,257,133,124,107.3,244,129,115,112.2
32380, 양구군,045,40~44세,2018,1247,673,574,117.2,1215,666,549,121.3
32380, 양구군,045001, 40세,2018,246,139,107,129.9,237,138,99,139.4
32380, 양구군,045002, 41세,2018,237,123,114,107.9,233,123,110,111.8
32380, 양구군,045003, 42세,2018,247,136,111,122.5,242,133,109,122
32380, 양구군,045004, 43세,2018,241,122,119,102.5,233,121,112,108
32380, 양구군,045005, 44세,2018,276,153,123,124.4,270,151,119,126.9
32380, 양구군,050,45~49세,2018,1437,784,653,120.1,1404,775,629,123.2
32380, 양구군,050001, 45세,2018,301,166,135,123,297,165,132,125
32380, 양구군,050002, 46세,2018,265,153,112,136.6,258,149,109,136.7
32380, 양구군,050003, 47세,2018,261,136,125,108.8,254,135,119,113.4
32380, 양구군,050004, 48세,2018,297,157,140,112.1,287,155,132,117.4
32380, 양구군,050005, 49세,2018,313,172,141,122,308,171,137,124.8
32380, 양구군,055,50~54세,2018,1574,833,741,112.4,1542,825,717,115.1
32380, 양구군,055001, 50세,2018,331,176,155,113.5,321,173,148,116.9
32380, 양구군,055002, 51세,2018,309,164,145,113.1,303,162,141,114.9
32380, 양구군,055003, 52세,2018,288,148,140,105.7,284,148,136,108.8
32380, 양구군,055004, 53세,2018,290,155,135,114.8,284,153,131,116.8
32380, 양구군,055005, 54세,2018,356,190,166,114.5,350,189,161,117.4
32380, 양구군,060,55~59세,2018,1983,1040,943,110.3,1957,1032,925,111.6
32380, 양구군,060001, 55세,2018,370,198,172,115.1,366,197,169,116.6
32380, 양구군,060002, 56세,2018,390,205,185,110.8,384,203,181,112.2
32380, 양구군,060003, 57세,2018,424,215,209,102.9,417,213,204,104.4
32380, 양구군,060004, 58세,2018,424,222,202,109.9,421,222,199,111.6
32380, 양구군,060005, 59세,2018,375,200,175,114.3,369,197,172,114.5
32380, 양구군,065,60~64세,2018,1783,958,825,116.1,1764,953,811,117.5
32380, 양구군,065001, 60세,2018,399,208,191,108.9,395,207,188,110.1
32380, 양구군,065002, 61세,2018,379,207,172,120.3,375,205,170,120.6
32380, 양구군,065003, 62세,2018,349,183,166,110.2,344,182,162,112.3
32380, 양구군,065004, 63세,2018,328,180,148,121.6,325,180,145,124.1
32380, 양구군,065005, 64세,2018,328,180,148,121.6,325,179,146,122.6
32380, 양구군,070,65~69세,2018,970,462,508,90.9,966,459,507,90.5
32380, 양구군,070001, 65세,2018,216,110,106,103.8,215,109,106,102.8
32380, 양구군,070002, 66세,2018,240,131,109,120.2,238,129,109,118.3
32380, 양구군,070003, 67세,2018,157,71,86,82.6,157,71,86,82.6
32380, 양구군,070004, 68세,2018,163,70,93,75.3,163,70,93,75.3
32380, 양구군,070005, 69세,2018,194,80,114,70.2,193,80,113,70.8
32380, 양구군,075,70~74세,2018,983,452,531,85.1,980,450,530,84.9
32380, 양구군,075001, 70세,2018,177,81,96,84.4,177,81,96,84.4
32380, 양구군,075002, 71세,2018,209,87,122,71.3,208,87,121,71.9
32380, 양구군,075003, 72세,2018,179,85,94,90.4,179,85,94,90.4
32380, 양구군,075004, 73세,2018,192,93,99,93.9,191,92,99,92.9
32380, 양구군,075005, 74세,2018,226,106,120,88.3,225,105,120,87.5
32380, 양구군,080,75~79세,2018,1062,432,630,68.6,1060,431,629,68.5
32380, 양구군,080001, 75세,2018,211,88,123,71.5,211,88,123,71.5
32380, 양구군,080002, 76세,2018,253,105,148,70.9,252,104,148,70.3
32380, 양구군,080003, 77세,2018,211,87,124,70.2,211,87,124,70.2
32380, 양구군,080004, 78세,2018,191,72,119,60.5,190,72,118,61
32380, 양구군,080005, 79세,2018,196,80,116,69,196,80,116,69
32380, 양구군,085,80~84세,2018,642,222,420,52.9,642,222,420,52.9
32380, 양구군,085001, 80세,2018,159,58,101,57.4,159,58,101,57.4
32380, 양구군,085002, 81세,2018,145,54,91,59.3,145,54,91,59.3
32380, 양구군,085003, 82세,2018,131,52,79,65.8,131,52,79,65.8
32380, 양구군,085004, 83세,2018,106,32,74,43.2,106,32,74,43.2
32380, 양구군,085005, 84세,2018,101,26,75,34.7,101,26,75,34.7
32380, 양구군,090,85~89세,2018,314,88,226,38.9,314,88,226,38.9
32380, 양구군,090001, 85세,2018,93,24,69,34.8,93,24,69,34.8
32380, 양구군,090002, 86세,2018,64,22,42,52.4,64,22,42,52.4
32380, 양구군,090003, 87세,2018,72,25,47,53.2,72,25,47,53.2
32380, 양구군,090004, 88세,2018,41,6,35,17.1,41,6,35,17.1
32380, 양구군,090005, 89세,2018,44,11,33,33.3,44,11,33,33.3
32380, 양구군,095,90~94세,2018,105,29,76,38.2,105,29,76,38.2
32380, 양구군,095001, 90세,2018,27,8,19,42.1,27,8,19,42.1
32380, 양구군,095002, 91세,2018,30,8,22,36.4,30,8,22,36.4
32380, 양구군,095003, 92세,2018,15,X,12,25,15,X,12,25
32380, 양구군,095004, 93세,2018,19,5,14,35.7,19,5,14,35.7
32380, 양구군,095005, 94세,2018,14,5,9,55.6,14,5,9,55.6
32380, 양구군,100,95~99세,2018,27,9,18,50,27,9,18,50
32380, 양구군,100001, 95세,2018,14,X,10,40,14,X,10,40
32380, 양구군,100002, 96세,2018,6,X,5,20,6,X,5,20
32380, 양구군,100003, 97세,2018,5,X,X,66.7,5,X,X,66.7
32380, 양구군,100004, 98세,2018,X,X,X,,X,X,X,
32380, 양구군,100005, 99세,2018,X,X,X,,X,X,X,
32380, 양구군,101,100세이상,2018,5,X,X,25,5,X,X,25
32380, 양구군,102,15세미만,2018,2820,1419,1401,101.3,2815,1415,1400,101.1
32380, 양구군,103,15~64세,2018,15173,8647,6526,132.5,14808,8514,6294,135.3
32380, 양구군,104,65세이상,2018,4108,1695,2413,70.2,4099,1689,2410,70.1
32380, 양구군,086,85세이상,2018,451,127,324,39.2,451,127,324,39.2
32380, 양구군,126,평균연령,2018,43.4,41.3,45.8,,43.5,41.4,45.9,
32380, 양구군,127,중위연령,2018,44.4,40.7,48.2,,44.6,40.9,48.6,
32390, 인제군,000,합계,2018,30373,16416,13957,117.6,29917,16190,13727,117.9
32390, 인제군,005,0~4세,2018,1377,711,666,106.8,1377,711,666,106.8
32390, 인제군,005001, 0세,2018,257,123,134,91.8,257,123,134,91.8
32390, 인제군,005002, 1세,2018,297,153,144,106.3,297,153,144,106.3
32390, 인제군,005003, 2세,2018,295,154,141,109.2,295,154,141,109.2
32390, 인제군,005004, 3세,2018,280,151,129,117.1,280,151,129,117.1
32390, 인제군,005005, 4세,2018,248,130,118,110.2,248,130,118,110.2
32390, 인제군,010,5~9세,2018,1316,710,606,117.2,1316,710,606,117.2
32390, 인제군,010001, 5세,2018,260,135,125,108,260,135,125,108
32390, 인제군,010002, 6세,2018,297,155,142,109.2,297,155,142,109.2
32390, 인제군,010003, 7세,2018,250,140,110,127.3,250,140,110,127.3
32390, 인제군,010004, 8세,2018,273,153,120,127.5,273,153,120,127.5
32390, 인제군,010005, 9세,2018,236,127,109,116.5,236,127,109,116.5
32390, 인제군,015,10~14세,2018,1200,605,595,101.7,1200,605,595,101.7
32390, 인제군,015001, 10세,2018,249,123,126,97.6,249,123,126,97.6
32390, 인제군,015002, 11세,2018,245,123,122,100.8,245,123,122,100.8
32390, 인제군,015003, 12세,2018,245,120,125,96,245,120,125,96
32390, 인제군,015004, 13세,2018,232,113,119,95,232,113,119,95
32390, 인제군,015005, 14세,2018,229,126,103,122.3,229,126,103,122.3
32390, 인제군,020,15~19세,2018,1011,557,454,122.7,1007,553,454,121.8
32390, 인제군,020001, 15세,2018,227,124,103,120.4,227,124,103,120.4
32390, 인제군,020002, 16세,2018,198,106,92,115.2,198,106,92,115.2
32390, 인제군,020003, 17세,2018,239,122,117,104.3,239,122,117,104.3
32390, 인제군,020004, 18세,2018,205,106,99,107.1,204,105,99,106.1
32390, 인제군,020005, 19세,2018,142,99,43,230.2,139,96,43,223.3
32390, 인제군,025,20~24세,2018,1598,1127,471,239.3,1532,1090,442,246.6
32390, 인제군,025001, 20세,2018,202,136,66,206.1,197,135,62,217.7
32390, 인제군,025002, 21세,2018,270,201,69,291.3,256,191,65,293.8
32390, 인제군,025003, 22세,2018,297,205,92,222.8,286,198,88,225
32390, 인제군,025004, 23세,2018,413,294,119,247.1,392,281,111,253.2
32390, 인제군,025005, 24세,2018,416,291,125,232.8,401,285,116,245.7
32390, 인제군,030,25~29세,2018,2249,1499,750,199.9,2145,1445,700,206.4
32390, 인제군,030001, 25세,2018,482,356,126,282.5,457,341,116,294
32390, 인제군,030002, 26세,2018,456,311,145,214.5,430,296,134,220.9
32390, 인제군,030003, 27세,2018,480,314,166,189.2,463,305,158,193
32390, 인제군,030004, 28세,2018,429,269,160,168.1,413,261,152,171.7
32390, 인제군,030005, 29세,2018,402,249,153,162.7,382,242,140,172.9
32390, 인제군,035,30~34세,2018,1920,1134,786,144.3,1849,1097,752,145.9
32390, 인제군,035001, 30세,2018,361,225,136,165.4,345,217,128,169.5
32390, 인제군,035002, 31세,2018,394,238,156,152.6,383,233,150,155.3
32390, 인제군,035003, 32세,2018,407,235,172,136.6,393,229,164,139.6
32390, 인제군,035004, 33세,2018,372,222,150,148,361,215,146,147.3
32390, 인제군,035005, 34세,2018,386,214,172,124.4,367,203,164,123.8
32390, 인제군,040,35~39세,2018,2137,1135,1002,113.3,2074,1110,964,115.1
32390, 인제군,040001, 35세,2018,418,213,205,103.9,399,206,193,106.7
32390, 인제군,040002, 36세,2018,434,227,207,109.7,416,224,192,116.7
32390, 인제군,040003, 37세,2018,446,250,196,127.6,437,242,195,124.1
32390, 인제군,040004, 38세,2018,428,237,191,124.1,416,232,184,126.1
32390, 인제군,040005, 39세,2018,411,208,203,102.5,406,206,200,103
32390, 인제군,045,40~44세,2018,1875,1038,837,124,1844,1025,819,125.2
32390, 인제군,045001, 40세,2018,383,210,173,121.4,374,205,169,121.3
32390, 인제군,045002, 41세,2018,367,175,192,91.1,363,173,190,91.1
32390, 인제군,045003, 42세,2018,334,192,142,135.2,332,190,142,133.8
32390, 인제군,045004, 43세,2018,392,219,173,126.6,383,218,165,132.1
32390, 인제군,045005, 44세,2018,399,242,157,154.1,392,239,153,156.2
32390, 인제군,050,45~49세,2018,2079,1174,905,129.7,2043,1157,886,130.6
32390, 인제군,050001, 45세,2018,362,204,158,129.1,353,200,153,130.7
32390, 인제군,050002, 46세,2018,398,223,175,127.4,391,220,171,128.7
32390, 인제군,050003, 47세,2018,432,252,180,140,424,246,178,138.2
32390, 인제군,050004, 48세,2018,417,225,192,117.2,412,224,188,119.1
32390, 인제군,050005, 49세,2018,470,270,200,135,463,267,196,136.2
32390, 인제군,055,50~54세,2018,2261,1219,1042,117,2234,1206,1028,117.3
32390, 인제군,055001, 50세,2018,454,253,201,125.9,449,251,198,126.8
32390, 인제군,055002, 51세,2018,385,211,174,121.3,379,209,170,122.9
32390, 인제군,055003, 52세,2018,465,266,199,133.7,459,262,197,133
32390, 인제군,055004, 53세,2018,446,223,223,100,440,220,220,100
32390, 인제군,055005, 54세,2018,511,266,245,108.6,507,264,243,108.6
32390, 인제군,060,55~59세,2018,2987,1558,1429,109,2957,1543,1414,109.1
32390, 인제군,060001, 55세,2018,543,259,284,91.2,532,252,280,90
32390, 인제군,060002, 56세,2018,578,317,261,121.5,572,314,258,121.7
32390, 인제군,060003, 57세,2018,706,361,345,104.6,704,361,343,105.2
32390, 인제군,060004, 58세,2018,618,326,292,111.6,611,323,288,112.2
32390, 인제군,060005, 59세,2018,542,295,247,119.4,538,293,245,119.6
32390, 인제군,065,60~64세,2018,2595,1415,1180,119.9,2583,1409,1174,120
32390, 인제군,065001, 60세,2018,571,326,245,133.1,567,325,242,134.3
32390, 인제군,065002, 61세,2018,604,349,255,136.9,602,347,255,136.1
32390, 인제군,065003, 62세,2018,497,265,232,114.2,496,265,231,114.7
32390, 인제군,065004, 63세,2018,506,264,242,109.1,505,263,242,108.7
32390, 인제군,065005, 64세,2018,417,211,206,102.4,413,209,204,102.5
32390, 인제군,070,65~69세,2018,1515,757,758,99.9,1509,754,755,99.9
32390, 인제군,070001, 65세,2018,347,188,159,118.2,346,188,158,119
32390, 인제군,070002, 66세,2018,436,219,217,100.9,433,217,216,100.5
32390, 인제군,070003, 67세,2018,246,124,122,101.6,245,123,122,100.8
32390, 인제군,070004, 68세,2018,223,101,122,82.8,223,101,122,82.8
32390, 인제군,070005, 69세,2018,263,125,138,90.6,262,125,137,91.2
32390, 인제군,075,70~74세,2018,1399,692,707,97.9,1395,690,705,97.9
32390, 인제군,075001, 70세,2018,267,132,135,97.8,267,132,135,97.8
32390, 인제군,075002, 71세,2018,300,151,149,101.3,297,150,147,102
32390, 인제군,075003, 72세,2018,250,122,128,95.3,249,121,128,94.5
32390, 인제군,075004, 73세,2018,295,136,159,85.5,295,136,159,85.5
32390, 인제군,075005, 74세,2018,287,151,136,111,287,151,136,111
32390, 인제군,080,75~79세,2018,1381,600,781,76.8,1380,600,780,76.9
32390, 인제군,080001, 75세,2018,292,122,170,71.8,292,122,170,71.8
32390, 인제군,080002, 76세,2018,295,141,154,91.6,295,141,154,91.6
32390, 인제군,080003, 77세,2018,283,131,152,86.2,283,131,152,86.2
32390, 인제군,080004, 78세,2018,270,119,151,78.8,269,119,150,79.3
32390, 인제군,080005, 79세,2018,241,87,154,56.5,241,87,154,56.5
32390, 인제군,085,80~84세,2018,870,320,550,58.2,870,320,550,58.2
32390, 인제군,085001, 80세,2018,253,88,165,53.3,253,88,165,53.3
32390, 인제군,085002, 81세,2018,203,94,109,86.2,203,94,109,86.2
32390, 인제군,085003, 82세,2018,165,63,102,61.8,165,63,102,61.8
32390, 인제군,085004, 83세,2018,147,43,104,41.3,147,43,104,41.3
32390, 인제군,085005, 84세,2018,102,32,70,45.7,102,32,70,45.7
32390, 인제군,090,85~89세,2018,391,98,293,33.4,391,98,293,33.4
32390, 인제군,090001, 85세,2018,114,31,83,37.3,114,31,83,37.3
32390, 인제군,090002, 86세,2018,90,22,68,32.4,90,22,68,32.4
32390, 인제군,090003, 87세,2018,70,21,49,42.9,70,21,49,42.9
32390, 인제군,090004, 88세,2018,67,11,56,19.6,67,11,56,19.6
32390, 인제군,090005, 89세,2018,50,13,37,35.1,50,13,37,35.1
32390, 인제군,095,90~94세,2018,162,48,114,42.1,161,48,113,42.5
32390, 인제군,095001, 90세,2018,57,13,44,29.5,57,13,44,29.5
32390, 인제군,095002, 91세,2018,36,10,26,38.5,36,10,26,38.5
32390, 인제군,095003, 92세,2018,27,6,21,28.6,26,6,20,30
32390, 인제군,095004, 93세,2018,16,5,11,45.5,16,5,11,45.5
32390, 인제군,095005, 94세,2018,26,14,12,116.7,26,14,12,116.7
32390, 인제군,100,95~99세,2018,46,17,29,58.6,46,17,29,58.6
32390, 인제군,100001, 95세,2018,21,7,14,50,21,7,14,50
32390, 인제군,100002, 96세,2018,10,X,8,25,10,X,8,25
32390, 인제군,100003, 97세,2018,6,X,X,100,6,X,X,100
32390, 인제군,100004, 98세,2018,5,X,X,150,5,X,X,150
32390, 인제군,100005, 99세,2018,X,X,X,100,X,X,X,100
32390, 인제군,101,100세이상,2018,X,X,X,100,X,X,X,100
32390, 인제군,102,15세미만,2018,3893,2026,1867,108.5,3893,2026,1867,108.5
32390, 인제군,103,15~64세,2018,20712,11856,8856,133.9,20268,11635,8633,134.8
32390, 인제군,104,65세이상,2018,5768,2534,3234,78.4,5756,2529,3227,78.4
32390, 인제군,086,85세이상,2018,603,165,438,37.7,602,165,437,37.8
32390, 인제군,126,평균연령,2018,44.5,42.7,46.7,,44.7,42.8,46.9,
32390, 인제군,127,중위연령,2018,46.4,43.7,49.5,,46.7,43.9,49.9,
32400, 고성군,000,합계,2018,28127,15139,12988,116.6,26869,14215,12654,112.3
32400, 고성군,005,0~4세,2018,610,310,300,103.3,608,308,300,102.7
32400, 고성군,005001, 0세,2018,101,56,45,124.4,101,56,45,124.4
32400, 고성군,005002, 1세,2018,120,50,70,71.4,119,49,70,70
32400, 고성군,005003, 2세,2018,137,65,72,90.3,136,64,72,88.9
32400, 고성군,005004, 3세,2018,120,69,51,135.3,120,69,51,135.3
32400, 고성군,005005, 4세,2018,132,70,62,112.9,132,70,62,112.9
32400, 고성군,010,5~9세,2018,696,362,334,108.4,695,362,333,108.7
32400, 고성군,010001, 5세,2018,130,63,67,94,130,63,67,94
32400, 고성군,010002, 6세,2018,144,77,67,114.9,144,77,67,114.9
32400, 고성군,010003, 7세,2018,157,87,70,124.3,156,87,69,126.1
32400, 고성군,010004, 8세,2018,131,70,61,114.8,131,70,61,114.8
32400, 고성군,010005, 9세,2018,134,65,69,94.2,134,65,69,94.2
32400, 고성군,015,10~14세,2018,786,434,352,123.3,786,434,352,123.3
32400, 고성군,015001, 10세,2018,155,93,62,150,155,93,62,150
32400, 고성군,015002, 11세,2018,154,86,68,126.5,154,86,68,126.5
32400, 고성군,015003, 12세,2018,154,86,68,126.5,154,86,68,126.5
32400, 고성군,015004, 13세,2018,163,86,77,111.7,163,86,77,111.7
32400, 고성군,015005, 14세,2018,160,83,77,107.8,160,83,77,107.8
32400, 고성군,020,15~19세,2018,1137,645,492,131.1,1071,605,466,129.8
32400, 고성군,020001, 15세,2018,174,84,90,93.3,173,84,89,94.4
32400, 고성군,020002, 16세,2018,185,101,84,120.2,185,101,84,120.2
32400, 고성군,020003, 17세,2018,223,121,102,118.6,222,121,101,119.8
32400, 고성군,020004, 18세,2018,260,152,108,140.7,240,140,100,140
32400, 고성군,020005, 19세,2018,295,187,108,173.1,251,159,92,172.8
32400, 고성군,025,20~24세,2018,3023,2103,920,228.6,2487,1689,798,211.7
32400, 고성군,025001, 20세,2018,465,305,160,190.6,373,245,128,191.4
32400, 고성군,025002, 21세,2018,505,279,226,123.5,388,193,195,99
32400, 고성군,025003, 22세,2018,716,474,242,195.9,552,337,215,156.7
32400, 고성군,025004, 23세,2018,626,468,158,296.2,525,389,136,286
32400, 고성군,025005, 24세,2018,711,577,134,430.6,649,525,124,423.4
32400, 고성군,030,25~29세,2018,1936,1353,583,232.1,1735,1189,546,217.8
32400, 고성군,030001, 25세,2018,510,382,128,298.4,456,339,117,289.7
32400, 고성군,030002, 26세,2018,464,318,146,217.8,422,284,138,205.8
32400, 고성군,030003, 27세,2018,365,251,114,220.2,327,222,105,211.4
32400, 고성군,030004, 28세,2018,327,221,106,208.5,283,183,100,183
32400, 고성군,030005, 29세,2018,270,181,89,203.4,247,161,86,187.2
32400, 고성군,035,30~34세,2018,1174,715,459,155.8,1046,622,424,146.7
32400, 고성군,035001, 30세,2018,235,150,85,176.5,213,133,80,166.3
32400, 고성군,035002, 31세,2018,240,156,84,185.7,212,137,75,182.7
32400, 고성군,035003, 32세,2018,230,141,89,158.4,211,128,83,154.2
32400, 고성군,035004, 33세,2018,218,128,90,142.2,188,109,79,138
32400, 고성군,035005, 34세,2018,251,140,111,126.1,222,115,107,107.5
32400, 고성군,040,35~39세,2018,1230,715,515,138.8,1101,613,488,125.6
32400, 고성군,040001, 35세,2018,233,134,99,135.4,199,104,95,109.5
32400, 고성군,040002, 36세,2018,244,148,96,154.2,222,131,91,144
32400, 고성군,040003, 37세,2018,247,147,100,147,223,127,96,132.3
32400, 고성군,040004, 38세,2018,272,149,123,121.1,243,131,112,117
32400, 고성군,040005, 39세,2018,234,137,97,141.2,214,120,94,127.7
32400, 고성군,045,40~44세,2018,1377,779,598,130.3,1306,730,576,126.7
32400, 고성군,045001, 40세,2018,240,137,103,133,228,128,100,128
32400, 고성군,045002, 41세,2018,247,136,111,122.5,225,121,104,116.3
32400, 고성군,045003, 42세,2018,282,156,126,123.8,269,147,122,120.5
32400, 고성군,045004, 43세,2018,265,149,116,128.4,255,143,112,127.7
32400, 고성군,045005, 44세,2018,343,201,142,141.5,329,191,138,138.4
32400, 고성군,050,45~49세,2018,1828,1034,794,130.2,1770,999,771,129.6
32400, 고성군,050001, 45세,2018,301,160,141,113.5,286,151,135,111.9
32400, 고성군,050002, 46세,2018,351,207,144,143.8,337,197,140,140.7
32400, 고성군,050003, 47세,2018,376,215,161,133.5,368,210,158,132.9
32400, 고성군,050004, 48세,2018,390,219,171,128.1,382,216,166,130.1
32400, 고성군,050005, 49세,2018,410,233,177,131.6,397,225,172,130.8
32400, 고성군,055,50~54세,2018,2009,1078,931,115.8,1983,1068,915,116.7
32400, 고성군,055001, 50세,2018,405,225,180,125,399,223,176,126.7
32400, 고성군,055002, 51세,2018,383,205,178,115.2,380,204,176,115.9
32400, 고성군,055003, 52세,2018,423,233,190,122.6,415,228,187,121.9
32400, 고성군,055004, 53세,2018,402,206,196,105.1,395,204,191,106.8
32400, 고성군,055005, 54세,2018,396,209,187,111.8,394,209,185,113
32400, 고성군,060,55~59세,2018,2682,1358,1324,102.6,2667,1356,1311,103.4
32400, 고성군,060001, 55세,2018,481,244,237,103,476,244,232,105.2
32400, 고성군,060002, 56세,2018,512,264,248,106.5,510,264,246,107.3
32400, 고성군,060003, 57세,2018,584,282,302,93.4,582,282,300,94
32400, 고성군,060004, 58세,2018,564,288,276,104.3,559,286,273,104.8
32400, 고성군,060005, 59세,2018,541,280,261,107.3,540,280,260,107.7
32400, 고성군,065,60~64세,2018,2625,1341,1284,104.4,2615,1334,1281,104.1
32400, 고성군,065001, 60세,2018,553,284,269,105.6,551,282,269,104.8
32400, 고성군,065002, 61세,2018,529,287,242,118.6,527,286,241,118.7
32400, 고성군,065003, 62세,2018,476,240,236,101.7,474,239,235,101.7
32400, 고성군,065004, 63세,2018,553,274,279,98.2,549,271,278,97.5
32400, 고성군,065005, 64세,2018,514,256,258,99.2,514,256,258,99.2
32400, 고성군,070,65~69세,2018,1752,856,896,95.5,1747,854,893,95.6
32400, 고성군,070001, 65세,2018,386,208,178,116.9,386,208,178,116.9
32400, 고성군,070002, 66세,2018,414,202,212,95.3,413,202,211,95.7
32400, 고성군,070003, 67세,2018,292,142,150,94.7,291,142,149,95.3
32400, 고성군,070004, 68세,2018,306,136,170,80,304,135,169,79.9
32400, 고성군,070005, 69세,2018,354,168,186,90.3,353,167,186,89.8
32400, 고성군,075,70~74세,2018,1752,772,980,78.8,1746,770,976,78.9
32400, 고성군,075001, 70세,2018,349,169,180,93.9,348,169,179,94.4
32400, 고성군,075002, 71세,2018,340,151,189,79.9,337,150,187,80.2
32400, 고성군,075003, 72세,2018,357,158,199,79.4,355,157,198,79.3
32400, 고성군,075004, 73세,2018,364,161,203,79.3,364,161,203,79.3
32400, 고성군,075005, 74세,2018,342,133,209,63.6,342,133,209,63.6
32400, 고성군,080,75~79세,2018,1706,715,991,72.1,1705,715,990,72.2
32400, 고성군,080001, 75세,2018,332,140,192,72.9,331,140,191,73.3
32400, 고성군,080002, 76세,2018,426,185,241,76.8,426,185,241,76.8
32400, 고성군,080003, 77세,2018,325,129,196,65.8,325,129,196,65.8
32400, 고성군,080004, 78세,2018,322,137,185,74.1,322,137,185,74.1
32400, 고성군,080005, 79세,2018,301,124,177,70.1,301,124,177,70.1
32400, 고성군,085,80~84세,2018,1041,365,676,54,1039,364,675,53.9
32400, 고성군,085001, 80세,2018,290,117,173,67.6,290,117,173,67.6
32400, 고성군,085002, 81세,2018,237,73,164,44.5,237,73,164,44.5
32400, 고성군,085003, 82세,2018,196,77,119,64.7,195,76,119,63.9
32400, 고성군,085004, 83세,2018,180,58,122,47.5,179,58,121,47.9
32400, 고성군,085005, 84세,2018,138,40,98,40.8,138,40,98,40.8
32400, 고성군,090,85~89세,2018,478,136,342,39.8,478,136,342,39.8
32400, 고성군,090001, 85세,2018,124,36,88,40.9,124,36,88,40.9
32400, 고성군,090002, 86세,2018,99,27,72,37.5,99,27,72,37.5
32400, 고성군,090003, 87세,2018,85,25,60,41.7,85,25,60,41.7
32400, 고성군,090004, 88세,2018,88,26,62,41.9,88,26,62,41.9
32400, 고성군,090005, 89세,2018,82,22,60,36.7,82,22,60,36.7
32400, 고성군,095,90~94세,2018,220,50,170,29.4,219,49,170,28.8
32400, 고성군,095001, 90세,2018,70,12,58,20.7,69,11,58,19
32400, 고성군,095002, 91세,2018,51,10,41,24.4,51,10,41,24.4
32400, 고성군,095003, 92세,2018,45,11,34,32.4,45,11,34,32.4
32400, 고성군,095004, 93세,2018,30,10,20,50,30,10,20,50
32400, 고성군,095005, 94세,2018,24,7,17,41.2,24,7,17,41.2
32400, 고성군,100,95~99세,2018,58,16,42,38.1,58,16,42,38.1
32400, 고성군,100001, 95세,2018,24,5,19,26.3,24,5,19,26.3
32400, 고성군,100002, 96세,2018,13,6,7,85.7,13,6,7,85.7
32400, 고성군,100003, 97세,2018,8,X,5,60,8,X,5,60
32400, 고성군,100004, 98세,2018,5,X,5,0,5,X,5,0
32400, 고성군,100005, 99세,2018,8,X,6,33.3,8,X,6,33.3
32400, 고성군,101,100세이상,2018,7,X,5,40,7,X,5,40
32400, 고성군,102,15세미만,2018,2092,1106,986,112.2,2089,1104,985,112.1
32400, 고성군,103,15~64세,2018,19021,11121,7900,140.8,17781,10205,7576,134.7
32400, 고성군,104,65세이상,2018,7014,2912,4102,71,6999,2906,4093,71
32400, 고성군,086,85세이상,2018,763,204,559,36.5,762,203,559,36.3
32400, 고성군,126,평균연령,2018,47.8,44.5,51.6,,48.6,45.5,52.1,
32400, 고성군,127,중위연령,2018,50.7,46,55.9,,52.1,48,56.5,
32410, 양양군,000,합계,2018,25642,12961,12681,102.2,25237,12733,12504,101.8
32410, 양양군,005,0~4세,2018,577,284,293,96.9,574,283,291,97.3
32410, 양양군,005001, 0세,2018,119,54,65,83.1,119,54,65,83.1
32410, 양양군,005002, 1세,2018,93,45,48,93.8,92,44,48,91.7
32410, 양양군,005003, 2세,2018,117,57,60,95,116,57,59,96.6
32410, 양양군,005004, 3세,2018,123,65,58,112.1,123,65,58,112.1
32410, 양양군,005005, 4세,2018,125,63,62,101.6,124,63,61,103.3
32410, 양양군,010,5~9세,2018,757,392,365,107.4,756,391,365,107.1
32410, 양양군,010001, 5세,2018,149,86,63,136.5,149,86,63,136.5
32410, 양양군,010002, 6세,2018,145,68,77,88.3,144,67,77,87
32410, 양양군,010003, 7세,2018,155,84,71,118.3,155,84,71,118.3
32410, 양양군,010004, 8세,2018,158,81,77,105.2,158,81,77,105.2
32410, 양양군,010005, 9세,2018,150,73,77,94.8,150,73,77,94.8
32410, 양양군,015,10~14세,2018,839,453,386,117.4,837,452,385,117.4
32410, 양양군,015001, 10세,2018,158,89,69,129,158,89,69,129
32410, 양양군,015002, 11세,2018,180,92,88,104.5,180,92,88,104.5
32410, 양양군,015003, 12세,2018,148,77,71,108.5,148,77,71,108.5
32410, 양양군,015004, 13세,2018,175,88,87,101.1,174,88,86,102.3
32410, 양양군,015005, 14세,2018,178,107,71,150.7,177,106,71,149.3
32410, 양양군,020,15~19세,2018,916,482,434,111.1,916,482,434,111.1
32410, 양양군,020001, 15세,2018,181,85,96,88.5,181,85,96,88.5
32410, 양양군,020002, 16세,2018,179,87,92,94.6,179,87,92,94.6
32410, 양양군,020003, 17세,2018,219,116,103,112.6,219,116,103,112.6
32410, 양양군,020004, 18세,2018,203,107,96,111.5,203,107,96,111.5
32410, 양양군,020005, 19세,2018,134,87,47,185.1,134,87,47,185.1
32410, 양양군,025,20~24세,2018,913,588,325,180.9,866,561,305,183.9
32410, 양양군,025001, 20세,2018,162,130,32,406.3,162,130,32,406.3
32410, 양양군,025002, 21세,2018,183,108,75,144,179,106,73,145.2
32410, 양양군,025003, 22세,2018,186,118,68,173.5,180,115,65,176.9
32410, 양양군,025004, 23세,2018,187,111,76,146.1,174,104,70,148.6
32410, 양양군,025005, 24세,2018,195,121,74,163.5,171,106,65,163.1
32410, 양양군,030,25~29세,2018,1129,657,472,139.2,1043,601,442,136
32410, 양양군,030001, 25세,2018,247,146,101,144.6,228,133,95,140
32410, 양양군,030002, 26세,2018,228,131,97,135.1,212,120,92,130.4
32410, 양양군,030003, 27세,2018,239,149,90,165.6,222,140,82,170.7
32410, 양양군,030004, 28세,2018,215,119,96,124,196,106,90,117.8
32410, 양양군,030005, 29세,2018,200,112,88,127.3,185,102,83,122.9
32410, 양양군,035,30~34세,2018,1013,588,425,138.4,952,556,396,140.4
32410, 양양군,035001, 30세,2018,209,126,83,151.8,196,121,75,161.3
32410, 양양군,035002, 31세,2018,202,105,97,108.2,189,97,92,105.4
32410, 양양군,035003, 32세,2018,180,108,72,150,164,99,65,152.3
32410, 양양군,035004, 33세,2018,207,116,91,127.5,197,111,86,129.1
32410, 양양군,035005, 34세,2018,215,133,82,162.2,206,128,78,164.1
32410, 양양군,040,35~39세,2018,1382,742,640,115.9,1318,702,616,114
32410, 양양군,040001, 35세,2018,237,124,113,109.7,224,116,108,107.4
32410, 양양군,040002, 36세,2018,285,142,143,99.3,267,132,135,97.8
32410, 양양군,040003, 37세,2018,271,161,110,146.4,254,147,107,137.4
32410, 양양군,040004, 38세,2018,299,152,147,103.4,290,146,144,101.4
32410, 양양군,040005, 39세,2018,290,163,127,128.3,283,161,122,132
32410, 양양군,045,40~44세,2018,1484,806,678,118.9,1448,786,662,118.7
32410, 양양군,045001, 40세,2018,278,150,128,117.2,274,146,128,114.1
32410, 양양군,045002, 41세,2018,287,148,139,106.5,278,146,132,110.6
32410, 양양군,045003, 42세,2018,275,171,104,164.4,267,168,99,169.7
32410, 양양군,045004, 43세,2018,316,159,157,101.3,308,154,154,100
32410, 양양군,045005, 44세,2018,328,178,150,118.7,321,172,149,115.4
32410, 양양군,050,45~49세,2018,1868,1047,821,127.5,1842,1030,812,126.8
32410, 양양군,050001, 45세,2018,370,216,154,140.3,361,210,151,139.1
32410, 양양군,050002, 46세,2018,329,172,157,109.6,323,167,156,107.1
32410, 양양군,050003, 47세,2018,374,197,177,111.3,368,194,174,111.5
32410, 양양군,050004, 48세,2018,382,231,151,153,377,228,149,153
32410, 양양군,050005, 49세,2018,413,231,182,126.9,413,231,182,126.9
32410, 양양군,055,50~54세,2018,2076,1101,975,112.9,2049,1095,954,114.8
32410, 양양군,055001, 50세,2018,431,248,183,135.5,429,248,181,137
32410, 양양군,055002, 51세,2018,399,226,173,130.6,392,223,169,132
32410, 양양군,055003, 52세,2018,420,231,189,122.2,415,231,184,125.5
32410, 양양군,055004, 53세,2018,408,195,213,91.5,402,194,208,93.3
32410, 양양군,055005, 54세,2018,418,201,217,92.6,411,199,212,93.9
32410, 양양군,060,55~59세,2018,2705,1377,1328,103.7,2686,1368,1318,103.8
32410, 양양군,060001, 55세,2018,460,234,226,103.5,456,233,223,104.5
32410, 양양군,060002, 56세,2018,511,259,252,102.8,505,255,250,102
32410, 양양군,060003, 57세,2018,594,299,295,101.4,590,298,292,102.1
32410, 양양군,060004, 58세,2018,594,309,285,108.4,592,308,284,108.5
32410, 양양군,060005, 59세,2018,546,276,270,102.2,543,274,269,101.9
32410, 양양군,065,60~64세,2018,2710,1326,1384,95.8,2694,1319,1375,95.9
32410, 양양군,065001, 60세,2018,581,293,288,101.7,578,293,285,102.8
32410, 양양군,065002, 61세,2018,552,260,292,89,543,257,286,89.9
32410, 양양군,065003, 62세,2018,473,230,243,94.7,472,229,243,94.2
32410, 양양군,065004, 63세,2018,568,287,281,102.1,567,286,281,101.8
32410, 양양군,065005, 64세,2018,536,256,280,91.4,534,254,280,90.7
32410, 양양군,070,65~69세,2018,1877,917,960,95.5,1867,910,957,95.1
32410, 양양군,070001, 65세,2018,392,200,192,104.2,391,200,191,104.7
32410, 양양군,070002, 66세,2018,488,217,271,80.1,485,215,270,79.6
32410, 양양군,070003, 67세,2018,313,164,149,110.1,308,160,148,108.1
32410, 양양군,070004, 68세,2018,330,154,176,87.5,329,153,176,86.9
32410, 양양군,070005, 69세,2018,354,182,172,105.8,354,182,172,105.8
32410, 양양군,075,70~74세,2018,1870,858,1012,84.8,1868,857,1011,84.8
32410, 양양군,075001, 70세,2018,358,158,200,79,358,158,200,79
32410, 양양군,075002, 71세,2018,410,204,206,99,410,204,206,99
32410, 양양군,075003, 72세,2018,338,172,166,103.6,336,171,165,103.6
32410, 양양군,075004, 73세,2018,372,150,222,67.6,372,150,222,67.6
32410, 양양군,075005, 74세,2018,392,174,218,79.8,392,174,218,79.8
32410, 양양군,080,75~79세,2018,1705,741,964,76.9,1704,740,964,76.8
32410, 양양군,080001, 75세,2018,369,161,208,77.4,369,161,208,77.4
32410, 양양군,080002, 76세,2018,381,177,204,86.8,381,177,204,86.8
32410, 양양군,080003, 77세,2018,337,137,200,68.5,337,137,200,68.5
32410, 양양군,080004, 78세,2018,333,147,186,79,332,146,186,78.5
32410, 양양군,080005, 79세,2018,285,119,166,71.7,285,119,166,71.7
32410, 양양군,085,80~84세,2018,1084,418,666,62.8,1081,417,664,62.8
32410, 양양군,085001, 80세,2018,299,123,176,69.9,299,123,176,69.9
32410, 양양군,085002, 81세,2018,211,88,123,71.5,210,87,123,70.7
32410, 양양군,085003, 82세,2018,234,80,154,51.9,234,80,154,51.9
32410, 양양군,085004, 83세,2018,196,84,112,75,196,84,112,75
32410, 양양군,085005, 84세,2018,144,43,101,42.6,142,43,99,43.4
32410, 양양군,090,85~89세,2018,460,133,327,40.7,459,132,327,40.4
32410, 양양군,090001, 85세,2018,128,39,89,43.8,127,38,89,42.7
32410, 양양군,090002, 86세,2018,105,26,79,32.9,105,26,79,32.9
32410, 양양군,090003, 87세,2018,87,33,54,61.1,87,33,54,61.1
32410, 양양군,090004, 88세,2018,69,17,52,32.7,69,17,52,32.7
32410, 양양군,090005, 89세,2018,71,18,53,34,71,18,53,34
32410, 양양군,095,90~94세,2018,223,42,181,23.2,223,42,181,23.2
32410, 양양군,095001, 90세,2018,60,16,44,36.4,60,16,44,36.4
32410, 양양군,095002, 91세,2018,56,13,43,30.2,56,13,43,30.2
32410, 양양군,095003, 92세,2018,40,5,35,14.3,40,5,35,14.3
32410, 양양군,095004, 93세,2018,38,X,34,11.8,38,X,34,11.8
32410, 양양군,095005, 94세,2018,29,X,25,16,29,X,25,16
32410, 양양군,100,95~99세,2018,51,8,43,18.6,51,8,43,18.6
32410, 양양군,100001, 95세,2018,18,X,14,28.6,18,X,14,28.6
32410, 양양군,100002, 96세,2018,12,X,11,9.1,12,X,11,9.1
32410, 양양군,100003, 97세,2018,9,X,7,28.6,9,X,7,28.6
32410, 양양군,100004, 98세,2018,5,X,X,25,5,X,X,25
32410, 양양군,100005, 99세,2018,7,X,7,0,7,X,7,0
32410, 양양군,101,100세이상,2018,X,X,X,50,X,X,X,50
32410, 양양군,102,15세미만,2018,2173,1129,1044,108.1,2167,1126,1041,108.2
32410, 양양군,103,15~64세,2018,16196,8714,7482,116.5,15814,8500,7314,116.2
32410, 양양군,104,65세이상,2018,7273,3118,4155,75,7256,3107,4149,74.9
32410, 양양군,086,85세이상,2018,737,184,553,33.3,736,183,553,33.1
32410, 양양군,126,평균연령,2018,50.9,48.8,53.1,,51.1,49,53.3,
32410, 양양군,127,중위연령,2018,54.7,51.9,57.2,,55,52.2,57.4,
33,충청북도,000,합계,2018,1620935,826183,794752,104,1566100,791904,774196,102.3
33,충청북도,005,0~4세,2018,62106,31660,30446,104,61354,31261,30093,103.9
33,충청북도,005001, 0세,2018,10843,5542,5301,104.5,10692,5456,5236,104.2
33,충청북도,005002, 1세,2018,11571,5941,5630,105.5,11404,5852,5552,105.4
33,충청북도,005003, 2세,2018,12955,6645,6310,105.3,12780,6559,6221,105.4
33,충청북도,005004, 3세,2018,13320,6798,6522,104.2,13185,6727,6458,104.2
33,충청북도,005005, 4세,2018,13417,6734,6683,100.8,13293,6667,6626,100.6
33,충청북도,010,5~9세,2018,71283,36546,34737,105.2,70796,36313,34483,105.3
33,충청북도,010001, 5세,2018,13600,6903,6697,103.1,13488,6855,6633,103.3
33,충청북도,010002, 6세,2018,14865,7577,7288,104,14751,7523,7228,104.1
33,충청북도,010003, 7세,2018,14881,7592,7289,104.2,14781,7547,7234,104.3
33,충청북도,010004, 8세,2018,14287,7357,6930,106.2,14207,7314,6893,106.1
33,충청북도,010005, 9세,2018,13650,7117,6533,108.9,13569,7074,6495,108.9
33,충청북도,015,10~14세,2018,71002,36866,34136,108,70678,36694,33984,108
33,충청북도,015001, 10세,2018,14433,7509,6924,108.4,14361,7470,6891,108.4
33,충청북도,015002, 11세,2018,14883,7672,7211,106.4,14807,7637,7170,106.5
33,충청북도,015003, 12세,2018,13505,6948,6557,106,13444,6910,6534,105.8
33,충청북도,015004, 13세,2018,13453,6981,6472,107.9,13398,6951,6447,107.8
33,충청북도,015005, 14세,2018,14728,7756,6972,111.2,14668,7726,6942,111.3
33,충청북도,020,15~19세,2018,91800,48510,43290,112.1,90662,47905,42757,112
33,충청북도,020001, 15세,2018,14967,7878,7089,111.1,14915,7846,7069,111
33,충청북도,020002, 16세,2018,15680,8208,7472,109.9,15620,8177,7443,109.9
33,충청북도,020003, 17세,2018,18080,9445,8635,109.4,17978,9389,8589,109.3
33,충청북도,020004, 18세,2018,20487,10784,9703,111.1,20245,10657,9588,111.1
33,충청북도,020005, 19세,2018,22586,12195,10391,117.4,21904,11836,10068,117.6
33,충청북도,025,20~24세,2018,117659,65165,52494,124.1,110420,60500,49920,121.2
33,충청북도,025001, 20세,2018,22896,11866,11030,107.6,21951,11296,10655,106
33,충청북도,025002, 21세,2018,23377,12127,11250,107.8,22169,11400,10769,105.9
33,충청북도,025003, 22세,2018,24289,13494,10795,125,22767,12511,10256,122
33,충청북도,025004, 23세,2018,23722,13717,10005,137.1,22015,12584,9431,133.4
33,충청북도,025005, 24세,2018,23375,13961,9414,148.3,21518,12709,8809,144.3
33,충청북도,030,25~29세,2018,103505,59358,44147,134.5,93665,52809,40856,129.3
33,충청북도,030001, 25세,2018,22591,13143,9448,139.1,20712,11901,8811,135.1
33,충청북도,030002, 26세,2018,21931,12782,9149,139.7,20013,11486,8527,134.7
33,충청북도,030003, 27세,2018,20365,11613,8752,132.7,18395,10301,8094,127.3
33,충청북도,030004, 28세,2018,19717,11196,8521,131.4,17640,9837,7803,126.1
33,충청북도,030005, 29세,2018,18901,10624,8277,128.4,16905,9284,7621,121.8
33,충청북도,035,30~34세,2018,97768,53421,44347,120.5,88653,47305,41348,114.4
33,충청북도,035001, 30세,2018,18820,10351,8469,122.2,16859,9045,7814,115.8
33,충청북도,035002, 31세,2018,19189,10448,8741,119.5,17143,9083,8060,112.7
33,충청북도,035003, 32세,2018,19529,10824,8705,124.3,17698,9579,8119,118
33,충청북도,035004, 33세,2018,19514,10560,8954,117.9,17799,9412,8387,112.2
33,충청북도,035005, 34세,2018,20716,11238,9478,118.6,19154,10186,8968,113.6
33,충청북도,040,35~39세,2018,117850,62202,55648,111.8,110983,57554,53429,107.7
33,충청북도,040001, 35세,2018,22316,11804,10512,112.3,20722,10707,10015,106.9
33,충청북도,040002, 36세,2018,24601,12932,11669,110.8,23080,11931,11149,107
33,충청북도,040003, 37세,2018,23412,12509,10903,114.7,22067,11590,10477,110.6
33,충청북도,040004, 38세,2018,24262,12673,11589,109.4,23049,11846,11203,105.7
33,충청북도,040005, 39세,2018,23259,12284,10975,111.9,22065,11480,10585,108.5
33,충청북도,045,40~44세,2018,115493,60046,55447,108.3,110859,57150,53709,106.4
33,충청북도,045001, 40세,2018,21540,11267,10273,109.7,20458,10575,9883,107
33,충청북도,045002, 41세,2018,22398,11692,10706,109.2,21367,11013,10354,106.4
33,충청북도,045003, 42세,2018,22319,11678,10641,109.7,21400,11105,10295,107.9
33,충청북도,045004, 43세,2018,23499,12018,11481,104.7,22663,11518,11145,103.3
33,충청북도,045005, 44세,2018,25737,13391,12346,108.5,24971,12939,12032,107.5
33,충청북도,050,45~49세,2018,133310,68972,64338,107.2,128909,66392,62517,106.2
33,충청북도,050001, 45세,2018,26023,13367,12656,105.6,25143,12856,12287,104.6
33,충청북도,050002, 46세,2018,24633,12872,11761,109.4,23760,12372,11388,108.6
33,충청북도,050003, 47세,2018,27269,14222,13047,109,26352,13673,12679,107.8
33,충청북도,050004, 48세,2018,26445,13775,12670,108.7,25542,13233,12309,107.5
33,충청북도,050005, 49세,2018,28940,14736,14204,103.7,28112,14258,13854,102.9
33,충청북도,055,50~54세,2018,130773,67034,63739,105.2,127005,64933,62072,104.6
33,충청북도,055001, 50세,2018,28441,14293,14148,101,27582,13793,13789,100
33,충청북도,055002, 51세,2018,26162,13430,12732,105.5,25488,13058,12430,105.1
33,충청북도,055003, 52세,2018,26056,13555,12501,108.4,25316,13165,12151,108.3
33,충청북도,055004, 53세,2018,26676,13653,13023,104.8,25911,13212,12699,104
33,충청북도,055005, 54세,2018,23438,12103,11335,106.8,22708,11705,11003,106.4
33,충청북도,060,55~59세,2018,137525,70114,67411,104,134566,68541,66025,103.8
33,충청북도,060001, 55세,2018,24923,13014,11909,109.3,24071,12529,11542,108.6
33,충청북도,060002, 56세,2018,27788,14422,13366,107.9,27165,14090,13075,107.8
33,충청북도,060003, 57세,2018,31201,15881,15320,103.7,30742,15650,15092,103.7
33,충청북도,060004, 58세,2018,27734,13834,13900,99.5,27169,13533,13636,99.2
33,충청북도,060005, 59세,2018,25879,12963,12916,100.4,25419,12739,12680,100.5
33,충청북도,065,60~64세,2018,115153,58123,57030,101.9,113209,56990,56219,101.4
33,충청북도,065001, 60세,2018,25520,13113,12407,105.7,25039,12842,12197,105.3
33,충청북도,065002, 61세,2018,25088,12738,12350,103.1,24611,12466,12145,102.6
33,충청북도,065003, 62세,2018,22933,11670,11263,103.6,22577,11452,11125,102.9
33,충청북도,065004, 63세,2018,22019,10845,11174,97.1,21695,10650,11045,96.4
33,충청북도,065005, 64세,2018,19593,9757,9836,99.2,19287,9580,9707,98.7
33,충청북도,070,65~69세,2018,75066,36807,38259,96.2,74232,36381,37851,96.1
33,충청북도,070001, 65세,2018,16778,8352,8426,99.1,16544,8220,8324,98.8
33,충청북도,070002, 66세,2018,19003,9390,9613,97.7,18812,9292,9520,97.6
33,충청북도,070003, 67세,2018,12463,5974,6489,92.1,12314,5908,6406,92.2
33,충청북도,070004, 68세,2018,13113,6337,6776,93.5,12993,6282,6711,93.6
33,충청북도,070005, 69세,2018,13709,6754,6955,97.1,13569,6679,6890,96.9
33,충청북도,075,70~74세,2018,58786,27195,31591,86.1,58495,27079,31416,86.2
33,충청북도,075001, 70세,2018,13488,6547,6941,94.3,13410,6518,6892,94.6
33,충청북도,075002, 71세,2018,13193,6200,6993,88.7,13117,6166,6951,88.7
33,충청북도,075003, 72세,2018,10122,4754,5368,88.6,10066,4731,5335,88.7
33,충청북도,075004, 73세,2018,10902,4983,5919,84.2,10855,4963,5892,84.2
33,충청북도,075005, 74세,2018,11081,4711,6370,74,11047,4701,6346,74.1
33,충청북도,080,75~79세,2018,57258,23693,33565,70.6,57127,23651,33476,70.7
33,충청북도,080001, 75세,2018,11608,4957,6651,74.5,11574,4941,6633,74.5
33,충청북도,080002, 76세,2018,13864,5910,7954,74.3,13843,5905,7938,74.4
33,충청북도,080003, 77세,2018,11183,4594,6589,69.7,11152,4584,6568,69.8
33,충청북도,080004, 78세,2018,10111,4068,6043,67.3,10090,4063,6027,67.4
33,충청북도,080005, 79세,2018,10492,4164,6328,65.8,10468,4158,6310,65.9
33,충청북도,085,80~84세,2018,39429,14008,25421,55.1,39353,13991,25362,55.2
33,충청북도,085001, 80세,2018,9255,3518,5737,61.3,9239,3517,5722,61.5
33,충청북도,085002, 81세,2018,8548,3164,5384,58.8,8532,3157,5375,58.7
33,충청북도,085003, 82세,2018,8056,2856,5200,54.9,8034,2855,5179,55.1
33,충청북도,085004, 83세,2018,7489,2503,4986,50.2,7476,2499,4977,50.2
33,충청북도,085005, 84세,2018,6081,1967,4114,47.8,6072,1963,4109,47.8
33,충청북도,090,85~89세,2018,17889,4859,13030,37.3,17861,4853,13008,37.3
33,충청북도,090001, 85세,2018,5203,1564,3639,43,5197,1563,3634,43
33,충청북도,090002, 86세,2018,4221,1198,3023,39.6,4216,1196,3020,39.6
33,충청북도,090003, 87세,2018,3038,780,2258,34.5,3035,780,2255,34.6
33,충청북도,090004, 88세,2018,2985,723,2262,32,2977,721,2256,32
33,충청북도,090005, 89세,2018,2442,594,1848,32.1,2436,593,1843,32.2
33,충청북도,095,90~94세,2018,5759,1321,4438,29.8,5753,1320,4433,29.8
33,충청북도,095001, 90세,2018,1881,429,1452,29.5,1879,429,1450,29.6
33,충청북도,095002, 91세,2018,1524,363,1161,31.3,1522,363,1159,31.3
33,충청북도,095003, 92세,2018,942,204,738,27.6,941,204,737,27.7
33,충청북도,095004, 93세,2018,885,195,690,28.3,885,195,690,28.3
33,충청북도,095005, 94세,2018,527,130,397,32.7,526,129,397,32.5
33,충청북도,100,95~99세,2018,1361,267,1094,24.4,1360,266,1094,24.3
33,충청북도,100001, 95세,2018,512,101,411,24.6,511,100,411,24.3
33,충청북도,100002, 96세,2018,370,82,288,28.5,370,82,288,28.5
33,충청북도,100003, 97세,2018,247,47,200,23.5,247,47,200,23.5
33,충청북도,100004, 98세,2018,134,20,114,17.5,134,20,114,17.5
33,충청북도,100005, 99세,2018,98,17,81,21,98,17,81,21
33,충청북도,101,100세이상,2018,160,16,144,11.1,160,16,144,11.1
33,충청북도,102,15세미만,2018,204391,105072,99319,105.8,202828,104268,98560,105.8
33,충청북도,103,15~64세,2018,1160836,612945,547891,111.9,1108931,580079,528852,109.7
33,충청북도,104,65세이상,2018,255708,108166,147542,73.3,254341,107557,146784,73.3
33,충청북도,086,85세이상,2018,25169,6463,18706,34.6,25134,6455,18679,34.6
33,충청북도,126,평균연령,2018,42.4,41,43.9,,42.6,41.2,44,
33,충청북도,127,중위연령,2018,43.5,41.7,45.2,,44,42.4,45.5,
33004, 읍부,000,합계,2018,324696,167828,156868,107,312475,160212,152263,105.2
33004, 읍부,005,0~4세,2018,15562,7924,7638,103.7,15361,7809,7552,103.4
33004, 읍부,005001, 0세,2018,2776,1399,1377,101.6,2737,1380,1357,101.7
33004, 읍부,005002, 1세,2018,2943,1469,1474,99.7,2899,1441,1458,98.8
33004, 읍부,005003, 2세,2018,3262,1676,1586,105.7,3216,1649,1567,105.2
33004, 읍부,005004, 3세,2018,3281,1694,1587,106.7,3239,1668,1571,106.2
33004, 읍부,005005, 4세,2018,3300,1686,1614,104.5,3270,1671,1599,104.5
33004, 읍부,010,5~9세,2018,16637,8555,8082,105.9,16524,8502,8022,106
33004, 읍부,010001, 5세,2018,3255,1650,1605,102.8,3227,1637,1590,103
33004, 읍부,010002, 6세,2018,3526,1774,1752,101.3,3504,1766,1738,101.6
33004, 읍부,010003, 7세,2018,3475,1784,1691,105.5,3450,1772,1678,105.6
33004, 읍부,010004, 8세,2018,3288,1726,1562,110.5,3271,1717,1554,110.5
33004, 읍부,010005, 9세,2018,3093,1621,1472,110.1,3072,1610,1462,110.1
33004, 읍부,015,10~14세,2018,15131,7864,7267,108.2,15068,7826,7242,108.1
33004, 읍부,015001, 10세,2018,3236,1661,1575,105.5,3221,1651,1570,105.2
33004, 읍부,015002, 11세,2018,3245,1649,1596,103.3,3231,1644,1587,103.6
33004, 읍부,015003, 12세,2018,2868,1503,1365,110.1,2853,1493,1360,109.8
33004, 읍부,015004, 13세,2018,2813,1505,1308,115.1,2804,1499,1305,114.9
33004, 읍부,015005, 14세,2018,2969,1546,1423,108.6,2959,1539,1420,108.4
33004, 읍부,020,15~19세,2018,18075,9503,8572,110.9,17926,9413,8513,110.6
33004, 읍부,020001, 15세,2018,2966,1519,1447,105,2958,1513,1445,104.7
33004, 읍부,020002, 16세,2018,3219,1647,1572,104.8,3202,1639,1563,104.9
33004, 읍부,020003, 17세,2018,3758,1943,1815,107.1,3731,1926,1805,106.7
33004, 읍부,020004, 18세,2018,4045,2065,1980,104.3,4014,2046,1968,104
33004, 읍부,020005, 19세,2018,4087,2329,1758,132.5,4021,2289,1732,132.2
33004, 읍부,025,20~24세,2018,20934,11950,8984,133,19698,11146,8552,130.3
33004, 읍부,025001, 20세,2018,4183,2271,1912,118.8,4059,2188,1871,116.9
33004, 읍부,025002, 21세,2018,4302,2242,2060,108.8,4128,2142,1986,107.9
33004, 읍부,025003, 22세,2018,4295,2460,1835,134.1,4028,2273,1755,129.5
33004, 읍부,025004, 23세,2018,4084,2473,1611,153.5,3780,2279,1501,151.8
33004, 읍부,025005, 24세,2018,4070,2504,1566,159.9,3703,2264,1439,157.3
33004, 읍부,030,25~29세,2018,20167,11830,8337,141.9,18064,10418,7646,136.3
33004, 읍부,030001, 25세,2018,4075,2407,1668,144.3,3708,2149,1559,137.8
33004, 읍부,030002, 26세,2018,4167,2461,1706,144.3,3736,2169,1567,138.4
33004, 읍부,030003, 27세,2018,4017,2416,1601,150.9,3574,2111,1463,144.3
33004, 읍부,030004, 28세,2018,3975,2283,1692,134.9,3560,2018,1542,130.9
33004, 읍부,030005, 29세,2018,3933,2263,1670,135.5,3486,1971,1515,130.1
33004, 읍부,035,30~34세,2018,22151,12069,10082,119.7,20113,10713,9400,114
33004, 읍부,035001, 30세,2018,4012,2145,1867,114.9,3594,1883,1711,110.1
33004, 읍부,035002, 31세,2018,4321,2356,1965,119.9,3852,2041,1811,112.7
33004, 읍부,035003, 32세,2018,4412,2451,1961,125,4004,2170,1834,118.3
33004, 읍부,035004, 33세,2018,4553,2456,2097,117.1,4163,2196,1967,111.6
33004, 읍부,035005, 34세,2018,4853,2661,2192,121.4,4500,2423,2077,116.7
33004, 읍부,040,35~39세,2018,26907,14388,12519,114.9,25364,13361,12003,111.3
33004, 읍부,040001, 35세,2018,5161,2774,2387,116.2,4819,2539,2280,111.4
33004, 읍부,040002, 36세,2018,5631,2973,2658,111.9,5281,2741,2540,107.9
33004, 읍부,040003, 37세,2018,5277,2851,2426,117.5,4987,2653,2334,113.7
33004, 읍부,040004, 38세,2018,5561,2937,2624,111.9,5295,2765,2530,109.3
33004, 읍부,040005, 39세,2018,5277,2853,2424,117.7,4982,2663,2319,114.8
33004, 읍부,045,40~44세,2018,24539,13124,11415,115,23478,12471,11007,113.3
33004, 읍부,045001, 40세,2018,4867,2598,2269,114.5,4614,2439,2175,112.1
33004, 읍부,045002, 41세,2018,4747,2540,2207,115.1,4509,2384,2125,112.2
33004, 읍부,045003, 42세,2018,4757,2549,2208,115.4,4551,2422,2129,113.8
33004, 읍부,045004, 43세,2018,4908,2610,2298,113.6,4716,2495,2221,112.3
33004, 읍부,045005, 44세,2018,5260,2827,2433,116.2,5088,2731,2357,115.9
33004, 읍부,050,45~49세,2018,26170,14167,12003,118,25111,13552,11559,117.2
33004, 읍부,050001, 45세,2018,5369,2873,2496,115.1,5168,2763,2405,114.9
33004, 읍부,050002, 46세,2018,4840,2614,2226,117.4,4638,2485,2153,115.4
33004, 읍부,050003, 47세,2018,5332,2866,2466,116.2,5118,2737,2381,115
33004, 읍부,050004, 48세,2018,5065,2820,2245,125.6,4838,2700,2138,126.3
33004, 읍부,050005, 49세,2018,5564,2994,2570,116.5,5349,2867,2482,115.5
33004, 읍부,055,50~54세,2018,23802,12680,11122,114,22848,12159,10689,113.8
33004, 읍부,055001, 50세,2018,5258,2813,2445,115.1,5053,2695,2358,114.3
33004, 읍부,055002, 51세,2018,4717,2518,2199,114.5,4557,2439,2118,115.2
33004, 읍부,055003, 52세,2018,4730,2518,2212,113.8,4531,2417,2114,114.3
33004, 읍부,055004, 53세,2018,4864,2545,2319,109.7,4658,2430,2228,109.1
33004, 읍부,055005, 54세,2018,4233,2286,1947,117.4,4049,2178,1871,116.4
33004, 읍부,060,55~59세,2018,24862,12825,12037,106.5,24090,12418,11672,106.4
33004, 읍부,060001, 55세,2018,4456,2365,2091,113.1,4233,2224,2009,110.7
33004, 읍부,060002, 56세,2018,5136,2770,2366,117.1,4952,2671,2281,117.1
33004, 읍부,060003, 57세,2018,5587,2839,2748,103.3,5490,2795,2695,103.7
33004, 읍부,060004, 58세,2018,5000,2495,2505,99.6,4853,2422,2431,99.6
33004, 읍부,060005, 59세,2018,4683,2356,2327,101.2,4562,2306,2256,102.2
33004, 읍부,065,60~64세,2018,21002,10533,10469,100.6,20459,10192,10267,99.3
33004, 읍부,065001, 60세,2018,4520,2321,2199,105.5,4396,2240,2156,103.9
33004, 읍부,065002, 61세,2018,4605,2357,2248,104.8,4470,2271,2199,103.3
33004, 읍부,065003, 62세,2018,4142,2086,2056,101.5,4059,2037,2022,100.7
33004, 읍부,065004, 63세,2018,4127,2023,2104,96.2,4009,1952,2057,94.9
33004, 읍부,065005, 64세,2018,3608,1746,1862,93.8,3525,1692,1833,92.3
33004, 읍부,070,65~69세,2018,14181,6933,7248,95.7,13935,6799,7136,95.3
33004, 읍부,070001, 65세,2018,3100,1545,1555,99.4,3036,1508,1528,98.7
33004, 읍부,070002, 66세,2018,3476,1727,1749,98.7,3409,1692,1717,98.5
33004, 읍부,070003, 67세,2018,2347,1110,1237,89.7,2304,1086,1218,89.2
33004, 읍부,070004, 68세,2018,2572,1217,1355,89.8,2539,1201,1338,89.8
33004, 읍부,070005, 69세,2018,2686,1334,1352,98.7,2647,1312,1335,98.3
33004, 읍부,075,70~74세,2018,11070,5035,6035,83.4,10992,5004,5988,83.6
33004, 읍부,075001, 70세,2018,2513,1174,1339,87.7,2495,1168,1327,88
33004, 읍부,075002, 71세,2018,2497,1165,1332,87.5,2472,1155,1317,87.7
33004, 읍부,075003, 72세,2018,1968,903,1065,84.8,1954,896,1058,84.7
33004, 읍부,075004, 73세,2018,2013,932,1081,86.2,2001,927,1074,86.3
33004, 읍부,075005, 74세,2018,2079,861,1218,70.7,2070,858,1212,70.8
33004, 읍부,080,75~79세,2018,10957,4563,6394,71.4,10924,4552,6372,71.4
33004, 읍부,080001, 75세,2018,2297,965,1332,72.4,2290,963,1327,72.6
33004, 읍부,080002, 76세,2018,2634,1118,1516,73.7,2632,1116,1516,73.6
33004, 읍부,080003, 77세,2018,2118,891,1227,72.6,2105,885,1220,72.5
33004, 읍부,080004, 78세,2018,1932,801,1131,70.8,1926,800,1126,71
33004, 읍부,080005, 79세,2018,1976,788,1188,66.3,1971,788,1183,66.6
33004, 읍부,085,80~84세,2018,7573,2651,4922,53.9,7556,2646,4910,53.9
33004, 읍부,085001, 80세,2018,1816,685,1131,60.6,1814,685,1129,60.7
33004, 읍부,085002, 81세,2018,1602,593,1009,58.8,1597,591,1006,58.7
33004, 읍부,085003, 82세,2018,1505,502,1003,50,1501,502,999,50.3
33004, 읍부,085004, 83세,2018,1462,471,991,47.5,1458,469,989,47.4
33004, 읍부,085005, 84세,2018,1188,400,788,50.8,1186,399,787,50.7
33004, 읍부,090,85~89세,2018,3564,944,2620,36,3554,942,2612,36.1
33004, 읍부,090001, 85세,2018,993,286,707,40.5,992,286,706,40.5
33004, 읍부,090002, 86세,2018,867,229,638,35.9,866,228,638,35.7
33004, 읍부,090003, 87세,2018,639,166,473,35.1,638,166,472,35.2
33004, 읍부,090004, 88세,2018,579,143,436,32.8,575,143,432,33.1
33004, 읍부,090005, 89세,2018,486,120,366,32.8,483,119,364,32.7
33004, 읍부,095,90~94세,2018,1115,249,866,28.8,1114,249,865,28.8
33004, 읍부,095001, 90세,2018,365,73,292,25,365,73,292,25
33004, 읍부,095002, 91세,2018,266,66,200,33,266,66,200,33
33004, 읍부,095003, 92세,2018,198,39,159,24.5,197,39,158,24.7
33004, 읍부,095004, 93세,2018,164,41,123,33.3,164,41,123,33.3
33004, 읍부,095005, 94세,2018,122,30,92,32.6,122,30,92,32.6
33004, 읍부,100,95~99세,2018,269,39,230,17,268,38,230,16.5
33004, 읍부,100001, 95세,2018,118,16,102,15.7,117,15,102,14.7
33004, 읍부,100002, 96세,2018,67,11,56,19.6,67,11,56,19.6
33004, 읍부,100003, 97세,2018,42,6,36,16.7,42,6,36,16.7
33004, 읍부,100004, 98세,2018,21,X,18,16.7,21,X,18,16.7
33004, 읍부,100005, 99세,2018,21,X,18,16.7,21,X,18,16.7
33004, 읍부,101,100세이상,2018,28,X,26,7.7,28,X,26,7.7
33004, 읍부,102,15세미만,2018,47330,24343,22987,105.9,46953,24137,22816,105.8
33004, 읍부,103,15~64세,2018,228609,123069,105540,116.6,217151,115843,101308,114.3
33004, 읍부,104,65세이상,2018,48757,20416,28341,72,48371,20232,28139,71.9
33004, 읍부,086,85세이상,2018,4976,1234,3742,33,4964,1231,3733,33
33004, 읍부,126,평균연령,2018,41.2,39.8,42.7,,41.3,39.9,42.8,
33004, 읍부,127,중위연령,2018,41.4,39.9,43.1,,41.8,40.4,43.3,
33005, 면부,000,합계,2018,356704,187712,168992,111.1,333723,171400,162323,105.6
33005, 면부,005,0~4세,2018,9825,4983,4842,102.9,9662,4898,4764,102.8
33005, 면부,005001, 0세,2018,1831,964,867,111.2,1800,946,854,110.8
33005, 면부,005002, 1세,2018,1888,953,935,101.9,1853,936,917,102.1
33005, 면부,005003, 2세,2018,2043,1072,971,110.4,1999,1051,948,110.9
33005, 면부,005004, 3세,2018,2053,1025,1028,99.7,2029,1012,1017,99.5
33005, 면부,005005, 4세,2018,2010,969,1041,93.1,1981,953,1028,92.7
33005, 면부,010,5~9세,2018,10329,5321,5008,106.3,10221,5275,4946,106.7
33005, 면부,010001, 5세,2018,2017,1023,994,102.9,1993,1014,979,103.6
33005, 면부,010002, 6세,2018,2175,1122,1053,106.6,2146,1110,1036,107.1
33005, 면부,010003, 7세,2018,2169,1114,1055,105.6,2148,1108,1040,106.5
33005, 면부,010004, 8세,2018,1993,1028,965,106.5,1980,1021,959,106.5
33005, 면부,010005, 9세,2018,1975,1034,941,109.9,1954,1022,932,109.7
33005, 면부,015,10~14세,2018,9885,5233,4652,112.5,9814,5197,4617,112.6
33005, 면부,015001, 10세,2018,2075,1104,971,113.7,2051,1090,961,113.4
33005, 면부,015002, 11세,2018,2100,1097,1003,109.4,2085,1091,994,109.8
33005, 면부,015003, 12세,2018,1817,929,888,104.6,1806,922,884,104.3
33005, 면부,015004, 13세,2018,1847,982,865,113.5,1836,977,859,113.7
33005, 면부,015005, 14세,2018,2046,1121,925,121.2,2036,1117,919,121.5
33005, 면부,020,15~19세,2018,14019,7635,6384,119.6,13836,7515,6321,118.9
33005, 면부,020001, 15세,2018,2098,1164,934,124.6,2089,1159,930,124.6
33005, 면부,020002, 16세,2018,2262,1169,1093,107,2251,1163,1088,106.9
33005, 면부,020003, 17세,2018,2520,1351,1169,115.6,2500,1338,1162,115.1
33005, 면부,020004, 18세,2018,3109,1706,1403,121.6,3064,1672,1392,120.1
33005, 면부,020005, 19세,2018,4030,2245,1785,125.8,3932,2183,1749,124.8
33005, 면부,025,20~24세,2018,20347,12107,8240,146.9,17669,10066,7603,132.4
33005, 면부,025001, 20세,2018,3942,2066,1876,110.1,3707,1900,1807,105.1
33005, 면부,025002, 21세,2018,3993,2208,1785,123.7,3592,1914,1678,114.1
33005, 면부,025003, 22세,2018,4142,2505,1637,153,3607,2099,1508,139.2
33005, 면부,025004, 23세,2018,4107,2592,1515,171.1,3441,2075,1366,151.9
33005, 면부,025005, 24세,2018,4163,2736,1427,191.7,3322,2078,1244,167
33005, 면부,030,25~29세,2018,19809,12470,7339,169.9,14971,8854,6117,144.7
33005, 면부,030001, 25세,2018,4152,2666,1486,179.4,3233,1986,1247,159.3
33005, 면부,030002, 26세,2018,3993,2533,1460,173.5,3081,1842,1239,148.7
33005, 면부,030003, 27세,2018,3840,2405,1435,167.6,2872,1676,1196,140.1
33005, 면부,030004, 28세,2018,3987,2485,1502,165.4,2939,1718,1221,140.7
33005, 면부,030005, 29세,2018,3837,2381,1456,163.5,2846,1632,1214,134.4
33005, 면부,035,30~34세,2018,19023,11733,7290,160.9,14610,8400,6210,135.3
33005, 면부,035001, 30세,2018,3857,2387,1470,162.4,2874,1660,1214,136.7
33005, 면부,035002, 31세,2018,3794,2297,1497,153.4,2851,1594,1257,126.8
33005, 면부,035003, 32세,2018,3804,2357,1447,162.9,2915,1683,1232,136.6
33005, 면부,035004, 33세,2018,3730,2335,1395,167.4,2909,1697,1212,140
33005, 면부,035005, 34세,2018,3838,2357,1481,159.1,3061,1766,1295,136.4
33005, 면부,040,35~39세,2018,21064,12383,8681,142.6,17787,9945,7842,126.8
33005, 면부,040001, 35세,2018,4215,2487,1728,143.9,3459,1913,1546,123.7
33005, 면부,040002, 36세,2018,4363,2565,1798,142.7,3632,2031,1601,126.9
33005, 면부,040003, 37세,2018,4248,2515,1733,145.1,3599,2031,1568,129.5
33005, 면부,040004, 38세,2018,4238,2452,1786,137.3,3638,2005,1633,122.8
33005, 면부,040005, 39세,2018,4000,2364,1636,144.5,3459,1965,1494,131.5
33005, 면부,045,40~44세,2018,19366,11459,7907,144.9,17343,10046,7297,137.7
33005, 면부,045001, 40세,2018,3598,2106,1492,141.2,3139,1768,1371,129
33005, 면부,045002, 41세,2018,3851,2280,1571,145.1,3395,1950,1445,134.9
33005, 면부,045003, 42세,2018,3810,2302,1508,152.7,3395,2016,1379,146.2
33005, 면부,045004, 43세,2018,3934,2318,1616,143.4,3571,2075,1496,138.7
33005, 면부,045005, 44세,2018,4173,2453,1720,142.6,3843,2237,1606,139.3
33005, 면부,050,45~49세,2018,23125,13185,9940,132.6,21414,12101,9313,129.9
33005, 면부,050001, 45세,2018,4291,2493,1798,138.7,3930,2255,1675,134.6
33005, 면부,050002, 46세,2018,4109,2376,1733,137.1,3756,2163,1593,135.8
33005, 면부,050003, 47세,2018,4740,2734,2006,136.3,4392,2511,1881,133.5
33005, 면부,050004, 48세,2018,4697,2684,2013,133.3,4353,2468,1885,130.9
33005, 면부,050005, 49세,2018,5288,2898,2390,121.3,4983,2704,2279,118.6
33005, 면부,055,50~54세,2018,28309,15234,13075,116.5,26857,14343,12514,114.6
33005, 면부,055001, 50세,2018,5533,2967,2566,115.6,5204,2762,2442,113.1
33005, 면부,055002, 51세,2018,5415,2890,2525,114.5,5139,2727,2412,113.1
33005, 면부,055003, 52세,2018,5755,3215,2540,126.6,5479,3044,2435,125
33005, 면부,055004, 53세,2018,6054,3244,2810,115.4,5764,3064,2700,113.5
33005, 면부,055005, 54세,2018,5552,2918,2634,110.8,5271,2746,2525,108.8
33005, 면부,060,55~59세,2018,35577,18822,16755,112.3,34541,18210,16331,111.5
33005, 면부,060001, 55세,2018,5983,3272,2711,120.7,5672,3085,2587,119.3
33005, 면부,060002, 56세,2018,6902,3654,3248,112.5,6688,3527,3161,111.6
33005, 면부,060003, 57세,2018,8154,4320,3834,112.7,7982,4230,3752,112.7
33005, 면부,060004, 58세,2018,7412,3799,3613,105.1,7219,3680,3539,104
33005, 면부,060005, 59세,2018,7126,3777,3349,112.8,6980,3688,3292,112
33005, 면부,065,60~64세,2018,34368,17909,16459,108.8,33730,17502,16228,107.9
33005, 면부,065001, 60세,2018,7259,3844,3415,112.6,7108,3748,3360,111.5
33005, 면부,065002, 61세,2018,7309,3839,3470,110.6,7140,3732,3408,109.5
33005, 면부,065003, 62세,2018,6939,3659,3280,111.6,6816,3574,3242,110.2
33005, 면부,065004, 63세,2018,6615,3358,3257,103.1,6523,3301,3222,102.5
33005, 면부,065005, 64세,2018,6246,3209,3037,105.7,6143,3147,2996,105
33005, 면부,070,65~69세,2018,23961,12252,11709,104.6,23720,12119,11601,104.5
33005, 면부,070001, 65세,2018,5170,2705,2465,109.7,5094,2659,2435,109.2
33005, 면부,070002, 66세,2018,5993,3091,2902,106.5,5939,3063,2876,106.5
33005, 면부,070003, 67세,2018,4041,2003,2038,98.3,4006,1987,2019,98.4
33005, 면부,070004, 68세,2018,4191,2132,2059,103.5,4153,2111,2042,103.4
33005, 면부,070005, 69세,2018,4566,2321,2245,103.4,4528,2299,2229,103.1
33005, 면부,075,70~74세,2018,19571,9395,10176,92.3,19483,9357,10126,92.4
33005, 면부,075001, 70세,2018,4384,2245,2139,105,4359,2235,2124,105.2
33005, 면부,075002, 71세,2018,4253,2148,2105,102,4232,2135,2097,101.8
33005, 면부,075003, 72세,2018,3405,1677,1728,97,3389,1670,1719,97.1
33005, 면부,075004, 73세,2018,3734,1732,2002,86.5,3720,1726,1994,86.6
33005, 면부,075005, 74세,2018,3795,1593,2202,72.3,3783,1591,2192,72.6
33005, 면부,080,75~79세,2018,21561,8977,12584,71.3,21526,8963,12563,71.3
33005, 면부,080001, 75세,2018,4082,1752,2330,75.2,4071,1744,2327,74.9
33005, 면부,080002, 76세,2018,5131,2213,2918,75.8,5126,2213,2913,76
33005, 면부,080003, 77세,2018,4253,1778,2475,71.8,4244,1775,2469,71.9
33005, 면부,080004, 78세,2018,3917,1584,2333,67.9,3912,1583,2329,68
33005, 면부,080005, 79세,2018,4178,1650,2528,65.3,4173,1648,2525,65.3
33005, 면부,085,80~84세,2018,16097,5755,10342,55.6,16078,5752,10326,55.7
33005, 면부,085001, 80세,2018,3675,1432,2243,63.8,3667,1431,2236,64
33005, 면부,085002, 81세,2018,3447,1285,2162,59.4,3442,1283,2159,59.4
33005, 면부,085003, 82세,2018,3265,1183,2082,56.8,3262,1183,2079,56.9
33005, 면부,085004, 83세,2018,3134,1036,2098,49.4,3133,1036,2097,49.4
33005, 면부,085005, 84세,2018,2576,819,1757,46.6,2574,819,1755,46.7
33005, 면부,090,85~89세,2018,7401,2097,5304,39.5,7396,2095,5301,39.5
33005, 면부,090001, 85세,2018,2207,676,1531,44.2,2205,675,1530,44.1
33005, 면부,090002, 86세,2018,1738,539,1199,45,1737,539,1198,45
33005, 면부,090003, 87세,2018,1245,309,936,33,1245,309,936,33
33005, 면부,090004, 88세,2018,1215,311,904,34.4,1214,310,904,34.3
33005, 면부,090005, 89세,2018,996,262,734,35.7,995,262,733,35.7
33005, 면부,095,90~94세,2018,2435,634,1801,35.2,2433,634,1799,35.2
33005, 면부,095001, 90세,2018,835,213,622,34.2,834,213,621,34.3
33005, 면부,095002, 91세,2018,656,171,485,35.3,655,171,484,35.3
33005, 면부,095003, 92세,2018,378,102,276,37,378,102,276,37
33005, 면부,095004, 93세,2018,356,80,276,29,356,80,276,29
33005, 면부,095005, 94세,2018,210,68,142,47.9,210,68,142,47.9
33005, 면부,100,95~99세,2018,561,120,441,27.2,561,120,441,27.2
33005, 면부,100001, 95세,2018,201,41,160,25.6,201,41,160,25.6
33005, 면부,100002, 96세,2018,149,38,111,34.2,149,38,111,34.2
33005, 면부,100003, 97세,2018,106,23,83,27.7,106,23,83,27.7
33005, 면부,100004, 98세,2018,61,10,51,19.6,61,10,51,19.6
33005, 면부,100005, 99세,2018,44,8,36,22.2,44,8,36,22.2
33005, 면부,101,100세이상,2018,71,8,63,12.7,71,8,63,12.7
33005, 면부,102,15세미만,2018,30039,15537,14502,107.1,29697,15370,14327,107.3
33005, 면부,103,15~64세,2018,235007,132937,102070,130.2,212758,116982,95776,122.1
33005, 면부,104,65세이상,2018,91658,39238,52420,74.9,91268,39048,52220,74.8
33005, 면부,086,85세이상,2018,10468,2859,7609,37.6,10461,2857,7604,37.6
33005, 면부,126,평균연령,2018,48.9,46.7,51.4,,49.8,47.7,52,
33005, 면부,127,중위연령,2018,52.1,49.1,55.4,,53.6,51.2,56.3,
33003, 동부,000,합계,2018,939535,470643,468892,100.4,919902,460292,459610,100.1
33003, 동부,005,0~4세,2018,36719,18753,17966,104.4,36331,18554,17777,104.4
33003, 동부,005001, 0세,2018,6236,3179,3057,104,6155,3130,3025,103.5
33003, 동부,005002, 1세,2018,6740,3519,3221,109.3,6652,3475,3177,109.4
33003, 동부,005003, 2세,2018,7650,3897,3753,103.8,7565,3859,3706,104.1
33003, 동부,005004, 3세,2018,7986,4079,3907,104.4,7917,4047,3870,104.6
33003, 동부,005005, 4세,2018,8107,4079,4028,101.3,8042,4043,3999,101.1
33003, 동부,010,5~9세,2018,44317,22670,21647,104.7,44051,22536,21515,104.7
33003, 동부,010001, 5세,2018,8328,4230,4098,103.2,8268,4204,4064,103.4
33003, 동부,010002, 6세,2018,9164,4681,4483,104.4,9101,4647,4454,104.3
33003, 동부,010003, 7세,2018,9237,4694,4543,103.3,9183,4667,4516,103.3
33003, 동부,010004, 8세,2018,9006,4603,4403,104.5,8956,4576,4380,104.5
33003, 동부,010005, 9세,2018,8582,4462,4120,108.3,8543,4442,4101,108.3
33003, 동부,015,10~14세,2018,45986,23769,22217,107,45796,23671,22125,107
33003, 동부,015001, 10세,2018,9122,4744,4378,108.4,9089,4729,4360,108.5
33003, 동부,015002, 11세,2018,9538,4926,4612,106.8,9491,4902,4589,106.8
33003, 동부,015003, 12세,2018,8820,4516,4304,104.9,8785,4495,4290,104.8
33003, 동부,015004, 13세,2018,8793,4494,4299,104.5,8758,4475,4283,104.5
33003, 동부,015005, 14세,2018,9713,5089,4624,110.1,9673,5070,4603,110.1
33003, 동부,020,15~19세,2018,59706,31372,28334,110.7,58900,30977,27923,110.9
33003, 동부,020001, 15세,2018,9903,5195,4708,110.3,9868,5174,4694,110.2
33003, 동부,020002, 16세,2018,10199,5392,4807,112.2,10167,5375,4792,112.2
33003, 동부,020003, 17세,2018,11802,6151,5651,108.8,11747,6125,5622,108.9
33003, 동부,020004, 18세,2018,13333,7013,6320,111,13167,6939,6228,111.4
33003, 동부,020005, 19세,2018,14469,7621,6848,111.3,13951,7364,6587,111.8
33003, 동부,025,20~24세,2018,76378,41108,35270,116.6,73053,39288,33765,116.4
33003, 동부,025001, 20세,2018,14771,7529,7242,104,14185,7208,6977,103.3
33003, 동부,025002, 21세,2018,15082,7677,7405,103.7,14449,7344,7105,103.4
33003, 동부,025003, 22세,2018,15852,8529,7323,116.5,15132,8139,6993,116.4
33003, 동부,025004, 23세,2018,15531,8652,6879,125.8,14794,8230,6564,125.4
33003, 동부,025005, 24세,2018,15142,8721,6421,135.8,14493,8367,6126,136.6
33003, 동부,030,25~29세,2018,63529,35058,28471,123.1,60630,33537,27093,123.8
33003, 동부,030001, 25세,2018,14364,8070,6294,128.2,13771,7766,6005,129.3
33003, 동부,030002, 26세,2018,13771,7788,5983,130.2,13196,7475,5721,130.7
33003, 동부,030003, 27세,2018,12508,6792,5716,118.8,11949,6514,5435,119.9
33003, 동부,030004, 28세,2018,11755,6428,5327,120.7,11141,6101,5040,121.1
33003, 동부,030005, 29세,2018,11131,5980,5151,116.1,10573,5681,4892,116.1
33003, 동부,035,30~34세,2018,56594,29619,26975,109.8,53930,28192,25738,109.5
33003, 동부,035001, 30세,2018,10951,5819,5132,113.4,10391,5502,4889,112.5
33003, 동부,035002, 31세,2018,11074,5795,5279,109.8,10440,5448,4992,109.1
33003, 동부,035003, 32세,2018,11313,6016,5297,113.6,10779,5726,5053,113.3
33003, 동부,035004, 33세,2018,11231,5769,5462,105.6,10727,5519,5208,106
33003, 동부,035005, 34세,2018,12025,6220,5805,107.1,11593,5997,5596,107.2
33003, 동부,040,35~39세,2018,69879,35431,34448,102.9,67832,34248,33584,102
33003, 동부,040001, 35세,2018,12940,6543,6397,102.3,12444,6255,6189,101.1
33003, 동부,040002, 36세,2018,14607,7394,7213,102.5,14167,7159,7008,102.2
33003, 동부,040003, 37세,2018,13887,7143,6744,105.9,13481,6906,6575,105
33003, 동부,040004, 38세,2018,14463,7284,7179,101.5,14116,7076,7040,100.5
33003, 동부,040005, 39세,2018,13982,7067,6915,102.2,13624,6852,6772,101.2
33003, 동부,045,40~44세,2018,71588,35463,36125,98.2,70038,34633,35405,97.8
33003, 동부,045001, 40세,2018,13075,6563,6512,100.8,12705,6368,6337,100.5
33003, 동부,045002, 41세,2018,13800,6872,6928,99.2,13463,6679,6784,98.5
33003, 동부,045003, 42세,2018,13752,6827,6925,98.6,13454,6667,6787,98.2
33003, 동부,045004, 43세,2018,14657,7090,7567,93.7,14376,6948,7428,93.5
33003, 동부,045005, 44세,2018,16304,8111,8193,99,16040,7971,8069,98.8
33003, 동부,050,45~49세,2018,84015,41620,42395,98.2,82384,40739,41645,97.8
33003, 동부,050001, 45세,2018,16363,8001,8362,95.7,16045,7838,8207,95.5
33003, 동부,050002, 46세,2018,15684,7882,7802,101,15366,7724,7642,101.1
33003, 동부,050003, 47세,2018,17197,8622,8575,100.5,16842,8425,8417,100.1
33003, 동부,050004, 48세,2018,16683,8271,8412,98.3,16351,8065,8286,97.3
33003, 동부,050005, 49세,2018,18088,8844,9244,95.7,17780,8687,9093,95.5
33003, 동부,055,50~54세,2018,78662,39120,39542,98.9,77300,38431,38869,98.9
33003, 동부,055001, 50세,2018,17650,8513,9137,93.2,17325,8336,8989,92.7
33003, 동부,055002, 51세,2018,16030,8022,8008,100.2,15792,7892,7900,99.9
33003, 동부,055003, 52세,2018,15571,7822,7749,100.9,15306,7704,7602,101.3
33003, 동부,055004, 53세,2018,15758,7864,7894,99.6,15489,7718,7771,99.3
33003, 동부,055005, 54세,2018,13653,6899,6754,102.1,13388,6781,6607,102.6
33003, 동부,060,55~59세,2018,77086,38467,38619,99.6,75935,37913,38022,99.7
33003, 동부,060001, 55세,2018,14484,7377,7107,103.8,14166,7220,6946,103.9
33003, 동부,060002, 56세,2018,15750,7998,7752,103.2,15525,7892,7633,103.4
33003, 동부,060003, 57세,2018,17460,8722,8738,99.8,17270,8625,8645,99.8
33003, 동부,060004, 58세,2018,15322,7540,7782,96.9,15097,7431,7666,96.9
33003, 동부,060005, 59세,2018,14070,6830,7240,94.3,13877,6745,7132,94.6
33003, 동부,065,60~64세,2018,59783,29681,30102,98.6,59020,29296,29724,98.6
33003, 동부,065001, 60세,2018,13741,6948,6793,102.3,13535,6854,6681,102.6
33003, 동부,065002, 61세,2018,13174,6542,6632,98.6,13001,6463,6538,98.9
33003, 동부,065003, 62세,2018,11852,5925,5927,100,11702,5841,5861,99.7
33003, 동부,065004, 63세,2018,11277,5464,5813,94,11163,5397,5766,93.6
33003, 동부,065005, 64세,2018,9739,4802,4937,97.3,9619,4741,4878,97.2
33003, 동부,070,65~69세,2018,36924,17622,19302,91.3,36577,17463,19114,91.4
33003, 동부,070001, 65세,2018,8508,4102,4406,93.1,8414,4053,4361,92.9
33003, 동부,070002, 66세,2018,9534,4572,4962,92.1,9464,4537,4927,92.1
33003, 동부,070003, 67세,2018,6075,2861,3214,89,6004,2835,3169,89.5
33003, 동부,070004, 68세,2018,6350,2988,3362,88.9,6301,2970,3331,89.2
33003, 동부,070005, 69세,2018,6457,3099,3358,92.3,6394,3068,3326,92.2
33003, 동부,075,70~74세,2018,28145,12765,15380,83,28020,12718,15302,83.1
33003, 동부,075001, 70세,2018,6591,3128,3463,90.3,6556,3115,3441,90.5
33003, 동부,075002, 71세,2018,6443,2887,3556,81.2,6413,2876,3537,81.3
33003, 동부,075003, 72세,2018,4749,2174,2575,84.4,4723,2165,2558,84.6
33003, 동부,075004, 73세,2018,5155,2319,2836,81.8,5134,2310,2824,81.8
33003, 동부,075005, 74세,2018,5207,2257,2950,76.5,5194,2252,2942,76.5
33003, 동부,080,75~79세,2018,24740,10153,14587,69.6,24677,10136,14541,69.7
33003, 동부,080001, 75세,2018,5229,2240,2989,74.9,5213,2234,2979,75
33003, 동부,080002, 76세,2018,6099,2579,3520,73.3,6085,2576,3509,73.4
33003, 동부,080003, 77세,2018,4812,1925,2887,66.7,4803,1924,2879,66.8
33003, 동부,080004, 78세,2018,4262,1683,2579,65.3,4252,1680,2572,65.3
33003, 동부,080005, 79세,2018,4338,1726,2612,66.1,4324,1722,2602,66.2
33003, 동부,085,80~84세,2018,15759,5602,10157,55.2,15719,5593,10126,55.2
33003, 동부,085001, 80세,2018,3764,1401,2363,59.3,3758,1401,2357,59.4
33003, 동부,085002, 81세,2018,3499,1286,2213,58.1,3493,1283,2210,58.1
33003, 동부,085003, 82세,2018,3286,1171,2115,55.4,3271,1170,2101,55.7
33003, 동부,085004, 83세,2018,2893,996,1897,52.5,2885,994,1891,52.6
33003, 동부,085005, 84세,2018,2317,748,1569,47.7,2312,745,1567,47.5
33003, 동부,090,85~89세,2018,6924,1818,5106,35.6,6911,1816,5095,35.6
33003, 동부,090001, 85세,2018,2003,602,1401,43,2000,602,1398,43.1
33003, 동부,090002, 86세,2018,1616,430,1186,36.3,1613,429,1184,36.2
33003, 동부,090003, 87세,2018,1154,305,849,35.9,1152,305,847,36
33003, 동부,090004, 88세,2018,1191,269,922,29.2,1188,268,920,29.1
33003, 동부,090005, 89세,2018,960,212,748,28.3,958,212,746,28.4
33003, 동부,095,90~94세,2018,2209,438,1771,24.7,2206,437,1769,24.7
33003, 동부,095001, 90세,2018,681,143,538,26.6,680,143,537,26.6
33003, 동부,095002, 91세,2018,602,126,476,26.5,601,126,475,26.5
33003, 동부,095003, 92세,2018,366,63,303,20.8,366,63,303,20.8
33003, 동부,095004, 93세,2018,365,74,291,25.4,365,74,291,25.4
33003, 동부,095005, 94세,2018,195,32,163,19.6,194,31,163,19
33003, 동부,100,95~99세,2018,531,108,423,25.5,531,108,423,25.5
33003, 동부,100001, 95세,2018,193,44,149,29.5,193,44,149,29.5
33003, 동부,100002, 96세,2018,154,33,121,27.3,154,33,121,27.3
33003, 동부,100003, 97세,2018,99,18,81,22.2,99,18,81,22.2
33003, 동부,100004, 98세,2018,52,7,45,15.6,52,7,45,15.6
33003, 동부,100005, 99세,2018,33,6,27,22.2,33,6,27,22.2
33003, 동부,101,100세이상,2018,61,6,55,10.9,61,6,55,10.9
33003, 동부,102,15세미만,2018,127022,65192,61830,105.4,126178,64761,61417,105.4
33003, 동부,103,15~64세,2018,697220,356939,340281,104.9,679022,347254,331768,104.7
33003, 동부,104,65세이상,2018,115293,48512,66781,72.6,114702,48277,66425,72.7
33003, 동부,086,85세이상,2018,9725,2370,7355,32.2,9709,2367,7342,32.2
33003, 동부,126,평균연령,2018,40.3,39.1,41.6,,40.4,39.2,41.7,
33003, 동부,127,중위연령,2018,41.3,39.7,42.8,,41.5,39.9,43.1,
33020, 충주시,000,합계,2018,215224,109825,105399,104.2,208077,105428,102649,102.7
33020, 충주시,005,0~4세,2018,7107,3589,3518,102,7061,3564,3497,101.9
33020, 충주시,005001, 0세,2018,1177,592,585,101.2,1168,588,580,101.4
33020, 충주시,005002, 1세,2018,1324,703,621,113.2,1310,695,615,113
33020, 충주시,005003, 2세,2018,1527,775,752,103.1,1521,772,749,103.1
33020, 충주시,005004, 3세,2018,1501,752,749,100.4,1492,747,745,100.3
33020, 충주시,005005, 4세,2018,1578,767,811,94.6,1570,762,808,94.3
33020, 충주시,010,5~9세,2018,8481,4297,4184,102.7,8452,4288,4164,103
33020, 충주시,010001, 5세,2018,1570,812,758,107.1,1562,809,753,107.4
33020, 충주시,010002, 6세,2018,1709,839,870,96.4,1703,837,866,96.7
33020, 충주시,010003, 7세,2018,1840,968,872,111,1835,967,868,111.4
33020, 충주시,010004, 8세,2018,1728,842,886,95,1724,840,884,95
33020, 충주시,010005, 9세,2018,1634,836,798,104.8,1628,835,793,105.3
33020, 충주시,015,10~14세,2018,8971,4670,4301,108.6,8950,4656,4294,108.4
33020, 충주시,015001, 10세,2018,1813,970,843,115.1,1808,969,839,115.5
33020, 충주시,015002, 11세,2018,1923,987,936,105.4,1921,985,936,105.2
33020, 충주시,015003, 12세,2018,1684,871,813,107.1,1682,870,812,107.1
33020, 충주시,015004, 13세,2018,1669,874,795,109.9,1666,871,795,109.6
33020, 충주시,015005, 14세,2018,1882,968,914,105.9,1873,961,912,105.4
33020, 충주시,020,15~19세,2018,12566,6753,5813,116.2,12233,6566,5667,115.9
33020, 충주시,020001, 15세,2018,1924,1026,898,114.3,1920,1022,898,113.8
33020, 충주시,020002, 16세,2018,1985,1045,940,111.2,1980,1043,937,111.3
33020, 충주시,020003, 17세,2018,2393,1232,1161,106.1,2384,1228,1156,106.2
33020, 충주시,020004, 18세,2018,2846,1534,1312,116.9,2787,1497,1290,116
33020, 충주시,020005, 19세,2018,3418,1916,1502,127.6,3162,1776,1386,128.1
33020, 충주시,025,20~24세,2018,16698,9589,7109,134.9,15216,8668,6548,132.4
33020, 충주시,025001, 20세,2018,3271,1725,1546,111.6,3001,1569,1432,109.6
33020, 충주시,025002, 21세,2018,3305,1816,1489,122,2989,1636,1353,120.9
33020, 충주시,025003, 22세,2018,3462,1971,1491,132.2,3161,1773,1388,127.7
33020, 충주시,025004, 23세,2018,3443,2070,1373,150.8,3154,1886,1268,148.7
33020, 충주시,025005, 24세,2018,3217,2007,1210,165.9,2911,1804,1107,163
33020, 충주시,030,25~29세,2018,12844,7575,5269,143.8,11472,6712,4760,141
33020, 충주시,030001, 25세,2018,2960,1836,1124,163.3,2651,1659,992,167.2
33020, 충주시,030002, 26세,2018,2782,1677,1105,151.8,2511,1504,1007,149.4
33020, 충주시,030003, 27세,2018,2512,1440,1072,134.3,2241,1263,978,129.1
33020, 충주시,030004, 28세,2018,2367,1338,1029,130,2098,1161,937,123.9
33020, 충주시,030005, 29세,2018,2223,1284,939,136.7,1971,1125,846,133
33020, 충주시,035,30~34세,2018,11627,6466,5161,125.3,10536,5747,4789,120
33020, 충주시,035001, 30세,2018,2211,1276,935,136.5,1980,1131,849,133.2
33020, 충주시,035002, 31세,2018,2297,1290,1007,128.1,2054,1120,934,119.9
33020, 충주시,035003, 32세,2018,2343,1287,1056,121.9,2106,1137,969,117.3
33020, 충주시,035004, 33세,2018,2232,1225,1007,121.6,2029,1094,935,117
33020, 충주시,035005, 34세,2018,2544,1388,1156,120.1,2367,1265,1102,114.8
33020, 충주시,040,35~39세,2018,14083,7382,6701,110.2,13350,6901,6449,107
33020, 충주시,040001, 35세,2018,2645,1398,1247,112.1,2458,1272,1186,107.3
33020, 충주시,040002, 36세,2018,2899,1530,1369,111.8,2720,1418,1302,108.9
33020, 충주시,040003, 37세,2018,2836,1553,1283,121,2699,1459,1240,117.7
33020, 충주시,040004, 38세,2018,2866,1442,1424,101.3,2747,1358,1389,97.8
33020, 충주시,040005, 39세,2018,2837,1459,1378,105.9,2726,1394,1332,104.7
33020, 충주시,045,40~44세,2018,14609,7546,7063,106.8,14109,7228,6881,105
33020, 충주시,045001, 40세,2018,2598,1334,1264,105.5,2485,1265,1220,103.7
33020, 충주시,045002, 41세,2018,2813,1442,1371,105.2,2701,1370,1331,102.9
33020, 충주시,045003, 42세,2018,2825,1482,1343,110.3,2713,1407,1306,107.7
33020, 충주시,045004, 43세,2018,3015,1519,1496,101.5,2923,1463,1460,100.2
33020, 충주시,045005, 44세,2018,3358,1769,1589,111.3,3287,1723,1564,110.2
33020, 충주시,050,45~49세,2018,17638,9007,8631,104.4,17130,8711,8419,103.5
33020, 충주시,050001, 45세,2018,3397,1741,1656,105.1,3299,1682,1617,104
33020, 충주시,050002, 46세,2018,3256,1698,1558,109,3140,1633,1507,108.4
33020, 충주시,050003, 47세,2018,3618,1842,1776,103.7,3523,1791,1732,103.4
33020, 충주시,050004, 48세,2018,3472,1779,1693,105.1,3368,1711,1657,103.3
33020, 충주시,050005, 49세,2018,3895,1947,1948,99.9,3800,1894,1906,99.4
33020, 충주시,055,50~54세,2018,17863,9250,8613,107.4,17461,9026,8435,107
33020, 충주시,055001, 50세,2018,3872,1975,1897,104.1,3775,1922,1853,103.7
33020, 충주시,055002, 51세,2018,3562,1837,1725,106.5,3491,1797,1694,106.1
33020, 충주시,055003, 52세,2018,3561,1908,1653,115.4,3481,1860,1621,114.7
33020, 충주시,055004, 53세,2018,3654,1872,1782,105.1,3580,1829,1751,104.5
33020, 충주시,055005, 54세,2018,3214,1658,1556,106.6,3134,1618,1516,106.7
33020, 충주시,060,55~59세,2018,19286,9849,9437,104.4,19005,9697,9308,104.2
33020, 충주시,060001, 55세,2018,3486,1781,1705,104.5,3413,1740,1673,104
33020, 충주시,060002, 56세,2018,3829,1987,1842,107.9,3771,1959,1812,108.1
33020, 충주시,060003, 57세,2018,4414,2230,2184,102.1,4368,2202,2166,101.7
33020, 충주시,060004, 58세,2018,3885,1963,1922,102.1,3832,1935,1897,102
33020, 충주시,060005, 59세,2018,3672,1888,1784,105.8,3621,1861,1760,105.7
33020, 충주시,065,60~64세,2018,16145,8205,7940,103.3,15955,8084,7871,102.7
33020, 충주시,065001, 60세,2018,3609,1852,1757,105.4,3568,1826,1742,104.8
33020, 충주시,065002, 61세,2018,3493,1790,1703,105.1,3443,1758,1685,104.3
33020, 충주시,065003, 62세,2018,3340,1703,1637,104,3304,1680,1624,103.4
33020, 충주시,065004, 63세,2018,3011,1496,1515,98.7,2984,1478,1506,98.1
33020, 충주시,065005, 64세,2018,2692,1364,1328,102.7,2656,1342,1314,102.1
33020, 충주시,070,65~69세,2018,10587,5040,5547,90.9,10489,4991,5498,90.8
33020, 충주시,070001, 65세,2018,2409,1183,1226,96.5,2379,1164,1215,95.8
33020, 충주시,070002, 66세,2018,2870,1360,1510,90.1,2850,1347,1503,89.6
33020, 충주시,070003, 67세,2018,1698,806,892,90.4,1679,801,878,91.2
33020, 충주시,070004, 68세,2018,1727,804,923,87.1,1717,803,914,87.9
33020, 충주시,070005, 69세,2018,1883,887,996,89.1,1864,876,988,88.7
33020, 충주시,075,70~74세,2018,8614,3945,4669,84.5,8585,3935,4650,84.6
33020, 충주시,075001, 70세,2018,1822,873,949,92,1816,871,945,92.2
33020, 충주시,075002, 71세,2018,1982,925,1057,87.5,1976,922,1054,87.5
33020, 충주시,075003, 72세,2018,1499,701,798,87.8,1492,698,794,87.9
33020, 충주시,075004, 73세,2018,1579,691,888,77.8,1574,689,885,77.9
33020, 충주시,075005, 74세,2018,1732,755,977,77.3,1727,755,972,77.7
33020, 충주시,080,75~79세,2018,8737,3637,5100,71.3,8716,3632,5084,71.4
33020, 충주시,080001, 75세,2018,1687,727,960,75.7,1682,726,956,75.9
33020, 충주시,080002, 76세,2018,2046,893,1153,77.5,2041,892,1149,77.6
33020, 충주시,080003, 77세,2018,1749,720,1029,70,1748,720,1028,70
33020, 충주시,080004, 78세,2018,1563,637,926,68.8,1559,636,923,68.9
33020, 충주시,080005, 79세,2018,1692,660,1032,64,1686,658,1028,64
33020, 충주시,085,80~84세,2018,5788,2061,3727,55.3,5779,2058,3721,55.3
33020, 충주시,085001, 80세,2018,1392,540,852,63.4,1392,540,852,63.4
33020, 충주시,085002, 81세,2018,1257,470,787,59.7,1255,468,787,59.5
33020, 충주시,085003, 82세,2018,1165,431,734,58.7,1162,431,731,59
33020, 충주시,085004, 83세,2018,1052,326,726,44.9,1050,325,725,44.8
33020, 충주시,085005, 84세,2018,922,294,628,46.8,920,294,626,47
33020, 충주시,090,85~89세,2018,2585,710,1875,37.9,2584,710,1874,37.9
33020, 충주시,090001, 85세,2018,762,228,534,42.7,762,228,534,42.7
33020, 충주시,090002, 86세,2018,643,167,476,35.1,643,167,476,35.1
33020, 충주시,090003, 87세,2018,414,115,299,38.5,414,115,299,38.5
33020, 충주시,090004, 88세,2018,428,111,317,35,427,111,316,35.1
33020, 충주시,090005, 89세,2018,338,89,249,35.7,338,89,249,35.7
33020, 충주시,095,90~94세,2018,784,209,575,36.3,783,209,574,36.4
33020, 충주시,095001, 90세,2018,252,60,192,31.3,251,60,191,31.4
33020, 충주시,095002, 91세,2018,205,53,152,34.9,205,53,152,34.9
33020, 충주시,095003, 92세,2018,138,36,102,35.3,138,36,102,35.3
33020, 충주시,095004, 93세,2018,115,37,78,47.4,115,37,78,47.4
33020, 충주시,095005, 94세,2018,74,23,51,45.1,74,23,51,45.1
33020, 충주시,100,95~99세,2018,194,43,151,28.5,194,43,151,28.5
33020, 충주시,100001, 95세,2018,75,20,55,36.4,75,20,55,36.4
33020, 충주시,100002, 96세,2018,55,10,45,22.2,55,10,45,22.2
33020, 충주시,100003, 97세,2018,36,8,28,28.6,36,8,28,28.6
33020, 충주시,100004, 98세,2018,18,X,14,28.6,18,X,14,28.6
33020, 충주시,100005, 99세,2018,10,X,9,11.1,10,X,9,11.1
33020, 충주시,101,100세이상,2018,17,X,15,13.3,17,X,15,13.3
33020, 충주시,102,15세미만,2018,24559,12556,12003,104.6,24463,12508,11955,104.6
33020, 충주시,103,15~64세,2018,153359,81622,71737,113.8,146467,77340,69127,111.9
33020, 충주시,104,65세이상,2018,37306,15647,21659,72.2,37147,15580,21567,72.2
33020, 충주시,086,85세이상,2018,3580,964,2616,36.9,3578,964,2614,36.9
33020, 충주시,126,평균연령,2018,43.6,41.9,45.2,,43.9,42.3,45.5,
33020, 충주시,127,중위연령,2018,45.2,43.2,47.2,,45.8,44.1,47.7,
33030, 제천시,000,합계,2018,136101,68478,67623,101.3,134150,67502,66648,101.3
33030, 제천시,005,0~4세,2018,4388,2254,2134,105.6,4381,2250,2131,105.6
33030, 제천시,005001, 0세,2018,761,371,390,95.1,761,371,390,95.1
33030, 제천시,005002, 1세,2018,775,415,360,115.3,774,415,359,115.6
33030, 제천시,005003, 2세,2018,919,503,416,120.9,918,502,416,120.7
33030, 제천시,005004, 3세,2018,936,460,476,96.6,932,457,475,96.2
33030, 제천시,005005, 4세,2018,997,505,492,102.6,996,505,491,102.9
33030, 제천시,010,5~9세,2018,5219,2592,2627,98.7,5214,2590,2624,98.7
33030, 제천시,010001, 5세,2018,968,477,491,97.1,967,477,490,97.3
33030, 제천시,010002, 6세,2018,1098,563,535,105.2,1098,563,535,105.2
33030, 제천시,010003, 7세,2018,1074,529,545,97.1,1073,529,544,97.2
33030, 제천시,010004, 8세,2018,1085,519,566,91.7,1082,517,565,91.5
33030, 제천시,010005, 9세,2018,994,504,490,102.9,994,504,490,102.9
33030, 제천시,015,10~14세,2018,5558,2888,2670,108.2,5552,2885,2667,108.2
33030, 제천시,015001, 10세,2018,1108,597,511,116.8,1108,597,511,116.8
33030, 제천시,015002, 11세,2018,1112,561,551,101.8,1111,560,551,101.6
33030, 제천시,015003, 12세,2018,1074,557,517,107.7,1073,556,517,107.5
33030, 제천시,015004, 13세,2018,1077,559,518,107.9,1077,559,518,107.9
33030, 제천시,015005, 14세,2018,1187,614,573,107.2,1183,613,570,107.5
33030, 제천시,020,15~19세,2018,8210,4265,3945,108.1,8123,4233,3890,108.8
33030, 제천시,020001, 15세,2018,1186,615,571,107.7,1186,615,571,107.7
33030, 제천시,020002, 16세,2018,1259,662,597,110.9,1255,660,595,110.9
33030, 제천시,020003, 17세,2018,1515,823,692,118.9,1510,819,691,118.5
33030, 제천시,020004, 18세,2018,1831,933,898,103.9,1804,924,880,105
33030, 제천시,020005, 19세,2018,2419,1232,1187,103.8,2368,1215,1153,105.4
33030, 제천시,025,20~24세,2018,10583,6026,4557,132.2,10228,5826,4402,132.3
33030, 제천시,025001, 20세,2018,2329,1165,1164,100.1,2254,1126,1128,99.8
33030, 제천시,025002, 21세,2018,2155,1100,1055,104.3,2095,1067,1028,103.8
33030, 제천시,025003, 22세,2018,2185,1232,953,129.3,2106,1192,914,130.4
33030, 제천시,025004, 23세,2018,2029,1296,733,176.8,1959,1251,708,176.7
33030, 제천시,025005, 24세,2018,1885,1233,652,189.1,1814,1190,624,190.7
33030, 제천시,030,25~29세,2018,6921,3897,3024,128.9,6626,3748,2878,130.2
33030, 제천시,030001, 25세,2018,1665,967,698,138.5,1607,939,668,140.6
33030, 제천시,030002, 26세,2018,1510,879,631,139.3,1451,846,605,139.8
33030, 제천시,030003, 27세,2018,1313,732,581,126,1253,705,548,128.6
33030, 제천시,030004, 28세,2018,1229,682,547,124.7,1167,651,516,126.2
33030, 제천시,030005, 29세,2018,1204,637,567,112.3,1148,607,541,112.2
33030, 제천시,035,30~34세,2018,6172,3262,2910,112.1,5881,3119,2762,112.9
33030, 제천시,035001, 30세,2018,1142,601,541,111.1,1080,568,512,110.9
33030, 제천시,035002, 31세,2018,1194,618,576,107.3,1118,582,536,108.6
33030, 제천시,035003, 32세,2018,1244,671,573,117.1,1188,644,544,118.4
33030, 제천시,035004, 33세,2018,1239,665,574,115.9,1185,636,549,115.8
33030, 제천시,035005, 34세,2018,1353,707,646,109.4,1310,689,621,111
33030, 제천시,040,35~39세,2018,7989,4095,3894,105.2,7763,3972,3791,104.8
33030, 제천시,040001, 35세,2018,1468,755,713,105.9,1403,721,682,105.7
33030, 제천시,040002, 36세,2018,1641,853,788,108.2,1593,830,763,108.8
33030, 제천시,040003, 37세,2018,1610,826,784,105.4,1569,802,767,104.6
33030, 제천시,040004, 38세,2018,1651,842,809,104.1,1614,822,792,103.8
33030, 제천시,040005, 39세,2018,1619,819,800,102.4,1584,797,787,101.3
33030, 제천시,045,40~44세,2018,8487,4314,4173,103.4,8329,4244,4085,103.9
33030, 제천시,045001, 40세,2018,1527,783,744,105.2,1485,770,715,107.7
33030, 제천시,045002, 41세,2018,1577,830,747,111.1,1544,811,733,110.6
33030, 제천시,045003, 42세,2018,1590,807,783,103.1,1560,794,766,103.7
33030, 제천시,045004, 43세,2018,1806,897,909,98.7,1780,884,896,98.7
33030, 제천시,045005, 44세,2018,1987,997,990,100.7,1960,985,975,101
33030, 제천시,050,45~49세,2018,10846,5620,5226,107.5,10709,5545,5164,107.4
33030, 제천시,050001, 45세,2018,1978,1004,974,103.1,1950,986,964,102.3
33030, 제천시,050002, 46세,2018,2050,1079,971,111.1,2024,1065,959,111.1
33030, 제천시,050003, 47세,2018,2258,1178,1080,109.1,2223,1157,1066,108.5
33030, 제천시,050004, 48세,2018,2188,1132,1056,107.2,2161,1119,1042,107.4
33030, 제천시,050005, 49세,2018,2372,1227,1145,107.2,2351,1218,1133,107.5
33030, 제천시,055,50~54세,2018,11279,5783,5496,105.2,11133,5713,5420,105.4
33030, 제천시,055001, 50세,2018,2466,1242,1224,101.5,2435,1228,1207,101.7
33030, 제천시,055002, 51세,2018,2243,1171,1072,109.2,2211,1157,1054,109.8
33030, 제천시,055003, 52세,2018,2275,1154,1121,102.9,2248,1143,1105,103.4
33030, 제천시,055004, 53세,2018,2274,1176,1098,107.1,2251,1162,1089,106.7
33030, 제천시,055005, 54세,2018,2021,1040,981,106,1988,1023,965,106
33030, 제천시,060,55~59세,2018,12747,6306,6441,97.9,12638,6261,6377,98.2
33030, 제천시,060001, 55세,2018,2178,1081,1097,98.5,2153,1074,1079,99.5
33030, 제천시,060002, 56세,2018,2534,1254,1280,98,2515,1243,1272,97.7
33030, 제천시,060003, 57세,2018,2860,1461,1399,104.4,2843,1453,1390,104.5
33030, 제천시,060004, 58세,2018,2675,1293,1382,93.6,2653,1286,1367,94.1
33030, 제천시,060005, 59세,2018,2500,1217,1283,94.9,2474,1205,1269,95
33030, 제천시,065,60~64세,2018,11660,5874,5786,101.5,11592,5838,5754,101.5
33030, 제천시,065001, 60세,2018,2649,1365,1284,106.3,2628,1352,1276,106
33030, 제천시,065002, 61세,2018,2530,1270,1260,100.8,2516,1265,1251,101.1
33030, 제천시,065003, 62세,2018,2308,1166,1142,102.1,2290,1158,1132,102.3
33030, 제천시,065004, 63세,2018,2176,1105,1071,103.2,2168,1099,1069,102.8
33030, 제천시,065005, 64세,2018,1997,968,1029,94.1,1990,964,1026,94
33030, 제천시,070,65~69세,2018,7819,3892,3927,99.1,7798,3880,3918,99
33030, 제천시,070001, 65세,2018,1769,913,856,106.7,1763,909,854,106.4
33030, 제천시,070002, 66세,2018,2217,1127,1090,103.4,2214,1125,1089,103.3
33030, 제천시,070003, 67세,2018,1260,583,677,86.1,1253,580,673,86.2
33030, 제천시,070004, 68세,2018,1280,631,649,97.2,1278,629,649,96.9
33030, 제천시,070005, 69세,2018,1293,638,655,97.4,1290,637,653,97.5
33030, 제천시,075,70~74세,2018,6200,2886,3314,87.1,6181,2880,3301,87.2
33030, 제천시,075001, 70세,2018,1407,694,713,97.3,1405,694,711,97.6
33030, 제천시,075002, 71세,2018,1400,643,757,84.9,1392,640,752,85.1
33030, 제천시,075003, 72세,2018,1011,467,544,85.8,1006,466,540,86.3
33030, 제천시,075004, 73세,2018,1172,528,644,82,1170,528,642,82.2
33030, 제천시,075005, 74세,2018,1210,554,656,84.5,1208,552,656,84.1
33030, 제천시,080,75~79세,2018,5886,2467,3419,72.2,5876,2464,3412,72.2
33030, 제천시,080001, 75세,2018,1219,548,671,81.7,1215,547,668,81.9
33030, 제천시,080002, 76세,2018,1442,621,821,75.6,1440,621,819,75.8
33030, 제천시,080003, 77세,2018,1184,496,688,72.1,1184,496,688,72.1
33030, 제천시,080004, 78세,2018,1025,387,638,60.7,1025,387,638,60.7
33030, 제천시,080005, 79세,2018,1016,415,601,69.1,1012,413,599,68.9
33030, 제천시,085,80~84세,2018,3829,1442,2387,60.4,3824,1441,2383,60.5
33030, 제천시,085001, 80세,2018,964,385,579,66.5,964,385,579,66.5
33030, 제천시,085002, 81세,2018,858,328,530,61.9,857,328,529,62
33030, 제천시,085003, 82세,2018,766,296,470,63,764,296,468,63.2
33030, 제천시,085004, 83세,2018,690,250,440,56.8,689,250,439,56.9
33030, 제천시,085005, 84세,2018,551,183,368,49.7,550,182,368,49.5
33030, 제천시,090,85~89세,2018,1641,488,1153,42.3,1637,487,1150,42.3
33030, 제천시,090001, 85세,2018,459,155,304,51,458,155,303,51.2
33030, 제천시,090002, 86세,2018,379,113,266,42.5,379,113,266,42.5
33030, 제천시,090003, 87세,2018,299,82,217,37.8,298,82,216,38
33030, 제천시,090004, 88세,2018,298,81,217,37.3,297,80,217,36.9
33030, 제천시,090005, 89세,2018,206,57,149,38.3,205,57,148,38.5
33030, 제천시,095,90~94세,2018,527,96,431,22.3,526,96,430,22.3
33030, 제천시,095001, 90세,2018,156,33,123,26.8,156,33,123,26.8
33030, 제천시,095002, 91세,2018,138,23,115,20,137,23,114,20.2
33030, 제천시,095003, 92세,2018,99,12,87,13.8,99,12,87,13.8
33030, 제천시,095004, 93세,2018,79,19,60,31.7,79,19,60,31.7
33030, 제천시,095005, 94세,2018,55,9,46,19.6,55,9,46,19.6
33030, 제천시,100,95~99세,2018,121,29,92,31.5,120,28,92,30.4
33030, 제천시,100001, 95세,2018,35,8,27,29.6,34,7,27,25.9
33030, 제천시,100002, 96세,2018,33,11,22,50,33,11,22,50
33030, 제천시,100003, 97세,2018,27,X,23,17.4,27,X,23,17.4
33030, 제천시,100004, 98세,2018,15,X,13,15.4,15,X,13,15.4
33030, 제천시,100005, 99세,2018,11,X,7,57.1,11,X,7,57.1
33030, 제천시,101,100세이상,2018,19,X,17,11.8,19,X,17,11.8
33030, 제천시,102,15세미만,2018,15165,7734,7431,104.1,15147,7725,7422,104.1
33030, 제천시,103,15~64세,2018,94894,49442,45452,108.8,93022,48499,44523,108.9
33030, 제천시,104,65세이상,2018,26042,11302,14740,76.7,25981,11278,14703,76.7
33030, 제천시,086,85세이상,2018,2308,615,1693,36.3,2302,613,1689,36.3
33030, 제천시,126,평균연령,2018,44.6,43.2,46.1,,44.7,43.3,46.2,
33030, 제천시,127,중위연령,2018,47.2,45.6,48.8,,47.5,45.9,49.1,
33040, 청주시,000,합계,2018,845036,425541,419495,101.4,826211,415082,411129,101
33040, 청주시,005,0~4세,2018,37301,19044,18257,104.3,36901,18834,18067,104.2
33040, 청주시,005001, 0세,2018,6573,3367,3206,105,6486,3312,3174,104.3
33040, 청주시,005002, 1세,2018,6957,3571,3386,105.5,6873,3527,3346,105.4
33040, 청주시,005003, 2세,2018,7724,3927,3797,103.4,7634,3885,3749,103.6
33040, 청주시,005004, 3세,2018,8047,4147,3900,106.3,7977,4114,3863,106.5
33040, 청주시,005005, 4세,2018,8000,4032,3968,101.6,7931,3996,3935,101.6
33040, 청주시,010,5~9세,2018,42050,21579,20471,105.4,41796,21449,20347,105.4
33040, 청주시,010001, 5세,2018,8152,4162,3990,104.3,8095,4137,3958,104.5
33040, 청주시,010002, 6세,2018,8873,4531,4342,104.4,8813,4498,4315,104.2
33040, 청주시,010003, 7세,2018,8657,4349,4308,101,8603,4320,4283,100.9
33040, 청주시,010004, 8세,2018,8329,4321,4008,107.8,8284,4298,3986,107.8
33040, 청주시,010005, 9세,2018,8039,4216,3823,110.3,8001,4196,3805,110.3
33040, 청주시,015,10~14세,2018,41060,21242,19818,107.2,40879,21152,19727,107.2
33040, 청주시,015001, 10세,2018,8352,4306,4046,106.4,8318,4289,4029,106.5
33040, 청주시,015002, 11세,2018,8605,4439,4166,106.6,8558,4418,4140,106.7
33040, 청주시,015003, 12세,2018,7868,4047,3821,105.9,7831,4025,3806,105.8
33040, 청주시,015004, 13세,2018,7766,3994,3772,105.9,7732,3977,3755,105.9
33040, 청주시,015005, 14세,2018,8469,4456,4013,111,8440,4443,3997,111.2
33040, 청주시,020,15~19세,2018,50996,26785,24211,110.6,50499,26543,23956,110.8
33040, 청주시,020001, 15세,2018,8641,4523,4118,109.8,8608,4505,4103,109.8
33040, 청주시,020002, 16세,2018,8876,4710,4166,113.1,8846,4695,4151,113.1
33040, 청주시,020003, 17세,2018,10141,5299,4842,109.4,10089,5272,4817,109.4
33040, 청주시,020004, 18세,2018,11402,5993,5409,110.8,11292,5946,5346,111.2
33040, 청주시,020005, 19세,2018,11936,6260,5676,110.3,11664,6125,5539,110.6
33040, 청주시,025,20~24세,2018,64954,34352,30602,112.3,62379,32893,29486,111.6
33040, 청주시,025001, 20세,2018,12425,6224,6201,100.4,12078,6035,6043,99.9
33040, 청주시,025002, 21세,2018,12795,6387,6408,99.7,12370,6159,6211,99.2
33040, 청주시,025003, 22세,2018,13373,7160,6213,115.2,12832,6862,5970,114.9
33040, 청주시,025004, 23세,2018,13138,7115,6023,118.1,12493,6733,5760,116.9
33040, 청주시,025005, 24세,2018,13223,7466,5757,129.7,12606,7104,5502,129.1
33040, 청주시,030,25~29세,2018,60363,33387,26976,123.8,57257,31564,25693,122.9
33040, 청주시,030001, 25세,2018,13041,7265,5776,125.8,12466,6927,5539,125.1
33040, 청주시,030002, 26세,2018,12786,7234,5552,130.3,12166,6852,5314,128.9
33040, 청주시,030003, 27세,2018,11979,6566,5413,121.3,11362,6215,5147,120.7
33040, 청주시,030004, 28세,2018,11462,6304,5158,122.2,10788,5931,4857,122.1
33040, 청주시,030005, 29세,2018,11095,6018,5077,118.5,10475,5639,4836,116.6
33040, 청주시,035,30~34세,2018,57096,30136,26960,111.8,54216,28438,25778,110.3
33040, 청주시,035001, 30세,2018,11050,5838,5212,112,10437,5469,4968,110.1
33040, 청주시,035002, 31세,2018,11206,5884,5322,110.6,10551,5505,5046,109.1
33040, 청주시,035003, 32세,2018,11398,6144,5254,116.9,10810,5774,5036,114.7
33040, 청주시,035004, 33세,2018,11424,5932,5492,108,10879,5637,5242,107.5
33040, 청주시,035005, 34세,2018,12018,6338,5680,111.6,11539,6053,5486,110.3
33040, 청주시,040,35~39세,2018,68336,35190,33146,106.2,66134,33870,32264,105
33040, 청주시,040001, 35세,2018,13038,6672,6366,104.8,12504,6347,6157,103.1
33040, 청주시,040002, 36세,2018,14414,7350,7064,104,13935,7074,6861,103.1
33040, 청주시,040003, 37세,2018,13439,6992,6447,108.5,12994,6730,6264,107.4
33040, 청주시,040004, 38세,2018,14095,7285,6810,107,13715,7054,6661,105.9
33040, 청주시,040005, 39세,2018,13350,6891,6459,106.7,12986,6665,6321,105.4
33040, 청주시,045,40~44세,2018,65472,33071,32401,102.1,63902,32184,31718,101.5
33040, 청주시,045001, 40세,2018,12286,6309,5977,105.6,11931,6102,5829,104.7
33040, 청주시,045002, 41세,2018,12841,6479,6362,101.8,12485,6265,6220,100.7
33040, 청주시,045003, 42세,2018,12663,6433,6230,103.3,12358,6261,6097,102.7
33040, 청주시,045004, 43세,2018,13218,6535,6683,97.8,12934,6387,6547,97.6
33040, 청주시,045005, 44세,2018,14464,7315,7149,102.3,14194,7169,7025,102
33040, 청주시,050,45~49세,2018,73122,36636,36486,100.4,71573,35775,35798,99.9
33040, 청주시,050001, 45세,2018,14499,7171,7328,97.9,14180,7006,7174,97.7
33040, 청주시,050002, 46세,2018,13616,6898,6718,102.7,13310,6735,6575,102.4
33040, 청주시,050003, 47세,2018,14939,7589,7350,103.3,14617,7407,7210,102.7
33040, 청주시,050004, 48세,2018,14374,7232,7142,101.3,14068,7044,7024,100.3
33040, 청주시,050005, 49세,2018,15694,7746,7948,97.5,15398,7583,7815,97
33040, 청주시,055,50~54세,2018,67540,33594,33946,99,66280,32973,33307,99
33040, 청주시,055001, 50세,2018,15076,7288,7788,93.6,14777,7130,7647,93.2
33040, 청주시,055002, 51세,2018,13754,6891,6863,100.4,13550,6783,6767,100.2
33040, 청주시,055003, 52세,2018,13311,6692,6619,101.1,13062,6582,6480,101.6
33040, 청주시,055004, 53세,2018,13646,6788,6858,99,13368,6646,6722,98.9
33040, 청주시,055005, 54세,2018,11753,5935,5818,102,11523,5832,5691,102.5
33040, 청주시,060,55~59세,2018,65962,33160,32802,101.1,64869,32627,32242,101.2
33040, 청주시,060001, 55세,2018,12467,6455,6012,107.4,12152,6292,5860,107.4
33040, 청주시,060002, 56세,2018,13422,6897,6525,105.7,13206,6800,6406,106.2
33040, 청주시,060003, 57세,2018,15007,7511,7496,100.2,14837,7430,7407,100.3
33040, 청주시,060004, 58세,2018,13015,6426,6589,97.5,12792,6307,6485,97.3
33040, 청주시,060005, 59세,2018,12051,5871,6180,95,11882,5798,6084,95.3
33040, 청주시,065,60~64세,2018,51208,25397,25811,98.4,50477,25030,25447,98.4
33040, 청주시,065001, 60세,2018,11590,5830,5760,101.2,11399,5747,5652,101.7
33040, 청주시,065002, 61세,2018,11292,5595,5697,98.2,11120,5512,5608,98.3
33040, 청주시,065003, 62세,2018,10092,5092,5000,101.8,9951,5014,4937,101.6
33040, 청주시,065004, 63세,2018,9795,4716,5079,92.9,9680,4653,5027,92.6
33040, 청주시,065005, 64세,2018,8439,4164,4275,97.4,8327,4104,4223,97.2
33040, 청주시,070,65~69세,2018,31439,15276,16163,94.5,31113,15128,15985,94.6
33040, 청주시,070001, 65세,2018,7213,3515,3698,95.1,7126,3474,3652,95.1
33040, 청주시,070002, 66세,2018,7810,3845,3965,97,7735,3810,3925,97.1
33040, 청주시,070003, 67세,2018,5249,2511,2738,91.7,5188,2484,2704,91.9
33040, 청주시,070004, 68세,2018,5505,2636,2869,91.9,5460,2619,2841,92.2
33040, 청주시,070005, 69세,2018,5662,2769,2893,95.7,5604,2741,2863,95.7
33040, 청주시,075,70~74세,2018,23638,10836,12802,84.6,23531,10791,12740,84.7
33040, 청주시,075001, 70세,2018,5608,2670,2938,90.9,5575,2656,2919,91
33040, 청주시,075002, 71세,2018,5349,2472,2877,85.9,5322,2462,2860,86.1
33040, 청주시,075003, 72세,2018,4079,1909,2170,88,4058,1901,2157,88.1
33040, 청주시,075004, 73세,2018,4333,1993,2340,85.2,4315,1983,2332,85
33040, 청주시,075005, 74세,2018,4269,1792,2477,72.3,4261,1789,2472,72.4
33040, 청주시,080,75~79세,2018,21073,8676,12397,70,21024,8662,12362,70.1
33040, 청주시,080001, 75세,2018,4455,1915,2540,75.4,4444,1908,2536,75.2
33040, 청주시,080002, 76세,2018,5203,2214,2989,74.1,5193,2211,2982,74.1
33040, 청주시,080003, 77세,2018,4023,1606,2417,66.4,4010,1605,2405,66.7
33040, 청주시,080004, 78세,2018,3668,1471,2197,67,3660,1469,2191,67
33040, 청주시,080005, 79세,2018,3724,1470,2254,65.2,3717,1469,2248,65.3
33040, 청주시,085,80~84세,2018,14245,4964,9281,53.5,14212,4956,9256,53.5
33040, 청주시,085001, 80세,2018,3272,1203,2069,58.1,3265,1203,2062,58.3
33040, 청주시,085002, 81세,2018,3123,1142,1981,57.6,3117,1139,1978,57.6
33040, 청주시,085003, 82세,2018,2969,1016,1953,52,2959,1015,1944,52.2
33040, 청주시,085004, 83세,2018,2730,925,1805,51.2,2724,924,1800,51.3
33040, 청주시,085005, 84세,2018,2151,678,1473,46,2147,675,1472,45.9
33040, 청주시,090,85~89세,2018,6508,1680,4828,34.8,6497,1678,4819,34.8
33040, 청주시,090001, 85세,2018,1885,566,1319,42.9,1883,566,1317,43
33040, 청주시,090002, 86세,2018,1538,411,1127,36.5,1535,410,1125,36.4
33040, 청주시,090003, 87세,2018,1058,263,795,33.1,1057,263,794,33.1
33040, 청주시,090004, 88세,2018,1110,255,855,29.8,1107,254,853,29.8
33040, 청주시,090005, 89세,2018,917,185,732,25.3,915,185,730,25.3
33040, 청주시,095,90~94세,2018,2108,438,1670,26.2,2107,437,1670,26.2
33040, 청주시,095001, 90세,2018,676,155,521,29.8,676,155,521,29.8
33040, 청주시,095002, 91세,2018,570,124,446,27.8,570,124,446,27.8
33040, 청주시,095003, 92세,2018,335,65,270,24.1,335,65,270,24.1
33040, 청주시,095004, 93세,2018,337,60,277,21.7,337,60,277,21.7
33040, 청주시,095005, 94세,2018,190,34,156,21.8,189,33,156,21.2
33040, 청주시,100,95~99세,2018,504,92,412,22.3,504,92,412,22.3
33040, 청주시,100001, 95세,2018,179,41,138,29.7,179,41,138,29.7
33040, 청주시,100002, 96세,2018,142,22,120,18.3,142,22,120,18.3
33040, 청주시,100003, 97세,2018,98,21,77,27.3,98,21,77,27.3
33040, 청주시,100004, 98세,2018,53,5,48,10.4,53,5,48,10.4
33040, 청주시,100005, 99세,2018,32,X,29,10.3,32,X,29,10.3
33040, 청주시,101,100세이상,2018,61,6,55,10.9,61,6,55,10.9
33040, 청주시,102,15세미만,2018,120411,61865,58546,105.7,119576,61435,58141,105.7
33040, 청주시,103,15~64세,2018,625049,321708,303341,106.1,607586,311897,295689,105.5
33040, 청주시,104,65세이상,2018,99576,41968,57608,72.9,99049,41750,57299,72.9
33040, 청주시,086,85세이상,2018,9181,2216,6965,31.8,9169,2213,6956,31.8
33040, 청주시,126,평균연령,2018,39.8,38.6,40.9,,39.8,38.7,41,
33040, 청주시,127,중위연령,2018,40,38.7,41.5,,40.3,38.9,41.7,
33041, 상당구,000,합계,2018,170120,84868,85252,99.5,168484,84066,84418,99.6
33041, 상당구,005,0~4세,2018,6327,3178,3149,100.9,6316,3174,3142,101
33041, 상당구,005001, 0세,2018,1032,510,522,97.7,1030,509,521,97.7
33041, 상당구,005002, 1세,2018,1141,563,578,97.4,1137,562,575,97.7
33041, 상당구,005003, 2세,2018,1277,650,627,103.7,1274,649,625,103.8
33041, 상당구,005004, 3세,2018,1438,725,713,101.7,1437,725,712,101.8
33041, 상당구,005005, 4세,2018,1439,730,709,103,1438,729,709,102.8
33041, 상당구,010,5~9세,2018,8111,4251,3860,110.1,8097,4244,3853,110.1
33041, 상당구,010001, 5세,2018,1555,805,750,107.3,1555,805,750,107.3
33041, 상당구,010002, 6세,2018,1707,873,834,104.7,1704,872,832,104.8
33041, 상당구,010003, 7세,2018,1658,843,815,103.4,1652,840,812,103.4
33041, 상당구,010004, 8세,2018,1656,907,749,121.1,1652,905,747,121.2
33041, 상당구,010005, 9세,2018,1535,823,712,115.6,1534,822,712,115.4
33041, 상당구,015,10~14세,2018,8387,4293,4094,104.9,8377,4287,4090,104.8
33041, 상당구,015001, 10세,2018,1626,833,793,105,1624,832,792,105.1
33041, 상당구,015002, 11세,2018,1763,923,840,109.9,1759,921,838,109.9
33041, 상당구,015003, 12세,2018,1549,767,782,98.1,1547,765,782,97.8
33041, 상당구,015004, 13세,2018,1600,813,787,103.3,1600,813,787,103.3
33041, 상당구,015005, 14세,2018,1849,957,892,107.3,1847,956,891,107.3
33041, 상당구,020,15~19세,2018,10438,5550,4888,113.5,10424,5542,4882,113.5
33041, 상당구,020001, 15세,2018,1852,952,900,105.8,1852,952,900,105.8
33041, 상당구,020002, 16세,2018,2022,1071,951,112.6,2019,1069,950,112.5
33041, 상당구,020003, 17세,2018,2276,1211,1065,113.7,2274,1210,1064,113.7
33041, 상당구,020004, 18세,2018,2398,1269,1129,112.4,2396,1268,1128,112.4
33041, 상당구,020005, 19세,2018,1890,1047,843,124.2,1883,1043,840,124.2
33041, 상당구,025,20~24세,2018,11375,6299,5076,124.1,11196,6186,5010,123.5
33041, 상당구,025001, 20세,2018,2146,1198,948,126.4,2129,1192,937,127.2
33041, 상당구,025002, 21세,2018,2234,1239,995,124.5,2207,1223,984,124.3
33041, 상당구,025003, 22세,2018,2382,1323,1059,124.9,2346,1299,1047,124.1
33041, 상당구,025004, 23세,2018,2297,1236,1061,116.5,2252,1203,1049,114.7
33041, 상당구,025005, 24세,2018,2316,1303,1013,128.6,2262,1269,993,127.8
33041, 상당구,030,25~29세,2018,9953,5408,4545,119,9657,5242,4415,118.7
33041, 상당구,030001, 25세,2018,2272,1254,1018,123.2,2220,1228,992,123.8
33041, 상당구,030002, 26세,2018,2236,1196,1040,115,2175,1165,1010,115.3
33041, 상당구,030003, 27세,2018,1958,1059,899,117.8,1894,1025,869,118
33041, 상당구,030004, 28세,2018,1843,1007,836,120.5,1783,975,808,120.7
33041, 상당구,030005, 29세,2018,1644,892,752,118.6,1585,849,736,115.4
33041, 상당구,035,30~34세,2018,8912,4644,4268,108.8,8641,4498,4143,108.6
33041, 상당구,035001, 30세,2018,1707,885,822,107.7,1630,839,791,106.1
33041, 상당구,035002, 31세,2018,1730,905,825,109.7,1671,871,800,108.9
33041, 상당구,035003, 32세,2018,1730,903,827,109.2,1692,887,805,110.2
33041, 상당구,035004, 33세,2018,1826,935,891,104.9,1778,911,867,105.1
33041, 상당구,035005, 34세,2018,1919,1016,903,112.5,1870,990,880,112.5
33041, 상당구,040,35~39세,2018,11900,5985,5915,101.2,11711,5898,5813,101.5
33041, 상당구,040001, 35세,2018,2099,1021,1078,94.7,2061,1007,1054,95.5
33041, 상당구,040002, 36세,2018,2447,1224,1223,100.1,2393,1198,1195,100.3
33041, 상당구,040003, 37세,2018,2364,1198,1166,102.7,2320,1178,1142,103.2
33041, 상당구,040004, 38세,2018,2563,1293,1270,101.8,2541,1283,1258,102
33041, 상당구,040005, 39세,2018,2427,1249,1178,106,2396,1232,1164,105.8
33041, 상당구,045,40~44세,2018,12694,6263,6431,97.4,12573,6220,6353,97.9
33041, 상당구,045001, 40세,2018,2228,1084,1144,94.8,2213,1079,1134,95.1
33041, 상당구,045002, 41세,2018,2491,1233,1258,98,2459,1221,1238,98.6
33041, 상당구,045003, 42세,2018,2440,1230,1210,101.7,2416,1220,1196,102
33041, 상당구,045004, 43세,2018,2610,1269,1341,94.6,2583,1261,1322,95.4
33041, 상당구,045005, 44세,2018,2925,1447,1478,97.9,2902,1439,1463,98.4
33041, 상당구,050,45~49세,2018,15399,7589,7810,97.2,15265,7531,7734,97.4
33041, 상당구,050001, 45세,2018,3027,1468,1559,94.2,2994,1457,1537,94.8
33041, 상당구,050002, 46세,2018,2891,1469,1422,103.3,2870,1458,1412,103.3
33041, 상당구,050003, 47세,2018,3156,1568,1588,98.7,3127,1555,1572,98.9
33041, 상당구,050004, 48세,2018,3040,1514,1526,99.2,3017,1502,1515,99.1
33041, 상당구,050005, 49세,2018,3285,1570,1715,91.5,3257,1559,1698,91.8
33041, 상당구,055,50~54세,2018,15022,7465,7557,98.8,14895,7418,7477,99.2
33041, 상당구,055001, 50세,2018,3272,1580,1692,93.4,3238,1560,1678,93
33041, 상당구,055002, 51세,2018,3056,1514,1542,98.2,3035,1507,1528,98.6
33041, 상당구,055003, 52세,2018,3009,1521,1488,102.2,2986,1517,1469,103.3
33041, 상당구,055004, 53세,2018,3043,1514,1529,99,3020,1507,1513,99.6
33041, 상당구,055005, 54세,2018,2642,1336,1306,102.3,2616,1327,1289,102.9
33041, 상당구,060,55~59세,2018,14672,7439,7233,102.8,14550,7387,7163,103.1
33041, 상당구,060001, 55세,2018,2818,1473,1345,109.5,2770,1454,1316,110.5
33041, 상당구,060002, 56세,2018,2998,1557,1441,108,2971,1544,1427,108.2
33041, 상당구,060003, 57세,2018,3322,1680,1642,102.3,3306,1673,1633,102.4
33041, 상당구,060004, 58세,2018,2906,1449,1457,99.5,2892,1443,1449,99.6
33041, 상당구,060005, 59세,2018,2628,1280,1348,95,2611,1273,1338,95.1
33041, 상당구,065,60~64세,2018,11947,5995,5952,100.7,11865,5951,5914,100.6
33041, 상당구,065001, 60세,2018,2667,1348,1319,102.2,2647,1336,1311,101.9
33041, 상당구,065002, 61세,2018,2657,1340,1317,101.7,2637,1330,1307,101.8
33041, 상당구,065003, 62세,2018,2312,1166,1146,101.7,2296,1158,1138,101.8
33041, 상당구,065004, 63세,2018,2268,1082,1186,91.2,2256,1075,1181,91
33041, 상당구,065005, 64세,2018,2043,1059,984,107.6,2029,1052,977,107.7
33041, 상당구,070,65~69세,2018,7576,3694,3882,95.2,7541,3681,3860,95.4
33041, 상당구,070001, 65세,2018,1754,853,901,94.7,1743,847,896,94.5
33041, 상당구,070002, 66세,2018,1902,928,974,95.3,1894,925,969,95.5
33041, 상당구,070003, 67세,2018,1241,614,627,97.9,1238,613,625,98.1
33041, 상당구,070004, 68세,2018,1307,623,684,91.1,1299,621,678,91.6
33041, 상당구,070005, 69세,2018,1372,676,696,97.1,1367,675,692,97.5
33041, 상당구,075,70~74세,2018,5905,2676,3229,82.9,5890,2671,3219,83
33041, 상당구,075001, 70세,2018,1387,641,746,85.9,1383,640,743,86.1
33041, 상당구,075002, 71세,2018,1347,632,715,88.4,1342,630,712,88.5
33041, 상당구,075003, 72세,2018,978,462,516,89.5,975,460,515,89.3
33041, 상당구,075004, 73세,2018,1103,494,609,81.1,1101,494,607,81.4
33041, 상당구,075005, 74세,2018,1090,447,643,69.5,1089,447,642,69.6
33041, 상당구,080,75~79세,2018,5493,2267,3226,70.3,5483,2266,3217,70.4
33041, 상당구,080001, 75세,2018,1131,474,657,72.1,1130,473,657,72
33041, 상당구,080002, 76세,2018,1392,573,819,70,1388,573,815,70.3
33041, 상당구,080003, 77세,2018,1059,439,620,70.8,1057,439,618,71
33041, 상당구,080004, 78세,2018,939,372,567,65.6,937,372,565,65.8
33041, 상당구,080005, 79세,2018,972,409,563,72.6,971,409,562,72.8
33041, 상당구,085,80~84세,2018,3687,1288,2399,53.7,3681,1286,2395,53.7
33041, 상당구,085001, 80세,2018,824,298,526,56.7,821,298,523,57
33041, 상당구,085002, 81세,2018,812,278,534,52.1,810,277,533,52
33041, 상당구,085003, 82세,2018,770,275,495,55.6,770,275,495,55.6
33041, 상당구,085004, 83세,2018,726,254,472,53.8,726,254,472,53.8
33041, 상당구,085005, 84세,2018,555,183,372,49.2,554,182,372,48.9
33041, 상당구,090,85~89세,2018,1654,433,1221,35.5,1654,433,1221,35.5
33041, 상당구,090001, 85세,2018,461,135,326,41.4,461,135,326,41.4
33041, 상당구,090002, 86세,2018,401,110,291,37.8,401,110,291,37.8
33041, 상당구,090003, 87세,2018,240,60,180,33.3,240,60,180,33.3
33041, 상당구,090004, 88세,2018,298,72,226,31.9,298,72,226,31.9
33041, 상당구,090005, 89세,2018,254,56,198,28.3,254,56,198,28.3
33041, 상당구,095,90~94세,2018,540,122,418,29.2,540,122,418,29.2
33041, 상당구,095001, 90세,2018,191,48,143,33.6,191,48,143,33.6
33041, 상당구,095002, 91세,2018,149,39,110,35.5,149,39,110,35.5
33041, 상당구,095003, 92세,2018,82,18,64,28.1,82,18,64,28.1
33041, 상당구,095004, 93세,2018,68,13,55,23.6,68,13,55,23.6
33041, 상당구,095005, 94세,2018,50,X,46,8.7,50,X,46,8.7
33041, 상당구,100,95~99세,2018,116,29,87,33.3,116,29,87,33.3
33041, 상당구,100001, 95세,2018,34,12,22,54.5,34,12,22,54.5
33041, 상당구,100002, 96세,2018,35,7,28,25,35,7,28,25
33041, 상당구,100003, 97세,2018,29,8,21,38.1,29,8,21,38.1
33041, 상당구,100004, 98세,2018,12,X,10,20,12,X,10,20
33041, 상당구,100005, 99세,2018,6,X,6,0,6,X,6,0
33041, 상당구,101,100세이상,2018,12,X,12,0,12,X,12,0
33041, 상당구,102,15세미만,2018,22825,11722,11103,105.6,22790,11705,11085,105.6
33041, 상당구,103,15~64세,2018,122312,62637,59675,105,120777,61873,58904,105
33041, 상당구,104,65세이상,2018,24983,10509,14474,72.6,24917,10488,14429,72.7
33041, 상당구,086,85세이상,2018,2322,584,1738,33.6,2322,584,1738,33.6
33041, 상당구,126,평균연령,2018,42,40.7,43.4,,42.1,40.7,43.4,
33041, 상당구,127,중위연령,2018,44,42.4,45.3,,44.1,42.5,45.3,
33042, 서원구,000,합계,2018,216409,107382,109027,98.5,212208,105234,106974,98.4
33042, 서원구,005,0~4세,2018,8012,4133,3879,106.5,7912,4082,3830,106.6
33042, 서원구,005001, 0세,2018,1367,714,653,109.3,1347,702,645,108.8
33042, 서원구,005002, 1세,2018,1500,784,716,109.5,1478,774,704,109.9
33042, 서원구,005003, 2세,2018,1662,836,826,101.2,1634,822,812,101.2
33042, 서원구,005004, 3세,2018,1721,906,815,111.2,1706,900,806,111.7
33042, 서원구,005005, 4세,2018,1762,893,869,102.8,1747,884,863,102.4
33042, 서원구,010,5~9세,2018,9863,4975,4888,101.8,9797,4942,4855,101.8
33042, 서원구,010001, 5세,2018,1823,878,945,92.9,1804,870,934,93.1
33042, 서원구,010002, 6세,2018,2061,1071,990,108.2,2043,1061,982,108
33042, 서원구,010003, 7세,2018,2050,1002,1048,95.6,2043,996,1047,95.1
33042, 서원구,010004, 8세,2018,1975,1013,962,105.3,1964,1008,956,105.4
33042, 서원구,010005, 9세,2018,1954,1011,943,107.2,1943,1007,936,107.6
33042, 서원구,015,10~14세,2018,10528,5459,5069,107.7,10478,5438,5040,107.9
33042, 서원구,015001, 10세,2018,2108,1076,1032,104.3,2100,1070,1030,103.9
33042, 서원구,015002, 11세,2018,2147,1125,1022,110.1,2131,1118,1013,110.4
33042, 서원구,015003, 12세,2018,2061,1058,1003,105.5,2052,1054,998,105.6
33042, 서원구,015004, 13세,2018,2030,1039,991,104.8,2023,1037,986,105.2
33042, 서원구,015005, 14세,2018,2182,1161,1021,113.7,2172,1159,1013,114.4
33042, 서원구,020,15~19세,2018,14361,7475,6886,108.6,14253,7431,6822,108.9
33042, 서원구,020001, 15세,2018,2317,1241,1076,115.3,2309,1236,1073,115.2
33042, 서원구,020002, 16세,2018,2279,1216,1063,114.4,2271,1213,1058,114.7
33042, 서원구,020003, 17세,2018,2687,1380,1307,105.6,2671,1376,1295,106.3
33042, 서원구,020004, 18세,2018,3101,1620,1481,109.4,3075,1610,1465,109.9
33042, 서원구,020005, 19세,2018,3977,2018,1959,103,3927,1996,1931,103.4
33042, 서원구,025,20~24세,2018,19806,10284,9522,108,19076,9935,9141,108.7
33042, 서원구,025001, 20세,2018,3974,1864,2110,88.3,3864,1815,2049,88.6
33042, 서원구,025002, 21세,2018,3993,1847,2146,86.1,3847,1778,2069,85.9
33042, 서원구,025003, 22세,2018,4053,2171,1882,115.4,3902,2102,1800,116.8
33042, 서원구,025004, 23세,2018,3992,2184,1808,120.8,3805,2097,1708,122.8
33042, 서원구,025005, 24세,2018,3794,2218,1576,140.7,3658,2143,1515,141.5
33042, 서원구,030,25~29세,2018,14815,8240,6575,125.3,14173,7896,6277,125.8
33042, 서원구,030001, 25세,2018,3460,1950,1510,129.1,3323,1878,1445,130
33042, 서원구,030002, 26세,2018,3226,1867,1359,137.4,3098,1790,1308,136.9
33042, 서원구,030003, 27세,2018,2901,1566,1335,117.3,2791,1512,1279,118.2
33042, 서원구,030004, 28세,2018,2700,1490,1210,123.1,2561,1416,1145,123.7
33042, 서원구,030005, 29세,2018,2528,1367,1161,117.7,2400,1300,1100,118.2
33042, 서원구,035,30~34세,2018,12602,6527,6075,107.4,12024,6203,5821,106.6
33042, 서원구,035001, 30세,2018,2471,1296,1175,110.3,2347,1222,1125,108.6
33042, 서원구,035002, 31세,2018,2499,1270,1229,103.3,2360,1189,1171,101.5
33042, 서원구,035003, 32세,2018,2469,1336,1133,117.9,2350,1267,1083,117
33042, 서원구,035004, 33세,2018,2488,1253,1235,101.5,2385,1203,1182,101.8
33042, 서원구,035005, 34세,2018,2675,1372,1303,105.3,2582,1322,1260,104.9
33042, 서원구,040,35~39세,2018,15394,7719,7675,100.6,14923,7456,7467,99.9
33042, 서원구,040001, 35세,2018,2840,1409,1431,98.5,2719,1340,1379,97.2
33042, 서원구,040002, 36세,2018,3149,1592,1557,102.2,3056,1543,1513,102
33042, 서원구,040003, 37세,2018,3135,1601,1534,104.4,3033,1544,1489,103.7
33042, 서원구,040004, 38세,2018,3161,1578,1583,99.7,3063,1522,1541,98.8
33042, 서원구,040005, 39세,2018,3109,1539,1570,98,3052,1507,1545,97.5
33042, 서원구,045,40~44세,2018,16084,7936,8148,97.4,15728,7753,7975,97.2
33042, 서원구,045001, 40세,2018,2949,1464,1485,98.6,2872,1425,1447,98.5
33042, 서원구,045002, 41세,2018,3052,1525,1527,99.9,2968,1476,1492,98.9
33042, 서원구,045003, 42세,2018,3150,1564,1586,98.6,3082,1537,1545,99.5
33042, 서원구,045004, 43세,2018,3264,1567,1697,92.3,3197,1528,1669,91.6
33042, 서원구,045005, 44세,2018,3669,1816,1853,98,3609,1787,1822,98.1
33042, 서원구,050,45~49세,2018,19186,9289,9897,93.9,18863,9125,9738,93.7
33042, 서원구,050001, 45세,2018,3768,1780,1988,89.5,3701,1747,1954,89.4
33042, 서원구,050002, 46세,2018,3567,1751,1816,96.4,3499,1719,1780,96.6
33042, 서원구,050003, 47세,2018,3886,1909,1977,96.6,3820,1876,1944,96.5
33042, 서원구,050004, 48세,2018,3781,1855,1926,96.3,3714,1814,1900,95.5
33042, 서원구,050005, 49세,2018,4184,1994,2190,91.1,4129,1969,2160,91.2
33042, 서원구,055,50~54세,2018,17774,8725,9049,96.4,17508,8594,8914,96.4
33042, 서원구,055001, 50세,2018,3995,1888,2107,89.6,3936,1855,2081,89.1
33042, 서원구,055002, 51세,2018,3746,1828,1918,95.3,3698,1803,1895,95.1
33042, 서원구,055003, 52세,2018,3434,1730,1704,101.5,3386,1702,1684,101.1
33042, 서원구,055004, 53세,2018,3544,1786,1758,101.6,3491,1762,1729,101.9
33042, 서원구,055005, 54세,2018,3055,1493,1562,95.6,2997,1472,1525,96.5
33042, 서원구,060,55~59세,2018,17648,8737,8911,98,17402,8615,8787,98
33042, 서원구,060001, 55세,2018,3304,1683,1621,103.8,3243,1647,1596,103.2
33042, 서원구,060002, 56세,2018,3546,1787,1759,101.6,3497,1767,1730,102.1
33042, 서원구,060003, 57세,2018,4043,2027,2016,100.5,3997,2006,1991,100.8
33042, 서원구,060004, 58세,2018,3523,1724,1799,95.8,3462,1692,1770,95.6
33042, 서원구,060005, 59세,2018,3232,1516,1716,88.3,3203,1503,1700,88.4
33042, 서원구,065,60~64세,2018,13733,6817,6916,98.6,13587,6744,6843,98.6
33042, 서원구,065001, 60세,2018,3108,1555,1553,100.1,3057,1533,1524,100.6
33042, 서원구,065002, 61세,2018,3057,1528,1529,99.9,3032,1515,1517,99.9
33042, 서원구,065003, 62세,2018,2702,1340,1362,98.4,2682,1329,1353,98.2
33042, 서원구,065004, 63세,2018,2579,1235,1344,91.9,2555,1222,1333,91.7
33042, 서원구,065005, 64세,2018,2287,1159,1128,102.7,2261,1145,1116,102.6
33042, 서원구,070,65~69세,2018,8444,3960,4484,88.3,8379,3931,4448,88.4
33042, 서원구,070001, 65세,2018,1923,890,1033,86.2,1907,881,1026,85.9
33042, 서원구,070002, 66세,2018,2099,1025,1074,95.4,2089,1022,1067,95.8
33042, 서원구,070003, 67세,2018,1392,637,755,84.4,1382,635,747,85
33042, 서원구,070004, 68세,2018,1528,700,828,84.5,1515,693,822,84.3
33042, 서원구,070005, 69세,2018,1502,708,794,89.2,1486,700,786,89.1
33042, 서원구,075,70~74세,2018,6373,2934,3439,85.3,6344,2923,3421,85.4
33042, 서원구,075001, 70세,2018,1513,708,805,88,1500,705,795,88.7
33042, 서원구,075002, 71세,2018,1455,659,796,82.8,1448,657,791,83.1
33042, 서원구,075003, 72세,2018,1109,522,587,88.9,1103,519,584,88.9
33042, 서원구,075004, 73세,2018,1144,531,613,86.6,1142,529,613,86.3
33042, 서원구,075005, 74세,2018,1152,514,638,80.6,1151,513,638,80.4
33042, 서원구,080,75~79세,2018,5513,2259,3254,69.4,5498,2256,3242,69.6
33042, 서원구,080001, 75세,2018,1168,501,667,75.1,1165,500,665,75.2
33042, 서원구,080002, 76세,2018,1341,577,764,75.5,1338,576,762,75.6
33042, 서원구,080003, 77세,2018,1058,411,647,63.5,1053,411,642,64
33042, 서원구,080004, 78세,2018,992,402,590,68.1,988,401,587,68.3
33042, 서원구,080005, 79세,2018,954,368,586,62.8,954,368,586,62.8
33042, 서원구,085,80~84세,2018,3771,1348,2423,55.6,3762,1345,2417,55.6
33042, 서원구,085001, 80세,2018,877,341,536,63.6,874,341,533,64
33042, 서원구,085002, 81세,2018,852,323,529,61.1,848,321,527,60.9
33042, 서원구,085003, 82세,2018,769,274,495,55.4,769,274,495,55.4
33042, 서원구,085004, 83세,2018,731,250,481,52,729,249,480,51.9
33042, 서원구,085005, 84세,2018,542,160,382,41.9,542,160,382,41.9
33042, 서원구,090,85~89세,2018,1719,424,1295,32.7,1718,424,1294,32.8
33042, 서원구,090001, 85세,2018,513,156,357,43.7,512,156,356,43.8
33042, 서원구,090002, 86세,2018,397,98,299,32.8,397,98,299,32.8
33042, 서원구,090003, 87세,2018,299,62,237,26.2,299,62,237,26.2
33042, 서원구,090004, 88세,2018,293,71,222,32,293,71,222,32
33042, 서원구,090005, 89세,2018,217,37,180,20.6,217,37,180,20.6
33042, 서원구,095,90~94세,2018,617,120,497,24.1,617,120,497,24.1
33042, 서원구,095001, 90세,2018,170,44,126,34.9,170,44,126,34.9
33042, 서원구,095002, 91세,2018,174,32,142,22.5,174,32,142,22.5
33042, 서원구,095003, 92세,2018,104,17,87,19.5,104,17,87,19.5
33042, 서원구,095004, 93세,2018,113,16,97,16.5,113,16,97,16.5
33042, 서원구,095005, 94세,2018,56,11,45,24.4,56,11,45,24.4
33042, 서원구,100,95~99세,2018,146,19,127,15,146,19,127,15
33042, 서원구,100001, 95세,2018,53,8,45,17.8,53,8,45,17.8
33042, 서원구,100002, 96세,2018,43,5,38,13.2,43,5,38,13.2
33042, 서원구,100003, 97세,2018,31,X,27,14.8,31,X,27,14.8
33042, 서원구,100004, 98세,2018,11,X,10,10,11,X,10,10
33042, 서원구,100005, 99세,2018,8,X,7,14.3,8,X,7,14.3
33042, 서원구,101,100세이상,2018,20,X,18,11.1,20,X,18,11.1
33042, 서원구,102,15세미만,2018,28403,14567,13836,105.3,28187,14462,13725,105.4
33042, 서원구,103,15~64세,2018,161403,81749,79654,102.6,157537,79752,77785,102.5
33042, 서원구,104,65세이상,2018,26603,11066,15537,71.2,26484,11020,15464,71.3
33042, 서원구,086,85세이상,2018,2502,565,1937,29.2,2501,565,1936,29.2
33042, 서원구,126,평균연령,2018,40.2,39,41.5,,40.3,39.1,41.6,
33042, 서원구,127,중위연령,2018,41,39.3,42.6,,41.2,39.5,42.8,
33043, 흥덕구,000,합계,2018,258037,130621,127416,102.5,250690,126498,124192,101.9
33043, 흥덕구,005,0~4세,2018,11464,5895,5569,105.9,11260,5786,5474,105.7
33043, 흥덕구,005001, 0세,2018,2072,1071,1001,107,2028,1042,986,105.7
33043, 흥덕구,005002, 1세,2018,2199,1141,1058,107.8,2157,1119,1038,107.8
33043, 흥덕구,005003, 2세,2018,2311,1197,1114,107.5,2266,1178,1088,108.3
33043, 흥덕구,005004, 3세,2018,2436,1253,1183,105.9,2400,1235,1165,106
33043, 흥덕구,005005, 4세,2018,2446,1233,1213,101.6,2409,1212,1197,101.3
33043, 흥덕구,010,5~9세,2018,12724,6529,6195,105.4,12584,6453,6131,105.3
33043, 흥덕구,010001, 5세,2018,2469,1287,1182,108.9,2440,1274,1166,109.3
33043, 흥덕구,010002, 6세,2018,2583,1306,1277,102.3,2552,1289,1263,102.1
33043, 흥덕구,010003, 7세,2018,2648,1340,1308,102.4,2616,1323,1293,102.3
33043, 흥덕구,010004, 8세,2018,2549,1305,1244,104.9,2525,1291,1234,104.6
33043, 흥덕구,010005, 9세,2018,2475,1291,1184,109,2451,1276,1175,108.6
33043, 흥덕구,015,10~14세,2018,12464,6501,5963,109,12368,6447,5921,108.9
33043, 흥덕구,015001, 10세,2018,2530,1337,1193,112.1,2512,1330,1182,112.5
33043, 흥덕구,015002, 11세,2018,2541,1332,1209,110.2,2520,1320,1200,110
33043, 흥덕구,015003, 12세,2018,2414,1249,1165,107.2,2391,1235,1156,106.8
33043, 흥덕구,015004, 13세,2018,2343,1189,1154,103,2324,1178,1146,102.8
33043, 흥덕구,015005, 14세,2018,2636,1394,1242,112.2,2621,1384,1237,111.9
33043, 흥덕구,020,15~19세,2018,15042,7946,7096,112,14878,7855,7023,111.8
33043, 흥덕구,020001, 15세,2018,2647,1382,1265,109.2,2626,1371,1255,109.2
33043, 흥덕구,020002, 16세,2018,2652,1395,1257,111,2640,1388,1252,110.9
33043, 흥덕구,020003, 17세,2018,3010,1600,1410,113.5,2990,1587,1403,113.1
33043, 흥덕구,020004, 18세,2018,3432,1848,1584,116.7,3396,1831,1565,117
33043, 흥덕구,020005, 19세,2018,3301,1721,1580,108.9,3226,1678,1548,108.4
33043, 흥덕구,025,20~24세,2018,19960,10377,9583,108.3,19169,9913,9256,107.1
33043, 흥덕구,025001, 20세,2018,3650,1822,1828,99.7,3556,1762,1794,98.2
33043, 흥덕구,025002, 21세,2018,3809,1918,1891,101.4,3699,1856,1843,100.7
33043, 흥덕구,025003, 22세,2018,4115,2132,1983,107.5,3948,2034,1914,106.3
33043, 흥덕구,025004, 23세,2018,4100,2173,1927,112.8,3898,2051,1847,111
33043, 흥덕구,025005, 24세,2018,4286,2332,1954,119.3,4068,2210,1858,118.9
33043, 흥덕구,030,25~29세,2018,21126,11467,9659,118.7,19910,10787,9123,118.2
33043, 흥덕구,030001, 25세,2018,4407,2448,1959,125,4183,2326,1857,125.3
33043, 흥덕구,030002, 26세,2018,4410,2439,1971,123.7,4176,2304,1872,123.1
33043, 흥덕구,030003, 27세,2018,4199,2243,1956,114.7,3963,2119,1844,114.9
33043, 흥덕구,030004, 28세,2018,4108,2220,1888,117.6,3838,2068,1770,116.8
33043, 흥덕구,030005, 29세,2018,4002,2117,1885,112.3,3750,1970,1780,110.7
33043, 흥덕구,035,30~34세,2018,19007,10008,8999,111.2,17845,9334,8511,109.7
33043, 흥덕구,035001, 30세,2018,3824,2005,1819,110.2,3599,1872,1727,108.4
33043, 흥덕구,035002, 31세,2018,3788,2020,1768,114.3,3522,1875,1647,113.8
33043, 흥덕구,035003, 32세,2018,3848,2046,1802,113.5,3587,1875,1712,109.5
33043, 흥덕구,035004, 33세,2018,3706,1956,1750,111.8,3481,1839,1642,112
33043, 흥덕구,035005, 34세,2018,3841,1981,1860,106.5,3656,1873,1783,105
33043, 흥덕구,040,35~39세,2018,21626,11125,10501,105.9,20756,10581,10175,104
33043, 흥덕구,040001, 35세,2018,4278,2223,2055,108.2,4065,2085,1980,105.3
33043, 흥덕구,040002, 36세,2018,4612,2333,2279,102.4,4436,2227,2209,100.8
33043, 흥덕구,040003, 37세,2018,4235,2203,2032,108.4,4055,2094,1961,106.8
33043, 흥덕구,040004, 38세,2018,4346,2224,2122,104.8,4205,2136,2069,103.2
33043, 흥덕구,040005, 39세,2018,4155,2142,2013,106.4,3995,2039,1956,104.2
33043, 흥덕구,045,40~44세,2018,20495,10342,10153,101.9,19866,9967,9899,100.7
33043, 흥덕구,045001, 40세,2018,3896,2029,1867,108.7,3732,1921,1811,106.1
33043, 흥덕구,045002, 41세,2018,4019,1992,2027,98.3,3894,1914,1980,96.7
33043, 흥덕구,045003, 42세,2018,3891,1972,1919,102.8,3773,1899,1874,101.3
33043, 흥덕구,045004, 43세,2018,4175,2100,2075,101.2,4068,2048,2020,101.4
33043, 흥덕구,045005, 44세,2018,4514,2249,2265,99.3,4399,2185,2214,98.7
33043, 흥덕구,050,45~49세,2018,22907,11584,11323,102.3,22288,11236,11052,101.7
33043, 흥덕구,050001, 45세,2018,4513,2260,2253,100.3,4403,2198,2205,99.7
33043, 흥덕구,050002, 46세,2018,4178,2134,2044,104.4,4062,2075,1987,104.4
33043, 흥덕구,050003, 47세,2018,4658,2414,2244,107.6,4517,2330,2187,106.5
33043, 흥덕구,050004, 48세,2018,4610,2318,2292,101.1,4483,2242,2241,100
33043, 흥덕구,050005, 49세,2018,4948,2458,2490,98.7,4823,2391,2432,98.3
33043, 흥덕구,055,50~54세,2018,20908,10403,10505,99,20409,10147,10262,98.9
33043, 흥덕구,055001, 50세,2018,4685,2276,2409,94.5,4558,2215,2343,94.5
33043, 흥덕구,055002, 51세,2018,4161,2112,2049,103.1,4084,2066,2018,102.4
33043, 흥덕구,055003, 52세,2018,4106,2034,2072,98.2,4005,1987,2018,98.5
33043, 흥덕구,055004, 53세,2018,4241,2062,2179,94.6,4135,2002,2133,93.9
33043, 흥덕구,055005, 54세,2018,3715,1919,1796,106.8,3627,1877,1750,107.3
33043, 흥덕구,060,55~59세,2018,20047,10186,9861,103.3,19588,9968,9620,103.6
33043, 흥덕구,060001, 55세,2018,3895,2008,1887,106.4,3761,1940,1821,106.5
33043, 흥덕구,060002, 56세,2018,4157,2129,2028,105,4066,2089,1977,105.7
33043, 흥덕구,060003, 57세,2018,4564,2322,2242,103.6,4493,2289,2204,103.9
33043, 흥덕구,060004, 58세,2018,3856,1920,1936,99.2,3770,1874,1896,98.8
33043, 흥덕구,060005, 59세,2018,3575,1807,1768,102.2,3498,1776,1722,103.1
33043, 흥덕구,065,60~64세,2018,14621,7251,7370,98.4,14311,7103,7208,98.5
33043, 흥덕구,065001, 60세,2018,3388,1722,1666,103.4,3314,1693,1621,104.4
33043, 흥덕구,065002, 61세,2018,3198,1543,1655,93.2,3124,1510,1614,93.6
33043, 흥덕구,065003, 62세,2018,2870,1478,1392,106.2,2806,1443,1363,105.9
33043, 흥덕구,065004, 63세,2018,2790,1362,1428,95.4,2744,1336,1408,94.9
33043, 흥덕구,065005, 64세,2018,2375,1146,1229,93.2,2323,1121,1202,93.3
33043, 흥덕구,070,65~69세,2018,8659,4287,4372,98.1,8527,4224,4303,98.2
33043, 흥덕구,070001, 65세,2018,1959,999,960,104.1,1926,983,943,104.2
33043, 흥덕구,070002, 66세,2018,2143,1043,1100,94.8,2110,1026,1084,94.6
33043, 흥덕구,070003, 67세,2018,1472,710,762,93.2,1440,694,746,93
33043, 흥덕구,070004, 68세,2018,1505,749,756,99.1,1491,744,747,99.6
33043, 흥덕구,070005, 69세,2018,1580,786,794,99,1560,777,783,99.2
33043, 흥덕구,075,70~74세,2018,6072,2818,3254,86.6,6041,2805,3236,86.7
33043, 흥덕구,075001, 70세,2018,1456,720,736,97.8,1447,714,733,97.4
33043, 흥덕구,075002, 71세,2018,1368,634,734,86.4,1363,632,731,86.5
33043, 흥덕구,075003, 72세,2018,1047,494,553,89.3,1041,493,548,90
33043, 흥덕구,075004, 73세,2018,1124,531,593,89.5,1117,528,589,89.6
33043, 흥덕구,075005, 74세,2018,1077,439,638,68.8,1073,438,635,69
33043, 흥덕구,080,75~79세,2018,5224,2140,3084,69.4,5210,2133,3077,69.3
33043, 흥덕구,080001, 75세,2018,1155,489,666,73.4,1149,485,664,73
33043, 흥덕구,080002, 76세,2018,1264,554,710,78,1262,553,709,78
33043, 흥덕구,080003, 77세,2018,1002,391,611,64,999,390,609,64
33043, 흥덕구,080004, 78세,2018,878,360,518,69.5,877,359,518,69.3
33043, 흥덕구,080005, 79세,2018,925,346,579,59.8,923,346,577,60
33043, 흥덕구,085,80~84세,2018,3489,1220,2269,53.8,3484,1218,2266,53.8
33043, 흥덕구,085001, 80세,2018,768,282,486,58,768,282,486,58
33043, 흥덕구,085002, 81세,2018,750,278,472,58.9,750,278,472,58.9
33043, 흥덕구,085003, 82세,2018,752,252,500,50.4,749,252,497,50.7
33043, 흥덕구,085004, 83세,2018,693,237,456,52,693,237,456,52
33043, 흥덕구,085005, 84세,2018,526,171,355,48.2,524,169,355,47.6
33043, 흥덕구,090,85~89세,2018,1578,411,1167,35.2,1573,411,1162,35.4
33043, 흥덕구,090001, 85세,2018,468,150,318,47.2,467,150,317,47.3
33043, 흥덕구,090002, 86세,2018,385,88,297,29.6,383,88,295,29.8
33043, 흥덕구,090003, 87세,2018,255,71,184,38.6,254,71,183,38.8
33043, 흥덕구,090004, 88세,2018,267,57,210,27.1,267,57,210,27.1
33043, 흥덕구,090005, 89세,2018,203,45,158,28.5,202,45,157,28.7
33043, 흥덕구,095,90~94세,2018,482,101,381,26.5,481,100,381,26.2
33043, 흥덕구,095001, 90세,2018,163,35,128,27.3,163,35,128,27.3
33043, 흥덕구,095002, 91세,2018,115,28,87,32.2,115,28,87,32.2
33043, 흥덕구,095003, 92세,2018,79,11,68,16.2,79,11,68,16.2
33043, 흥덕구,095004, 93세,2018,89,17,72,23.6,89,17,72,23.6
33043, 흥덕구,095005, 94세,2018,36,10,26,38.5,35,9,26,34.6
33043, 흥덕구,100,95~99세,2018,127,27,100,27,127,27,100,27
33043, 흥덕구,100001, 95세,2018,47,14,33,42.4,47,14,33,42.4
33043, 흥덕구,100002, 96세,2018,38,6,32,18.8,38,6,32,18.8
33043, 흥덕구,100003, 97세,2018,17,5,12,41.7,17,5,12,41.7
33043, 흥덕구,100004, 98세,2018,15,X,14,7.1,15,X,14,7.1
33043, 흥덕구,100005, 99세,2018,10,X,9,11.1,10,X,9,11.1
33043, 흥덕구,101,100세이상,2018,15,X,12,25,15,X,12,25
33043, 흥덕구,102,15세미만,2018,36652,18925,17727,106.8,36212,18686,17526,106.6
33043, 흥덕구,103,15~64세,2018,195739,100689,95050,105.9,189020,96891,92129,105.2
33043, 흥덕구,104,65세이상,2018,25646,11007,14639,75.2,25458,10921,14537,75.1
33043, 흥덕구,086,85세이상,2018,2202,542,1660,32.7,2196,541,1655,32.7
33043, 흥덕구,126,평균연령,2018,38.9,37.9,39.9,,39,38,39.9,
33043, 흥덕구,127,중위연령,2018,38.9,37.9,40.1,,39.1,38.1,40.3,
33044, 청원구,000,합계,2018,200470,102670,97800,105,194829,99284,95545,103.9
33044, 청원구,005,0~4세,2018,11498,5838,5660,103.1,11413,5792,5621,103
33044, 청원구,005001, 0세,2018,2102,1072,1030,104.1,2081,1059,1022,103.6
33044, 청원구,005002, 1세,2018,2117,1083,1034,104.7,2101,1072,1029,104.2
33044, 청원구,005003, 2세,2018,2474,1244,1230,101.1,2460,1236,1224,101
33044, 청원구,005004, 3세,2018,2452,1263,1189,106.2,2434,1254,1180,106.3
33044, 청원구,005005, 4세,2018,2353,1176,1177,99.9,2337,1171,1166,100.4
33044, 청원구,010,5~9세,2018,11352,5824,5528,105.4,11318,5810,5508,105.5
33044, 청원구,010001, 5세,2018,2305,1192,1113,107.1,2296,1188,1108,107.2
33044, 청원구,010002, 6세,2018,2522,1281,1241,103.2,2514,1276,1238,103.1
33044, 청원구,010003, 7세,2018,2301,1164,1137,102.4,2292,1161,1131,102.7
33044, 청원구,010004, 8세,2018,2149,1096,1053,104.1,2143,1094,1049,104.3
33044, 청원구,010005, 9세,2018,2075,1091,984,110.9,2073,1091,982,111.1
33044, 청원구,015,10~14세,2018,9681,4989,4692,106.3,9656,4980,4676,106.5
33044, 청원구,015001, 10세,2018,2088,1060,1028,103.1,2082,1057,1025,103.1
33044, 청원구,015002, 11세,2018,2154,1059,1095,96.7,2148,1059,1089,97.2
33044, 청원구,015003, 12세,2018,1844,973,871,111.7,1841,971,870,111.6
33044, 청원구,015004, 13세,2018,1793,953,840,113.5,1785,949,836,113.5
33044, 청원구,015005, 14세,2018,1802,944,858,110,1800,944,856,110.3
33044, 청원구,020,15~19세,2018,11155,5814,5341,108.9,10944,5715,5229,109.3
33044, 청원구,020001, 15세,2018,1825,948,877,108.1,1821,946,875,108.1
33044, 청원구,020002, 16세,2018,1923,1028,895,114.9,1916,1025,891,115
33044, 청원구,020003, 17세,2018,2168,1108,1060,104.5,2154,1099,1055,104.2
33044, 청원구,020004, 18세,2018,2471,1256,1215,103.4,2425,1237,1188,104.1
33044, 청원구,020005, 19세,2018,2768,1474,1294,113.9,2628,1408,1220,115.4
33044, 청원구,025,20~24세,2018,13813,7392,6421,115.1,12938,6859,6079,112.8
33044, 청원구,025001, 20세,2018,2655,1340,1315,101.9,2529,1266,1263,100.2
33044, 청원구,025002, 21세,2018,2759,1383,1376,100.5,2617,1302,1315,99
33044, 청원구,025003, 22세,2018,2823,1534,1289,119,2636,1427,1209,118
33044, 청원구,025004, 23세,2018,2749,1522,1227,124,2538,1382,1156,119.6
33044, 청원구,025005, 24세,2018,2827,1613,1214,132.9,2618,1482,1136,130.5
33044, 청원구,030,25~29세,2018,14469,8272,6197,133.5,13517,7639,5878,130
33044, 청원구,030001, 25세,2018,2902,1613,1289,125.1,2740,1495,1245,120.1
33044, 청원구,030002, 26세,2018,2914,1732,1182,146.5,2717,1593,1124,141.7
33044, 청원구,030003, 27세,2018,2921,1698,1223,138.8,2714,1559,1155,135
33044, 청원구,030004, 28세,2018,2811,1587,1224,129.7,2606,1472,1134,129.8
33044, 청원구,030005, 29세,2018,2921,1642,1279,128.4,2740,1520,1220,124.6
33044, 청원구,035,30~34세,2018,16575,8957,7618,117.6,15706,8403,7303,115.1
33044, 청원구,035001, 30세,2018,3048,1652,1396,118.3,2861,1536,1325,115.9
33044, 청원구,035002, 31세,2018,3189,1689,1500,112.6,2998,1570,1428,109.9
33044, 청원구,035003, 32세,2018,3351,1859,1492,124.6,3181,1745,1436,121.5
33044, 청원구,035004, 33세,2018,3404,1788,1616,110.6,3235,1684,1551,108.6
33044, 청원구,035005, 34세,2018,3583,1969,1614,122,3431,1868,1563,119.5
33044, 청원구,040,35~39세,2018,19416,10361,9055,114.4,18744,9935,8809,112.8
33044, 청원구,040001, 35세,2018,3821,2019,1802,112,3659,1915,1744,109.8
33044, 청원구,040002, 36세,2018,4206,2201,2005,109.8,4050,2106,1944,108.3
33044, 청원구,040003, 37세,2018,3705,1990,1715,116,3586,1914,1672,114.5
33044, 청원구,040004, 38세,2018,4025,2190,1835,119.3,3906,2113,1793,117.8
33044, 청원구,040005, 39세,2018,3659,1961,1698,115.5,3543,1887,1656,113.9
33044, 청원구,045,40~44세,2018,16199,8530,7669,111.2,15735,8244,7491,110.1
33044, 청원구,045001, 40세,2018,3213,1732,1481,116.9,3114,1677,1437,116.7
33044, 청원구,045002, 41세,2018,3279,1729,1550,111.5,3164,1654,1510,109.5
33044, 청원구,045003, 42세,2018,3182,1667,1515,110,3087,1605,1482,108.3
33044, 청원구,045004, 43세,2018,3169,1599,1570,101.8,3086,1550,1536,100.9
33044, 청원구,045005, 44세,2018,3356,1803,1553,116.1,3284,1758,1526,115.2
33044, 청원구,050,45~49세,2018,15630,8174,7456,109.6,15157,7883,7274,108.4
33044, 청원구,050001, 45세,2018,3191,1663,1528,108.8,3082,1604,1478,108.5
33044, 청원구,050002, 46세,2018,2980,1544,1436,107.5,2879,1483,1396,106.2
33044, 청원구,050003, 47세,2018,3239,1698,1541,110.2,3153,1646,1507,109.2
33044, 청원구,050004, 48세,2018,2943,1545,1398,110.5,2854,1486,1368,108.6
33044, 청원구,050005, 49세,2018,3277,1724,1553,111,3189,1664,1525,109.1
33044, 청원구,055,50~54세,2018,13836,7001,6835,102.4,13468,6814,6654,102.4
33044, 청원구,055001, 50세,2018,3124,1544,1580,97.7,3045,1500,1545,97.1
33044, 청원구,055002, 51세,2018,2791,1437,1354,106.1,2733,1407,1326,106.1
33044, 청원구,055003, 52세,2018,2762,1407,1355,103.8,2685,1376,1309,105.1
33044, 청원구,055004, 53세,2018,2818,1426,1392,102.4,2722,1375,1347,102.1
33044, 청원구,055005, 54세,2018,2341,1187,1154,102.9,2283,1156,1127,102.6
33044, 청원구,060,55~59세,2018,13595,6798,6797,100,13329,6657,6672,99.8
33044, 청원구,060001, 55세,2018,2450,1291,1159,111.4,2378,1251,1127,111
33044, 청원구,060002, 56세,2018,2721,1424,1297,109.8,2672,1400,1272,110.1
33044, 청원구,060003, 57세,2018,3078,1482,1596,92.9,3041,1462,1579,92.6
33044, 청원구,060004, 58세,2018,2730,1333,1397,95.4,2668,1298,1370,94.7
33044, 청원구,060005, 59세,2018,2616,1268,1348,94.1,2570,1246,1324,94.1
33044, 청원구,065,60~64세,2018,10907,5334,5573,95.7,10714,5232,5482,95.4
33044, 청원구,065001, 60세,2018,2427,1205,1222,98.6,2381,1185,1196,99.1
33044, 청원구,065002, 61세,2018,2380,1184,1196,99,2327,1157,1170,98.9
33044, 청원구,065003, 62세,2018,2208,1108,1100,100.7,2167,1084,1083,100.1
33044, 청원구,065004, 63세,2018,2158,1037,1121,92.5,2125,1020,1105,92.3
33044, 청원구,065005, 64세,2018,1734,800,934,85.7,1714,786,928,84.7
33044, 청원구,070,65~69세,2018,6760,3335,3425,97.4,6666,3292,3374,97.6
33044, 청원구,070001, 65세,2018,1577,773,804,96.1,1550,763,787,97
33044, 청원구,070002, 66세,2018,1666,849,817,103.9,1642,837,805,104
33044, 청원구,070003, 67세,2018,1144,550,594,92.6,1128,542,586,92.5
33044, 청원구,070004, 68세,2018,1165,564,601,93.8,1155,561,594,94.4
33044, 청원구,070005, 69세,2018,1208,599,609,98.4,1191,589,602,97.8
33044, 청원구,075,70~74세,2018,5288,2408,2880,83.6,5256,2392,2864,83.5
33044, 청원구,075001, 70세,2018,1252,601,651,92.3,1245,597,648,92.1
33044, 청원구,075002, 71세,2018,1179,547,632,86.6,1169,543,626,86.7
33044, 청원구,075003, 72세,2018,945,431,514,83.9,939,429,510,84.1
33044, 청원구,075004, 73세,2018,962,437,525,83.2,955,432,523,82.6
33044, 청원구,075005, 74세,2018,950,392,558,70.3,948,391,557,70.2
33044, 청원구,080,75~79세,2018,4843,2010,2833,70.9,4833,2007,2826,71
33044, 청원구,080001, 75세,2018,1001,451,550,82,1000,450,550,81.8
33044, 청원구,080002, 76세,2018,1206,510,696,73.3,1205,509,696,73.1
33044, 청원구,080003, 77세,2018,904,365,539,67.7,901,365,536,68.1
33044, 청원구,080004, 78세,2018,859,337,522,64.6,858,337,521,64.7
33044, 청원구,080005, 79세,2018,873,347,526,66,869,346,523,66.2
33044, 청원구,085,80~84세,2018,3298,1108,2190,50.6,3285,1107,2178,50.8
33044, 청원구,085001, 80세,2018,803,282,521,54.1,802,282,520,54.2
33044, 청원구,085002, 81세,2018,709,263,446,59,709,263,446,59
33044, 청원구,085003, 82세,2018,678,215,463,46.4,671,214,457,46.8
33044, 청원구,085004, 83세,2018,580,184,396,46.5,576,184,392,46.9
33044, 청원구,085005, 84세,2018,528,164,364,45.1,527,164,363,45.2
33044, 청원구,090,85~89세,2018,1557,412,1145,36,1552,410,1142,35.9
33044, 청원구,090001, 85세,2018,443,125,318,39.3,443,125,318,39.3
33044, 청원구,090002, 86세,2018,355,115,240,47.9,354,114,240,47.5
33044, 청원구,090003, 87세,2018,264,70,194,36.1,264,70,194,36.1
33044, 청원구,090004, 88세,2018,252,55,197,27.9,249,54,195,27.7
33044, 청원구,090005, 89세,2018,243,47,196,24,242,47,195,24.1
33044, 청원구,095,90~94세,2018,469,95,374,25.4,469,95,374,25.4
33044, 청원구,095001, 90세,2018,152,28,124,22.6,152,28,124,22.6
33044, 청원구,095002, 91세,2018,132,25,107,23.4,132,25,107,23.4
33044, 청원구,095003, 92세,2018,70,19,51,37.3,70,19,51,37.3
33044, 청원구,095004, 93세,2018,67,14,53,26.4,67,14,53,26.4
33044, 청원구,095005, 94세,2018,48,9,39,23.1,48,9,39,23.1
33044, 청원구,100,95~99세,2018,115,17,98,17.3,115,17,98,17.3
33044, 청원구,100001, 95세,2018,45,7,38,18.4,45,7,38,18.4
33044, 청원구,100002, 96세,2018,26,X,22,18.2,26,X,22,18.2
33044, 청원구,100003, 97세,2018,21,X,17,23.5,21,X,17,23.5
33044, 청원구,100004, 98세,2018,15,X,14,7.1,15,X,14,7.1
33044, 청원구,100005, 99세,2018,8,X,7,14.3,8,X,7,14.3
33044, 청원구,101,100세이상,2018,14,X,13,7.7,14,X,13,7.7
33044, 청원구,102,15세미만,2018,32531,16651,15880,104.9,32387,16582,15805,104.9
33044, 청원구,103,15~64세,2018,145595,76633,68962,111.1,140252,73381,66871,109.7
33044, 청원구,104,65세이상,2018,22344,9386,12958,72.4,22190,9321,12869,72.4
33044, 청원구,086,85세이상,2018,2155,525,1630,32.2,2150,523,1627,32.1
33044, 청원구,126,평균연령,2018,38.4,37.3,39.6,,38.5,37.4,39.6,
33044, 청원구,127,중위연령,2018,38,37,39.1,,38.2,37.2,39.2,
33320, 보은군,000,합계,2018,32507,16357,16150,101.3,31852,16037,15815,101.4
33320, 보은군,005,0~4세,2018,816,423,393,107.6,811,420,391,107.4
33320, 보은군,005001, 0세,2018,178,83,95,87.4,178,83,95,87.4
33320, 보은군,005002, 1세,2018,154,81,73,111,153,80,73,109.6
33320, 보은군,005003, 2세,2018,180,101,79,127.8,177,100,77,129.9
33320, 보은군,005004, 3세,2018,155,78,77,101.3,154,77,77,100
33320, 보은군,005005, 4세,2018,149,80,69,115.9,149,80,69,115.9
33320, 보은군,010,5~9세,2018,904,473,431,109.7,902,472,430,109.8
33320, 보은군,010001, 5세,2018,162,73,89,82,161,72,89,80.9
33320, 보은군,010002, 6세,2018,165,90,75,120,165,90,75,120
33320, 보은군,010003, 7세,2018,198,102,96,106.3,198,102,96,106.3
33320, 보은군,010004, 8세,2018,194,116,78,148.7,194,116,78,148.7
33320, 보은군,010005, 9세,2018,185,92,93,98.9,184,92,92,100
33320, 보은군,015,10~14세,2018,1001,549,452,121.5,999,547,452,121
33320, 보은군,015001, 10세,2018,173,91,82,111,173,91,82,111
33320, 보은군,015002, 11세,2018,196,114,82,139,196,114,82,139
33320, 보은군,015003, 12세,2018,178,103,75,137.3,177,102,75,136
33320, 보은군,015004, 13세,2018,221,129,92,140.2,221,129,92,140.2
33320, 보은군,015005, 14세,2018,233,112,121,92.6,232,111,121,91.7
33320, 보은군,020,15~19세,2018,1286,685,601,114,1283,684,599,114.2
33320, 보은군,020001, 15세,2018,254,128,126,101.6,253,127,126,100.8
33320, 보은군,020002, 16세,2018,295,144,151,95.4,295,144,151,95.4
33320, 보은군,020003, 17세,2018,307,173,134,129.1,306,173,133,130.1
33320, 보은군,020004, 18세,2018,251,132,119,110.9,251,132,119,110.9
33320, 보은군,020005, 19세,2018,179,108,71,152.1,178,108,70,154.3
33320, 보은군,025,20~24세,2018,1236,757,479,158,1164,713,451,158.1
33320, 보은군,025001, 20세,2018,228,149,79,188.6,224,145,79,183.5
33320, 보은군,025002, 21세,2018,259,174,85,204.7,246,166,80,207.5
33320, 보은군,025003, 22세,2018,263,153,110,139.1,247,141,106,133
33320, 보은군,025004, 23세,2018,257,143,114,125.4,234,132,102,129.4
33320, 보은군,025005, 24세,2018,229,138,91,151.6,213,129,84,153.6
33320, 보은군,030,25~29세,2018,1289,724,565,128.1,1172,670,502,133.5
33320, 보은군,030001, 25세,2018,272,157,115,136.5,255,152,103,147.6
33320, 보은군,030002, 26세,2018,290,162,128,126.6,265,152,113,134.5
33320, 보은군,030003, 27세,2018,243,140,103,135.9,214,122,92,132.6
33320, 보은군,030004, 28세,2018,241,127,114,111.4,221,117,104,112.5
33320, 보은군,030005, 29세,2018,243,138,105,131.4,217,127,90,141.1
33320, 보은군,035,30~34세,2018,1237,699,538,129.9,1144,654,490,133.5
33320, 보은군,035001, 30세,2018,224,127,97,130.9,206,118,88,134.1
33320, 보은군,035002, 31세,2018,243,142,101,140.6,226,135,91,148.4
33320, 보은군,035003, 32세,2018,239,139,100,139,219,127,92,138
33320, 보은군,035004, 33세,2018,278,159,119,133.6,256,149,107,139.3
33320, 보은군,035005, 34세,2018,253,132,121,109.1,237,125,112,111.6
33320, 보은군,040,35~39세,2018,1464,842,622,135.4,1372,795,577,137.8
33320, 보은군,040001, 35세,2018,267,160,107,149.5,243,142,101,140.6
33320, 보은군,040002, 36세,2018,310,169,141,119.9,287,161,126,127.8
33320, 보은군,040003, 37세,2018,322,191,131,145.8,303,181,122,148.4
33320, 보은군,040004, 38세,2018,263,143,120,119.2,251,139,112,124.1
33320, 보은군,040005, 39세,2018,302,179,123,145.5,288,172,116,148.3
33320, 보은군,045,40~44세,2018,1500,838,662,126.6,1445,812,633,128.3
33320, 보은군,045001, 40세,2018,250,145,105,138.1,236,138,98,140.8
33320, 보은군,045002, 41세,2018,265,142,123,115.4,252,137,115,119.1
33320, 보은군,045003, 42세,2018,322,191,131,145.8,314,186,128,145.3
33320, 보은군,045004, 43세,2018,296,151,145,104.1,283,147,136,108.1
33320, 보은군,045005, 44세,2018,367,209,158,132.3,360,204,156,130.8
33320, 보은군,050,45~49세,2018,2049,1134,915,123.9,1995,1112,883,125.9
33320, 보은군,050001, 45세,2018,379,208,171,121.6,372,207,165,125.5
33320, 보은군,050002, 46세,2018,377,214,163,131.3,370,212,158,134.2
33320, 보은군,050003, 47세,2018,444,250,194,128.9,431,244,187,130.5
33320, 보은군,050004, 48세,2018,419,228,191,119.4,402,218,184,118.5
33320, 보은군,050005, 49세,2018,430,234,196,119.4,420,231,189,122.2
33320, 보은군,055,50~54세,2018,2562,1403,1159,121.1,2491,1366,1125,121.4
33320, 보은군,055001, 50세,2018,480,249,231,107.8,467,241,226,106.6
33320, 보은군,055002, 51세,2018,486,270,216,125,480,268,212,126.4
33320, 보은군,055003, 52세,2018,544,314,230,136.5,523,305,218,139.9
33320, 보은군,055004, 53세,2018,559,308,251,122.7,542,298,244,122.1
33320, 보은군,055005, 54세,2018,493,262,231,113.4,479,254,225,112.9
33320, 보은군,060,55~59세,2018,3388,1788,1600,111.8,3341,1767,1574,112.3
33320, 보은군,060001, 55세,2018,547,300,247,121.5,536,294,242,121.5
33320, 보은군,060002, 56세,2018,683,377,306,123.2,674,373,301,123.9
33320, 보은군,060003, 57세,2018,802,427,375,113.9,792,423,369,114.6
33320, 보은군,060004, 58세,2018,685,331,354,93.5,676,327,349,93.7
33320, 보은군,060005, 59세,2018,671,353,318,111,663,350,313,111.8
33320, 보은군,065,60~64세,2018,3500,1789,1711,104.6,3475,1779,1696,104.9
33320, 보은군,065001, 60세,2018,733,395,338,116.9,727,392,335,117
33320, 보은군,065002, 61세,2018,697,355,342,103.8,692,353,339,104.1
33320, 보은군,065003, 62세,2018,731,377,354,106.5,728,375,353,106.2
33320, 보은군,065004, 63세,2018,702,342,360,95,694,339,355,95.5
33320, 보은군,065005, 64세,2018,637,320,317,100.9,634,320,314,101.9
33320, 보은군,070,65~69세,2018,2485,1251,1234,101.4,2475,1244,1231,101.1
33320, 보은군,070001, 65세,2018,516,255,261,97.7,512,253,259,97.7
33320, 보은군,070002, 66세,2018,568,288,280,102.9,567,288,279,103.2
33320, 보은군,070003, 67세,2018,428,219,209,104.8,427,218,209,104.3
33320, 보은군,070004, 68세,2018,466,229,237,96.6,463,226,237,95.4
33320, 보은군,070005, 69세,2018,507,260,247,105.3,506,259,247,104.9
33320, 보은군,075,70~74세,2018,2080,974,1106,88.1,2076,974,1102,88.4
33320, 보은군,075001, 70세,2018,461,234,227,103.1,459,234,225,104
33320, 보은군,075002, 71세,2018,459,217,242,89.7,458,217,241,90
33320, 보은군,075003, 72세,2018,379,178,201,88.6,379,178,201,88.6
33320, 보은군,075004, 73세,2018,375,173,202,85.6,375,173,202,85.6
33320, 보은군,075005, 74세,2018,406,172,234,73.5,405,172,233,73.8
33320, 보은군,080,75~79세,2018,2446,971,1475,65.8,2444,971,1473,65.9
33320, 보은군,080001, 75세,2018,464,191,273,70,463,191,272,70.2
33320, 보은군,080002, 76세,2018,556,217,339,64,556,217,339,64
33320, 보은군,080003, 77세,2018,490,183,307,59.6,490,183,307,59.6
33320, 보은군,080004, 78세,2018,453,184,269,68.4,452,184,268,68.7
33320, 보은군,080005, 79세,2018,483,196,287,68.3,483,196,287,68.3
33320, 보은군,085,80~84세,2018,1927,692,1235,56,1926,692,1234,56.1
33320, 보은군,085001, 80세,2018,428,171,257,66.5,427,171,256,66.8
33320, 보은군,085002, 81세,2018,410,142,268,53,410,142,268,53
33320, 보은군,085003, 82세,2018,381,126,255,49.4,381,126,255,49.4
33320, 보은군,085004, 83세,2018,400,147,253,58.1,400,147,253,58.1
33320, 보은군,085005, 84세,2018,308,106,202,52.5,308,106,202,52.5
33320, 보은군,090,85~89세,2018,944,263,681,38.6,944,263,681,38.6
33320, 보은군,090001, 85세,2018,268,81,187,43.3,268,81,187,43.3
33320, 보은군,090002, 86세,2018,225,71,154,46.1,225,71,154,46.1
33320, 보은군,090003, 87세,2018,151,39,112,34.8,151,39,112,34.8
33320, 보은군,090004, 88세,2018,153,35,118,29.7,153,35,118,29.7
33320, 보은군,090005, 89세,2018,147,37,110,33.6,147,37,110,33.6
33320, 보은군,095,90~94세,2018,337,94,243,38.7,337,94,243,38.7
33320, 보은군,095001, 90세,2018,92,26,66,39.4,92,26,66,39.4
33320, 보은군,095002, 91세,2018,103,29,74,39.2,103,29,74,39.2
33320, 보은군,095003, 92세,2018,52,16,36,44.4,52,16,36,44.4
33320, 보은군,095004, 93세,2018,59,14,45,31.1,59,14,45,31.1
33320, 보은군,095005, 94세,2018,31,9,22,40.9,31,9,22,40.9
33320, 보은군,100,95~99세,2018,48,8,40,20,48,8,40,20
33320, 보은군,100001, 95세,2018,21,X,18,16.7,21,X,18,16.7
33320, 보은군,100002, 96세,2018,13,X,9,44.4,13,X,9,44.4
33320, 보은군,100003, 97세,2018,6,X,5,20,6,X,5,20
33320, 보은군,100004, 98세,2018,X,X,X,0,X,X,X,0
33320, 보은군,100005, 99세,2018,X,X,X,0,X,X,X,0
33320, 보은군,101,100세이상,2018,8,X,8,0,8,X,8,0
33320, 보은군,102,15세미만,2018,2721,1445,1276,113.2,2712,1439,1273,113
33320, 보은군,103,15~64세,2018,19511,10659,8852,120.4,18882,10352,8530,121.4
33320, 보은군,104,65세이상,2018,10275,4253,6022,70.6,10258,4246,6012,70.6
33320, 보은군,086,85세이상,2018,1337,365,972,37.6,1337,365,972,37.6
33320, 보은군,126,평균연령,2018,52.2,49.6,54.8,,52.5,49.9,55.1,
33320, 보은군,127,중위연령,2018,56.5,53.7,58.9,,56.9,54.1,59.4,
33330, 옥천군,000,합계,2018,49756,24997,24759,101,48739,24399,24340,100.2
33330, 옥천군,005,0~4세,2018,1194,609,585,104.1,1190,607,583,104.1
33330, 옥천군,005001, 0세,2018,179,94,85,110.6,178,94,84,111.9
33330, 옥천군,005002, 1세,2018,204,93,111,83.8,202,91,111,82
33330, 옥천군,005003, 2세,2018,256,141,115,122.6,256,141,115,122.6
33330, 옥천군,005004, 3세,2018,266,140,126,111.1,265,140,125,112
33330, 옥천군,005005, 4세,2018,289,141,148,95.3,289,141,148,95.3
33330, 옥천군,010,5~9세,2018,1713,893,820,108.9,1712,893,819,109
33330, 옥천군,010001, 5세,2018,296,154,142,108.5,296,154,142,108.5
33330, 옥천군,010002, 6세,2018,337,162,175,92.6,336,162,174,93.1
33330, 옥천군,010003, 7세,2018,386,214,172,124.4,386,214,172,124.4
33330, 옥천군,010004, 8세,2018,351,187,164,114,351,187,164,114
33330, 옥천군,010005, 9세,2018,343,176,167,105.4,343,176,167,105.4
33330, 옥천군,015,10~14세,2018,1828,951,877,108.4,1826,949,877,108.2
33330, 옥천군,015001, 10세,2018,374,186,188,98.9,374,186,188,98.9
33330, 옥천군,015002, 11세,2018,372,194,178,109,371,193,178,108.4
33330, 옥천군,015003, 12세,2018,368,196,172,114,367,195,172,113.4
33330, 옥천군,015004, 13세,2018,344,180,164,109.8,344,180,164,109.8
33330, 옥천군,015005, 14세,2018,370,195,175,111.4,370,195,175,111.4
33330, 옥천군,020,15~19세,2018,2166,1173,993,118.1,2160,1170,990,118.2
33330, 옥천군,020001, 15세,2018,369,197,172,114.5,369,197,172,114.5
33330, 옥천군,020002, 16세,2018,388,201,187,107.5,386,200,186,107.5
33330, 옥천군,020003, 17세,2018,519,274,245,111.8,517,273,244,111.9
33330, 옥천군,020004, 18세,2018,485,257,228,112.7,485,257,228,112.7
33330, 옥천군,020005, 19세,2018,405,244,161,151.6,403,243,160,151.9
33330, 옥천군,025,20~24세,2018,2474,1504,970,155.1,2355,1428,927,154
33330, 옥천군,025001, 20세,2018,484,291,193,150.8,472,282,190,148.4
33330, 옥천군,025002, 21세,2018,532,341,191,178.5,505,319,186,171.5
33330, 옥천군,025003, 22세,2018,511,309,202,153,489,295,194,152.1
33330, 옥천군,025004, 23세,2018,485,292,193,151.3,464,282,182,154.9
33330, 옥천군,025005, 24세,2018,462,271,191,141.9,425,250,175,142.9
33330, 옥천군,030,25~29세,2018,2025,1166,859,135.7,1816,1041,775,134.3
33330, 옥천군,030001, 25세,2018,433,253,180,140.6,398,233,165,141.2
33330, 옥천군,030002, 26세,2018,456,245,211,116.1,408,217,191,113.6
33330, 옥천군,030003, 27세,2018,392,237,155,152.9,354,216,138,156.5
33330, 옥천군,030004, 28세,2018,406,235,171,137.4,351,200,151,132.5
33330, 옥천군,030005, 29세,2018,338,196,142,138,305,175,130,134.6
33330, 옥천군,035,30~34세,2018,1930,1048,882,118.8,1738,919,819,112.2
33330, 옥천군,035001, 30세,2018,375,212,163,130.1,331,182,149,122.1
33330, 옥천군,035002, 31세,2018,349,187,162,115.4,304,156,148,105.4
33330, 옥천군,035003, 32세,2018,381,212,169,125.4,343,186,157,118.5
33330, 옥천군,035004, 33세,2018,379,204,175,116.6,345,183,162,113
33330, 옥천군,035005, 34세,2018,446,233,213,109.4,415,212,203,104.4
33330, 옥천군,040,35~39세,2018,2618,1421,1197,118.7,2470,1325,1145,115.7
33330, 옥천군,040001, 35세,2018,450,255,195,130.8,416,228,188,121.3
33330, 옥천군,040002, 36세,2018,562,301,261,115.3,520,276,244,113.1
33330, 옥천군,040003, 37세,2018,527,289,238,121.4,497,270,227,118.9
33330, 옥천군,040004, 38세,2018,554,281,273,102.9,532,266,266,100
33330, 옥천군,040005, 39세,2018,525,295,230,128.3,505,285,220,129.5
33330, 옥천군,045,40~44세,2018,2870,1547,1323,116.9,2786,1501,1285,116.8
33330, 옥천군,045001, 40세,2018,534,283,251,112.7,515,274,241,113.7
33330, 옥천군,045002, 41세,2018,537,298,239,124.7,518,286,232,123.3
33330, 옥천군,045003, 42세,2018,534,287,247,116.2,515,277,238,116.4
33330, 옥천군,045004, 43세,2018,598,325,273,119,582,316,266,118.8
33330, 옥천군,045005, 44세,2018,667,354,313,113.1,656,348,308,113
33330, 옥천군,050,45~49세,2018,3556,1936,1620,119.5,3479,1899,1580,120.2
33330, 옥천군,050001, 45세,2018,706,392,314,124.8,687,380,307,123.8
33330, 옥천군,050002, 46세,2018,621,344,277,124.2,607,339,268,126.5
33330, 옥천군,050003, 47세,2018,713,380,333,114.1,699,373,326,114.4
33330, 옥천군,050004, 48세,2018,686,387,299,129.4,670,381,289,131.8
33330, 옥천군,050005, 49세,2018,830,433,397,109.1,816,426,390,109.2
33330, 옥천군,055,50~54세,2018,3920,2028,1892,107.2,3857,1999,1858,107.6
33330, 옥천군,055001, 50세,2018,826,418,408,102.5,814,413,401,103
33330, 옥천군,055002, 51세,2018,762,394,368,107.1,744,385,359,107.2
33330, 옥천군,055003, 52세,2018,763,401,362,110.8,752,398,354,112.4
33330, 옥천군,055004, 53세,2018,807,414,393,105.3,798,409,389,105.1
33330, 옥천군,055005, 54세,2018,762,401,361,111.1,749,394,355,111
33330, 옥천군,060,55~59세,2018,4966,2539,2427,104.6,4918,2516,2402,104.7
33330, 옥천군,060001, 55세,2018,850,451,399,113,836,443,393,112.7
33330, 옥천군,060002, 56세,2018,983,532,451,118,974,527,447,117.9
33330, 옥천군,060003, 57세,2018,1129,552,577,95.7,1119,550,569,96.7
33330, 옥천군,060004, 58세,2018,1062,518,544,95.2,1053,513,540,95
33330, 옥천군,060005, 59세,2018,942,486,456,106.6,936,483,453,106.6
33330, 옥천군,065,60~64세,2018,4835,2426,2409,100.7,4805,2410,2395,100.6
33330, 옥천군,065001, 60세,2018,908,460,448,102.7,901,456,445,102.5
33330, 옥천군,065002, 61세,2018,1071,555,516,107.6,1068,554,514,107.8
33330, 옥천군,065003, 62세,2018,990,500,490,102,983,496,487,101.8
33330, 옥천군,065004, 63세,2018,963,461,502,91.8,954,456,498,91.6
33330, 옥천군,065005, 64세,2018,903,450,453,99.3,899,448,451,99.3
33330, 옥천군,070,65~69세,2018,3770,1906,1864,102.3,3753,1898,1855,102.3
33330, 옥천군,070001, 65세,2018,765,382,383,99.7,764,381,383,99.5
33330, 옥천군,070002, 66세,2018,881,423,458,92.4,874,420,454,92.5
33330, 옥천군,070003, 67세,2018,658,322,336,95.8,654,320,334,95.8
33330, 옥천군,070004, 68세,2018,748,403,345,116.8,746,402,344,116.9
33330, 옥천군,070005, 69세,2018,718,376,342,109.9,715,375,340,110.3
33330, 옥천군,075,70~74세,2018,2834,1319,1515,87.1,2821,1314,1507,87.2
33330, 옥천군,075001, 70세,2018,648,325,323,100.6,645,325,320,101.6
33330, 옥천군,075002, 71세,2018,644,297,347,85.6,641,295,346,85.3
33330, 옥천군,075003, 72세,2018,495,226,269,84,495,226,269,84
33330, 옥천군,075004, 73세,2018,499,242,257,94.2,495,241,254,94.9
33330, 옥천군,075005, 74세,2018,548,229,319,71.8,545,227,318,71.4
33330, 옥천군,080,75~79세,2018,3126,1263,1863,67.8,3124,1262,1862,67.8
33330, 옥천군,080001, 75세,2018,615,252,363,69.4,615,252,363,69.4
33330, 옥천군,080002, 76세,2018,850,355,495,71.7,850,355,495,71.7
33330, 옥천군,080003, 77세,2018,592,245,347,70.6,591,245,346,70.8
33330, 옥천군,080004, 78세,2018,490,194,296,65.5,489,193,296,65.2
33330, 옥천군,080005, 79세,2018,579,217,362,59.9,579,217,362,59.9
33330, 옥천군,085,80~84세,2018,2310,832,1478,56.3,2310,832,1478,56.3
33330, 옥천군,085001, 80세,2018,505,188,317,59.3,505,188,317,59.3
33330, 옥천군,085002, 81세,2018,462,192,270,71.1,462,192,270,71.1
33330, 옥천군,085003, 82세,2018,479,169,310,54.5,479,169,310,54.5
33330, 옥천군,085004, 83세,2018,477,158,319,49.5,477,158,319,49.5
33330, 옥천군,085005, 84세,2018,387,125,262,47.7,387,125,262,47.7
33330, 옥천군,090,85~89세,2018,1168,329,839,39.2,1167,329,838,39.3
33330, 옥천군,090001, 85세,2018,367,108,259,41.7,366,108,258,41.9
33330, 옥천군,090002, 86세,2018,255,76,179,42.5,255,76,179,42.5
33330, 옥천군,090003, 87세,2018,196,45,151,29.8,196,45,151,29.8
33330, 옥천군,090004, 88세,2018,196,54,142,38,196,54,142,38
33330, 옥천군,090005, 89세,2018,154,46,108,42.6,154,46,108,42.6
33330, 옥천군,095,90~94세,2018,356,90,266,33.8,355,90,265,34
33330, 옥천군,095001, 90세,2018,123,32,91,35.2,123,32,91,35.2
33330, 옥천군,095002, 91세,2018,106,24,82,29.3,106,24,82,29.3
33330, 옥천군,095003, 92세,2018,49,15,34,44.1,48,15,33,45.5
33330, 옥천군,095004, 93세,2018,49,13,36,36.1,49,13,36,36.1
33330, 옥천군,095005, 94세,2018,29,6,23,26.1,29,6,23,26.1
33330, 옥천군,100,95~99세,2018,86,16,70,22.9,86,16,70,22.9
33330, 옥천군,100001, 95세,2018,42,X,38,10.5,42,X,38,10.5
33330, 옥천군,100002, 96세,2018,21,5,16,31.3,21,5,16,31.3
33330, 옥천군,100003, 97세,2018,9,X,7,28.6,9,X,7,28.6
33330, 옥천군,100004, 98세,2018,9,X,5,80,9,X,5,80
33330, 옥천군,100005, 99세,2018,5,X,X,25,5,X,X,25
33330, 옥천군,101,100세이상,2018,11,X,10,10,11,X,10,10
33330, 옥천군,102,15세미만,2018,4735,2453,2282,107.5,4728,2449,2279,107.5
33330, 옥천군,103,15~64세,2018,31360,16788,14572,115.2,30384,16208,14176,114.3
33330, 옥천군,104,65세이상,2018,13661,5756,7905,72.8,13627,5742,7885,72.8
33330, 옥천군,086,85세이상,2018,1621,436,1185,36.8,1619,436,1183,36.9
33330, 옥천군,126,평균연령,2018,49.6,47.4,51.9,,49.9,47.7,52.1,
33330, 옥천군,127,중위연령,2018,53.2,50.6,55.9,,53.7,51.1,56.3,
33340, 영동군,000,합계,2018,48475,24151,24324,99.3,47675,23763,23912,99.4
33340, 영동군,005,0~4세,2018,1271,654,617,106,1270,654,616,106.2
33340, 영동군,005001, 0세,2018,286,161,125,128.8,285,161,124,129.8
33340, 영동군,005002, 1세,2018,247,114,133,85.7,247,114,133,85.7
33340, 영동군,005003, 2세,2018,224,118,106,111.3,224,118,106,111.3
33340, 영동군,005004, 3세,2018,245,128,117,109.4,245,128,117,109.4
33340, 영동군,005005, 4세,2018,269,133,136,97.8,269,133,136,97.8
33340, 영동군,010,5~9세,2018,1391,729,662,110.1,1389,727,662,109.8
33340, 영동군,010001, 5세,2018,243,123,120,102.5,243,123,120,102.5
33340, 영동군,010002, 6세,2018,282,134,148,90.5,281,133,148,89.9
33340, 영동군,010003, 7세,2018,299,160,139,115.1,299,160,139,115.1
33340, 영동군,010004, 8세,2018,305,172,133,129.3,304,171,133,128.6
33340, 영동군,010005, 9세,2018,262,140,122,114.8,262,140,122,114.8
33340, 영동군,015,10~14세,2018,1522,778,744,104.6,1521,777,744,104.4
33340, 영동군,015001, 10세,2018,273,152,121,125.6,272,151,121,124.8
33340, 영동군,015002, 11세,2018,324,175,149,117.4,324,175,149,117.4
33340, 영동군,015003, 12세,2018,297,145,152,95.4,297,145,152,95.4
33340, 영동군,015004, 13세,2018,286,149,137,108.8,286,149,137,108.8
33340, 영동군,015005, 14세,2018,342,157,185,84.9,342,157,185,84.9
33340, 영동군,020,15~19세,2018,2335,1242,1093,113.6,2322,1233,1089,113.2
33340, 영동군,020001, 15세,2018,336,170,166,102.4,335,170,165,103
33340, 영동군,020002, 16세,2018,372,193,179,107.8,372,193,179,107.8
33340, 영동군,020003, 17세,2018,433,223,210,106.2,431,221,210,105.2
33340, 영동군,020004, 18세,2018,519,290,229,126.6,516,287,229,125.3
33340, 영동군,020005, 19세,2018,675,366,309,118.4,668,362,306,118.3
33340, 영동군,025,20~24세,2018,3483,2062,1421,145.1,3382,2009,1373,146.3
33340, 영동군,025001, 20세,2018,690,376,314,119.7,674,365,309,118.1
33340, 영동군,025002, 21세,2018,707,365,342,106.7,686,353,333,106
33340, 영동군,025003, 22세,2018,727,409,318,128.6,713,404,309,130.7
33340, 영동군,025004, 23세,2018,704,450,254,177.2,677,437,240,182.1
33340, 영동군,025005, 24세,2018,655,462,193,239.4,632,450,182,247.3
33340, 영동군,030,25~29세,2018,2063,1213,850,142.7,1904,1129,775,145.7
33340, 영동군,030001, 25세,2018,498,296,202,146.5,460,282,178,158.4
33340, 영동군,030002, 26세,2018,452,274,178,153.9,419,254,165,153.9
33340, 영동군,030003, 27세,2018,401,248,153,162.1,366,226,140,161.4
33340, 영동군,030004, 28세,2018,359,209,150,139.3,332,190,142,133.8
33340, 영동군,030005, 29세,2018,353,186,167,111.4,327,177,150,118
33340, 영동군,035,30~34세,2018,1757,935,822,113.7,1619,864,755,114.4
33340, 영동군,035001, 30세,2018,351,191,160,119.4,320,175,145,120.7
33340, 영동군,035002, 31세,2018,354,169,185,91.4,318,156,162,96.3
33340, 영동군,035003, 32세,2018,365,209,156,134,338,190,148,128.4
33340, 영동군,035004, 33세,2018,332,177,155,114.2,314,169,145,116.6
33340, 영동군,035005, 34세,2018,355,189,166,113.9,329,174,155,112.3
33340, 영동군,040,35~39세,2018,2123,1067,1056,101,2032,1028,1004,102.4
33340, 영동군,040001, 35세,2018,394,192,202,95,378,185,193,95.9
33340, 영동군,040002, 36세,2018,412,206,206,100,389,197,192,102.6
33340, 영동군,040003, 37세,2018,418,219,199,110.1,400,211,189,111.6
33340, 영동군,040004, 38세,2018,453,236,217,108.8,439,230,209,110
33340, 영동군,040005, 39세,2018,446,214,232,92.2,426,205,221,92.8
33340, 영동군,045,40~44세,2018,2417,1315,1102,119.3,2348,1283,1065,120.5
33340, 영동군,045001, 40세,2018,441,224,217,103.2,423,211,212,99.5
33340, 영동군,045002, 41세,2018,405,225,180,125,392,219,173,126.6
33340, 영동군,045003, 42세,2018,454,247,207,119.3,437,242,195,124.1
33340, 영동군,045004, 43세,2018,534,292,242,120.7,525,290,235,123.4
33340, 영동군,045005, 44세,2018,583,327,256,127.7,571,321,250,128.4
33340, 영동군,050,45~49세,2018,3277,1772,1505,117.7,3219,1748,1471,118.8
33340, 영동군,050001, 45세,2018,645,350,295,118.6,630,342,288,118.8
33340, 영동군,050002, 46세,2018,565,297,268,110.8,551,292,259,112.7
33340, 영동군,050003, 47세,2018,640,349,291,119.9,630,346,284,121.8
33340, 영동군,050004, 48세,2018,687,374,313,119.5,674,368,306,120.3
33340, 영동군,050005, 49세,2018,740,402,338,118.9,734,400,334,119.8
33340, 영동군,055,50~54세,2018,3753,1984,1769,112.2,3689,1961,1728,113.5
33340, 영동군,055001, 50세,2018,760,408,352,115.9,745,402,343,117.2
33340, 영동군,055002, 51세,2018,731,389,342,113.7,726,388,338,114.8
33340, 영동군,055003, 52세,2018,772,408,364,112.1,756,405,351,115.4
33340, 영동군,055004, 53세,2018,793,436,357,122.1,786,432,354,122
33340, 영동군,055005, 54세,2018,697,343,354,96.9,676,334,342,97.7
33340, 영동군,060,55~59세,2018,4699,2362,2337,101.1,4659,2346,2313,101.4
33340, 영동군,060001, 55세,2018,753,386,367,105.2,746,381,365,104.4
33340, 영동군,060002, 56세,2018,931,475,456,104.2,924,474,450,105.3
33340, 영동군,060003, 57세,2018,1063,544,519,104.8,1056,542,514,105.4
33340, 영동군,060004, 58세,2018,1005,492,513,95.9,992,486,506,96
33340, 영동군,060005, 59세,2018,947,465,482,96.5,941,463,478,96.9
33340, 영동군,065,60~64세,2018,4545,2345,2200,106.6,4515,2328,2187,106.4
33340, 영동군,065001, 60세,2018,952,525,427,123,941,519,422,123
33340, 영동군,065002, 61세,2018,999,502,497,101,991,498,493,101
33340, 영동군,065003, 62세,2018,879,422,457,92.3,872,418,454,92.1
33340, 영동군,065004, 63세,2018,911,482,429,112.4,909,481,428,112.4
33340, 영동군,065005, 64세,2018,804,414,390,106.2,802,412,390,105.6
33340, 영동군,070,65~69세,2018,3583,1686,1897,88.9,3560,1675,1885,88.9
33340, 영동군,070001, 65세,2018,736,378,358,105.6,731,376,355,105.9
33340, 영동군,070002, 66세,2018,785,365,420,86.9,778,362,416,87
33340, 영동군,070003, 67세,2018,632,290,342,84.8,631,289,342,84.5
33340, 영동군,070004, 68세,2018,671,306,365,83.8,666,305,361,84.5
33340, 영동군,070005, 69세,2018,759,347,412,84.2,754,343,411,83.5
33340, 영동군,075,70~74세,2018,2939,1337,1602,83.5,2935,1335,1600,83.4
33340, 영동군,075001, 70세,2018,678,321,357,89.9,676,320,356,89.9
33340, 영동군,075002, 71세,2018,604,300,304,98.7,604,300,304,98.7
33340, 영동군,075003, 72세,2018,530,240,290,82.8,530,240,290,82.8
33340, 영동군,075004, 73세,2018,537,246,291,84.5,535,245,290,84.5
33340, 영동군,075005, 74세,2018,590,230,360,63.9,590,230,360,63.9
33340, 영동군,080,75~79세,2018,3381,1387,1994,69.6,3377,1384,1993,69.4
33340, 영동군,080001, 75세,2018,705,294,411,71.5,704,293,411,71.3
33340, 영동군,080002, 76세,2018,833,353,480,73.5,833,353,480,73.5
33340, 영동군,080003, 77세,2018,637,260,377,69,635,258,377,68.4
33340, 영동군,080004, 78세,2018,571,232,339,68.4,571,232,339,68.4
33340, 영동군,080005, 79세,2018,635,248,387,64.1,634,248,386,64.2
33340, 영동군,085,80~84세,2018,2408,860,1548,55.6,2408,860,1548,55.6
33340, 영동군,085001, 80세,2018,562,214,348,61.5,562,214,348,61.5
33340, 영동군,085002, 81세,2018,536,184,352,52.3,536,184,352,52.3
33340, 영동군,085003, 82세,2018,491,172,319,53.9,491,172,319,53.9
33340, 영동군,085004, 83세,2018,460,166,294,56.5,460,166,294,56.5
33340, 영동군,085005, 84세,2018,359,124,235,52.8,359,124,235,52.8
33340, 영동군,090,85~89세,2018,1056,302,754,40.1,1054,301,753,40
33340, 영동군,090001, 85세,2018,302,85,217,39.2,301,84,217,38.7
33340, 영동군,090002, 86세,2018,249,96,153,62.7,249,96,153,62.7
33340, 영동군,090003, 87세,2018,198,50,148,33.8,197,50,147,34
33340, 영동군,090004, 88세,2018,154,35,119,29.4,154,35,119,29.4
33340, 영동군,090005, 89세,2018,153,36,117,30.8,153,36,117,30.8
33340, 영동군,095,90~94세,2018,379,106,273,38.8,379,106,273,38.8
33340, 영동군,095001, 90세,2018,122,32,90,35.6,122,32,90,35.6
33340, 영동군,095002, 91세,2018,116,34,82,41.5,116,34,82,41.5
33340, 영동군,095003, 92세,2018,65,12,53,22.6,65,12,53,22.6
33340, 영동군,095004, 93세,2018,51,16,35,45.7,51,16,35,45.7
33340, 영동군,095005, 94세,2018,25,12,13,92.3,25,12,13,92.3
33340, 영동군,100,95~99세,2018,89,15,74,20.3,89,15,74,20.3
33340, 영동군,100001, 95세,2018,30,6,24,25,30,6,24,25
33340, 영동군,100002, 96세,2018,28,6,22,27.3,28,6,22,27.3
33340, 영동군,100003, 97세,2018,13,X,12,8.3,13,X,12,8.3
33340, 영동군,100004, 98세,2018,15,X,13,15.4,15,X,13,15.4
33340, 영동군,100005, 99세,2018,X,X,X,0,X,X,X,0
33340, 영동군,101,100세이상,2018,X,X,X,0,X,X,X,0
33340, 영동군,102,15세미만,2018,4184,2161,2023,106.8,4180,2158,2022,106.7
33340, 영동군,103,15~64세,2018,30452,16297,14155,115.1,29689,15929,13760,115.8
33340, 영동군,104,65세이상,2018,13839,5693,8146,69.9,13806,5676,8130,69.8
33340, 영동군,086,85세이상,2018,1528,423,1105,38.3,1526,422,1104,38.2
33340, 영동군,126,평균연령,2018,49.6,47.3,52,,49.8,47.5,52.2,
33340, 영동군,127,중위연령,2018,53.4,50.8,56.3,,53.8,51.1,56.7,
33350, 진천군,000,합계,2018,83915,45247,38668,117,75070,39083,35987,108.6
33350, 진천군,005,0~4세,2018,3618,1844,1774,103.9,3477,1763,1714,102.9
33350, 진천군,005001, 0세,2018,601,307,294,104.4,576,294,282,104.3
33350, 진천군,005002, 1세,2018,691,347,344,100.9,659,330,329,100.3
33350, 진천군,005003, 2세,2018,766,401,365,109.9,733,381,352,108.2
33350, 진천군,005004, 3세,2018,813,406,407,99.8,789,391,398,98.2
33350, 진천군,005005, 4세,2018,747,383,364,105.2,720,367,353,104
33350, 진천군,010,5~9세,2018,4018,2051,1967,104.3,3922,2009,1913,105
33350, 진천군,010001, 5세,2018,797,410,387,105.9,778,401,377,106.4
33350, 진천군,010002, 6세,2018,827,419,408,102.7,803,412,391,105.4
33350, 진천군,010003, 7세,2018,855,434,421,103.1,837,430,407,105.7
33350, 진천군,010004, 8세,2018,780,399,381,104.7,765,391,374,104.5
33350, 진천군,010005, 9세,2018,759,389,370,105.1,739,375,364,103
33350, 진천군,015,10~14세,2018,3704,1959,1745,112.3,3641,1924,1717,112.1
33350, 진천군,015001, 10세,2018,811,424,387,109.6,792,412,380,108.4
33350, 진천군,015002, 11세,2018,815,420,395,106.3,804,415,389,106.7
33350, 진천군,015003, 12세,2018,674,346,328,105.5,661,337,324,104
33350, 진천군,015004, 13세,2018,662,355,307,115.6,650,348,302,115.2
33350, 진천군,015005, 14세,2018,742,414,328,126.2,734,412,322,128
33350, 진천군,020,15~19세,2018,4200,2254,1946,115.8,4118,2202,1916,114.9
33350, 진천군,020001, 15세,2018,699,388,311,124.8,693,385,308,125
33350, 진천군,020002, 16세,2018,789,373,416,89.7,779,369,410,90
33350, 진천군,020003, 17세,2018,881,434,447,97.1,867,425,442,96.2
33350, 진천군,020004, 18세,2018,973,531,442,120.1,951,515,436,118.1
33350, 진천군,020005, 19세,2018,858,528,330,160,828,508,320,158.8
33350, 진천군,025,20~24세,2018,4777,2891,1886,153.3,4035,2338,1697,137.8
33350, 진천군,025001, 20세,2018,869,520,349,149,816,484,332,145.8
33350, 진천군,025002, 21세,2018,941,538,403,133.5,823,459,364,126.1
33350, 진천군,025003, 22세,2018,962,574,388,147.9,810,461,349,132.1
33350, 진천군,025004, 23세,2018,964,615,349,176.2,788,479,309,155
33350, 진천군,025005, 24세,2018,1041,644,397,162.2,798,455,343,132.7
33350, 진천군,030,25~29세,2018,5531,3533,1998,176.8,4000,2351,1649,142.6
33350, 진천군,030001, 25세,2018,1091,684,407,168.1,818,467,351,133
33350, 진천군,030002, 26세,2018,1094,705,389,181.2,831,506,325,155.7
33350, 진천군,030003, 27세,2018,1072,679,393,172.8,770,444,326,136.2
33350, 진천군,030004, 28세,2018,1165,757,408,185.5,827,494,333,148.3
33350, 진천군,030005, 29세,2018,1109,708,401,176.6,754,440,314,140.1
33350, 진천군,035,30~34세,2018,6092,3688,2404,153.4,4459,2478,1981,125.1
33350, 진천군,035001, 30세,2018,1159,707,452,156.4,813,456,357,127.7
33350, 진천군,035002, 31세,2018,1155,686,469,146.3,809,429,380,112.9
33350, 진천군,035003, 32세,2018,1236,765,471,162.4,915,528,387,136.4
33350, 진천군,035004, 33세,2018,1238,745,493,151.1,930,508,422,120.4
33350, 진천군,035005, 34세,2018,1304,785,519,151.3,992,557,435,128
33350, 진천군,040,35~39세,2018,7524,4309,3215,134,6275,3365,2910,115.6
33350, 진천군,040001, 35세,2018,1481,869,612,142,1204,661,543,121.7
33350, 진천군,040002, 36세,2018,1562,902,660,136.7,1281,700,581,120.5
33350, 진천군,040003, 37세,2018,1487,840,647,129.8,1249,658,591,111.3
33350, 진천군,040004, 38세,2018,1549,836,713,117.3,1325,667,658,101.4
33350, 진천군,040005, 39세,2018,1445,862,583,147.9,1216,679,537,126.4
33350, 진천군,045,40~44세,2018,6680,3762,2918,128.9,5835,3176,2659,119.4
33350, 진천군,045001, 40세,2018,1360,758,602,125.9,1171,615,556,110.6
33350, 진천군,045002, 41세,2018,1320,748,572,130.8,1140,616,524,117.6
33350, 진천군,045003, 42세,2018,1359,784,575,136.3,1186,666,520,128.1
33350, 진천군,045004, 43세,2018,1318,731,587,124.5,1158,624,534,116.9
33350, 진천군,045005, 44세,2018,1323,741,582,127.3,1180,655,525,124.8
33350, 진천군,050,45~49세,2018,6812,3777,3035,124.4,6038,3298,2740,120.4
33350, 진천군,050001, 45세,2018,1364,766,598,128.1,1209,673,536,125.6
33350, 진천군,050002, 46세,2018,1246,704,542,129.9,1091,603,488,123.6
33350, 진천군,050003, 47세,2018,1397,778,619,125.7,1233,676,557,121.4
33350, 진천군,050004, 48세,2018,1366,755,611,123.6,1202,653,549,118.9
33350, 진천군,050005, 49세,2018,1439,774,665,116.4,1303,693,610,113.6
33350, 진천군,055,50~54세,2018,6633,3650,2983,122.4,5969,3241,2728,118.8
33350, 진천군,055001, 50세,2018,1377,748,629,118.9,1229,654,575,113.7
33350, 진천군,055002, 51세,2018,1305,723,582,124.2,1180,652,528,123.5
33350, 진천군,055003, 52세,2018,1357,766,591,129.6,1228,690,538,128.3
33350, 진천군,055004, 53세,2018,1358,743,615,120.8,1232,666,566,117.7
33350, 진천군,055005, 54세,2018,1236,670,566,118.4,1100,579,521,111.1
33350, 진천군,060,55~59세,2018,6741,3619,3122,115.9,6231,3317,2914,113.8
33350, 진천군,060001, 55세,2018,1257,701,556,126.1,1098,602,496,121.4
33350, 진천군,060002, 56세,2018,1417,768,649,118.3,1309,701,608,115.3
33350, 진천군,060003, 57세,2018,1563,823,740,111.2,1494,784,710,110.4
33350, 진천군,060004, 58세,2018,1302,696,606,114.9,1200,639,561,113.9
33350, 진천군,060005, 59세,2018,1202,631,571,110.5,1130,591,539,109.6
33350, 진천군,065,60~64세,2018,5332,2756,2576,107,5018,2567,2451,104.7
33350, 진천군,065001, 60세,2018,1148,622,526,118.3,1058,562,496,113.3
33350, 진천군,065002, 61세,2018,1176,621,555,111.9,1093,569,524,108.6
33350, 진천군,065003, 62세,2018,1055,562,493,114,1004,525,479,109.6
33350, 진천군,065004, 63세,2018,1017,501,516,97.1,970,481,489,98.4
33350, 진천군,065005, 64세,2018,936,450,486,92.6,893,430,463,92.9
33350, 진천군,070,65~69세,2018,3496,1732,1764,98.2,3369,1660,1709,97.1
33350, 진천군,070001, 65세,2018,826,413,413,100,790,388,402,96.5
33350, 진천군,070002, 66세,2018,866,422,444,95,835,408,427,95.6
33350, 진천군,070003, 67세,2018,562,277,285,97.2,541,268,273,98.2
33350, 진천군,070004, 68세,2018,604,283,321,88.2,586,273,313,87.2
33350, 진천군,070005, 69세,2018,638,337,301,112,617,323,294,109.9
33350, 진천군,075,70~74세,2018,2695,1264,1431,88.3,2650,1244,1406,88.5
33350, 진천군,075001, 70세,2018,635,317,318,99.7,621,313,308,101.6
33350, 진천군,075002, 71세,2018,571,280,291,96.2,561,273,288,94.8
33350, 진천군,075003, 72세,2018,481,238,243,97.9,470,233,237,98.3
33350, 진천군,075004, 73세,2018,533,236,297,79.5,528,233,295,79
33350, 진천군,075005, 74세,2018,475,193,282,68.4,470,192,278,69.1
33350, 진천군,080,75~79세,2018,2704,1108,1596,69.4,2688,1102,1586,69.5
33350, 진천군,080001, 75세,2018,519,206,313,65.8,511,202,309,65.4
33350, 진천군,080002, 76세,2018,638,274,364,75.3,636,274,362,75.7
33350, 진천군,080003, 77세,2018,495,207,288,71.9,492,205,287,71.4
33350, 진천군,080004, 78세,2018,510,218,292,74.7,508,218,290,75.2
33350, 진천군,080005, 79세,2018,542,203,339,59.9,541,203,338,60.1
33350, 진천군,085,80~84세,2018,2114,741,1373,54,2105,740,1365,54.2
33350, 진천군,085001, 80세,2018,483,205,278,73.7,479,205,274,74.8
33350, 진천군,085002, 81세,2018,465,170,295,57.6,463,170,293,58
33350, 진천군,085003, 82세,2018,437,154,283,54.4,435,154,281,54.8
33350, 진천군,085004, 83세,2018,402,111,291,38.1,401,110,291,37.8
33350, 진천군,085005, 84세,2018,327,101,226,44.7,327,101,226,44.7
33350, 진천군,090,85~89세,2018,864,241,623,38.7,862,240,622,38.6
33350, 진천군,090001, 85세,2018,269,84,185,45.4,268,84,184,45.7
33350, 진천군,090002, 86세,2018,189,61,128,47.7,188,60,128,46.9
33350, 진천군,090003, 87세,2018,153,34,119,28.6,153,34,119,28.6
33350, 진천군,090004, 88세,2018,132,26,106,24.5,132,26,106,24.5
33350, 진천군,090005, 89세,2018,121,36,85,42.4,121,36,85,42.4
33350, 진천군,095,90~94세,2018,302,54,248,21.8,300,54,246,22
33350, 진천군,095001, 90세,2018,112,18,94,19.1,111,18,93,19.4
33350, 진천군,095002, 91세,2018,76,17,59,28.8,75,17,58,29.3
33350, 진천군,095003, 92세,2018,53,10,43,23.3,53,10,43,23.3
33350, 진천군,095004, 93세,2018,38,5,33,15.2,38,5,33,15.2
33350, 진천군,095005, 94세,2018,23,X,19,21.1,23,X,19,21.1
33350, 진천군,100,95~99세,2018,75,14,61,23,75,14,61,23
33350, 진천군,100001, 95세,2018,33,5,28,17.9,33,5,28,17.9
33350, 진천군,100002, 96세,2018,18,X,15,20,18,X,15,20
33350, 진천군,100003, 97세,2018,14,X,11,27.3,14,X,11,27.3
33350, 진천군,100004, 98세,2018,X,X,X,33.3,X,X,X,33.3
33350, 진천군,100005, 99세,2018,6,X,X,50,6,X,X,50
33350, 진천군,101,100세이상,2018,X,X,X,0,X,X,X,0
33350, 진천군,102,15세미만,2018,11340,5854,5486,106.7,11040,5696,5344,106.6
33350, 진천군,103,15~64세,2018,60322,34239,26083,131.3,51978,28333,23645,119.8
33350, 진천군,104,65세이상,2018,12253,5154,7099,72.6,12052,5054,6998,72.2
33350, 진천군,086,85세이상,2018,1244,309,935,33,1240,308,932,33
33350, 진천군,126,평균연령,2018,41.7,40.2,43.4,,42.2,40.8,43.7,
33350, 진천군,127,중위연령,2018,41.9,40.1,44.1,,43.1,41.8,44.7,
33360, 괴산군,000,합계,2018,38453,19905,18548,107.3,37310,19169,18141,105.7
33360, 괴산군,005,0~4세,2018,628,316,312,101.3,627,315,312,101
33360, 괴산군,005001, 0세,2018,105,60,45,133.3,105,60,45,133.3
33360, 괴산군,005002, 1세,2018,128,63,65,96.9,128,63,65,96.9
33360, 괴산군,005003, 2세,2018,120,66,54,122.2,119,65,54,120.4
33360, 괴산군,005004, 3세,2018,120,52,68,76.5,120,52,68,76.5
33360, 괴산군,005005, 4세,2018,155,75,80,93.8,155,75,80,93.8
33360, 괴산군,010,5~9세,2018,785,375,410,91.5,781,373,408,91.4
33360, 괴산군,010001, 5세,2018,135,61,74,82.4,135,61,74,82.4
33360, 괴산군,010002, 6세,2018,162,90,72,125,161,89,72,123.6
33360, 괴산군,010003, 7세,2018,151,67,84,79.8,150,67,83,80.7
33360, 괴산군,010004, 8세,2018,171,89,82,108.5,170,88,82,107.3
33360, 괴산군,010005, 9세,2018,166,68,98,69.4,165,68,97,70.1
33360, 괴산군,015,10~14세,2018,946,475,471,100.8,943,474,469,101.1
33360, 괴산군,015001, 10세,2018,195,93,102,91.2,195,93,102,91.2
33360, 괴산군,015002, 11세,2018,201,99,102,97.1,201,99,102,97.1
33360, 괴산군,015003, 12세,2018,155,71,84,84.5,155,71,84,84.5
33360, 괴산군,015004, 13세,2018,178,83,95,87.4,175,82,93,88.2
33360, 괴산군,015005, 14세,2018,217,129,88,146.6,217,129,88,146.6
33360, 괴산군,020,15~19세,2018,1881,1071,810,132.2,1866,1062,804,132.1
33360, 괴산군,020001, 15세,2018,227,133,94,141.5,226,132,94,140.4
33360, 괴산군,020002, 16세,2018,219,115,104,110.6,219,115,104,110.6
33360, 괴산군,020003, 17세,2018,264,130,134,97,264,130,134,97
33360, 괴산군,020004, 18세,2018,421,235,186,126.3,418,233,185,125.9
33360, 괴산군,020005, 19세,2018,750,458,292,156.8,739,452,287,157.5
33360, 괴산군,025,20~24세,2018,3150,1920,1230,156.1,2959,1788,1171,152.7
33360, 괴산군,025001, 20세,2018,660,359,301,119.3,638,345,293,117.7
33360, 괴산군,025002, 21세,2018,653,300,353,85,625,282,343,82.2
33360, 괴산군,025003, 22세,2018,739,449,290,154.8,689,410,279,147
33360, 괴산군,025004, 23세,2018,596,429,167,256.9,549,396,153,258.8
33360, 괴산군,025005, 24세,2018,502,383,119,321.8,458,355,103,344.7
33360, 괴산군,030,25~29세,2018,1624,1017,607,167.5,1379,855,524,163.2
33360, 괴산군,030001, 25세,2018,414,278,136,204.4,365,246,119,206.7
33360, 괴산군,030002, 26세,2018,335,203,132,153.8,289,173,116,149.1
33360, 괴산군,030003, 27세,2018,290,188,102,184.3,238,153,85,180
33360, 괴산군,030004, 28세,2018,307,183,124,147.6,257,149,108,138
33360, 괴산군,030005, 29세,2018,278,165,113,146,230,134,96,139.6
33360, 괴산군,035,30~34세,2018,1289,747,542,137.8,1110,623,487,127.9
33360, 괴산군,035001, 30세,2018,251,145,106,136.8,213,122,91,134.1
33360, 괴산군,035002, 31세,2018,252,144,108,133.3,218,120,98,122.4
33360, 괴산군,035003, 32세,2018,273,167,106,157.5,232,137,95,144.2
33360, 괴산군,035004, 33세,2018,240,138,102,135.3,204,114,90,126.7
33360, 괴산군,035005, 34세,2018,273,153,120,127.5,243,130,113,115
33360, 괴산군,040,35~39세,2018,1510,845,665,127.1,1377,762,615,123.9
33360, 괴산군,040001, 35세,2018,299,170,129,131.8,270,150,120,125
33360, 괴산군,040002, 36세,2018,309,173,136,127.2,281,155,126,123
33360, 괴산군,040003, 37세,2018,290,169,121,139.7,268,152,116,131
33360, 괴산군,040004, 38세,2018,327,184,143,128.7,296,167,129,129.5
33360, 괴산군,040005, 39세,2018,285,149,136,109.6,262,138,124,111.3
33360, 괴산군,045,40~44세,2018,1693,987,706,139.8,1607,935,672,139.1
33360, 괴산군,045001, 40세,2018,325,179,146,122.6,301,166,135,123
33360, 괴산군,045002, 41세,2018,287,163,124,131.5,274,154,120,128.3
33360, 괴산군,045003, 42세,2018,310,173,137,126.3,299,167,132,126.5
33360, 괴산군,045004, 43세,2018,374,235,139,169.1,352,220,132,166.7
33360, 괴산군,045005, 44세,2018,397,237,160,148.1,381,228,153,149
33360, 괴산군,050,45~49세,2018,2246,1305,941,138.7,2175,1261,914,138
33360, 괴산군,050001, 45세,2018,396,236,160,147.5,382,226,156,144.9
33360, 괴산군,050002, 46세,2018,384,233,151,154.3,369,227,142,159.9
33360, 괴산군,050003, 47세,2018,469,261,208,125.5,458,255,203,125.6
33360, 괴산군,050004, 48세,2018,457,281,176,159.7,443,272,171,159.1
33360, 괴산군,050005, 49세,2018,540,294,246,119.5,523,281,242,116.1
33360, 괴산군,055,50~54세,2018,3049,1632,1417,115.2,2982,1595,1387,115
33360, 괴산군,055001, 50세,2018,572,311,261,119.2,561,303,258,117.4
33360, 괴산군,055002, 51세,2018,569,300,269,111.5,554,293,261,112.3
33360, 괴산군,055003, 52세,2018,643,358,285,125.6,638,355,283,125.4
33360, 괴산군,055004, 53세,2018,640,336,304,110.5,621,327,294,111.2
33360, 괴산군,055005, 54세,2018,625,327,298,109.7,608,317,291,108.9
33360, 괴산군,060,55~59세,2018,4060,2092,1968,106.3,3990,2056,1934,106.3
33360, 괴산군,060001, 55세,2018,662,331,331,100,646,323,323,100
33360, 괴산군,060002, 56세,2018,786,390,396,98.5,773,383,390,98.2
33360, 괴산군,060003, 57세,2018,906,471,435,108.3,891,462,429,107.7
33360, 괴산군,060004, 58세,2018,871,467,404,115.6,856,461,395,116.7
33360, 괴산군,060005, 59세,2018,835,433,402,107.7,824,427,397,107.6
33360, 괴산군,065,60~64세,2018,4206,2224,1982,112.2,4155,2189,1966,111.3
33360, 괴산군,065001, 60세,2018,919,493,426,115.7,908,487,421,115.7
33360, 괴산군,065002, 61세,2018,821,441,380,116.1,807,431,376,114.6
33360, 괴산군,065003, 62세,2018,874,480,394,121.8,866,474,392,120.9
33360, 괴산군,065004, 63세,2018,801,405,396,102.3,792,400,392,102
33360, 괴산군,065005, 64세,2018,791,405,386,104.9,782,397,385,103.1
33360, 괴산군,070,65~69세,2018,2997,1516,1481,102.4,2978,1503,1475,101.9
33360, 괴산군,070001, 65세,2018,638,310,328,94.5,628,305,323,94.4
33360, 괴산군,070002, 66세,2018,699,371,328,113.1,695,367,328,111.9
33360, 괴산군,070003, 67세,2018,527,254,273,93,526,254,272,93.4
33360, 괴산군,070004, 68세,2018,563,289,274,105.5,560,286,274,104.4
33360, 괴산군,070005, 69세,2018,570,292,278,105,569,291,278,104.7
33360, 괴산군,075,70~74세,2018,2562,1247,1315,94.8,2557,1243,1314,94.6
33360, 괴산군,075001, 70세,2018,559,295,264,111.7,558,294,264,111.4
33360, 괴산군,075002, 71세,2018,578,294,284,103.5,578,294,284,103.5
33360, 괴산군,075003, 72세,2018,426,215,211,101.9,424,214,210,101.9
33360, 괴산군,075004, 73세,2018,540,254,286,88.8,538,252,286,88.1
33360, 괴산군,075005, 74세,2018,459,189,270,70,459,189,270,70
33360, 괴산군,080,75~79세,2018,2707,1116,1591,70.1,2706,1116,1590,70.2
33360, 괴산군,080001, 75세,2018,509,207,302,68.5,509,207,302,68.5
33360, 괴산군,080002, 76세,2018,616,249,367,67.8,616,249,367,67.8
33360, 괴산군,080003, 77세,2018,568,244,324,75.3,568,244,324,75.3
33360, 괴산군,080004, 78세,2018,511,210,301,69.8,510,210,300,70
33360, 괴산군,080005, 79세,2018,503,206,297,69.4,503,206,297,69.4
33360, 괴산군,085,80~84세,2018,1922,716,1206,59.4,1920,715,1205,59.3
33360, 괴산군,085001, 80세,2018,482,205,277,74,482,205,277,74
33360, 괴산군,085002, 81세,2018,414,147,267,55.1,413,146,267,54.7
33360, 괴산군,085003, 82세,2018,371,135,236,57.2,370,135,235,57.4
33360, 괴산군,085004, 83세,2018,345,125,220,56.8,345,125,220,56.8
33360, 괴산군,085005, 84세,2018,310,104,206,50.5,310,104,206,50.5
33360, 괴산군,090,85~89세,2018,868,230,638,36.1,868,230,638,36.1
33360, 괴산군,090001, 85세,2018,262,68,194,35.1,262,68,194,35.1
33360, 괴산군,090002, 86세,2018,202,65,137,47.4,202,65,137,47.4
33360, 괴산군,090003, 87세,2018,163,41,122,33.6,163,41,122,33.6
33360, 괴산군,090004, 88세,2018,138,33,105,31.4,138,33,105,31.4
33360, 괴산군,090005, 89세,2018,103,23,80,28.8,103,23,80,28.8
33360, 괴산군,095,90~94세,2018,252,58,194,29.9,252,58,194,29.9
33360, 괴산군,095001, 90세,2018,97,22,75,29.3,97,22,75,29.3
33360, 괴산군,095002, 91세,2018,54,12,42,28.6,54,12,42,28.6
33360, 괴산군,095003, 92세,2018,40,9,31,29,40,9,31,29
33360, 괴산군,095004, 93세,2018,38,7,31,22.6,38,7,31,22.6
33360, 괴산군,095005, 94세,2018,23,8,15,53.3,23,8,15,53.3
33360, 괴산군,100,95~99세,2018,63,14,49,28.6,63,14,49,28.6
33360, 괴산군,100001, 95세,2018,25,X,22,13.6,25,X,22,13.6
33360, 괴산군,100002, 96세,2018,16,7,9,77.8,16,7,9,77.8
33360, 괴산군,100003, 97세,2018,10,X,9,11.1,10,X,9,11.1
33360, 괴산군,100004, 98세,2018,5,X,5,0,5,X,5,0
33360, 괴산군,100005, 99세,2018,7,X,X,75,7,X,X,75
33360, 괴산군,101,100세이상,2018,15,X,13,15.4,15,X,13,15.4
33360, 괴산군,102,15세미만,2018,2359,1166,1193,97.7,2351,1162,1189,97.7
33360, 괴산군,103,15~64세,2018,24708,13840,10868,127.3,23600,13126,10474,125.3
33360, 괴산군,104,65세이상,2018,11386,4899,6487,75.5,11359,4881,6478,75.3
33360, 괴산군,086,85세이상,2018,1198,304,894,34,1198,304,894,34
33360, 괴산군,126,평균연령,2018,51.1,48.7,53.6,,51.5,49.2,54,
33360, 괴산군,127,중위연령,2018,55.6,52.8,58,,56.3,53.6,58.4,
33370, 음성군,000,합계,2018,105539,58229,47310,123.1,92398,48655,43743,111.2
33370, 음성군,005,0~4세,2018,3383,1733,1650,105,3250,1665,1585,105
33370, 음성군,005001, 0세,2018,572,300,272,110.3,548,288,260,110.8
33370, 음성군,005002, 1세,2018,626,315,311,101.3,597,300,297,101
33370, 음성군,005003, 2세,2018,756,382,374,102.1,718,364,354,102.8
33370, 음성군,005004, 3세,2018,732,376,356,105.6,708,363,345,105.2
33370, 음성군,005005, 4세,2018,697,360,337,106.8,679,350,329,106.4
33370, 음성군,010,5~9세,2018,3959,2106,1853,113.7,3874,2064,1810,114
33370, 음성군,010001, 5세,2018,738,358,380,94.2,713,348,365,95.3
33370, 음성군,010002, 6세,2018,853,467,386,121,833,457,376,121.5
33370, 음성군,010003, 7세,2018,835,466,369,126.3,819,458,361,126.9
33370, 음성군,010004, 8세,2018,786,406,380,106.8,776,400,376,106.4
33370, 음성군,010005, 9세,2018,747,409,338,121,733,401,332,120.8
33370, 음성군,015,10~14세,2018,3751,1942,1809,107.4,3708,1920,1788,107.4
33370, 음성군,015001, 10세,2018,774,400,374,107,761,392,369,106.2
33370, 음성군,015002, 11세,2018,799,402,397,101.3,785,397,388,102.3
33370, 음성군,015003, 12세,2018,721,360,361,99.7,715,357,358,99.7
33370, 음성군,015004, 13세,2018,687,349,338,103.3,684,347,337,103
33370, 음성군,015005, 14세,2018,770,431,339,127.1,763,427,336,127.1
33370, 음성군,020,15~19세,2018,5210,2808,2402,116.9,5115,2741,2374,115.5
33370, 음성군,020001, 15세,2018,820,432,388,111.3,814,427,387,110.3
33370, 음성군,020002, 16세,2018,936,482,454,106.2,927,475,452,105.1
33370, 음성군,020003, 17세,2018,1019,544,475,114.5,1002,535,467,114.6
33370, 음성군,020004, 18세,2018,1074,570,504,113.1,1056,557,499,111.6
33370, 음성군,020005, 19세,2018,1361,780,581,134.3,1316,747,569,131.3
33370, 음성군,025,20~24세,2018,6723,4117,2606,158,5259,2962,2297,129
33370, 음성군,025001, 20세,2018,1244,688,556,123.7,1114,587,527,111.4
33370, 음성군,025002, 21세,2018,1294,727,567,128.2,1112,587,525,111.8
33370, 음성군,025003, 22세,2018,1378,873,505,172.9,1054,620,434,142.9
33370, 음성군,025004, 23세,2018,1413,921,492,187.2,1039,622,417,149.2
33370, 음성군,025005, 24세,2018,1394,908,486,186.8,940,546,394,138.6
33370, 음성군,030,25~29세,2018,7313,4752,2561,185.6,4737,2781,1956,142.2
33370, 음성군,030001, 25세,2018,1444,950,494,192.3,952,561,391,143.5
33370, 음성군,030002, 26세,2018,1515,981,534,183.7,1003,587,416,141.1
33370, 음성군,030003, 27세,2018,1462,958,504,190.1,941,556,385,144.4
33370, 음성군,030004, 28세,2018,1496,956,540,177,970,569,401,141.9
33370, 음성군,030005, 29세,2018,1396,907,489,185.5,871,508,363,139.9
33370, 음성군,035,30~34세,2018,7145,4556,2589,176,4752,2686,2066,130
33370, 음성군,035001, 30세,2018,1442,922,520,177.3,893,508,385,131.9
33370, 음성군,035002, 31세,2018,1459,965,494,195.3,920,538,382,140.8
33370, 음성군,035003, 32세,2018,1383,858,525,163.4,931,511,420,121.7
33370, 음성군,035004, 33세,2018,1422,901,521,172.9,971,532,439,121.2
33370, 음성군,035005, 34세,2018,1439,910,529,172,1037,597,440,135.7
33370, 음성군,040,35~39세,2018,7949,4763,3186,149.5,6106,3328,2778,119.8
33370, 음성군,040001, 35세,2018,1442,881,561,157,1055,574,481,119.3
33370, 음성군,040002, 36세,2018,1615,973,642,151.6,1232,664,568,116.9
33370, 음성군,040003, 37세,2018,1638,983,655,150.1,1270,692,578,119.7
33370, 음성군,040004, 38세,2018,1639,957,682,140.3,1287,689,598,115.2
33370, 음성군,040005, 39세,2018,1615,969,646,150,1262,709,553,128.2
33370, 음성군,045,40~44세,2018,7582,4393,3189,137.8,6442,3574,2868,124.6
33370, 음성군,045001, 40세,2018,1421,818,603,135.7,1144,617,527,117.1
33370, 음성군,045002, 41세,2018,1539,929,610,152.3,1275,734,541,135.7
33370, 음성군,045003, 42세,2018,1458,830,628,132.2,1239,669,570,117.4
33370, 음성군,045004, 43세,2018,1532,894,638,140.1,1341,758,583,130
33370, 음성군,045005, 44세,2018,1632,922,710,129.9,1443,796,647,123
33370, 음성군,050,45~49세,2018,8678,5043,3635,138.7,7613,4352,3261,133.5
33370, 음성군,050001, 45세,2018,1676,961,715,134.4,1471,825,646,127.7
33370, 음성군,050002, 46세,2018,1585,909,676,134.5,1381,780,601,129.8
33370, 음성군,050003, 47세,2018,1742,1044,698,149.6,1511,885,626,141.4
33370, 음성군,050004, 48세,2018,1802,1053,749,140.6,1585,924,661,139.8
33370, 음성군,050005, 49세,2018,1873,1076,797,135,1665,938,727,129
33370, 음성군,055,50~54세,2018,8835,4939,3896,126.8,7901,4328,3573,121.1
33370, 음성군,055001, 50세,2018,1884,1084,800,135.5,1672,940,732,128.4
33370, 음성군,055002, 51세,2018,1691,922,769,119.9,1511,808,703,114.9
33370, 음성군,055003, 52세,2018,1737,976,761,128.3,1557,856,701,122.1
33370, 음성군,055004, 53세,2018,1861,1020,841,121.3,1669,893,776,115.1
33370, 음성군,055005, 54세,2018,1662,937,725,129.2,1492,831,661,125.7
33370, 음성군,060,55~59세,2018,9428,5192,4236,122.6,8763,4793,3970,120.7
33370, 음성군,060001, 55세,2018,1670,947,723,131,1467,818,649,126
33370, 음성군,060002, 56세,2018,1963,1077,886,121.6,1802,974,828,117.6
33370, 음성군,060003, 57세,2018,2054,1157,897,129,1950,1103,847,130.2
33370, 음성군,060004, 58세,2018,1926,1036,890,116.4,1819,973,846,115
33370, 음성군,060005, 59세,2018,1815,975,840,116.1,1725,925,800,115.6
33370, 음성군,065,60~64세,2018,7925,4179,3746,111.6,7479,3876,3603,107.6
33370, 음성군,065001, 60세,2018,1797,970,827,117.3,1701,906,795,114
33370, 음성군,065002, 61세,2018,1669,901,768,117.3,1558,828,730,113.4
33370, 음성군,065003, 62세,2018,1535,797,738,108,1463,748,715,104.6
33370, 음성군,065004, 63세,2018,1560,810,750,108,1472,745,727,102.5
33370, 음성군,065005, 64세,2018,1364,701,663,105.7,1285,649,636,102
33370, 음성군,070,65~69세,2018,5061,2609,2452,106.4,4901,2522,2379,106
33370, 음성군,070001, 65세,2018,1115,611,504,121.2,1068,584,484,120.7
33370, 음성군,070002, 66세,2018,1317,685,632,108.4,1281,664,617,107.6
33370, 음성군,070003, 67세,2018,813,402,411,97.8,787,388,399,97.2
33370, 음성군,070004, 68세,2018,863,428,435,98.4,836,413,423,97.6
33370, 음성군,070005, 69세,2018,953,483,470,102.8,929,473,456,103.7
33370, 음성군,075,70~74세,2018,3989,1923,2066,93.1,3932,1902,2030,93.7
33370, 음성군,075001, 70세,2018,891,445,446,99.8,876,438,438,100
33370, 음성군,075002, 71세,2018,885,432,453,95.4,869,425,444,95.7
33370, 음성군,075003, 72세,2018,702,351,351,100,692,346,346,100
33370, 음성군,075004, 73세,2018,747,357,390,91.5,739,356,383,93
33370, 음성군,075005, 74세,2018,764,338,426,79.3,756,337,419,80.4
33370, 음성군,080,75~79세,2018,3979,1727,2252,76.7,3956,1718,2238,76.8
33370, 음성군,080001, 75세,2018,763,343,420,81.7,760,341,419,81.4
33370, 음성군,080002, 76세,2018,959,440,519,84.8,958,439,519,84.6
33370, 음성군,080003, 77세,2018,787,340,447,76.1,777,336,441,76.2
33370, 음성군,080004, 78세,2018,743,302,441,68.5,739,301,438,68.7
33370, 음성군,080005, 79세,2018,727,302,425,71.1,722,301,421,71.5
33370, 음성군,085,80~84세,2018,2754,953,1801,52.9,2740,950,1790,53.1
33370, 음성군,085001, 80세,2018,615,222,393,56.5,611,221,390,56.7
33370, 음성군,085002, 81세,2018,591,212,379,55.9,587,211,376,56.1
33370, 음성군,085003, 82세,2018,557,202,355,56.9,555,202,353,57.2
33370, 음성군,085004, 83세,2018,545,178,367,48.5,543,177,366,48.4
33370, 음성군,085005, 84세,2018,446,139,307,45.3,444,139,305,45.6
33370, 음성군,090,85~89세,2018,1322,357,965,37,1317,356,961,37
33370, 음성군,090001, 85세,2018,350,110,240,45.8,350,110,240,45.8
33370, 음성군,090002, 86세,2018,320,87,233,37.3,319,87,232,37.5
33370, 음성군,090003, 87세,2018,247,64,183,35,247,64,183,35
33370, 음성군,090004, 88세,2018,219,50,169,29.6,217,50,167,29.9
33370, 음성군,090005, 89세,2018,186,46,140,32.9,184,45,139,32.4
33370, 음성군,095,90~94세,2018,438,112,326,34.4,438,112,326,34.4
33370, 음성군,095001, 90세,2018,164,36,128,28.1,164,36,128,28.1
33370, 음성군,095002, 91세,2018,88,30,58,51.7,88,30,58,51.7
33370, 음성군,095003, 92세,2018,66,13,53,24.5,66,13,53,24.5
33370, 음성군,095004, 93세,2018,76,19,57,33.3,76,19,57,33.3
33370, 음성군,095005, 94세,2018,44,14,30,46.7,44,14,30,46.7
33370, 음성군,100,95~99세,2018,103,22,81,27.2,103,22,81,27.2
33370, 음성군,100001, 95세,2018,46,8,38,21.1,46,8,38,21.1
33370, 음성군,100002, 96세,2018,20,7,13,53.8,20,7,13,53.8
33370, 음성군,100003, 97세,2018,17,5,12,41.7,17,5,12,41.7
33370, 음성군,100004, 98세,2018,9,X,7,28.6,9,X,7,28.6
33370, 음성군,100005, 99세,2018,11,X,11,0,11,X,11,0
33370, 음성군,101,100세이상,2018,12,X,9,33.3,12,X,9,33.3
33370, 음성군,102,15세미만,2018,11093,5781,5312,108.8,10832,5649,5183,109
33370, 음성군,103,15~64세,2018,76788,44742,32046,139.6,64167,35421,28746,123.2
33370, 음성군,104,65세이상,2018,17658,7706,9952,77.4,17399,7585,9814,77.3
33370, 음성군,086,85세이상,2018,1875,494,1381,35.8,1870,493,1377,35.8
33370, 음성군,126,평균연령,2018,43.8,42.3,45.8,,44.8,43.5,46.4,
33370, 음성군,127,중위연령,2018,44.8,42.7,47.6,,47.1,45.7,48.7,
33380, 단양군,000,합계,2018,28444,14254,14190,100.5,28155,14127,14028,100.7
33380, 단양군,005,0~4세,2018,583,298,285,104.6,583,298,285,104.6
33380, 단양군,005001, 0세,2018,94,51,43,118.6,94,51,43,118.6
33380, 단양군,005002, 1세,2018,109,52,57,91.2,109,52,57,91.2
33380, 단양군,005003, 2세,2018,109,47,62,75.8,109,47,62,75.8
33380, 단양군,005004, 3세,2018,133,70,63,111.1,133,70,63,111.1
33380, 단양군,005005, 4세,2018,138,78,60,130,138,78,60,130
33380, 단양군,010,5~9세,2018,771,415,356,116.6,771,415,356,116.6
33380, 단양군,010001, 5세,2018,122,61,61,100,122,61,61,100
33380, 단양군,010002, 6세,2018,164,83,81,102.5,164,83,81,102.5
33380, 단양군,010003, 7세,2018,165,90,75,120,165,90,75,120
33380, 단양군,010004, 8세,2018,155,89,66,134.8,155,89,66,134.8
33380, 단양군,010005, 9세,2018,165,92,73,126,165,92,73,126
33380, 단양군,015,10~14세,2018,988,535,453,118.1,988,535,453,118.1
33380, 단양군,015001, 10세,2018,195,99,96,103.1,195,99,96,103.1
33380, 단양군,015002, 11세,2018,198,104,94,110.6,198,104,94,110.6
33380, 단양군,015003, 12세,2018,186,94,92,102.2,186,94,92,102.2
33380, 단양군,015004, 13세,2018,206,120,86,139.5,206,120,86,139.5
33380, 단양군,015005, 14세,2018,203,118,85,138.8,203,118,85,138.8
33380, 단양군,020,15~19세,2018,1128,578,550,105.1,1128,578,550,105.1
33380, 단양군,020001, 15세,2018,205,109,96,113.5,205,109,96,113.5
33380, 단양군,020002, 16세,2018,228,121,107,113.1,228,121,107,113.1
33380, 단양군,020003, 17세,2018,280,137,143,95.8,280,137,143,95.8
33380, 단양군,020004, 18세,2018,272,116,156,74.4,272,116,156,74.4
33380, 단양군,020005, 19세,2018,143,95,48,197.9,143,95,48,197.9
33380, 단양군,025,20~24세,2018,1046,616,430,143.3,1013,604,409,147.7
33380, 단양군,025001, 20세,2018,191,124,67,185.1,190,124,66,187.9
33380, 단양군,025002, 21세,2018,212,136,76,178.9,206,135,71,190.1
33380, 단양군,025003, 22세,2018,209,126,83,151.8,204,121,83,145.8
33380, 단양군,025004, 23세,2018,202,100,102,98,193,97,96,101
33380, 단양군,025005, 24세,2018,232,130,102,127.5,220,127,93,136.6
33380, 단양군,030,25~29세,2018,1100,640,460,139.1,1042,610,432,141.2
33380, 단양군,030001, 25세,2018,202,118,84,140.5,196,112,84,133.3
33380, 단양군,030002, 26세,2018,246,147,99,148.5,233,138,95,145.3
33380, 단양군,030003, 27세,2018,199,111,88,126.1,186,106,80,132.5
33380, 단양군,030004, 28세,2018,234,139,95,146.3,218,133,85,156.5
33380, 단양군,030005, 29세,2018,219,125,94,133,209,121,88,137.5
33380, 단양군,035,30~34세,2018,987,550,437,125.9,932,523,409,127.9
33380, 단양군,035001, 30세,2018,188,105,83,126.5,182,101,81,124.7
33380, 단양군,035002, 31세,2018,218,116,102,113.7,201,108,93,116.1
33380, 단양군,035003, 32세,2018,183,109,74,147.3,174,103,71,145.1
33380, 단양군,035004, 33세,2018,204,114,90,126.7,191,108,83,130.1
33380, 단양군,035005, 34세,2018,194,106,88,120.5,184,103,81,127.2
33380, 단양군,040,35~39세,2018,1298,684,614,111.4,1265,669,596,112.2
33380, 단양군,040001, 35세,2018,236,112,124,90.3,227,109,118,92.4
33380, 단양군,040002, 36세,2018,258,133,125,106.4,251,130,121,107.4
33380, 단양군,040003, 37세,2018,260,136,124,109.7,254,133,121,109.9
33380, 단양군,040004, 38세,2018,280,158,122,129.5,274,154,120,128.3
33380, 단양군,040005, 39세,2018,264,145,119,121.8,259,143,116,123.3
33380, 단양군,045,40~44세,2018,1438,787,651,120.9,1407,774,633,122.3
33380, 단양군,045001, 40세,2018,273,158,115,137.4,266,154,112,137.5
33380, 단양군,045002, 41세,2018,256,141,115,122.6,248,138,110,125.5
33380, 단양군,045003, 42세,2018,275,160,115,139.1,269,158,111,142.3
33380, 단양군,045004, 43세,2018,292,160,132,121.2,288,158,130,121.5
33380, 단양군,045005, 44세,2018,342,168,174,96.6,336,166,170,97.6
33380, 단양군,050,45~49세,2018,2122,1170,952,122.9,2102,1162,940,123.6
33380, 단양군,050001, 45세,2018,390,214,176,121.6,386,212,174,121.8
33380, 단양군,050002, 46세,2018,391,218,173,126,387,217,170,127.6
33380, 단양군,050003, 47세,2018,443,226,217,104.1,437,223,214,104.2
33380, 단양군,050004, 48세,2018,441,259,182,142.3,440,259,181,143.1
33380, 단양군,050005, 49세,2018,457,253,204,124,452,251,201,124.9
33380, 단양군,055,50~54세,2018,2473,1284,1189,108,2451,1279,1172,109.1
33380, 단양군,055001, 50세,2018,500,240,260,92.3,495,238,257,92.6
33380, 단양군,055002, 51세,2018,452,223,229,97.4,449,222,227,97.8
33380, 단양군,055003, 52세,2018,512,280,232,120.7,507,280,227,123.3
33380, 단양군,055004, 53세,2018,530,280,250,112,524,278,246,113
33380, 단양군,055005, 54세,2018,479,261,218,119.7,476,261,215,121.4
33380, 단양군,060,55~59세,2018,3251,1639,1612,101.7,3232,1630,1602,101.7
33380, 단양군,060001, 55세,2018,520,286,234,122.2,514,284,230,123.5
33380, 단양군,060002, 56세,2018,614,331,283,117,606,326,280,116.4
33380, 단양군,060003, 57세,2018,751,387,364,106.3,749,386,363,106.3
33380, 단양군,060004, 58세,2018,715,315,400,78.8,712,314,398,78.9
33380, 단양군,060005, 59세,2018,651,320,331,96.7,651,320,331,96.7
33380, 단양군,065,60~64세,2018,3235,1668,1567,106.4,3225,1663,1562,106.5
33380, 단양군,065001, 60세,2018,682,338,344,98.3,679,336,343,98
33380, 단양군,065002, 61세,2018,734,391,343,114,733,391,342,114.3
33380, 단양군,065003, 62세,2018,620,326,294,110.9,618,325,293,110.9
33380, 단양군,065004, 63세,2018,628,311,317,98.1,626,310,316,98.1
33380, 단양군,065005, 64세,2018,571,302,269,112.3,569,301,268,112.3
33380, 단양군,070,65~69세,2018,2190,1090,1100,99.1,2183,1087,1096,99.2
33380, 단양군,070001, 65세,2018,432,216,216,100,430,215,215,100
33380, 단양군,070002, 66세,2018,552,286,266,107.5,551,286,265,107.9
33380, 단양군,070003, 67세,2018,349,169,180,93.9,348,168,180,93.3
33380, 단양군,070004, 68세,2018,404,185,219,84.5,403,185,218,84.9
33380, 단양군,070005, 69세,2018,453,234,219,106.8,451,233,218,106.9
33380, 단양군,075,70~74세,2018,1913,842,1071,78.6,1913,842,1071,78.6
33380, 단양군,075001, 70세,2018,466,218,248,87.9,466,218,248,87.9
33380, 단양군,075002, 71세,2018,417,193,224,86.2,417,193,224,86.2
33380, 단양군,075003, 72세,2018,305,127,178,71.3,305,127,178,71.3
33380, 단양군,075004, 73세,2018,346,152,194,78.4,346,152,194,78.4
33380, 단양군,075005, 74세,2018,379,152,227,67,379,152,227,67
33380, 단양군,080,75~79세,2018,1928,809,1119,72.3,1927,809,1118,72.4
33380, 단양군,080001, 75세,2018,376,160,216,74.1,376,160,216,74.1
33380, 단양군,080002, 76세,2018,439,178,261,68.2,438,178,260,68.5
33380, 단양군,080003, 77세,2018,397,187,210,89,397,187,210,89
33380, 단양군,080004, 78세,2018,351,132,219,60.3,351,132,219,60.3
33380, 단양군,080005, 79세,2018,365,152,213,71.4,365,152,213,71.4
33380, 단양군,085,80~84세,2018,1234,441,793,55.6,1234,441,793,55.6
33380, 단양군,085001, 80세,2018,321,107,214,50,321,107,214,50
33380, 단양군,085002, 81세,2018,263,107,156,68.6,263,107,156,68.6
33380, 단양군,085003, 82세,2018,241,92,149,61.7,241,92,149,61.7
33380, 단양군,085004, 83세,2018,215,67,148,45.3,215,67,148,45.3
33380, 단양군,085005, 84세,2018,194,68,126,54,194,68,126,54
33380, 단양군,090,85~89세,2018,544,164,380,43.2,544,164,380,43.2
33380, 단양군,090001, 85세,2018,158,50,108,46.3,158,50,108,46.3
33380, 단양군,090002, 86세,2018,126,34,92,37,126,34,92,37
33380, 단양군,090003, 87세,2018,90,29,61,47.5,90,29,61,47.5
33380, 단양군,090004, 88세,2018,99,26,73,35.6,99,26,73,35.6
33380, 단양군,090005, 89세,2018,71,25,46,54.3,71,25,46,54.3
33380, 단양군,095,90~94세,2018,160,38,122,31.1,160,38,122,31.1
33380, 단양군,095001, 90세,2018,53,7,46,15.2,53,7,46,15.2
33380, 단양군,095002, 91세,2018,39,7,32,21.9,39,7,32,21.9
33380, 단양군,095003, 92세,2018,26,10,16,62.5,26,10,16,62.5
33380, 단양군,095004, 93세,2018,22,X,18,22.2,22,X,18,22.2
33380, 단양군,095005, 94세,2018,20,10,10,100,20,10,10,100
33380, 단양군,100,95~99세,2018,49,6,43,14,49,6,43,14
33380, 단양군,100001, 95세,2018,17,X,15,13.3,17,X,15,13.3
33380, 단양군,100002, 96세,2018,16,X,13,23.1,16,X,13,23.1
33380, 단양군,100003, 97세,2018,11,X,11,0,11,X,11,0
33380, 단양군,100004, 98세,2018,X,X,X,0,X,X,X,0
33380, 단양군,100005, 99세,2018,X,X,X,33.3,X,X,X,33.3
33380, 단양군,101,100세이상,2018,6,X,6,0,6,X,6,0
33380, 단양군,102,15세미만,2018,2342,1248,1094,114.1,2342,1248,1094,114.1
33380, 단양군,103,15~64세,2018,18078,9616,8462,113.6,17797,9492,8305,114.3
33380, 단양군,104,65세이상,2018,8024,3390,4634,73.2,8016,3387,4629,73.2
33380, 단양군,086,85세이상,2018,759,208,551,37.7,759,208,551,37.7
33380, 단양군,126,평균연령,2018,51.3,49.3,53.4,,51.5,49.4,53.5,
33380, 단양군,127,중위연령,2018,55.6,53.4,57.6,,55.8,53.6,57.7,
33390, 증평군,000,합계,2018,37485,19199,18286,105,36463,18659,17804,104.8
33390, 증평군,005,0~4세,2018,1817,896,921,97.3,1803,891,912,97.7
33390, 증평군,005001, 0세,2018,317,156,161,96.9,313,154,159,96.9
33390, 증평군,005002, 1세,2018,356,187,169,110.7,352,185,167,110.8
33390, 증평군,005003, 2세,2018,374,184,190,96.8,371,184,187,98.4
33390, 증평군,005004, 3세,2018,372,189,183,103.3,370,188,182,103.3
33390, 증평군,005005, 4세,2018,398,180,218,82.6,397,180,217,82.9
33390, 증평군,010,5~9세,2018,1992,1036,956,108.4,1983,1033,950,108.7
33390, 증평군,010001, 5세,2018,417,212,205,103.4,416,212,204,103.9
33390, 증평군,010002, 6세,2018,395,199,196,101.5,394,199,195,102.1
33390, 증평군,010003, 7세,2018,421,213,208,102.4,416,210,206,101.9
33390, 증평군,010004, 8세,2018,403,217,186,116.7,402,217,185,117.3
33390, 증평군,010005, 9세,2018,356,195,161,121.1,355,195,160,121.9
33390, 증평군,015,10~14세,2018,1673,877,796,110.2,1671,875,796,109.9
33390, 증평군,015001, 10세,2018,365,191,174,109.8,365,191,174,109.8
33390, 증평군,015002, 11세,2018,338,177,161,109.9,338,177,161,109.9
33390, 증평군,015003, 12세,2018,300,158,142,111.3,300,158,142,111.3
33390, 증평군,015004, 13세,2018,357,189,168,112.5,357,189,168,112.5
33390, 증평군,015005, 14세,2018,313,162,151,107.3,311,160,151,106
33390, 증평군,020,15~19세,2018,1822,896,926,96.8,1815,893,922,96.9
33390, 증평군,020001, 15세,2018,306,157,149,105.4,306,157,149,105.4
33390, 증평군,020002, 16세,2018,333,162,171,94.7,333,162,171,94.7
33390, 증평군,020003, 17세,2018,328,176,152,115.8,328,176,152,115.8
33390, 증평군,020004, 18세,2018,413,193,220,87.7,413,193,220,87.7
33390, 증평군,020005, 19세,2018,442,208,234,88.9,435,205,230,89.1
33390, 증평군,025,20~24세,2018,2535,1331,1204,110.5,2430,1271,1159,109.7
33390, 증평군,025001, 20세,2018,505,245,260,94.2,490,234,256,91.4
33390, 증평군,025002, 21세,2018,524,243,281,86.5,512,237,275,86.2
33390, 증평군,025003, 22세,2018,480,238,242,98.3,462,232,230,100.9
33390, 증평군,025004, 23세,2018,491,286,205,139.5,465,269,196,137.2
33390, 증평군,025005, 24세,2018,535,319,216,147.7,501,299,202,148
33390, 증평군,030,25~29세,2018,2432,1454,978,148.7,2260,1348,912,147.8
33390, 증평군,030001, 25세,2018,571,339,232,146.1,544,323,221,146.2
33390, 증평군,030002, 26세,2018,465,275,190,144.7,437,257,180,142.8
33390, 증평군,030003, 27세,2018,502,314,188,167,470,295,175,168.6
33390, 증평군,030004, 28세,2018,451,266,185,143.8,411,242,169,143.2
33390, 증평군,030005, 29세,2018,443,260,183,142.1,398,231,167,138.3
33390, 증평군,035,30~34세,2018,2436,1334,1102,121.1,2266,1254,1012,123.9
33390, 증평군,035001, 30세,2018,427,227,200,113.5,404,215,189,113.8
33390, 증평군,035002, 31세,2018,462,247,215,114.9,424,234,190,123.2
33390, 증평군,035003, 32세,2018,484,263,221,119,442,242,200,121
33390, 증평군,035004, 33세,2018,526,300,226,132.7,495,282,213,132.4
33390, 증평군,035005, 34세,2018,537,297,240,123.8,501,281,220,127.7
33390, 증평군,040,35~39세,2018,2956,1604,1352,118.6,2839,1539,1300,118.4
33390, 증평군,040001, 35세,2018,596,340,256,132.8,564,318,246,129.3
33390, 증평군,040002, 36세,2018,619,342,277,123.5,591,326,265,123
33390, 증평군,040003, 37세,2018,585,311,274,113.5,564,302,262,115.3
33390, 증평군,040004, 38세,2018,585,309,276,112,569,300,269,111.5
33390, 증평군,040005, 39세,2018,571,302,269,112.3,551,293,258,113.6
33390, 증평군,045,40~44세,2018,2745,1486,1259,118,2649,1439,1210,118.9
33390, 증평군,045001, 40세,2018,525,276,249,110.8,501,263,238,110.5
33390, 증평군,045002, 41세,2018,558,295,263,112.2,538,283,255,111
33390, 증평군,045003, 42세,2018,529,284,245,115.9,510,278,232,119.8
33390, 증평군,045004, 43세,2018,516,279,237,117.7,497,271,226,119.9
33390, 증평군,045005, 44세,2018,617,352,265,132.8,603,344,259,132.8
33390, 증평군,050,45~49세,2018,2964,1572,1392,112.9,2876,1529,1347,113.5
33390, 증평군,050001, 45세,2018,593,324,269,120.4,577,317,260,121.9
33390, 증평군,050002, 46세,2018,542,278,264,105.3,530,269,261,103.1
33390, 증평군,050003, 47세,2018,606,325,281,115.7,590,316,274,115.3
33390, 증평군,050004, 48세,2018,553,295,258,114.3,529,284,245,115.9
33390, 증평군,050005, 49세,2018,670,350,320,109.4,650,343,307,111.7
33390, 증평군,055,50~54세,2018,2866,1487,1379,107.8,2791,1452,1339,108.4
33390, 증평군,055001, 50세,2018,628,330,298,110.7,612,322,290,111
33390, 증평군,055002, 51세,2018,607,310,297,104.4,592,305,287,106.3
33390, 증평군,055003, 52세,2018,581,298,283,105.3,564,291,273,106.6
33390, 증평군,055004, 53세,2018,554,280,274,102.2,540,272,268,101.5
33390, 증평군,055005, 54세,2018,496,269,227,118.5,483,262,221,118.6
33390, 증평군,060,55~59세,2018,2997,1568,1429,109.7,2920,1531,1389,110.2
33390, 증평군,060001, 55세,2018,533,295,238,123.9,510,278,232,119.8
33390, 증평군,060002, 56세,2018,626,334,292,114.4,611,330,281,117.4
33390, 증평군,060003, 57세,2018,652,318,334,95.2,643,315,328,96
33390, 증평군,060004, 58세,2018,593,297,296,100.3,584,292,292,100
33390, 증평군,060005, 59세,2018,593,324,269,120.4,572,316,256,123.4
33390, 증평군,065,60~64세,2018,2562,1260,1302,96.8,2513,1226,1287,95.3
33390, 증평군,065001, 60세,2018,533,263,270,97.4,529,259,270,95.9
33390, 증평군,065002, 61세,2018,606,317,289,109.7,590,307,283,108.5
33390, 증평군,065003, 62세,2018,509,245,264,92.8,498,239,259,92.3
33390, 증평군,065004, 63세,2018,455,216,239,90.4,446,208,238,87.4
33390, 증평군,065005, 64세,2018,459,219,240,91.3,450,213,237,89.9
33390, 증평군,070,65~69세,2018,1639,809,830,97.5,1613,793,820,96.7
33390, 증평군,070001, 65세,2018,359,176,183,96.2,353,171,182,94
33390, 증평군,070002, 66세,2018,438,218,220,99.1,432,215,217,99.1
33390, 증평군,070003, 67세,2018,287,141,146,96.6,280,138,142,97.2
33390, 증평군,070004, 68세,2018,282,143,139,102.9,278,141,137,102.9
33390, 증평군,070005, 69세,2018,273,131,142,92.3,270,128,142,90.1
33390, 증평군,075,70~74세,2018,1322,622,700,88.9,1314,619,695,89.1
33390, 증평군,075001, 70세,2018,313,155,158,98.1,313,155,158,98.1
33390, 증평군,075002, 71세,2018,304,147,157,93.6,299,145,154,94.2
33390, 증평군,075003, 72세,2018,215,102,113,90.3,215,102,113,90.3
33390, 증평군,075004, 73세,2018,241,111,130,85.4,240,111,129,86
33390, 증평군,075005, 74세,2018,249,107,142,75.4,247,106,141,75.2
33390, 증평군,080,75~79세,2018,1291,532,759,70.1,1289,531,758,70.1
33390, 증평군,080001, 75세,2018,296,114,182,62.6,295,114,181,63
33390, 증평군,080002, 76세,2018,282,116,166,69.9,282,116,166,69.9
33390, 증평군,080003, 77세,2018,261,106,155,68.4,260,105,155,67.7
33390, 증평군,080004, 78세,2018,226,101,125,80.8,226,101,125,80.8
33390, 증평군,080005, 79세,2018,226,95,131,72.5,226,95,131,72.5
33390, 증평군,085,80~84세,2018,898,306,592,51.7,895,306,589,52
33390, 증평군,085001, 80세,2018,231,78,153,51,231,78,153,51
33390, 증평군,085002, 81세,2018,169,70,99,70.7,169,70,99,70.7
33390, 증평군,085003, 82세,2018,199,63,136,46.3,197,63,134,47
33390, 증평군,085004, 83세,2018,173,50,123,40.7,172,50,122,41
33390, 증평군,085005, 84세,2018,126,45,81,55.6,126,45,81,55.6
33390, 증평군,090,85~89세,2018,389,95,294,32.3,387,95,292,32.5
33390, 증평군,090001, 85세,2018,121,29,92,31.5,121,29,92,31.5
33390, 증평군,090002, 86세,2018,95,17,78,21.8,95,17,78,21.8
33390, 증평군,090003, 87세,2018,69,18,51,35.3,69,18,51,35.3
33390, 증평군,090004, 88세,2018,58,17,41,41.5,57,17,40,42.5
33390, 증평군,090005, 89세,2018,46,14,32,43.8,45,14,31,45.2
33390, 증평군,095,90~94세,2018,116,26,90,28.9,116,26,90,28.9
33390, 증평군,095001, 90세,2018,34,8,26,30.8,34,8,26,30.8
33390, 증평군,095002, 91세,2018,29,10,19,52.6,29,10,19,52.6
33390, 증평군,095003, 92세,2018,19,6,13,46.2,19,6,13,46.2
33390, 증평군,095004, 93세,2018,21,X,20,5,21,X,20,5
33390, 증평군,095005, 94세,2018,13,X,12,8.3,13,X,12,8.3
33390, 증평군,100,95~99세,2018,29,8,21,38.1,29,8,21,38.1
33390, 증평군,100001, 95세,2018,9,X,8,12.5,9,X,8,12.5
33390, 증평군,100002, 96세,2018,8,X,X,100,8,X,X,100
33390, 증평군,100003, 97세,2018,6,X,5,20,6,X,5,20
33390, 증평군,100004, 98세,2018,X,X,X,0,X,X,X,0
33390, 증평군,100005, 99세,2018,5,X,X,66.7,5,X,X,66.7
33390, 증평군,101,100세이상,2018,X,X,X,0,X,X,X,0
33390, 증평군,102,15세미만,2018,5482,2809,2673,105.1,5457,2799,2658,105.3
33390, 증평군,103,15~64세,2018,26315,13992,12323,113.5,25359,13482,11877,113.5
33390, 증평군,104,65세이상,2018,5688,2398,3290,72.9,5647,2378,3269,72.7
33390, 증평군,086,85세이상,2018,538,129,409,31.5,536,129,407,31.7
33390, 증평군,126,평균연령,2018,41.5,40.2,42.8,,41.5,40.3,42.8,
33390, 증평군,127,중위연령,2018,42,40.6,43.6,,42.2,40.9,43.9,
34,충청남도,000,합계,2018,2181416,1119996,1061420,105.5,2085578,1061485,1024093,103.7
34,충청남도,005,0~4세,2018,88159,44922,43237,103.9,86621,44147,42474,103.9
34,충청남도,005001, 0세,2018,14923,7579,7344,103.2,14630,7435,7195,103.3
34,충청남도,005002, 1세,2018,16324,8375,7949,105.4,15973,8196,7777,105.4
34,충청남도,005003, 2세,2018,18398,9318,9080,102.6,18045,9142,8903,102.7
34,충청남도,005004, 3세,2018,19486,9903,9583,103.3,19205,9771,9434,103.6
34,충청남도,005005, 4세,2018,19028,9747,9281,105,18768,9603,9165,104.8
34,충청남도,010,5~9세,2018,101586,52389,49197,106.5,100687,51918,48769,106.5
34,충청남도,010001, 5세,2018,19705,10077,9628,104.7,19497,9964,9533,104.5
34,충청남도,010002, 6세,2018,21147,10812,10335,104.6,20933,10699,10234,104.5
34,충청남도,010003, 7세,2018,21004,10910,10094,108.1,20833,10834,9999,108.4
34,충청남도,010004, 8세,2018,20295,10546,9749,108.2,20125,10456,9669,108.1
34,충청남도,010005, 9세,2018,19435,10044,9391,107,19299,9965,9334,106.8
34,충청남도,015,10~14세,2018,97915,50647,47268,107.1,97353,50353,47000,107.1
34,충청남도,015001, 10세,2018,20305,10419,9886,105.4,20178,10354,9824,105.4
34,충청남도,015002, 11세,2018,20654,10756,9898,108.7,20522,10686,9836,108.6
34,충청남도,015003, 12세,2018,18931,9794,9137,107.2,18836,9743,9093,107.1
34,충청남도,015004, 13세,2018,18314,9455,8859,106.7,18219,9400,8819,106.6
34,충청남도,015005, 14세,2018,19711,10223,9488,107.7,19598,10170,9428,107.9
34,충청남도,020,15~19세,2018,123026,64278,58748,109.4,120816,63241,57575,109.8
34,충청남도,020001, 15세,2018,19904,10366,9538,108.7,19832,10327,9505,108.6
34,충청남도,020002, 16세,2018,20677,10918,9759,111.9,20582,10865,9717,111.8
34,충청남도,020003, 17세,2018,24050,12694,11356,111.8,23827,12591,11236,112.1
34,충청남도,020004, 18세,2018,27726,14586,13140,111,27160,14322,12838,111.6
34,충청남도,020005, 19세,2018,30669,15714,14955,105.1,29415,15136,14279,106
34,충청남도,025,20~24세,2018,148850,80883,67967,119,136454,73689,62765,117.4
34,충청남도,025001, 20세,2018,30315,15162,15153,100.1,28388,14237,14151,100.6
34,충청남도,025002, 21세,2018,30084,15205,14879,102.2,27965,14094,13871,101.6
34,충청남도,025003, 22세,2018,30653,16840,13813,121.9,28137,15381,12756,120.6
34,충청남도,025004, 23세,2018,29279,16941,12338,137.3,26496,15202,11294,134.6
34,충청남도,025005, 24세,2018,28519,16735,11784,142,25468,14775,10693,138.2
34,충청남도,030,25~29세,2018,135158,76756,58402,131.4,118697,65843,52854,124.6
34,충청남도,030001, 25세,2018,28026,15817,12209,129.6,24981,13818,11163,123.8
34,충청남도,030002, 26세,2018,28285,16022,12263,130.7,25053,13864,11189,123.9
34,충청남도,030003, 27세,2018,26159,14777,11382,129.8,22903,12684,10219,124.1
34,충청남도,030004, 28세,2018,26448,15073,11375,132.5,22942,12718,10224,124.4
34,충청남도,030005, 29세,2018,26240,15067,11173,134.9,22818,12759,10059,126.8
34,충청남도,035,30~34세,2018,139708,77443,62265,124.4,123349,66628,56721,117.5
34,충청남도,035001, 30세,2018,27008,15123,11885,127.2,23476,12779,10697,119.5
34,충청남도,035002, 31세,2018,27659,15388,12271,125.4,24165,13059,11106,117.6
34,충청남도,035003, 32세,2018,27683,15335,12348,124.2,24421,13223,11198,118.1
34,충청남도,035004, 33세,2018,27907,15521,12386,125.3,24766,13424,11342,118.4
34,충청남도,035005, 34세,2018,29451,16076,13375,120.2,26521,14143,12378,114.3
34,충청남도,040,35~39세,2018,171232,93064,78168,119.1,158758,84729,74029,114.5
34,충청남도,040001, 35세,2018,32317,17697,14620,121,29563,15860,13703,115.7
34,충청남도,040002, 36세,2018,35283,19153,16130,118.7,32565,17339,15226,113.9
34,충청남도,040003, 37세,2018,34761,19021,15740,120.8,32355,17433,14922,116.8
34,충청남도,040004, 38세,2018,35606,19209,16397,117.1,33281,17647,15634,112.9
34,충청남도,040005, 39세,2018,33265,17984,15281,117.7,30994,16450,14544,113.1
34,충청남도,045,40~44세,2018,160037,86036,74001,116.3,151487,80492,70995,113.4
34,충청남도,045001, 40세,2018,30749,16859,13890,121.4,28824,15552,13272,117.2
34,충청남도,045002, 41세,2018,31524,16954,14570,116.4,29747,15808,13939,113.4
34,충청남도,045003, 42세,2018,30932,16553,14379,115.1,29243,15479,13764,112.5
34,충청남도,045004, 43세,2018,31948,16871,15077,111.9,30364,15851,14513,109.2
34,충청남도,045005, 44세,2018,34884,18799,16085,116.9,33309,17802,15507,114.8
34,충청남도,050,45~49세,2018,175970,94315,81655,115.5,167942,89556,78386,114.2
34,충청남도,050001, 45세,2018,34895,18649,16246,114.8,33307,17689,15618,113.3
34,충청남도,050002, 46세,2018,33606,18136,15470,117.2,31894,17099,14795,115.6
34,충청남도,050003, 47세,2018,36699,19873,16826,118.1,35035,18855,16180,116.5
34,충청남도,050004, 48세,2018,34604,18489,16115,114.7,33001,17563,15438,113.8
34,충청남도,050005, 49세,2018,36166,19168,16998,112.8,34705,18350,16355,112.2
34,충청남도,055,50~54세,2018,163316,85911,77405,111,157075,82545,74530,110.8
34,충청남도,055001, 50세,2018,35562,18580,16982,109.4,34222,17834,16388,108.8
34,충청남도,055002, 51세,2018,32556,17057,15499,110.1,31368,16398,14970,109.5
34,충청남도,055003, 52세,2018,30108,16032,14076,113.9,28903,15404,13499,114.1
34,충청남도,055004, 53세,2018,34259,17976,16283,110.4,32917,17275,15642,110.4
34,충청남도,055005, 54세,2018,30831,16266,14565,111.7,29665,15634,14031,111.4
34,충청남도,060,55~59세,2018,172275,88802,83473,106.4,167709,86476,81233,106.5
34,충청남도,060001, 55세,2018,31722,16721,15001,111.5,30399,16033,14366,111.6
34,충청남도,060002, 56세,2018,34127,18056,16071,112.4,33112,17534,15578,112.6
34,충청남도,060003, 57세,2018,37869,19578,18291,107,37185,19225,17960,107
34,충청남도,060004, 58세,2018,36834,18558,18276,101.5,35960,18124,17836,101.6
34,충청남도,060005, 59세,2018,31723,15889,15834,100.3,31053,15560,15493,100.4
34,충청남도,065,60~64세,2018,141028,70769,70259,100.7,137876,69130,68746,100.6
34,충청남도,065001, 60세,2018,29928,15095,14833,101.8,29214,14722,14492,101.6
34,충청남도,065002, 61세,2018,29482,15130,14352,105.4,28729,14698,14031,104.8
34,충청남도,065003, 62세,2018,27894,14018,13876,101,27281,13713,13568,101.1
34,충청남도,065004, 63세,2018,28965,14440,14525,99.4,28396,14147,14249,99.3
34,충청남도,065005, 64세,2018,24759,12086,12673,95.4,24256,11850,12406,95.5
34,충청남도,070,65~69세,2018,102476,50005,52471,95.3,101091,49317,51774,95.3
34,충청남도,070001, 65세,2018,20315,10020,10295,97.3,19925,9829,10096,97.4
34,충청남도,070002, 66세,2018,23107,11225,11882,94.5,22772,11063,11709,94.5
34,충청남도,070003, 67세,2018,18062,8897,9165,97.1,17806,8751,9055,96.6
34,충청남도,070004, 68세,2018,20489,9861,10628,92.8,20291,9764,10527,92.8
34,충청남도,070005, 69세,2018,20503,10002,10501,95.2,20297,9910,10387,95.4
34,충청남도,075,70~74세,2018,80854,37852,43002,88,80339,37650,42689,88.2
34,충청남도,075001, 70세,2018,19190,9252,9938,93.1,19062,9202,9860,93.3
34,충청남도,075002, 71세,2018,18820,9019,9801,92,18684,8960,9724,92.1
34,충청남도,075003, 72세,2018,13648,6661,6987,95.3,13547,6626,6921,95.7
34,충청남도,075004, 73세,2018,13855,6298,7557,83.3,13785,6270,7515,83.4
34,충청남도,075005, 74세,2018,15341,6622,8719,75.9,15261,6592,8669,76
34,충청남도,080,75~79세,2018,79419,32620,46799,69.7,79155,32536,46619,69.8
34,충청남도,080001, 75세,2018,15528,6754,8774,77,15459,6729,8730,77.1
34,충청남도,080002, 76세,2018,19921,8278,11643,71.1,19872,8263,11609,71.2
34,충청남도,080003, 77세,2018,14929,6089,8840,68.9,14868,6068,8800,69
34,충청남도,080004, 78세,2018,13818,5545,8273,67,13766,5528,8238,67.1
34,충청남도,080005, 79세,2018,15223,5954,9269,64.2,15190,5948,9242,64.4
34,충청남도,085,80~84세,2018,60114,22003,38111,57.7,59943,21952,37991,57.8
34,충청남도,085001, 80세,2018,13985,5318,8667,61.4,13940,5306,8634,61.5
34,충청남도,085002, 81세,2018,12905,4897,8008,61.2,12860,4883,7977,61.2
34,충청남도,085003, 82세,2018,12219,4478,7741,57.8,12190,4470,7720,57.9
34,충청남도,085004, 83세,2018,11480,3965,7515,52.8,11450,3955,7495,52.8
34,충청남도,085005, 84세,2018,9525,3345,6180,54.1,9503,3338,6165,54.1
34,충청남도,090,85~89세,2018,28914,8738,20176,43.3,28860,8723,20137,43.3
34,충청남도,090001, 85세,2018,8173,2712,5461,49.7,8157,2708,5449,49.7
34,충청남도,090002, 86세,2018,7344,2343,5001,46.9,7335,2340,4995,46.8
34,충청남도,090003, 87세,2018,5076,1454,3622,40.1,5064,1450,3614,40.1
34,충청남도,090004, 88세,2018,4532,1226,3306,37.1,4523,1225,3298,37.1
34,충청남도,090005, 89세,2018,3789,1003,2786,36,3781,1000,2781,36
34,충청남도,095,90~94세,2018,8940,2122,6818,31.1,8929,2119,6810,31.1
34,충청남도,095001, 90세,2018,3074,774,2300,33.7,3069,773,2296,33.7
34,충청남도,095002, 91세,2018,2244,553,1691,32.7,2238,551,1687,32.7
34,충청남도,095003, 92세,2018,1538,337,1201,28.1,1538,337,1201,28.1
34,충청남도,095004, 93세,2018,1233,283,950,29.8,1233,283,950,29.8
34,충청남도,095005, 94세,2018,851,175,676,25.9,851,175,676,25.9
34,충청남도,100,95~99세,2018,2198,410,1788,22.9,2196,410,1786,23
34,충청남도,100001, 95세,2018,844,165,679,24.3,843,165,678,24.3
34,충청남도,100002, 96세,2018,612,99,513,19.3,611,99,512,19.3
34,충청남도,100003, 97세,2018,352,80,272,29.4,352,80,272,29.4
34,충청남도,100004, 98세,2018,236,35,201,17.4,236,35,201,17.4
34,충청남도,100005, 99세,2018,154,31,123,25.2,154,31,123,25.2
34,충청남도,101,100세이상,2018,241,31,210,14.8,241,31,210,14.8
34,충청남도,102,15세미만,2018,287660,147958,139702,105.9,284661,146418,138243,105.9
34,충청남도,103,15~64세,2018,1530600,818257,712343,114.9,1440163,762329,677834,112.5
34,충청남도,104,65세이상,2018,363156,153781,209375,73.4,360754,152738,208016,73.4
34,충청남도,086,85세이상,2018,40293,11301,28992,39,40226,11283,28943,39
34,충청남도,126,평균연령,2018,42.3,40.9,43.8,,42.6,41.2,44,
34,충청남도,127,중위연령,2018,42.7,41.2,44.5,,43.4,41.9,44.9,
34004, 읍부,000,합계,2018,507389,261430,245959,106.3,488140,249499,238641,104.5
34004, 읍부,005,0~4세,2018,20182,10285,9897,103.9,19976,10171,9805,103.7
34004, 읍부,005001, 0세,2018,3332,1712,1620,105.7,3298,1693,1605,105.5
34004, 읍부,005002, 1세,2018,3731,1894,1837,103.1,3687,1871,1816,103
34004, 읍부,005003, 2세,2018,4135,2075,2060,100.7,4089,2047,2042,100.2
34004, 읍부,005004, 3세,2018,4557,2325,2232,104.2,4518,2305,2213,104.2
34004, 읍부,005005, 4세,2018,4427,2279,2148,106.1,4384,2255,2129,105.9
34004, 읍부,010,5~9세,2018,24365,12666,11699,108.3,24209,12583,11626,108.2
34004, 읍부,010001, 5세,2018,4572,2394,2178,109.9,4533,2373,2160,109.9
34004, 읍부,010002, 6세,2018,5047,2574,2473,104.1,5020,2564,2456,104.4
34004, 읍부,010003, 7세,2018,4992,2584,2408,107.3,4967,2572,2395,107.4
34004, 읍부,010004, 8세,2018,4927,2584,2343,110.3,4888,2558,2330,109.8
34004, 읍부,010005, 9세,2018,4827,2530,2297,110.1,4801,2516,2285,110.1
34004, 읍부,015,10~14세,2018,24073,12338,11735,105.1,23977,12296,11681,105.3
34004, 읍부,015001, 10세,2018,4994,2587,2407,107.5,4973,2576,2397,107.5
34004, 읍부,015002, 11세,2018,5153,2646,2507,105.5,5132,2638,2494,105.8
34004, 읍부,015003, 12세,2018,4636,2398,2238,107.1,4626,2395,2231,107.4
34004, 읍부,015004, 13세,2018,4508,2301,2207,104.3,4489,2291,2198,104.2
34004, 읍부,015005, 14세,2018,4782,2406,2376,101.3,4757,2396,2361,101.5
34004, 읍부,020,15~19세,2018,30256,15820,14436,109.6,29932,15677,14255,110
34004, 읍부,020001, 15세,2018,5039,2666,2373,112.3,5023,2657,2366,112.3
34004, 읍부,020002, 16세,2018,5494,2889,2605,110.9,5479,2880,2599,110.8
34004, 읍부,020003, 17세,2018,6070,3174,2896,109.6,6041,3156,2885,109.4
34004, 읍부,020004, 18세,2018,6813,3569,3244,110,6731,3530,3201,110.3
34004, 읍부,020005, 19세,2018,6840,3522,3318,106.1,6658,3454,3204,107.8
34004, 읍부,025,20~24세,2018,31733,17872,13861,128.9,29347,16441,12906,127.4
34004, 읍부,025001, 20세,2018,6707,3441,3266,105.4,6370,3286,3084,106.5
34004, 읍부,025002, 21세,2018,6472,3393,3079,110.2,6057,3175,2882,110.2
34004, 읍부,025003, 22세,2018,6588,3791,2797,135.5,6077,3482,2595,134.2
34004, 읍부,025004, 23세,2018,6128,3706,2422,153,5589,3360,2229,150.7
34004, 읍부,025005, 24세,2018,5838,3541,2297,154.2,5254,3138,2116,148.3
34004, 읍부,030,25~29세,2018,28107,16180,11927,135.7,24625,13874,10751,129
34004, 읍부,030001, 25세,2018,5732,3297,2435,135.4,5080,2871,2209,130
34004, 읍부,030002, 26세,2018,5867,3370,2497,135,5166,2894,2272,127.4
34004, 읍부,030003, 27세,2018,5417,3122,2295,136,4770,2708,2062,131.3
34004, 읍부,030004, 28세,2018,5453,3154,2299,137.2,4723,2665,2058,129.5
34004, 읍부,030005, 29세,2018,5638,3237,2401,134.8,4886,2736,2150,127.3
34004, 읍부,035,30~34세,2018,30096,16723,13373,125.1,26667,14401,12266,117.4
34004, 읍부,035001, 30세,2018,5772,3229,2543,127,5040,2728,2312,118
34004, 읍부,035002, 31세,2018,5774,3231,2543,127.1,5048,2734,2314,118.2
34004, 읍부,035003, 32세,2018,5943,3353,2590,129.5,5264,2893,2371,122
34004, 읍부,035004, 33세,2018,6086,3365,2721,123.7,5382,2898,2484,116.7
34004, 읍부,035005, 34세,2018,6521,3545,2976,119.1,5933,3148,2785,113
34004, 읍부,040,35~39세,2018,39013,21199,17814,119,36481,19487,16994,114.7
34004, 읍부,040001, 35세,2018,7181,3967,3214,123.4,6600,3561,3039,117.2
34004, 읍부,040002, 36세,2018,7880,4203,3677,114.3,7348,3840,3508,109.5
34004, 읍부,040003, 37세,2018,7956,4430,3526,125.6,7466,4106,3360,122.2
34004, 읍부,040004, 38세,2018,8339,4525,3814,118.6,7823,4176,3647,114.5
34004, 읍부,040005, 39세,2018,7657,4074,3583,113.7,7244,3804,3440,110.6
34004, 읍부,045,40~44세,2018,38344,20560,17784,115.6,36553,19397,17156,113.1
34004, 읍부,045001, 40세,2018,7288,3946,3342,118.1,6897,3670,3227,113.7
34004, 읍부,045002, 41세,2018,7587,4065,3522,115.4,7224,3821,3403,112.3
34004, 읍부,045003, 42세,2018,7434,3989,3445,115.8,7072,3766,3306,113.9
34004, 읍부,045004, 43세,2018,7723,4078,3645,111.9,7383,3868,3515,110
34004, 읍부,045005, 44세,2018,8312,4482,3830,117,7977,4272,3705,115.3
34004, 읍부,050,45~49세,2018,42348,23069,19279,119.7,40777,22123,18654,118.6
34004, 읍부,050001, 45세,2018,8474,4593,3881,118.3,8149,4401,3748,117.4
34004, 읍부,050002, 46세,2018,8229,4543,3686,123.3,7895,4338,3557,122
34004, 읍부,050003, 47세,2018,8723,4774,3949,120.9,8420,4576,3844,119
34004, 읍부,050004, 48세,2018,8404,4550,3854,118.1,8069,4355,3714,117.3
34004, 읍부,050005, 49세,2018,8518,4609,3909,117.9,8244,4453,3791,117.5
34004, 읍부,055,50~54세,2018,38447,20556,17891,114.9,37229,19899,17330,114.8
34004, 읍부,055001, 50세,2018,8350,4510,3840,117.4,8082,4357,3725,117
34004, 읍부,055002, 51세,2018,7636,4091,3545,115.4,7401,3958,3443,115
34004, 읍부,055003, 52세,2018,7078,3804,3274,116.2,6846,3688,3158,116.8
34004, 읍부,055004, 53세,2018,8081,4291,3790,113.2,7824,4158,3666,113.4
34004, 읍부,055005, 54세,2018,7302,3860,3442,112.1,7076,3738,3338,112
34004, 읍부,060,55~59세,2018,40567,20875,19692,106,39637,20412,19225,106.2
34004, 읍부,060001, 55세,2018,7385,3890,3495,111.3,7144,3771,3373,111.8
34004, 읍부,060002, 56세,2018,7979,4255,3724,114.3,7758,4141,3617,114.5
34004, 읍부,060003, 57세,2018,9001,4627,4374,105.8,8859,4551,4308,105.6
34004, 읍부,060004, 58세,2018,8710,4393,4317,101.8,8526,4309,4217,102.2
34004, 읍부,060005, 59세,2018,7492,3710,3782,98.1,7350,3640,3710,98.1
34004, 읍부,065,60~64세,2018,33916,16832,17084,98.5,33277,16496,16781,98.3
34004, 읍부,065001, 60세,2018,7160,3582,3578,100.1,7009,3504,3505,100
34004, 읍부,065002, 61세,2018,7188,3687,3501,105.3,7041,3604,3437,104.9
34004, 읍부,065003, 62세,2018,6627,3312,3315,99.9,6501,3246,3255,99.7
34004, 읍부,065004, 63세,2018,6929,3362,3567,94.3,6825,3306,3519,93.9
34004, 읍부,065005, 64세,2018,6012,2889,3123,92.5,5901,2836,3065,92.5
34004, 읍부,070,65~69세,2018,24858,11942,12916,92.5,24592,11810,12782,92.4
34004, 읍부,070001, 65세,2018,4903,2403,2500,96.1,4833,2371,2462,96.3
34004, 읍부,070002, 66세,2018,5577,2644,2933,90.1,5517,2613,2904,90
34004, 읍부,070003, 67세,2018,4461,2149,2312,92.9,4408,2118,2290,92.5
34004, 읍부,070004, 68세,2018,4958,2356,2602,90.5,4920,2334,2586,90.3
34004, 읍부,070005, 69세,2018,4959,2390,2569,93,4914,2374,2540,93.5
34004, 읍부,075,70~74세,2018,19798,9322,10476,89,19692,9284,10408,89.2
34004, 읍부,075001, 70세,2018,4725,2267,2458,92.2,4708,2260,2448,92.3
34004, 읍부,075002, 71세,2018,4652,2251,2401,93.8,4618,2239,2379,94.1
34004, 읍부,075003, 72세,2018,3413,1659,1754,94.6,3390,1651,1739,94.9
34004, 읍부,075004, 73세,2018,3394,1592,1802,88.3,3375,1585,1790,88.5
34004, 읍부,075005, 74세,2018,3614,1553,2061,75.4,3601,1549,2052,75.5
34004, 읍부,080,75~79세,2018,18545,7678,10867,70.7,18490,7656,10834,70.7
34004, 읍부,080001, 75세,2018,3779,1651,2128,77.6,3765,1643,2122,77.4
34004, 읍부,080002, 76세,2018,4609,1942,2667,72.8,4598,1939,2659,72.9
34004, 읍부,080003, 77세,2018,3461,1412,2049,68.9,3450,1408,2042,69
34004, 읍부,080004, 78세,2018,3176,1290,1886,68.4,3161,1284,1877,68.4
34004, 읍부,080005, 79세,2018,3520,1383,2137,64.7,3516,1382,2134,64.8
34004, 읍부,085,80~84세,2018,13576,4971,8605,57.8,13530,4955,8575,57.8
34004, 읍부,085001, 80세,2018,3175,1240,1935,64.1,3161,1234,1927,64
34004, 읍부,085002, 81세,2018,2901,1082,1819,59.5,2889,1076,1813,59.3
34004, 읍부,085003, 82세,2018,2765,1044,1721,60.7,2756,1042,1714,60.8
34004, 읍부,085004, 83세,2018,2601,869,1732,50.2,2596,867,1729,50.1
34004, 읍부,085005, 84세,2018,2134,736,1398,52.6,2128,736,1392,52.9
34004, 읍부,090,85~89세,2018,6520,1963,4557,43.1,6510,1961,4549,43.1
34004, 읍부,090001, 85세,2018,1828,596,1232,48.4,1825,594,1231,48.3
34004, 읍부,090002, 86세,2018,1671,519,1152,45.1,1670,519,1151,45.1
34004, 읍부,090003, 87세,2018,1134,324,810,40,1132,324,808,40.1
34004, 읍부,090004, 88세,2018,1034,278,756,36.8,1032,278,754,36.9
34004, 읍부,090005, 89세,2018,853,246,607,40.5,851,246,605,40.7
34004, 읍부,095,90~94세,2018,2082,472,1610,29.3,2077,469,1608,29.2
34004, 읍부,095001, 90세,2018,691,168,523,32.1,688,167,521,32.1
34004, 읍부,095002, 91세,2018,522,118,404,29.2,520,116,404,28.7
34004, 읍부,095003, 92세,2018,350,82,268,30.6,350,82,268,30.6
34004, 읍부,095004, 93세,2018,299,58,241,24.1,299,58,241,24.1
34004, 읍부,095005, 94세,2018,220,46,174,26.4,220,46,174,26.4
34004, 읍부,100,95~99세,2018,511,101,410,24.6,510,101,409,24.7
34004, 읍부,100001, 95세,2018,201,35,166,21.1,201,35,166,21.1
34004, 읍부,100002, 96세,2018,140,24,116,20.7,139,24,115,20.9
34004, 읍부,100003, 97세,2018,86,25,61,41,86,25,61,41
34004, 읍부,100004, 98세,2018,46,9,37,24.3,46,9,37,24.3
34004, 읍부,100005, 99세,2018,38,8,30,26.7,38,8,30,26.7
34004, 읍부,101,100세이상,2018,52,6,46,13,52,6,46,13
34004, 읍부,102,15세미만,2018,68620,35289,33331,105.9,68162,35050,33112,105.9
34004, 읍부,103,15~64세,2018,352827,189686,163141,116.3,334525,178207,156318,114
34004, 읍부,104,65세이상,2018,85942,36455,49487,73.7,85453,36242,49211,73.6
34004, 읍부,086,85세이상,2018,9165,2542,6623,38.4,9149,2537,6612,38.4
34004, 읍부,126,평균연령,2018,42.5,41.1,44.1,,42.8,41.4,44.3,
34004, 읍부,127,중위연령,2018,43.5,41.9,45.1,,44,42.6,45.5,
34005, 면부,000,합계,2018,675822,354010,321812,110,628950,322544,306406,105.3
34005, 면부,005,0~4세,2018,17893,9091,8802,103.3,17346,8817,8529,103.4
34005, 면부,005001, 0세,2018,2974,1503,1471,102.2,2871,1450,1421,102
34005, 면부,005002, 1세,2018,3237,1639,1598,102.6,3116,1582,1534,103.1
34005, 면부,005003, 2세,2018,3795,1949,1846,105.6,3655,1883,1772,106.3
34005, 면부,005004, 3세,2018,3918,2005,1913,104.8,3835,1965,1870,105.1
34005, 면부,005005, 4세,2018,3969,1995,1974,101.1,3869,1937,1932,100.3
34005, 면부,010,5~9세,2018,21056,10953,10103,108.4,20703,10766,9937,108.3
34005, 면부,010001, 5세,2018,4063,2077,1986,104.6,3980,2028,1952,103.9
34005, 면부,010002, 6세,2018,4303,2257,2046,110.3,4222,2212,2010,110
34005, 면부,010003, 7세,2018,4352,2276,2076,109.6,4287,2249,2038,110.4
34005, 면부,010004, 8세,2018,4276,2207,2069,106.7,4209,2177,2032,107.1
34005, 면부,010005, 9세,2018,4062,2136,1926,110.9,4005,2100,1905,110.2
34005, 면부,015,10~14세,2018,20418,10568,9850,107.3,20178,10433,9745,107.1
34005, 면부,015001, 10세,2018,4285,2159,2126,101.6,4229,2128,2101,101.3
34005, 면부,015002, 11세,2018,4316,2304,2012,114.5,4259,2270,1989,114.1
34005, 면부,015003, 12세,2018,3955,2034,1921,105.9,3914,2008,1906,105.4
34005, 면부,015004, 13세,2018,3781,1954,1827,107,3746,1933,1813,106.6
34005, 면부,015005, 14세,2018,4081,2117,1964,107.8,4030,2094,1936,108.2
34005, 면부,020,15~19세,2018,30895,16656,14239,117,29892,16145,13747,117.4
34005, 면부,020001, 15세,2018,4258,2234,2024,110.4,4231,2221,2010,110.5
34005, 면부,020002, 16세,2018,4199,2264,1935,117,4159,2240,1919,116.7
34005, 면부,020003, 17세,2018,5264,2824,2440,115.7,5152,2772,2380,116.5
34005, 면부,020004, 18세,2018,6997,3796,3201,118.6,6761,3663,3098,118.2
34005, 면부,020005, 19세,2018,10177,5538,4639,119.4,9589,5249,4340,120.9
34005, 면부,025,20~24세,2018,44217,25524,18693,136.5,36904,21010,15894,132.2
34005, 면부,025001, 20세,2018,8922,4364,4558,95.7,7840,3823,4017,95.2
34005, 면부,025002, 21세,2018,8854,4566,4288,106.5,7606,3878,3728,104
34005, 면부,025003, 22세,2018,9200,5413,3787,142.9,7726,4514,3212,140.5
34005, 면부,025004, 23세,2018,8876,5740,3136,183,7175,4601,2574,178.7
34005, 면부,025005, 24세,2018,8365,5441,2924,186.1,6557,4194,2363,177.5
34005, 면부,030,25~29세,2018,37783,23764,14019,169.5,28523,17035,11488,148.3
34005, 면부,030001, 25세,2018,7951,4954,2997,165.3,6189,3690,2499,147.7
34005, 면부,030002, 26세,2018,7826,4919,2907,169.2,5966,3583,2383,150.4
34005, 면부,030003, 27세,2018,7280,4518,2762,163.6,5446,3219,2227,144.5
34005, 면부,030004, 28세,2018,7544,4749,2795,169.9,5583,3312,2271,145.8
34005, 면부,030005, 29세,2018,7182,4624,2558,180.8,5339,3231,2108,153.3
34005, 면부,035,30~34세,2018,35817,22069,13748,160.5,27194,15809,11385,138.9
34005, 면부,035001, 30세,2018,7141,4462,2679,166.6,5206,3063,2143,142.9
34005, 면부,035002, 31세,2018,7311,4548,2763,164.6,5466,3188,2278,139.9
34005, 면부,035003, 32세,2018,7029,4343,2686,161.7,5325,3141,2184,143.8
34005, 면부,035004, 33세,2018,7112,4351,2761,157.6,5473,3153,2320,135.9
34005, 면부,035005, 34세,2018,7224,4365,2859,152.7,5724,3264,2460,132.7
34005, 면부,040,35~39세,2018,40735,24407,16328,149.5,34307,19751,14556,135.7
34005, 면부,040001, 35세,2018,7797,4687,3110,150.7,6355,3634,2721,133.6
34005, 면부,040002, 36세,2018,8440,5136,3304,155.4,7026,4116,2910,141.4
34005, 면부,040003, 37세,2018,8257,4906,3351,146.4,6997,4002,2995,133.6
34005, 면부,040004, 38세,2018,8305,4919,3386,145.3,7150,4088,3062,133.5
34005, 면부,040005, 39세,2018,7936,4759,3177,149.8,6779,3911,2868,136.4
34005, 면부,045,40~44세,2018,38528,23068,15460,149.2,34318,20128,14190,141.8
34005, 면부,045001, 40세,2018,7358,4464,2894,154.3,6371,3759,2612,143.9
34005, 면부,045002, 41세,2018,7486,4457,3029,147.1,6576,3827,2749,139.2
34005, 면부,045003, 42세,2018,7498,4468,3030,147.5,6675,3909,2766,141.3
34005, 면부,045004, 43세,2018,7697,4586,3111,147.4,6959,4055,2904,139.6
34005, 면부,045005, 44세,2018,8489,5093,3396,150,7737,4578,3159,144.9
34005, 면부,050,45~49세,2018,44783,26035,18748,138.9,41384,23839,17545,135.9
34005, 면부,050001, 45세,2018,8580,5031,3549,141.8,7876,4569,3307,138.2
34005, 면부,050002, 46세,2018,8456,4956,3500,141.6,7709,4456,3253,137
34005, 면부,050003, 47세,2018,9357,5516,3841,143.6,8634,5037,3597,140
34005, 면부,050004, 48세,2018,8723,5045,3678,137.2,8087,4646,3441,135
34005, 면부,050005, 49세,2018,9667,5487,4180,131.3,9078,5131,3947,130
34005, 면부,055,50~54세,2018,47689,26105,21584,120.9,45292,24691,20601,119.9
34005, 면부,055001, 50세,2018,9675,5351,4324,123.8,9136,5026,4110,122.3
34005, 면부,055002, 51세,2018,9107,5020,4087,122.8,8626,4729,3897,121.3
34005, 면부,055003, 52세,2018,8800,4831,3969,121.7,8355,4570,3785,120.7
34005, 면부,055004, 53세,2018,10405,5696,4709,121,9924,5434,4490,121
34005, 면부,055005, 54세,2018,9702,5207,4495,115.8,9251,4932,4319,114.2
34005, 면부,060,55~59세,2018,60586,31414,29172,107.7,59030,30559,28471,107.3
34005, 면부,060001, 55세,2018,10170,5468,4702,116.3,9715,5205,4510,115.4
34005, 면부,060002, 56세,2018,11550,6098,5452,111.8,11194,5906,5288,111.7
34005, 면부,060003, 57세,2018,13377,6897,6480,106.4,13146,6780,6366,106.5
34005, 면부,060004, 58세,2018,13578,6878,6700,102.7,13276,6707,6569,102.1
34005, 면부,060005, 59세,2018,11911,6073,5838,104,11699,5961,5738,103.9
34005, 면부,065,60~64세,2018,56893,28815,28078,102.6,55970,28290,27680,102.2
34005, 면부,065001, 60세,2018,11534,5816,5718,101.7,11308,5684,5624,101.1
34005, 면부,065002, 61세,2018,11481,5902,5579,105.8,11278,5773,5505,104.9
34005, 면부,065003, 62세,2018,11404,5802,5602,103.6,11232,5714,5518,103.6
34005, 면부,065004, 63세,2018,11952,6085,5867,103.7,11773,5980,5793,103.2
34005, 면부,065005, 64세,2018,10522,5210,5312,98.1,10379,5139,5240,98.1
34005, 면부,070,65~69세,2018,45509,22571,22938,98.4,45153,22393,22760,98.4
34005, 면부,070001, 65세,2018,8751,4335,4416,98.2,8655,4281,4374,97.9
34005, 면부,070002, 66세,2018,9907,4911,4996,98.3,9827,4879,4948,98.6
34005, 면부,070003, 67세,2018,8108,4027,4081,98.7,8046,3992,4054,98.5
34005, 면부,070004, 68세,2018,9328,4590,4738,96.9,9264,4557,4707,96.8
34005, 면부,070005, 69세,2018,9415,4708,4707,100,9361,4684,4677,100.1
34005, 면부,075,70~74세,2018,37470,17718,19752,89.7,37346,17665,19681,89.8
34005, 면부,075001, 70세,2018,8765,4314,4451,96.9,8725,4296,4429,97
34005, 면부,075002, 71세,2018,8595,4177,4418,94.5,8571,4164,4407,94.5
34005, 면부,075003, 72세,2018,6145,3029,3116,97.2,6120,3021,3099,97.5
34005, 면부,075004, 73세,2018,6533,2962,3571,82.9,6516,2956,3560,83
34005, 면부,075005, 74세,2018,7432,3236,4196,77.1,7414,3228,4186,77.1
34005, 면부,080,75~79세,2018,40788,16784,24004,69.9,40710,16756,23954,70
34005, 면부,080001, 75세,2018,7668,3334,4334,76.9,7648,3324,4324,76.9
34005, 면부,080002, 76세,2018,10187,4270,5917,72.2,10171,4267,5904,72.3
34005, 면부,080003, 77세,2018,7655,3136,4519,69.4,7635,3129,4506,69.4
34005, 면부,080004, 78세,2018,7195,2885,4310,66.9,7183,2879,4304,66.9
34005, 면부,080005, 79세,2018,8083,3159,4924,64.2,8073,3157,4916,64.2
34005, 면부,085,80~84세,2018,32811,12147,20664,58.8,32768,12139,20629,58.8
34005, 면부,085001, 80세,2018,7517,2827,4690,60.3,7507,2826,4681,60.4
34005, 면부,085002, 81세,2018,6933,2676,4257,62.9,6921,2674,4247,63
34005, 면부,085003, 82세,2018,6734,2521,4213,59.8,6726,2519,4207,59.9
34005, 면부,085004, 83세,2018,6321,2252,4069,55.3,6313,2251,4062,55.4
34005, 면부,085005, 84세,2018,5306,1871,3435,54.5,5301,1869,3432,54.5
34005, 면부,090,85~89세,2018,15897,4914,10983,44.7,15881,4911,10970,44.8
34005, 면부,090001, 85세,2018,4543,1537,3006,51.1,4537,1536,3001,51.2
34005, 면부,090002, 86세,2018,4033,1331,2702,49.3,4031,1330,2701,49.2
34005, 면부,090003, 87세,2018,2783,818,1965,41.6,2779,817,1962,41.6
34005, 면부,090004, 88세,2018,2468,688,1780,38.7,2465,688,1777,38.7
34005, 면부,090005, 89세,2018,2070,540,1530,35.3,2069,540,1529,35.3
34005, 면부,095,90~94세,2018,4749,1174,3575,32.8,4747,1174,3573,32.9
34005, 면부,095001, 90세,2018,1670,422,1248,33.8,1669,422,1247,33.8
34005, 면부,095002, 91세,2018,1193,327,866,37.8,1192,327,865,37.8
34005, 면부,095003, 92세,2018,794,168,626,26.8,794,168,626,26.8
34005, 면부,095004, 93세,2018,648,165,483,34.2,648,165,483,34.2
34005, 면부,095005, 94세,2018,444,92,352,26.1,444,92,352,26.1
34005, 면부,100,95~99세,2018,1190,219,971,22.6,1189,219,970,22.6
34005, 면부,100001, 95세,2018,470,97,373,26,469,97,372,26.1
34005, 면부,100002, 96세,2018,339,50,289,17.3,339,50,289,17.3
34005, 면부,100003, 97세,2018,181,45,136,33.1,181,45,136,33.1
34005, 면부,100004, 98세,2018,120,15,105,14.3,120,15,105,14.3
34005, 면부,100005, 99세,2018,80,12,68,17.6,80,12,68,17.6
34005, 면부,101,100세이상,2018,115,14,101,13.9,115,14,101,13.9
34005, 면부,102,15세미만,2018,59367,30612,28755,106.5,58227,30016,28211,106.4
34005, 면부,103,15~64세,2018,437926,247857,190069,130.4,392814,217257,175557,123.8
34005, 면부,104,65세이상,2018,178529,75541,102988,73.3,177909,75271,102638,73.3
34005, 면부,086,85세이상,2018,21951,6321,15630,40.4,21932,6318,15614,40.5
34005, 면부,126,평균연령,2018,48.3,45.9,50.9,,49.3,47.1,51.7,
34005, 면부,127,중위연령,2018,50.6,47.2,54.9,,52.7,49.5,56.2,
34003, 동부,000,합계,2018,998205,504556,493649,102.2,968488,489442,479046,102.2
34003, 동부,005,0~4세,2018,50084,25546,24538,104.1,49299,25159,24140,104.2
34003, 동부,005001, 0세,2018,8617,4364,4253,102.6,8461,4292,4169,103
34003, 동부,005002, 1세,2018,9356,4842,4514,107.3,9170,4743,4427,107.1
34003, 동부,005003, 2세,2018,10468,5294,5174,102.3,10301,5212,5089,102.4
34003, 동부,005004, 3세,2018,11011,5573,5438,102.5,10852,5501,5351,102.8
34003, 동부,005005, 4세,2018,10632,5473,5159,106.1,10515,5411,5104,106
34003, 동부,010,5~9세,2018,56165,28770,27395,105,55775,28569,27206,105
34003, 동부,010001, 5세,2018,11070,5606,5464,102.6,10984,5563,5421,102.6
34003, 동부,010002, 6세,2018,11797,5981,5816,102.8,11691,5923,5768,102.7
34003, 동부,010003, 7세,2018,11660,6050,5610,107.8,11579,6013,5566,108
34003, 동부,010004, 8세,2018,11092,5755,5337,107.8,11028,5721,5307,107.8
34003, 동부,010005, 9세,2018,10546,5378,5168,104.1,10493,5349,5144,104
34003, 동부,015,10~14세,2018,53424,27741,25683,108,53198,27624,25574,108
34003, 동부,015001, 10세,2018,11026,5673,5353,106,10976,5650,5326,106.1
34003, 동부,015002, 11세,2018,11185,5806,5379,107.9,11131,5778,5353,107.9
34003, 동부,015003, 12세,2018,10340,5362,4978,107.7,10296,5340,4956,107.7
34003, 동부,015004, 13세,2018,10025,5200,4825,107.8,9984,5176,4808,107.7
34003, 동부,015005, 14세,2018,10848,5700,5148,110.7,10811,5680,5131,110.7
34003, 동부,020,15~19세,2018,61875,31802,30073,105.7,60992,31419,29573,106.2
34003, 동부,020001, 15세,2018,10607,5466,5141,106.3,10578,5449,5129,106.2
34003, 동부,020002, 16세,2018,10984,5765,5219,110.5,10944,5745,5199,110.5
34003, 동부,020003, 17세,2018,12716,6696,6020,111.2,12634,6663,5971,111.6
34003, 동부,020004, 18세,2018,13916,7221,6695,107.9,13668,7129,6539,109
34003, 동부,020005, 19세,2018,13652,6654,6998,95.1,13168,6433,6735,95.5
34003, 동부,025,20~24세,2018,72900,37487,35413,105.9,70203,36238,33965,106.7
34003, 동부,025001, 20세,2018,14686,7357,7329,100.4,14178,7128,7050,101.1
34003, 동부,025002, 21세,2018,14758,7246,7512,96.5,14302,7041,7261,97
34003, 동부,025003, 22세,2018,14865,7636,7229,105.6,14334,7385,6949,106.3
34003, 동부,025004, 23세,2018,14275,7495,6780,110.5,13732,7241,6491,111.6
34003, 동부,025005, 24세,2018,14316,7753,6563,118.1,13657,7443,6214,119.8
34003, 동부,030,25~29세,2018,69268,36812,32456,113.4,65549,34934,30615,114.1
34003, 동부,030001, 25세,2018,14343,7566,6777,111.6,13712,7257,6455,112.4
34003, 동부,030002, 26세,2018,14592,7733,6859,112.7,13921,7387,6534,113.1
34003, 동부,030003, 27세,2018,13462,7137,6325,112.8,12687,6757,5930,113.9
34003, 동부,030004, 28세,2018,13451,7170,6281,114.2,12636,6741,5895,114.4
34003, 동부,030005, 29세,2018,13420,7206,6214,116,12593,6792,5801,117.1
34003, 동부,035,30~34세,2018,73795,38651,35144,110,69488,36418,33070,110.1
34003, 동부,035001, 30세,2018,14095,7432,6663,111.5,13230,6988,6242,112
34003, 동부,035002, 31세,2018,14574,7609,6965,109.2,13651,7137,6514,109.6
34003, 동부,035003, 32세,2018,14711,7639,7072,108,13832,7189,6643,108.2
34003, 동부,035004, 33세,2018,14709,7805,6904,113.1,13911,7373,6538,112.8
34003, 동부,035005, 34세,2018,15706,8166,7540,108.3,14864,7731,7133,108.4
34003, 동부,040,35~39세,2018,91484,47458,44026,107.8,87970,45491,42479,107.1
34003, 동부,040001, 35세,2018,17339,9043,8296,109,16608,8665,7943,109.1
34003, 동부,040002, 36세,2018,18963,9814,9149,107.3,18191,9383,8808,106.5
34003, 동부,040003, 37세,2018,18548,9685,8863,109.3,17892,9325,8567,108.8
34003, 동부,040004, 38세,2018,18962,9765,9197,106.2,18308,9383,8925,105.1
34003, 동부,040005, 39세,2018,17672,9151,8521,107.4,16971,8735,8236,106.1
34003, 동부,045,40~44세,2018,83165,42408,40757,104.1,80616,40967,39649,103.3
34003, 동부,045001, 40세,2018,16103,8449,7654,110.4,15556,8123,7433,109.3
34003, 동부,045002, 41세,2018,16451,8432,8019,105.2,15947,8160,7787,104.8
34003, 동부,045003, 42세,2018,16000,8096,7904,102.4,15496,7804,7692,101.5
34003, 동부,045004, 43세,2018,16528,8207,8321,98.6,16022,7928,8094,97.9
34003, 동부,045005, 44세,2018,18083,9224,8859,104.1,17595,8952,8643,103.6
34003, 동부,050,45~49세,2018,88839,45211,43628,103.6,85781,43594,42187,103.3
34003, 동부,050001, 45세,2018,17841,9025,8816,102.4,17282,8719,8563,101.8
34003, 동부,050002, 46세,2018,16921,8637,8284,104.3,16290,8305,7985,104
34003, 동부,050003, 47세,2018,18619,9583,9036,106.1,17981,9242,8739,105.8
34003, 동부,050004, 48세,2018,17477,8894,8583,103.6,16845,8562,8283,103.4
34003, 동부,050005, 49세,2018,17981,9072,8909,101.8,17383,8766,8617,101.7
34003, 동부,055,50~54세,2018,77180,39250,37930,103.5,74554,37955,36599,103.7
34003, 동부,055001, 50세,2018,17537,8719,8818,98.9,17004,8451,8553,98.8
34003, 동부,055002, 51세,2018,15813,7946,7867,101,15341,7711,7630,101.1
34003, 동부,055003, 52세,2018,14230,7397,6833,108.3,13702,7146,6556,109
34003, 동부,055004, 53세,2018,15773,7989,7784,102.6,15169,7683,7486,102.6
34003, 동부,055005, 54세,2018,13827,7199,6628,108.6,13338,6964,6374,109.3
34003, 동부,060,55~59세,2018,71122,36513,34609,105.5,69042,35505,33537,105.9
34003, 동부,060001, 55세,2018,14167,7363,6804,108.2,13540,7057,6483,108.9
34003, 동부,060002, 56세,2018,14598,7703,6895,111.7,14160,7487,6673,112.2
34003, 동부,060003, 57세,2018,15491,8054,7437,108.3,15180,7894,7286,108.3
34003, 동부,060004, 58세,2018,14546,7287,7259,100.4,14158,7108,7050,100.8
34003, 동부,060005, 59세,2018,12320,6106,6214,98.3,12004,5959,6045,98.6
34003, 동부,065,60~64세,2018,50219,25122,25097,100.1,48629,24344,24285,100.2
34003, 동부,065001, 60세,2018,11234,5697,5537,102.9,10897,5534,5363,103.2
34003, 동부,065002, 61세,2018,10813,5541,5272,105.1,10410,5321,5089,104.6
34003, 동부,065003, 62세,2018,9863,4904,4959,98.9,9548,4753,4795,99.1
34003, 동부,065004, 63세,2018,10084,4993,5091,98.1,9798,4861,4937,98.5
34003, 동부,065005, 64세,2018,8225,3987,4238,94.1,7976,3875,4101,94.5
34003, 동부,070,65~69세,2018,32109,15492,16617,93.2,31346,15114,16232,93.1
34003, 동부,070001, 65세,2018,6661,3282,3379,97.1,6437,3177,3260,97.5
34003, 동부,070002, 66세,2018,7623,3670,3953,92.8,7428,3571,3857,92.6
34003, 동부,070003, 67세,2018,5493,2721,2772,98.2,5352,2641,2711,97.4
34003, 동부,070004, 68세,2018,6203,2915,3288,88.7,6107,2873,3234,88.8
34003, 동부,070005, 69세,2018,6129,2904,3225,90,6022,2852,3170,90
34003, 동부,075,70~74세,2018,23586,10812,12774,84.6,23301,10701,12600,84.9
34003, 동부,075001, 70세,2018,5700,2671,3029,88.2,5629,2646,2983,88.7
34003, 동부,075002, 71세,2018,5573,2591,2982,86.9,5495,2557,2938,87
34003, 동부,075003, 72세,2018,4090,1973,2117,93.2,4037,1954,2083,93.8
34003, 동부,075004, 73세,2018,3928,1744,2184,79.9,3894,1729,2165,79.9
34003, 동부,075005, 74세,2018,4295,1833,2462,74.5,4246,1815,2431,74.7
34003, 동부,080,75~79세,2018,20086,8158,11928,68.4,19955,8124,11831,68.7
34003, 동부,080001, 75세,2018,4081,1769,2312,76.5,4046,1762,2284,77.1
34003, 동부,080002, 76세,2018,5125,2066,3059,67.5,5103,2057,3046,67.5
34003, 동부,080003, 77세,2018,3813,1541,2272,67.8,3783,1531,2252,68
34003, 동부,080004, 78세,2018,3447,1370,2077,66,3422,1365,2057,66.4
34003, 동부,080005, 79세,2018,3620,1412,2208,63.9,3601,1409,2192,64.3
34003, 동부,085,80~84세,2018,13727,4885,8842,55.2,13645,4858,8787,55.3
34003, 동부,085001, 80세,2018,3293,1251,2042,61.3,3272,1246,2026,61.5
34003, 동부,085002, 81세,2018,3071,1139,1932,59,3050,1133,1917,59.1
34003, 동부,085003, 82세,2018,2720,913,1807,50.5,2708,909,1799,50.5
34003, 동부,085004, 83세,2018,2558,844,1714,49.2,2541,837,1704,49.1
34003, 동부,085005, 84세,2018,2085,738,1347,54.8,2074,733,1341,54.7
34003, 동부,090,85~89세,2018,6497,1861,4636,40.1,6469,1851,4618,40.1
34003, 동부,090001, 85세,2018,1802,579,1223,47.3,1795,578,1217,47.5
34003, 동부,090002, 86세,2018,1640,493,1147,43,1634,491,1143,43
34003, 동부,090003, 87세,2018,1159,312,847,36.8,1153,309,844,36.6
34003, 동부,090004, 88세,2018,1030,260,770,33.8,1026,259,767,33.8
34003, 동부,090005, 89세,2018,866,217,649,33.4,861,214,647,33.1
34003, 동부,095,90~94세,2018,2109,476,1633,29.1,2105,476,1629,29.2
34003, 동부,095001, 90세,2018,713,184,529,34.8,712,184,528,34.8
34003, 동부,095002, 91세,2018,529,108,421,25.7,526,108,418,25.8
34003, 동부,095003, 92세,2018,394,87,307,28.3,394,87,307,28.3
34003, 동부,095004, 93세,2018,286,60,226,26.5,286,60,226,26.5
34003, 동부,095005, 94세,2018,187,37,150,24.7,187,37,150,24.7
34003, 동부,100,95~99세,2018,497,90,407,22.1,497,90,407,22.1
34003, 동부,100001, 95세,2018,173,33,140,23.6,173,33,140,23.6
34003, 동부,100002, 96세,2018,133,25,108,23.1,133,25,108,23.1
34003, 동부,100003, 97세,2018,85,10,75,13.3,85,10,75,13.3
34003, 동부,100004, 98세,2018,70,11,59,18.6,70,11,59,18.6
34003, 동부,100005, 99세,2018,36,11,25,44,36,11,25,44
34003, 동부,101,100세이상,2018,74,11,63,17.5,74,11,63,17.5
34003, 동부,102,15세미만,2018,159673,82057,77616,105.7,158272,81352,76920,105.8
34003, 동부,103,15~64세,2018,739847,380714,359133,106,712824,366865,345959,106
34003, 동부,104,65세이상,2018,98685,41785,56900,73.4,97392,41225,56167,73.4
34003, 동부,086,85세이상,2018,9177,2438,6739,36.2,9145,2428,6717,36.1
34003, 동부,126,평균연령,2018,38.1,37.3,39,,38.1,37.3,39,
34003, 동부,127,중위연령,2018,38.4,37.7,39.1,,38.4,37.7,39.1,
34010, 천안시,000,합계,2018,671799,344688,327111,105.4,643376,327828,315548,103.9
34010, 천안시,005,0~4세,2018,31763,16225,15538,104.4,31200,15935,15265,104.4
34010, 천안시,005001, 0세,2018,5584,2857,2727,104.8,5469,2801,2668,105
34010, 천안시,005002, 1세,2018,5873,3051,2822,108.1,5737,2977,2760,107.9
34010, 천안시,005003, 2세,2018,6636,3343,3293,101.5,6514,3277,3237,101.2
34010, 천안시,005004, 3세,2018,6996,3575,3421,104.5,6884,3523,3361,104.8
34010, 천안시,005005, 4세,2018,6674,3399,3275,103.8,6596,3357,3239,103.6
34010, 천안시,010,5~9세,2018,34717,17826,16891,105.5,34412,17671,16741,105.6
34010, 천안시,010001, 5세,2018,6870,3478,3392,102.5,6800,3439,3361,102.3
34010, 천안시,010002, 6세,2018,7373,3727,3646,102.2,7302,3689,3613,102.1
34010, 천안시,010003, 7세,2018,7122,3696,3426,107.9,7060,3670,3390,108.3
34010, 천안시,010004, 8세,2018,6816,3543,3273,108.2,6752,3507,3245,108.1
34010, 천안시,010005, 9세,2018,6536,3382,3154,107.2,6498,3366,3132,107.5
34010, 천안시,015,10~14세,2018,32833,17097,15736,108.6,32655,17010,15645,108.7
34010, 천안시,015001, 10세,2018,6810,3536,3274,108,6773,3518,3255,108.1
34010, 천안시,015002, 11세,2018,6886,3539,3347,105.7,6840,3520,3320,106
34010, 천안시,015003, 12세,2018,6305,3308,2997,110.4,6272,3295,2977,110.7
34010, 천안시,015004, 13세,2018,6184,3194,2990,106.8,6152,3174,2978,106.6
34010, 천안시,015005, 14세,2018,6648,3520,3128,112.5,6618,3503,3115,112.5
34010, 천안시,020,15~19세,2018,41758,21423,20335,105.4,40912,21062,19850,106.1
34010, 천안시,020001, 15세,2018,6487,3347,3140,106.6,6468,3337,3131,106.6
34010, 천안시,020002, 16세,2018,6608,3434,3174,108.2,6582,3419,3163,108.1
34010, 천안시,020003, 17세,2018,7947,4145,3802,109,7888,4111,3777,108.8
34010, 천안시,020004, 18세,2018,9477,4988,4489,111.1,9233,4899,4334,113
34010, 천안시,020005, 19세,2018,11239,5509,5730,96.1,10741,5296,5445,97.3
34010, 천안시,025,20~24세,2018,55062,28569,26493,107.8,51765,26683,25082,106.4
34010, 천안시,025001, 20세,2018,10976,5263,5713,92.1,10387,4973,5414,91.9
34010, 천안시,025002, 21세,2018,10876,5151,5725,90,10295,4852,5443,89.1
34010, 천안시,025003, 22세,2018,11374,6025,5349,112.6,10704,5638,5066,111.3
34010, 천안시,025004, 23세,2018,11082,6059,5023,120.6,10399,5640,4759,118.5
34010, 천안시,025005, 24세,2018,10754,6071,4683,129.6,9980,5580,4400,126.8
34010, 천안시,030,25~29세,2018,51437,27927,23510,118.8,46940,24989,21951,113.8
34010, 천안시,030001, 25세,2018,10961,5923,5038,117.6,10157,5411,4746,114
34010, 천안시,030002, 26세,2018,10950,5962,4988,119.5,10078,5372,4706,114.2
34010, 천안시,030003, 27세,2018,9813,5268,4545,115.9,8948,4741,4207,112.7
34010, 천안시,030004, 28세,2018,9908,5399,4509,119.7,8908,4727,4181,113.1
34010, 천안시,030005, 29세,2018,9805,5375,4430,121.3,8849,4738,4111,115.3
34010, 천안시,035,30~34세,2018,52873,28641,24232,118.2,48274,25699,22575,113.8
34010, 천안시,035001, 30세,2018,10292,5579,4713,118.4,9351,4973,4378,113.6
34010, 천안시,035002, 31세,2018,10607,5659,4948,114.4,9564,4999,4565,109.5
34010, 천안시,035003, 32세,2018,10594,5762,4832,119.2,9665,5178,4487,115.4
34010, 천안시,035004, 33세,2018,10418,5698,4720,120.7,9567,5143,4424,116.3
34010, 천안시,035005, 34세,2018,10962,5943,5019,118.4,10127,5406,4721,114.5
34010, 천안시,040,35~39세,2018,61571,32967,28604,115.3,58054,30652,27402,111.9
34010, 천안시,040001, 35세,2018,11961,6406,5555,115.3,11190,5908,5282,111.9
34010, 천안시,040002, 36세,2018,12907,6906,6001,115.1,12139,6383,5756,110.9
34010, 천안시,040003, 37세,2018,12476,6753,5723,118,11799,6304,5495,114.7
34010, 천안시,040004, 38세,2018,12653,6756,5897,114.6,11969,6313,5656,111.6
34010, 천안시,040005, 39세,2018,11574,6146,5428,113.2,10957,5744,5213,110.2
34010, 천안시,045,40~44세,2018,54710,28545,26165,109.1,52268,26981,25287,106.7
34010, 천안시,045001, 40세,2018,10675,5792,4883,118.6,10139,5426,4713,115.1
34010, 천안시,045002, 41세,2018,10824,5719,5105,112,10305,5392,4913,109.7
34010, 천안시,045003, 42세,2018,10550,5477,5073,108,10078,5181,4897,105.8
34010, 천안시,045004, 43세,2018,10868,5480,5388,101.7,10403,5187,5216,99.4
34010, 천안시,045005, 44세,2018,11793,6077,5716,106.3,11343,5795,5548,104.5
34010, 천안시,050,45~49세,2018,58406,29954,28452,105.3,55888,28517,27371,104.2
34010, 천안시,050001, 45세,2018,11487,5944,5543,107.2,11031,5678,5353,106.1
34010, 천안시,050002, 46세,2018,11175,5686,5489,103.6,10626,5369,5257,102.1
34010, 천안시,050003, 47세,2018,12152,6274,5878,106.7,11646,5980,5666,105.5
34010, 천안시,050004, 48세,2018,11661,5987,5674,105.5,11155,5701,5454,104.5
34010, 천안시,050005, 49세,2018,11931,6063,5868,103.3,11430,5789,5641,102.6
34010, 천안시,055,50~54세,2018,51867,26444,25423,104,49782,25312,24470,103.4
34010, 천안시,055001, 50세,2018,11738,5926,5812,102,11288,5674,5614,101.1
34010, 천안시,055002, 51세,2018,10483,5223,5260,99.3,10103,5005,5098,98.2
34010, 천안시,055003, 52세,2018,9652,4995,4657,107.3,9241,4774,4467,106.9
34010, 천안시,055004, 53세,2018,10642,5487,5155,106.4,10177,5241,4936,106.2
34010, 천안시,055005, 54세,2018,9352,4813,4539,106,8973,4618,4355,106
34010, 천안시,060,55~59세,2018,48247,25142,23105,108.8,46647,24333,22314,109
34010, 천안시,060001, 55세,2018,9612,5019,4593,109.3,9150,4778,4372,109.3
34010, 천안시,060002, 56세,2018,9873,5313,4560,116.5,9508,5132,4376,117.3
34010, 천안시,060003, 57세,2018,10489,5493,4996,109.9,10269,5371,4898,109.7
34010, 천안시,060004, 58세,2018,9930,5097,4833,105.5,9640,4956,4684,105.8
34010, 천안시,060005, 59세,2018,8343,4220,4123,102.4,8080,4096,3984,102.8
34010, 천안시,065,60~64세,2018,33084,16885,16199,104.2,31929,16293,15636,104.2
34010, 천안시,065001, 60세,2018,7494,3894,3600,108.2,7242,3763,3479,108.2
34010, 천안시,065002, 61세,2018,7177,3757,3420,109.9,6898,3601,3297,109.2
34010, 천안시,065003, 62세,2018,6446,3269,3177,102.9,6219,3165,3054,103.6
34010, 천안시,065004, 63세,2018,6650,3336,3314,100.7,6435,3225,3210,100.5
34010, 천안시,065005, 64세,2018,5317,2629,2688,97.8,5135,2539,2596,97.8
34010, 천안시,070,65~69세,2018,20479,10063,10416,96.6,19998,9822,10176,96.5
34010, 천안시,070001, 65세,2018,4372,2218,2154,103,4227,2151,2076,103.6
34010, 천안시,070002, 66세,2018,4979,2464,2515,98,4862,2395,2467,97.1
34010, 천안시,070003, 67세,2018,3481,1749,1732,101,3392,1701,1691,100.6
34010, 천안시,070004, 68세,2018,3845,1808,2037,88.8,3787,1782,2005,88.9
34010, 천안시,070005, 69세,2018,3802,1824,1978,92.2,3730,1793,1937,92.6
34010, 천안시,075,70~74세,2018,14910,6951,7959,87.3,14734,6889,7845,87.8
34010, 천안시,075001, 70세,2018,3591,1763,1828,96.4,3542,1744,1798,97
34010, 천안시,075002, 71세,2018,3530,1620,1910,84.8,3482,1602,1880,85.2
34010, 천안시,075003, 72세,2018,2564,1249,1315,95,2534,1241,1293,96
34010, 천안시,075004, 73세,2018,2502,1144,1358,84.2,2480,1135,1345,84.4
34010, 천안시,075005, 74세,2018,2723,1175,1548,75.9,2696,1167,1529,76.3
34010, 천안시,080,75~79세,2018,12970,5239,7731,67.8,12882,5209,7673,67.9
34010, 천안시,080001, 75세,2018,2643,1099,1544,71.2,2625,1093,1532,71.3
34010, 천안시,080002, 76세,2018,3175,1296,1879,69,3155,1288,1867,69
34010, 천안시,080003, 77세,2018,2432,978,1454,67.3,2412,970,1442,67.3
34010, 천안시,080004, 78세,2018,2310,940,1370,68.6,2293,935,1358,68.9
34010, 천안시,080005, 79세,2018,2410,926,1484,62.4,2397,923,1474,62.6
34010, 천안시,085,80~84세,2018,8982,3166,5816,54.4,8926,3151,5775,54.6
34010, 천안시,085001, 80세,2018,2145,819,1326,61.8,2128,813,1315,61.8
34010, 천안시,085002, 81세,2018,1976,716,1260,56.8,1961,712,1249,57
34010, 천안시,085003, 82세,2018,1752,591,1161,50.9,1745,590,1155,51.1
34010, 천안시,085004, 83세,2018,1679,551,1128,48.8,1670,549,1121,49
34010, 천안시,085005, 84세,2018,1430,489,941,52,1422,487,935,52.1
34010, 천안시,090,85~89세,2018,4293,1237,3056,40.5,4275,1233,3042,40.5
34010, 천안시,090001, 85세,2018,1157,370,787,47,1151,369,782,47.2
34010, 천안시,090002, 86세,2018,1090,316,774,40.8,1087,315,772,40.8
34010, 천안시,090003, 87세,2018,778,209,569,36.7,772,207,565,36.6
34010, 천안시,090004, 88세,2018,698,203,495,41,697,203,494,41.1
34010, 천안시,090005, 89세,2018,570,139,431,32.3,568,139,429,32.4
34010, 천안시,095,90~94세,2018,1417,307,1110,27.7,1415,307,1108,27.7
34010, 천안시,095001, 90세,2018,469,111,358,31,468,111,357,31.1
34010, 천안시,095002, 91세,2018,370,79,291,27.1,369,79,290,27.2
34010, 천안시,095003, 92세,2018,244,42,202,20.8,244,42,202,20.8
34010, 천안시,095004, 93세,2018,203,46,157,29.3,203,46,157,29.3
34010, 천안시,095005, 94세,2018,131,29,102,28.4,131,29,102,28.4
34010, 천안시,100,95~99세,2018,376,77,299,25.8,376,77,299,25.8
34010, 천안시,100001, 95세,2018,137,31,106,29.2,137,31,106,29.2
34010, 천안시,100002, 96세,2018,108,20,88,22.7,108,20,88,22.7
34010, 천안시,100003, 97세,2018,60,14,46,30.4,60,14,46,30.4
34010, 천안시,100004, 98세,2018,47,6,41,14.6,47,6,41,14.6
34010, 천안시,100005, 99세,2018,24,6,18,33.3,24,6,18,33.3
34010, 천안시,101,100세이상,2018,44,X,41,7.3,44,X,41,7.3
34010, 천안시,102,15세미만,2018,99313,51148,48165,106.2,98267,50616,47651,106.2
34010, 천안시,103,15~64세,2018,509015,266497,242518,109.9,482459,250521,231938,108
34010, 천안시,104,65세이상,2018,63471,27043,36428,74.2,62650,26691,35959,74.2
34010, 천안시,086,85세이상,2018,6130,1624,4506,36,6110,1620,4490,36.1
34010, 천안시,126,평균연령,2018,38.1,37.3,38.9,,38.1,37.3,38.9,
34010, 천안시,127,중위연령,2018,37.8,37.2,38.6,,38,37.4,38.7,
34011, 동남구,000,합계,2018,276455,141393,135062,104.7,263455,133726,129729,103.1
34011, 동남구,005,0~4세,2018,10179,5268,4911,107.3,9931,5143,4788,107.4
34011, 동남구,005001, 0세,2018,1717,883,834,105.9,1666,862,804,107.2
34011, 동남구,005002, 1세,2018,1764,930,834,111.5,1703,896,807,111
34011, 동남구,005003, 2세,2018,2137,1117,1020,109.5,2083,1085,998,108.7
34011, 동남구,005004, 3세,2018,2315,1181,1134,104.1,2262,1155,1107,104.3
34011, 동남구,005005, 4세,2018,2246,1157,1089,106.2,2217,1145,1072,106.8
34011, 동남구,010,5~9세,2018,12619,6525,6094,107.1,12489,6461,6028,107.2
34011, 동남구,010001, 5세,2018,2394,1229,1165,105.5,2368,1213,1155,105
34011, 동남구,010002, 6세,2018,2559,1301,1258,103.4,2532,1284,1248,102.9
34011, 동남구,010003, 7세,2018,2643,1373,1270,108.1,2607,1357,1250,108.6
34011, 동남구,010004, 8세,2018,2517,1302,1215,107.2,2490,1292,1198,107.8
34011, 동남구,010005, 9세,2018,2506,1320,1186,111.3,2492,1315,1177,111.7
34011, 동남구,015,10~14세,2018,12730,6637,6093,108.9,12650,6595,6055,108.9
34011, 동남구,015001, 10세,2018,2645,1350,1295,104.2,2625,1341,1284,104.4
34011, 동남구,015002, 11세,2018,2680,1394,1286,108.4,2663,1386,1277,108.5
34011, 동남구,015003, 12세,2018,2439,1300,1139,114.1,2420,1289,1131,114
34011, 동남구,015004, 13세,2018,2417,1243,1174,105.9,2405,1236,1169,105.7
34011, 동남구,015005, 14세,2018,2549,1350,1199,112.6,2537,1343,1194,112.5
34011, 동남구,020,15~19세,2018,19162,9931,9231,107.6,18655,9692,8963,108.1
34011, 동남구,020001, 15세,2018,2629,1364,1265,107.8,2625,1362,1263,107.8
34011, 동남구,020002, 16세,2018,2722,1425,1297,109.9,2707,1417,1290,109.8
34011, 동남구,020003, 17세,2018,3493,1911,1582,120.8,3460,1893,1567,120.8
34011, 동남구,020004, 18세,2018,4440,2450,1990,123.1,4279,2382,1897,125.6
34011, 동남구,020005, 19세,2018,5878,2781,3097,89.8,5584,2638,2946,89.5
34011, 동남구,025,20~24세,2018,25577,13180,12397,106.3,23962,12284,11678,105.2
34011, 동남구,025001, 20세,2018,5442,2402,3040,79,5137,2247,2890,77.8
34011, 동남구,025002, 21세,2018,5169,2323,2846,81.6,4878,2179,2699,80.7
34011, 동남구,025003, 22세,2018,5284,2803,2481,113,4974,2628,2346,112
34011, 동남구,025004, 23세,2018,5020,2904,2116,137.2,4675,2695,1980,136.1
34011, 동남구,025005, 24세,2018,4662,2748,1914,143.6,4298,2535,1763,143.8
34011, 동남구,030,25~29세,2018,19295,10925,8370,130.5,17253,9588,7665,125.1
34011, 동남구,030001, 25세,2018,4422,2511,1911,131.4,4058,2275,1783,127.6
34011, 동남구,030002, 26세,2018,4157,2412,1745,138.2,3751,2142,1609,133.1
34011, 동남구,030003, 27세,2018,3742,2040,1702,119.9,3335,1806,1529,118.1
34011, 동남구,030004, 28세,2018,3556,2012,1544,130.3,3099,1698,1401,121.2
34011, 동남구,030005, 29세,2018,3418,1950,1468,132.8,3010,1667,1343,124.1
34011, 동남구,035,30~34세,2018,17108,9339,7769,120.2,15181,8087,7094,114
34011, 동남구,035001, 30세,2018,3355,1860,1495,124.4,2945,1586,1359,116.7
34011, 동남구,035002, 31세,2018,3402,1884,1518,124.1,2925,1577,1348,117
34011, 동남구,035003, 32세,2018,3329,1837,1492,123.1,2959,1594,1365,116.8
34011, 동남구,035004, 33세,2018,3428,1882,1546,121.7,3094,1665,1429,116.5
34011, 동남구,035005, 34세,2018,3594,1876,1718,109.2,3258,1665,1593,104.5
34011, 동남구,040,35~39세,2018,21570,11261,10309,109.2,20105,10293,9812,104.9
34011, 동남구,040001, 35세,2018,3866,2046,1820,112.4,3559,1838,1721,106.8
34011, 동남구,040002, 36세,2018,4414,2309,2105,109.7,4074,2086,1988,104.9
34011, 동남구,040003, 37세,2018,4356,2329,2027,114.9,4064,2128,1936,109.9
34011, 동남구,040004, 38세,2018,4630,2387,2243,106.4,4337,2201,2136,103
34011, 동남구,040005, 39세,2018,4304,2190,2114,103.6,4071,2040,2031,100.4
34011, 동남구,045,40~44세,2018,21434,11257,10177,110.6,20394,10603,9791,108.3
34011, 동남구,045001, 40세,2018,4044,2184,1860,117.4,3812,2031,1781,114
34011, 동남구,045002, 41세,2018,4174,2223,1951,113.9,3945,2078,1867,111.3
34011, 동남구,045003, 42세,2018,4091,2127,1964,108.3,3907,2015,1892,106.5
34011, 동남구,045004, 43세,2018,4367,2237,2130,105,4168,2113,2055,102.8
34011, 동남구,045005, 44세,2018,4758,2486,2272,109.4,4562,2366,2196,107.7
34011, 동남구,050,45~49세,2018,23438,12108,11330,106.9,22238,11432,10806,105.8
34011, 동남구,050001, 45세,2018,4642,2460,2182,112.7,4432,2335,2097,111.3
34011, 동남구,050002, 46세,2018,4396,2254,2142,105.2,4134,2116,2018,104.9
34011, 동남구,050003, 47세,2018,4798,2468,2330,105.9,4571,2338,2233,104.7
34011, 동남구,050004, 48세,2018,4724,2437,2287,106.6,4485,2296,2189,104.9
34011, 동남구,050005, 49세,2018,4878,2489,2389,104.2,4616,2347,2269,103.4
34011, 동남구,055,50~54세,2018,21897,11168,10729,104.1,20869,10605,10264,103.3
34011, 동남구,055001, 50세,2018,4738,2380,2358,100.9,4514,2251,2263,99.5
34011, 동남구,055002, 51세,2018,4399,2213,2186,101.2,4214,2106,2108,99.9
34011, 동남구,055003, 52세,2018,4110,2153,1957,110,3909,2038,1871,108.9
34011, 동남구,055004, 53세,2018,4570,2344,2226,105.3,4342,2222,2120,104.8
34011, 동남구,055005, 54세,2018,4080,2078,2002,103.8,3890,1988,1902,104.5
34011, 동남구,060,55~59세,2018,22065,11397,10668,106.8,21251,10986,10265,107
34011, 동남구,060001, 55세,2018,4212,2188,2024,108.1,3962,2057,1905,108
34011, 동남구,060002, 56세,2018,4411,2330,2081,112,4235,2238,1997,112.1
34011, 동남구,060003, 57세,2018,4933,2559,2374,107.8,4820,2496,2324,107.4
34011, 동남구,060004, 58세,2018,4626,2354,2272,103.6,4481,2283,2198,103.9
34011, 동남구,060005, 59세,2018,3883,1966,1917,102.6,3753,1912,1841,103.9
34011, 동남구,065,60~64세,2018,16183,8181,8002,102.2,15667,7903,7764,101.8
34011, 동남구,065001, 60세,2018,3585,1844,1741,105.9,3474,1781,1693,105.2
34011, 동남구,065002, 61세,2018,3476,1792,1684,106.4,3344,1708,1636,104.4
34011, 동남구,065003, 62세,2018,3194,1577,1617,97.5,3097,1537,1560,98.5
34011, 동남구,065004, 63세,2018,3273,1637,1636,100.1,3171,1582,1589,99.6
34011, 동남구,065005, 64세,2018,2655,1331,1324,100.5,2581,1295,1286,100.7
34011, 동남구,070,65~69세,2018,10498,5198,5300,98.1,10280,5087,5193,98
34011, 동남구,070001, 65세,2018,2216,1119,1097,102,2150,1086,1064,102.1
34011, 동남구,070002, 66세,2018,2528,1244,1284,96.9,2474,1212,1262,96
34011, 동남구,070003, 67세,2018,1786,909,877,103.6,1740,884,856,103.3
34011, 동남구,070004, 68세,2018,2009,962,1047,91.9,1984,952,1032,92.2
34011, 동남구,070005, 69세,2018,1959,964,995,96.9,1932,953,979,97.3
34011, 동남구,075,70~74세,2018,7697,3642,4055,89.8,7613,3613,4000,90.3
34011, 동남구,075001, 70세,2018,1829,908,921,98.6,1804,899,905,99.3
34011, 동남구,075002, 71세,2018,1829,851,978,87,1803,844,959,88
34011, 동남구,075003, 72세,2018,1286,625,661,94.6,1273,620,653,94.9
34011, 동남구,075004, 73세,2018,1312,618,694,89,1301,612,689,88.8
34011, 동남구,075005, 74세,2018,1441,640,801,79.9,1432,638,794,80.4
34011, 동남구,080,75~79세,2018,6740,2757,3983,69.2,6692,2746,3946,69.6
34011, 동남구,080001, 75세,2018,1352,556,796,69.8,1344,556,788,70.6
34011, 동남구,080002, 76세,2018,1637,671,966,69.5,1623,666,957,69.6
34011, 동남구,080003, 77세,2018,1278,526,752,69.9,1270,523,747,70
34011, 동남구,080004, 78세,2018,1215,501,714,70.2,1206,499,707,70.6
34011, 동남구,080005, 79세,2018,1258,503,755,66.6,1249,502,747,67.2
34011, 동남구,085,80~84세,2018,4837,1726,3111,55.5,4809,1717,3092,55.5
34011, 동남구,085001, 80세,2018,1132,436,696,62.6,1127,433,694,62.4
34011, 동남구,085002, 81세,2018,1083,398,685,58.1,1073,396,677,58.5
34011, 동남구,085003, 82세,2018,946,322,624,51.6,943,321,622,51.6
34011, 동남구,085004, 83세,2018,928,316,612,51.6,923,314,609,51.6
34011, 동남구,085005, 84세,2018,748,254,494,51.4,743,253,490,51.6
34011, 동남구,090,85~89세,2018,2391,693,1698,40.8,2382,691,1691,40.9
34011, 동남구,090001, 85세,2018,652,200,452,44.2,649,200,449,44.5
34011, 동남구,090002, 86세,2018,609,176,433,40.6,607,175,432,40.5
34011, 동남구,090003, 87세,2018,433,119,314,37.9,430,118,312,37.8
34011, 동남구,090004, 88세,2018,381,119,262,45.4,380,119,261,45.6
34011, 동남구,090005, 89세,2018,316,79,237,33.3,316,79,237,33.3
34011, 동남구,095,90~94세,2018,777,154,623,24.7,776,154,622,24.8
34011, 동남구,095001, 90세,2018,260,49,211,23.2,259,49,210,23.3
34011, 동남구,095002, 91세,2018,203,41,162,25.3,203,41,162,25.3
34011, 동남구,095003, 92세,2018,135,21,114,18.4,135,21,114,18.4
34011, 동남구,095004, 93세,2018,110,25,85,29.4,110,25,85,29.4
34011, 동남구,095005, 94세,2018,69,18,51,35.3,69,18,51,35.3
34011, 동남구,100,95~99세,2018,234,46,188,24.5,234,46,188,24.5
34011, 동남구,100001, 95세,2018,86,18,68,26.5,86,18,68,26.5
34011, 동남구,100002, 96세,2018,70,12,58,20.7,70,12,58,20.7
34011, 동남구,100003, 97세,2018,40,9,31,29,40,9,31,29
34011, 동남구,100004, 98세,2018,24,5,19,26.3,24,5,19,26.3
34011, 동남구,100005, 99세,2018,14,X,12,16.7,14,X,12,16.7
34011, 동남구,101,100세이상,2018,24,X,24,0,24,X,24,0
34011, 동남구,102,15세미만,2018,35528,18430,17098,107.8,35070,18199,16871,107.9
34011, 동남구,103,15~64세,2018,207729,108747,98982,109.9,195575,101473,94102,107.8
34011, 동남구,104,65세이상,2018,33198,14216,18982,74.9,32810,14054,18756,74.9
34011, 동남구,086,85세이상,2018,3426,893,2533,35.3,3416,891,2525,35.3
34011, 동남구,126,평균연령,2018,39.9,38.9,41,,40,39,41.1,
34011, 동남구,127,중위연령,2018,40,38.9,41.3,,40.4,39.4,41.5,
34012, 서북구,000,합계,2018,395344,203295,192049,105.9,379921,194102,185819,104.5
34012, 서북구,005,0~4세,2018,21584,10957,10627,103.1,21269,10792,10477,103
34012, 서북구,005001, 0세,2018,3867,1974,1893,104.3,3803,1939,1864,104
34012, 서북구,005002, 1세,2018,4109,2121,1988,106.7,4034,2081,1953,106.6
34012, 서북구,005003, 2세,2018,4499,2226,2273,97.9,4431,2192,2239,97.9
34012, 서북구,005004, 3세,2018,4681,2394,2287,104.7,4622,2368,2254,105.1
34012, 서북구,005005, 4세,2018,4428,2242,2186,102.6,4379,2212,2167,102.1
34012, 서북구,010,5~9세,2018,22098,11301,10797,104.7,21923,11210,10713,104.6
34012, 서북구,010001, 5세,2018,4476,2249,2227,101,4432,2226,2206,100.9
34012, 서북구,010002, 6세,2018,4814,2426,2388,101.6,4770,2405,2365,101.7
34012, 서북구,010003, 7세,2018,4479,2323,2156,107.7,4453,2313,2140,108.1
34012, 서북구,010004, 8세,2018,4299,2241,2058,108.9,4262,2215,2047,108.2
34012, 서북구,010005, 9세,2018,4030,2062,1968,104.8,4006,2051,1955,104.9
34012, 서북구,015,10~14세,2018,20103,10460,9643,108.5,20005,10415,9590,108.6
34012, 서북구,015001, 10세,2018,4165,2186,1979,110.5,4148,2177,1971,110.5
34012, 서북구,015002, 11세,2018,4206,2145,2061,104.1,4177,2134,2043,104.5
34012, 서북구,015003, 12세,2018,3866,2008,1858,108.1,3852,2006,1846,108.7
34012, 서북구,015004, 13세,2018,3767,1951,1816,107.4,3747,1938,1809,107.1
34012, 서북구,015005, 14세,2018,4099,2170,1929,112.5,4081,2160,1921,112.4
34012, 서북구,020,15~19세,2018,22596,11492,11104,103.5,22257,11370,10887,104.4
34012, 서북구,020001, 15세,2018,3858,1983,1875,105.8,3843,1975,1868,105.7
34012, 서북구,020002, 16세,2018,3886,2009,1877,107,3875,2002,1873,106.9
34012, 서북구,020003, 17세,2018,4454,2234,2220,100.6,4428,2218,2210,100.4
34012, 서북구,020004, 18세,2018,5037,2538,2499,101.6,4954,2517,2437,103.3
34012, 서북구,020005, 19세,2018,5361,2728,2633,103.6,5157,2658,2499,106.4
34012, 서북구,025,20~24세,2018,29485,15389,14096,109.2,27803,14399,13404,107.4
34012, 서북구,025001, 20세,2018,5534,2861,2673,107,5250,2726,2524,108
34012, 서북구,025002, 21세,2018,5707,2828,2879,98.2,5417,2673,2744,97.4
34012, 서북구,025003, 22세,2018,6090,3222,2868,112.3,5730,3010,2720,110.7
34012, 서북구,025004, 23세,2018,6062,3155,2907,108.5,5724,2945,2779,106
34012, 서북구,025005, 24세,2018,6092,3323,2769,120,5682,3045,2637,115.5
34012, 서북구,030,25~29세,2018,32142,17002,15140,112.3,29687,15401,14286,107.8
34012, 서북구,030001, 25세,2018,6539,3412,3127,109.1,6099,3136,2963,105.8
34012, 서북구,030002, 26세,2018,6793,3550,3243,109.5,6327,3230,3097,104.3
34012, 서북구,030003, 27세,2018,6071,3228,2843,113.5,5613,2935,2678,109.6
34012, 서북구,030004, 28세,2018,6352,3387,2965,114.2,5809,3029,2780,109
34012, 서북구,030005, 29세,2018,6387,3425,2962,115.6,5839,3071,2768,110.9
34012, 서북구,035,30~34세,2018,35765,19302,16463,117.2,33093,17612,15481,113.8
34012, 서북구,035001, 30세,2018,6937,3719,3218,115.6,6406,3387,3019,112.2
34012, 서북구,035002, 31세,2018,7205,3775,3430,110.1,6639,3422,3217,106.4
34012, 서북구,035003, 32세,2018,7265,3925,3340,117.5,6706,3584,3122,114.8
34012, 서북구,035004, 33세,2018,6990,3816,3174,120.2,6473,3478,2995,116.1
34012, 서북구,035005, 34세,2018,7368,4067,3301,123.2,6869,3741,3128,119.6
34012, 서북구,040,35~39세,2018,40001,21706,18295,118.6,37949,20359,17590,115.7
34012, 서북구,040001, 35세,2018,8095,4360,3735,116.7,7631,4070,3561,114.3
34012, 서북구,040002, 36세,2018,8493,4597,3896,118,8065,4297,3768,114
34012, 서북구,040003, 37세,2018,8120,4424,3696,119.7,7735,4176,3559,117.3
34012, 서북구,040004, 38세,2018,8023,4369,3654,119.6,7632,4112,3520,116.8
34012, 서북구,040005, 39세,2018,7270,3956,3314,119.4,6886,3704,3182,116.4
34012, 서북구,045,40~44세,2018,33276,17288,15988,108.1,31874,16378,15496,105.7
34012, 서북구,045001, 40세,2018,6631,3608,3023,119.4,6327,3395,2932,115.8
34012, 서북구,045002, 41세,2018,6650,3496,3154,110.8,6360,3314,3046,108.8
34012, 서북구,045003, 42세,2018,6459,3350,3109,107.8,6171,3166,3005,105.4
34012, 서북구,045004, 43세,2018,6501,3243,3258,99.5,6235,3074,3161,97.2
34012, 서북구,045005, 44세,2018,7035,3591,3444,104.3,6781,3429,3352,102.3
34012, 서북구,050,45~49세,2018,34968,17846,17122,104.2,33650,17085,16565,103.1
34012, 서북구,050001, 45세,2018,6845,3484,3361,103.7,6599,3343,3256,102.7
34012, 서북구,050002, 46세,2018,6779,3432,3347,102.5,6492,3253,3239,100.4
34012, 서북구,050003, 47세,2018,7354,3806,3548,107.3,7075,3642,3433,106.1
34012, 서북구,050004, 48세,2018,6937,3550,3387,104.8,6670,3405,3265,104.3
34012, 서북구,050005, 49세,2018,7053,3574,3479,102.7,6814,3442,3372,102.1
34012, 서북구,055,50~54세,2018,29970,15276,14694,104,28913,14707,14206,103.5
34012, 서북구,055001, 50세,2018,7000,3546,3454,102.7,6774,3423,3351,102.1
34012, 서북구,055002, 51세,2018,6084,3010,3074,97.9,5889,2899,2990,97
34012, 서북구,055003, 52세,2018,5542,2842,2700,105.3,5332,2736,2596,105.4
34012, 서북구,055004, 53세,2018,6072,3143,2929,107.3,5835,3019,2816,107.2
34012, 서북구,055005, 54세,2018,5272,2735,2537,107.8,5083,2630,2453,107.2
34012, 서북구,060,55~59세,2018,26182,13745,12437,110.5,25396,13347,12049,110.8
34012, 서북구,060001, 55세,2018,5400,2831,2569,110.2,5188,2721,2467,110.3
34012, 서북구,060002, 56세,2018,5462,2983,2479,120.3,5273,2894,2379,121.6
34012, 서북구,060003, 57세,2018,5556,2934,2622,111.9,5449,2875,2574,111.7
34012, 서북구,060004, 58세,2018,5304,2743,2561,107.1,5159,2673,2486,107.5
34012, 서북구,060005, 59세,2018,4460,2254,2206,102.2,4327,2184,2143,101.9
34012, 서북구,065,60~64세,2018,16901,8704,8197,106.2,16262,8390,7872,106.6
34012, 서북구,065001, 60세,2018,3909,2050,1859,110.3,3768,1982,1786,111
34012, 서북구,065002, 61세,2018,3701,1965,1736,113.2,3554,1893,1661,114
34012, 서북구,065003, 62세,2018,3252,1692,1560,108.5,3122,1628,1494,109
34012, 서북구,065004, 63세,2018,3377,1699,1678,101.3,3264,1643,1621,101.4
34012, 서북구,065005, 64세,2018,2662,1298,1364,95.2,2554,1244,1310,95
34012, 서북구,070,65~69세,2018,9981,4865,5116,95.1,9718,4735,4983,95
34012, 서북구,070001, 65세,2018,2156,1099,1057,104,2077,1065,1012,105.2
34012, 서북구,070002, 66세,2018,2451,1220,1231,99.1,2388,1183,1205,98.2
34012, 서북구,070003, 67세,2018,1695,840,855,98.2,1652,817,835,97.8
34012, 서북구,070004, 68세,2018,1836,846,990,85.5,1803,830,973,85.3
34012, 서북구,070005, 69세,2018,1843,860,983,87.5,1798,840,958,87.7
34012, 서북구,075,70~74세,2018,7213,3309,3904,84.8,7121,3276,3845,85.2
34012, 서북구,075001, 70세,2018,1762,855,907,94.3,1738,845,893,94.6
34012, 서북구,075002, 71세,2018,1701,769,932,82.5,1679,758,921,82.3
34012, 서북구,075003, 72세,2018,1278,624,654,95.4,1261,621,640,97
34012, 서북구,075004, 73세,2018,1190,526,664,79.2,1179,523,656,79.7
34012, 서북구,075005, 74세,2018,1282,535,747,71.6,1264,529,735,72
34012, 서북구,080,75~79세,2018,6230,2482,3748,66.2,6190,2463,3727,66.1
34012, 서북구,080001, 75세,2018,1291,543,748,72.6,1281,537,744,72.2
34012, 서북구,080002, 76세,2018,1538,625,913,68.5,1532,622,910,68.4
34012, 서북구,080003, 77세,2018,1154,452,702,64.4,1142,447,695,64.3
34012, 서북구,080004, 78세,2018,1095,439,656,66.9,1087,436,651,67
34012, 서북구,080005, 79세,2018,1152,423,729,58,1148,421,727,57.9
34012, 서북구,085,80~84세,2018,4145,1440,2705,53.2,4117,1434,2683,53.4
34012, 서북구,085001, 80세,2018,1013,383,630,60.8,1001,380,621,61.2
34012, 서북구,085002, 81세,2018,893,318,575,55.3,888,316,572,55.2
34012, 서북구,085003, 82세,2018,806,269,537,50.1,802,269,533,50.5
34012, 서북구,085004, 83세,2018,751,235,516,45.5,747,235,512,45.9
34012, 서북구,085005, 84세,2018,682,235,447,52.6,679,234,445,52.6
34012, 서북구,090,85~89세,2018,1902,544,1358,40.1,1893,542,1351,40.1
34012, 서북구,090001, 85세,2018,505,170,335,50.7,502,169,333,50.8
34012, 서북구,090002, 86세,2018,481,140,341,41.1,480,140,340,41.2
34012, 서북구,090003, 87세,2018,345,90,255,35.3,342,89,253,35.2
34012, 서북구,090004, 88세,2018,317,84,233,36.1,317,84,233,36.1
34012, 서북구,090005, 89세,2018,254,60,194,30.9,252,60,192,31.3
34012, 서북구,095,90~94세,2018,640,153,487,31.4,639,153,486,31.5
34012, 서북구,095001, 90세,2018,209,62,147,42.2,209,62,147,42.2
34012, 서북구,095002, 91세,2018,167,38,129,29.5,166,38,128,29.7
34012, 서북구,095003, 92세,2018,109,21,88,23.9,109,21,88,23.9
34012, 서북구,095004, 93세,2018,93,21,72,29.2,93,21,72,29.2
34012, 서북구,095005, 94세,2018,62,11,51,21.6,62,11,51,21.6
34012, 서북구,100,95~99세,2018,142,31,111,27.9,142,31,111,27.9
34012, 서북구,100001, 95세,2018,51,13,38,34.2,51,13,38,34.2
34012, 서북구,100002, 96세,2018,38,8,30,26.7,38,8,30,26.7
34012, 서북구,100003, 97세,2018,20,5,15,33.3,20,5,15,33.3
34012, 서북구,100004, 98세,2018,23,X,22,4.5,23,X,22,4.5
34012, 서북구,100005, 99세,2018,10,X,6,66.7,10,X,6,66.7
34012, 서북구,101,100세이상,2018,20,X,17,17.6,20,X,17,17.6
34012, 서북구,102,15세미만,2018,63785,32718,31067,105.3,63197,32417,30780,105.3
34012, 서북구,103,15~64세,2018,301286,157750,143536,109.9,286884,149048,137836,108.1
34012, 서북구,104,65세이상,2018,30273,12827,17446,73.5,29840,12637,17203,73.5
34012, 서북구,086,85세이상,2018,2704,731,1973,37.1,2694,729,1965,37.1
34012, 서북구,126,평균연령,2018,36.8,36.2,37.4,,36.8,36.2,37.4,
34012, 서북구,127,중위연령,2018,36.7,36.3,37.1,,36.8,36.4,37.2,
34020, 공주시,000,합계,2018,110119,54549,55570,98.2,107456,53202,54254,98.1
34020, 공주시,005,0~4세,2018,2692,1403,1289,108.8,2676,1393,1283,108.6
34020, 공주시,005001, 0세,2018,440,235,205,114.6,438,234,204,114.7
34020, 공주시,005002, 1세,2018,524,270,254,106.3,520,269,251,107.2
34020, 공주시,005003, 2세,2018,504,256,248,103.2,502,255,247,103.2
34020, 공주시,005004, 3세,2018,610,298,312,95.5,606,295,311,94.9
34020, 공주시,005005, 4세,2018,614,344,270,127.4,610,340,270,125.9
34020, 공주시,010,5~9세,2018,3623,1890,1733,109.1,3610,1881,1729,108.8
34020, 공주시,010001, 5세,2018,695,379,316,119.9,693,378,315,120
34020, 공주시,010002, 6세,2018,731,378,353,107.1,729,376,353,106.5
34020, 공주시,010003, 7세,2018,750,385,365,105.5,743,381,362,105.2
34020, 공주시,010004, 8세,2018,732,383,349,109.7,732,383,349,109.7
34020, 공주시,010005, 9세,2018,715,365,350,104.3,713,363,350,103.7
34020, 공주시,015,10~14세,2018,3832,1954,1878,104,3828,1952,1876,104.1
34020, 공주시,015001, 10세,2018,741,370,371,99.7,739,370,369,100.3
34020, 공주시,015002, 11세,2018,802,428,374,114.4,802,428,374,114.4
34020, 공주시,015003, 12세,2018,756,377,379,99.5,756,377,379,99.5
34020, 공주시,015004, 13세,2018,734,379,355,106.8,734,379,355,106.8
34020, 공주시,015005, 14세,2018,799,400,399,100.3,797,398,399,99.7
34020, 공주시,020,15~19세,2018,6873,3526,3347,105.3,6749,3484,3265,106.7
34020, 공주시,020001, 15세,2018,972,525,447,117.4,972,525,447,117.4
34020, 공주시,020002, 16세,2018,1157,634,523,121.2,1155,633,522,121.3
34020, 공주시,020003, 17세,2018,1267,705,562,125.4,1249,702,547,128.3
34020, 공주시,020004, 18세,2018,1509,802,707,113.4,1477,792,685,115.6
34020, 공주시,020005, 19세,2018,1968,860,1108,77.6,1896,832,1064,78.2
34020, 공주시,025,20~24세,2018,9562,4641,4921,94.3,9063,4408,4655,94.7
34020, 공주시,025001, 20세,2018,2082,847,1235,68.6,2004,820,1184,69.3
34020, 공주시,025002, 21세,2018,2139,880,1259,69.9,2049,842,1207,69.8
34020, 공주시,025003, 22세,2018,2048,969,1079,89.8,1957,921,1036,88.9
34020, 공주시,025004, 23세,2018,1691,961,730,131.6,1583,908,675,134.5
34020, 공주시,025005, 24세,2018,1602,984,618,159.2,1470,917,553,165.8
34020, 공주시,030,25~29세,2018,5850,3346,2504,133.6,5306,3053,2253,135.5
34020, 공주시,030001, 25세,2018,1312,780,532,146.6,1194,719,475,151.4
34020, 공주시,030002, 26세,2018,1266,736,530,138.9,1149,666,483,137.9
34020, 공주시,030003, 27세,2018,1149,666,483,137.9,1032,602,430,140
34020, 공주시,030004, 28세,2018,1102,599,503,119.1,1002,544,458,118.8
34020, 공주시,030005, 29세,2018,1021,565,456,123.9,929,522,407,128.3
34020, 공주시,035,30~34세,2018,4835,2616,2219,117.9,4450,2417,2033,118.9
34020, 공주시,035001, 30세,2018,990,530,460,115.2,893,479,414,115.7
34020, 공주시,035002, 31세,2018,994,542,452,119.9,907,497,410,121.2
34020, 공주시,035003, 32세,2018,968,520,448,116.1,900,487,413,117.9
34020, 공주시,035004, 33세,2018,934,511,423,120.8,868,480,388,123.7
34020, 공주시,035005, 34세,2018,949,513,436,117.7,882,474,408,116.2
34020, 공주시,040,35~39세,2018,5903,3065,2838,108,5623,2918,2705,107.9
34020, 공주시,040001, 35세,2018,1124,603,521,115.7,1063,570,493,115.6
34020, 공주시,040002, 36세,2018,1102,570,532,107.1,1046,542,504,107.5
34020, 공주시,040003, 37세,2018,1228,627,601,104.3,1164,596,568,104.9
34020, 공주시,040004, 38세,2018,1256,647,609,106.2,1210,623,587,106.1
34020, 공주시,040005, 39세,2018,1193,618,575,107.5,1140,587,553,106.1
34020, 공주시,045,40~44세,2018,6226,3340,2886,115.7,6051,3229,2822,114.4
34020, 공주시,045001, 40세,2018,1182,658,524,125.6,1140,635,505,125.7
34020, 공주시,045002, 41세,2018,1157,617,540,114.3,1120,589,531,110.9
34020, 공주시,045003, 42세,2018,1173,630,543,116,1143,613,530,115.7
34020, 공주시,045004, 43세,2018,1283,685,598,114.5,1240,659,581,113.4
34020, 공주시,045005, 44세,2018,1431,750,681,110.1,1408,733,675,108.6
34020, 공주시,050,45~49세,2018,7785,4022,3763,106.9,7626,3937,3689,106.7
34020, 공주시,050001, 45세,2018,1465,744,721,103.2,1434,728,706,103.1
34020, 공주시,050002, 46세,2018,1345,695,650,106.9,1319,682,637,107.1
34020, 공주시,050003, 47세,2018,1612,857,755,113.5,1573,834,739,112.9
34020, 공주시,050004, 48세,2018,1616,812,804,101,1577,795,782,101.7
34020, 공주시,050005, 49세,2018,1747,914,833,109.7,1723,898,825,108.8
34020, 공주시,055,50~54세,2018,8487,4404,4083,107.9,8307,4303,4004,107.5
34020, 공주시,055001, 50세,2018,1786,940,846,111.1,1748,920,828,111.1
34020, 공주시,055002, 51세,2018,1688,899,789,113.9,1646,872,774,112.7
34020, 공주시,055003, 52세,2018,1451,750,701,107,1423,734,689,106.5
34020, 공주시,055004, 53세,2018,1843,931,912,102.1,1802,909,893,101.8
34020, 공주시,055005, 54세,2018,1719,884,835,105.9,1688,868,820,105.9
34020, 공주시,060,55~59세,2018,10303,5192,5111,101.6,10193,5152,5041,102.2
34020, 공주시,060001, 55세,2018,1792,902,890,101.3,1757,889,868,102.4
34020, 공주시,060002, 56세,2018,1980,1022,958,106.7,1957,1013,944,107.3
34020, 공주시,060003, 57세,2018,2346,1206,1140,105.8,2329,1202,1127,106.7
34020, 공주시,060004, 58세,2018,2164,1081,1083,99.8,2144,1074,1070,100.4
34020, 공주시,060005, 59세,2018,2021,981,1040,94.3,2006,974,1032,94.4
34020, 공주시,065,60~64세,2018,9195,4566,4629,98.6,9104,4521,4583,98.6
34020, 공주시,065001, 60세,2018,1927,956,971,98.5,1904,948,956,99.2
34020, 공주시,065002, 61세,2018,1899,944,955,98.8,1882,933,949,98.3
34020, 공주시,065003, 62세,2018,1819,937,882,106.2,1802,927,875,105.9
34020, 공주시,065004, 63세,2018,1979,984,995,98.9,1958,973,985,98.8
34020, 공주시,065005, 64세,2018,1571,745,826,90.2,1558,740,818,90.5
34020, 공주시,070,65~69세,2018,6784,3401,3383,100.5,6739,3382,3357,100.7
34020, 공주시,070001, 65세,2018,1330,659,671,98.2,1320,653,667,97.9
34020, 공주시,070002, 66세,2018,1569,789,780,101.2,1558,785,773,101.6
34020, 공주시,070003, 67세,2018,1139,578,561,103,1135,576,559,103
34020, 공주시,070004, 68세,2018,1402,705,697,101.1,1389,699,690,101.3
34020, 공주시,070005, 69세,2018,1344,670,674,99.4,1337,669,668,100.1
34020, 공주시,075,70~74세,2018,5293,2439,2854,85.5,5276,2436,2840,85.8
34020, 공주시,075001, 70세,2018,1253,600,653,91.9,1248,599,649,92.3
34020, 공주시,075002, 71세,2018,1171,584,587,99.5,1166,582,584,99.7
34020, 공주시,075003, 72세,2018,871,409,462,88.5,868,409,459,89.1
34020, 공주시,075004, 73세,2018,937,407,530,76.8,936,407,529,76.9
34020, 공주시,075005, 74세,2018,1061,439,622,70.6,1058,439,619,70.9
34020, 공주시,080,75~79세,2018,5538,2273,3265,69.6,5527,2270,3257,69.7
34020, 공주시,080001, 75세,2018,935,412,523,78.8,931,410,521,78.7
34020, 공주시,080002, 76세,2018,1437,588,849,69.3,1436,588,848,69.3
34020, 공주시,080003, 77세,2018,1076,469,607,77.3,1074,468,606,77.2
34020, 공주시,080004, 78세,2018,980,388,592,65.5,978,388,590,65.8
34020, 공주시,080005, 79세,2018,1110,416,694,59.9,1108,416,692,60.1
34020, 공주시,085,80~84세,2018,4257,1564,2693,58.1,4250,1560,2690,58
34020, 공주시,085001, 80세,2018,932,349,583,59.9,931,349,582,60
34020, 공주시,085002, 81세,2018,917,355,562,63.2,915,354,561,63.1
34020, 공주시,085003, 82세,2018,874,310,564,55,872,308,564,54.6
34020, 공주시,085004, 83세,2018,823,308,515,59.8,821,307,514,59.7
34020, 공주시,085005, 84세,2018,711,242,469,51.6,711,242,469,51.6
34020, 공주시,090,85~89세,2018,2260,695,1565,44.4,2258,694,1564,44.4
34020, 공주시,090001, 85세,2018,624,213,411,51.8,623,212,411,51.6
34020, 공주시,090002, 86세,2018,546,169,377,44.8,545,169,376,44.9
34020, 공주시,090003, 87세,2018,429,132,297,44.4,429,132,297,44.4
34020, 공주시,090004, 88세,2018,338,99,239,41.4,338,99,239,41.4
34020, 공주시,090005, 89세,2018,323,82,241,34,323,82,241,34
34020, 공주시,095,90~94세,2018,630,171,459,37.3,629,171,458,37.3
34020, 공주시,095001, 90세,2018,226,67,159,42.1,226,67,159,42.1
34020, 공주시,095002, 91세,2018,151,37,114,32.5,150,37,113,32.7
34020, 공주시,095003, 92세,2018,117,31,86,36,117,31,86,36
34020, 공주시,095004, 93세,2018,82,21,61,34.4,82,21,61,34.4
34020, 공주시,095005, 94세,2018,54,15,39,38.5,54,15,39,38.5
34020, 공주시,100,95~99세,2018,174,37,137,27,174,37,137,27
34020, 공주시,100001, 95세,2018,64,19,45,42.2,64,19,45,42.2
34020, 공주시,100002, 96세,2018,47,7,40,17.5,47,7,40,17.5
34020, 공주시,100003, 97세,2018,30,6,24,25,30,6,24,25
34020, 공주시,100004, 98세,2018,16,X,15,6.7,16,X,15,6.7
34020, 공주시,100005, 99세,2018,17,X,13,30.8,17,X,13,30.8
34020, 공주시,101,100세이상,2018,17,X,13,30.8,17,X,13,30.8
34020, 공주시,102,15세미만,2018,10147,5247,4900,107.1,10114,5226,4888,106.9
34020, 공주시,103,15~64세,2018,75019,38718,36301,106.7,72472,37422,35050,106.8
34020, 공주시,104,65세이상,2018,24953,10584,14369,73.7,24870,10554,14316,73.7
34020, 공주시,086,85세이상,2018,3081,907,2174,41.7,3078,906,2172,41.7
34020, 공주시,126,평균연령,2018,46.3,44.7,47.9,,46.6,45,48.2,
34020, 공주시,127,중위연령,2018,48.8,47.1,50.5,,49.3,47.5,51,
34030, 보령시,000,합계,2018,100229,51911,48318,107.4,96489,49086,47403,103.6
34030, 보령시,005,0~4세,2018,2987,1501,1486,101,2974,1493,1481,100.8
34030, 보령시,005001, 0세,2018,447,221,226,97.8,446,220,226,97.3
34030, 보령시,005002, 1세,2018,553,286,267,107.1,551,285,266,107.1
34030, 보령시,005003, 2세,2018,632,328,304,107.9,627,324,303,106.9
34030, 보령시,005004, 3세,2018,661,328,333,98.5,658,326,332,98.2
34030, 보령시,005005, 4세,2018,694,338,356,94.9,692,338,354,95.5
34030, 보령시,010,5~9세,2018,3844,1956,1888,103.6,3837,1953,1884,103.7
34030, 보령시,010001, 5세,2018,726,376,350,107.4,723,375,348,107.8
34030, 보령시,010002, 6세,2018,730,375,355,105.6,728,374,354,105.6
34030, 보령시,010003, 7세,2018,841,412,429,96,841,412,429,96
34030, 보령시,010004, 8세,2018,794,408,386,105.7,793,407,386,105.4
34030, 보령시,010005, 9세,2018,753,385,368,104.6,752,385,367,104.9
34030, 보령시,015,10~14세,2018,4074,2125,1949,109,4065,2119,1946,108.9
34030, 보령시,015001, 10세,2018,832,405,427,94.8,828,403,425,94.8
34030, 보령시,015002, 11세,2018,798,416,382,108.9,798,416,382,108.9
34030, 보령시,015003, 12세,2018,797,419,378,110.8,795,418,377,110.9
34030, 보령시,015004, 13세,2018,787,435,352,123.6,786,434,352,123.3
34030, 보령시,015005, 14세,2018,860,450,410,109.8,858,448,410,109.3
34030, 보령시,020,15~19세,2018,4370,2440,1930,126.4,4331,2417,1914,126.3
34030, 보령시,020001, 15세,2018,789,394,395,99.7,787,393,394,99.7
34030, 보령시,020002, 16세,2018,807,429,378,113.5,805,429,376,114.1
34030, 보령시,020003, 17세,2018,928,481,447,107.6,923,480,443,108.4
34030, 보령시,020004, 18세,2018,981,536,445,120.4,970,528,442,119.5
34030, 보령시,020005, 19세,2018,865,600,265,226.4,846,587,259,226.6
34030, 보령시,025,20~24세,2018,5188,3390,1798,188.5,4766,3046,1720,177.1
34030, 보령시,025001, 20세,2018,904,617,287,215,869,594,275,216
34030, 보령시,025002, 21세,2018,989,696,293,237.5,934,652,282,231.2
34030, 보령시,025003, 22세,2018,1154,757,397,190.7,1076,691,385,179.5
34030, 보령시,025004, 23세,2018,1104,664,440,150.9,990,573,417,137.4
34030, 보령시,025005, 24세,2018,1037,656,381,172.2,897,536,361,148.5
34030, 보령시,030,25~29세,2018,4894,3072,1822,168.6,4074,2405,1669,144.1
34030, 보령시,030001, 25세,2018,1010,656,354,185.3,868,548,320,171.3
34030, 보령시,030002, 26세,2018,990,635,355,178.9,806,491,315,155.9
34030, 보령시,030003, 27세,2018,978,584,394,148.2,824,463,361,128.3
34030, 보령시,030004, 28세,2018,956,583,373,156.3,788,434,354,122.6
34030, 보령시,030005, 29세,2018,960,614,346,177.5,788,469,319,147
34030, 보령시,035,30~34세,2018,5059,2945,2114,139.3,4297,2339,1958,119.5
34030, 보령시,035001, 30세,2018,957,584,373,156.6,802,460,342,134.5
34030, 보령시,035002, 31세,2018,1030,594,436,136.2,864,460,404,113.9
34030, 보령시,035003, 32세,2018,967,568,399,142.4,820,452,368,122.8
34030, 보령시,035004, 33세,2018,1026,582,444,131.1,870,460,410,112.2
34030, 보령시,035005, 34세,2018,1079,617,462,133.5,941,507,434,116.8
34030, 보령시,040,35~39세,2018,6479,3644,2835,128.5,5887,3174,2713,117
34030, 보령시,040001, 35세,2018,1182,681,501,135.9,1044,568,476,119.3
34030, 보령시,040002, 36세,2018,1305,732,573,127.7,1192,642,550,116.7
34030, 보령시,040003, 37세,2018,1262,706,556,127,1147,613,534,114.8
34030, 보령시,040004, 38세,2018,1399,787,612,128.6,1280,693,587,118.1
34030, 보령시,040005, 39세,2018,1331,738,593,124.5,1224,658,566,116.3
34030, 보령시,045,40~44세,2018,6755,3769,2986,126.2,6353,3456,2897,119.3
34030, 보령시,045001, 40세,2018,1216,681,535,127.3,1112,597,515,115.9
34030, 보령시,045002, 41세,2018,1299,758,541,140.1,1231,705,526,134
34030, 보령시,045003, 42세,2018,1311,711,600,118.5,1232,651,581,112
34030, 보령시,045004, 43세,2018,1372,754,618,122,1298,693,605,114.5
34030, 보령시,045005, 44세,2018,1557,865,692,125,1480,810,670,120.9
34030, 보령시,050,45~49세,2018,7779,4232,3547,119.3,7486,4024,3462,116.2
34030, 보령시,050001, 45세,2018,1609,898,711,126.3,1528,833,695,119.9
34030, 보령시,050002, 46세,2018,1490,815,675,120.7,1420,769,651,118.1
34030, 보령시,050003, 47세,2018,1592,877,715,122.7,1545,840,705,119.1
34030, 보령시,050004, 48세,2018,1507,814,693,117.5,1456,779,677,115.1
34030, 보령시,050005, 49세,2018,1581,828,753,110,1537,803,734,109.4
34030, 보령시,055,50~54세,2018,7893,4214,3679,114.5,7734,4131,3603,114.7
34030, 보령시,055001, 50세,2018,1685,912,773,118,1651,896,755,118.7
34030, 보령시,055002, 51세,2018,1515,800,715,111.9,1487,786,701,112.1
34030, 보령시,055003, 52세,2018,1432,802,630,127.3,1403,786,617,127.4
34030, 보령시,055004, 53세,2018,1618,836,782,106.9,1591,820,771,106.4
34030, 보령시,055005, 54세,2018,1643,864,779,110.9,1602,843,759,111.1
34030, 보령시,060,55~59세,2018,9225,4636,4589,101,9121,4591,4530,101.3
34030, 보령시,060001, 55세,2018,1552,805,747,107.8,1517,789,728,108.4
34030, 보령시,060002, 56세,2018,1788,914,874,104.6,1762,901,861,104.6
34030, 보령시,060003, 57세,2018,2111,1087,1024,106.2,2097,1079,1018,106
34030, 보령시,060004, 58세,2018,1983,970,1013,95.8,1962,965,997,96.8
34030, 보령시,060005, 59세,2018,1791,860,931,92.4,1783,857,926,92.5
34030, 보령시,065,60~64세,2018,8577,4273,4304,99.3,8522,4251,4271,99.5
34030, 보령시,065001, 60세,2018,1750,848,902,94,1739,843,896,94.1
34030, 보령시,065002, 61세,2018,1703,883,820,107.7,1690,877,813,107.9
34030, 보령시,065003, 62세,2018,1676,848,828,102.4,1668,844,824,102.4
34030, 보령시,065004, 63세,2018,1818,901,917,98.3,1802,896,906,98.9
34030, 보령시,065005, 64세,2018,1630,793,837,94.7,1623,791,832,95.1
34030, 보령시,070,65~69세,2018,6623,3132,3491,89.7,6587,3116,3471,89.8
34030, 보령시,070001, 65세,2018,1233,568,665,85.4,1221,562,659,85.3
34030, 보령시,070002, 66세,2018,1407,637,770,82.7,1399,634,765,82.9
34030, 보령시,070003, 67세,2018,1233,610,623,97.9,1228,606,622,97.4
34030, 보령시,070004, 68세,2018,1352,640,712,89.9,1347,638,709,90
34030, 보령시,070005, 69세,2018,1398,677,721,93.9,1392,676,716,94.4
34030, 보령시,075,70~74세,2018,5352,2442,2910,83.9,5335,2435,2900,84
34030, 보령시,075001, 70세,2018,1276,606,670,90.4,1271,605,666,90.8
34030, 보령시,075002, 71세,2018,1247,562,685,82,1242,561,681,82.4
34030, 보령시,075003, 72세,2018,878,430,448,96,876,428,448,95.5
34030, 보령시,075004, 73세,2018,921,388,533,72.8,919,387,532,72.7
34030, 보령시,075005, 74세,2018,1030,456,574,79.4,1027,454,573,79.2
34030, 보령시,080,75~79세,2018,5049,2119,2930,72.3,5043,2117,2926,72.4
34030, 보령시,080001, 75세,2018,1025,474,551,86,1023,473,550,86
34030, 보령시,080002, 76세,2018,1212,489,723,67.6,1211,489,722,67.7
34030, 보령시,080003, 77세,2018,968,395,573,68.9,966,394,572,68.9
34030, 보령시,080004, 78세,2018,887,369,518,71.2,887,369,518,71.2
34030, 보령시,080005, 79세,2018,957,392,565,69.4,956,392,564,69.5
34030, 보령시,085,80~84세,2018,3704,1369,2335,58.6,3700,1367,2333,58.6
34030, 보령시,085001, 80세,2018,915,342,573,59.7,915,342,573,59.7
34030, 보령시,085002, 81세,2018,790,332,458,72.5,789,332,457,72.6
34030, 보령시,085003, 82세,2018,744,264,480,55,744,264,480,55
34030, 보령시,085004, 83세,2018,709,242,467,51.8,706,240,466,51.5
34030, 보령시,085005, 84세,2018,546,189,357,52.9,546,189,357,52.9
34030, 보령시,090,85~89세,2018,1701,511,1190,42.9,1701,511,1190,42.9
34030, 보령시,090001, 85세,2018,454,177,277,63.9,454,177,277,63.9
34030, 보령시,090002, 86세,2018,425,119,306,38.9,425,119,306,38.9
34030, 보령시,090003, 87세,2018,307,94,213,44.1,307,94,213,44.1
34030, 보령시,090004, 88세,2018,274,59,215,27.4,274,59,215,27.4
34030, 보령시,090005, 89세,2018,241,62,179,34.6,241,62,179,34.6
34030, 보령시,095,90~94세,2018,530,120,410,29.3,530,120,410,29.3
34030, 보령시,095001, 90세,2018,181,44,137,32.1,181,44,137,32.1
34030, 보령시,095002, 91세,2018,130,35,95,36.8,130,35,95,36.8
34030, 보령시,095003, 92세,2018,104,21,83,25.3,104,21,83,25.3
34030, 보령시,095004, 93세,2018,62,9,53,17,62,9,53,17
34030, 보령시,095005, 94세,2018,53,11,42,26.2,53,11,42,26.2
34030, 보령시,100,95~99세,2018,138,21,117,17.9,138,21,117,17.9
34030, 보령시,100001, 95세,2018,58,9,49,18.4,58,9,49,18.4
34030, 보령시,100002, 96세,2018,36,5,31,16.1,36,5,31,16.1
34030, 보령시,100003, 97세,2018,21,X,19,10.5,21,X,19,10.5
34030, 보령시,100004, 98세,2018,15,X,13,15.4,15,X,13,15.4
34030, 보령시,100005, 99세,2018,8,X,5,60,8,X,5,60
34030, 보령시,101,100세이상,2018,8,X,8,0,8,X,8,0
34030, 보령시,102,15세미만,2018,10905,5582,5323,104.9,10876,5565,5311,104.8
34030, 보령시,103,15~64세,2018,66219,36615,29604,123.7,62571,33834,28737,117.7
34030, 보령시,104,65세이상,2018,23105,9714,13391,72.5,23042,9687,13355,72.5
34030, 보령시,086,85세이상,2018,2377,652,1725,37.8,2377,652,1725,37.8
34030, 보령시,126,평균연령,2018,46.9,44.7,49.3,,47.4,45.3,49.5,
34030, 보령시,127,중위연령,2018,49.2,46.3,52.5,,50.1,47.6,53,
34040, 아산시,000,합계,2018,342272,179837,162435,110.7,316463,163697,152766,107.2
34040, 아산시,005,0~4세,2018,17638,8987,8651,103.9,17025,8690,8335,104.3
34040, 아산시,005001, 0세,2018,2851,1432,1419,100.9,2735,1374,1361,101
34040, 아산시,005002, 1세,2018,3255,1643,1612,101.9,3118,1577,1541,102.3
34040, 아산시,005003, 2세,2018,3835,1944,1891,102.8,3681,1870,1811,103.3
34040, 아산시,005004, 3세,2018,3936,2032,1904,106.7,3837,1992,1845,108
34040, 아산시,005005, 4세,2018,3761,1936,1825,106.1,3654,1877,1777,105.6
34040, 아산시,010,5~9세,2018,19865,10243,9622,106.5,19473,10031,9442,106.2
34040, 아산시,010001, 5세,2018,3929,2023,1906,106.1,3831,1966,1865,105.4
34040, 아산시,010002, 6세,2018,4227,2161,2066,104.6,4131,2109,2022,104.3
34040, 아산시,010003, 7세,2018,4157,2134,2023,105.5,4087,2103,1984,106
34040, 아산시,010004, 8세,2018,3867,2026,1841,110,3800,1993,1807,110.3
34040, 아산시,010005, 9세,2018,3685,1899,1786,106.3,3624,1860,1764,105.4
34040, 아산시,015,10~14세,2018,17059,8730,8329,104.8,16816,8596,8220,104.6
34040, 아산시,015001, 10세,2018,3758,1875,1883,99.6,3697,1842,1855,99.3
34040, 아산시,015002, 11세,2018,3628,1914,1714,111.7,3577,1883,1694,111.2
34040, 아산시,015003, 12세,2018,3308,1684,1624,103.7,3261,1653,1608,102.8
34040, 아산시,015004, 13세,2018,3122,1631,1491,109.4,3086,1613,1473,109.5
34040, 아산시,015005, 14세,2018,3243,1626,1617,100.6,3195,1605,1590,100.9
34040, 아산시,020,15~19세,2018,20540,10504,10036,104.7,19981,10246,9735,105.2
34040, 아산시,020001, 15세,2018,3287,1686,1601,105.3,3252,1667,1585,105.2
34040, 아산시,020002, 16세,2018,3289,1649,1640,100.5,3257,1631,1626,100.3
34040, 아산시,020003, 17세,2018,3562,1829,1733,105.5,3494,1802,1692,106.5
34040, 아산시,020004, 18세,2018,4638,2357,2281,103.3,4512,2295,2217,103.5
34040, 아산시,020005, 19세,2018,5764,2983,2781,107.3,5466,2851,2615,109
34040, 아산시,025,20~24세,2018,25066,13559,11507,117.8,21853,11706,10147,115.4
34040, 아산시,025001, 20세,2018,5407,2555,2852,89.6,4830,2308,2522,91.5
34040, 아산시,025002, 21세,2018,5005,2395,2610,91.8,4408,2086,2322,89.8
34040, 아산시,025003, 22세,2018,5100,2839,2261,125.6,4445,2451,1994,122.9
34040, 아산시,025004, 23세,2018,4770,2910,1860,156.5,4085,2470,1615,152.9
34040, 아산시,025005, 24세,2018,4784,2860,1924,148.6,4085,2391,1694,141.1
34040, 아산시,030,25~29세,2018,23923,13626,10297,132.3,20025,10866,9159,118.6
34040, 아산시,030001, 25세,2018,4789,2674,2115,126.4,4085,2168,1917,113.1
34040, 아산시,030002, 26세,2018,4898,2744,2154,127.4,4193,2240,1953,114.7
34040, 아산시,030003, 27세,2018,4672,2698,1974,136.7,3890,2154,1736,124.1
34040, 아산시,030004, 28세,2018,4714,2679,2035,131.6,3878,2085,1793,116.3
34040, 아산시,030005, 29세,2018,4850,2831,2019,140.2,3979,2219,1760,126.1
34040, 아산시,035,30~34세,2018,27242,15162,12080,125.5,22807,12103,10704,113.1
34040, 아산시,035001, 30세,2018,5072,2804,2268,123.6,4107,2132,1975,107.9
34040, 아산시,035002, 31세,2018,5369,3081,2288,134.7,4412,2424,1988,121.9
34040, 아산시,035003, 32세,2018,5420,2981,2439,122.2,4518,2355,2163,108.9
34040, 아산시,035004, 33세,2018,5597,3165,2432,130.1,4758,2586,2172,119.1
34040, 아산시,035005, 34세,2018,5784,3131,2653,118,5012,2606,2406,108.3
34040, 아산시,040,35~39세,2018,34514,19279,15235,126.5,30994,16843,14151,119
34040, 아산시,040001, 35세,2018,6429,3550,2879,123.3,5646,3011,2635,114.3
34040, 아산시,040002, 36세,2018,7286,4059,3227,125.8,6534,3547,2987,118.7
34040, 아산시,040003, 37세,2018,7012,3960,3052,129.8,6332,3491,2841,122.9
34040, 아산시,040004, 38세,2018,7066,3912,3154,124,6445,3481,2964,117.4
34040, 아산시,040005, 39세,2018,6721,3798,2923,129.9,6037,3313,2724,121.6
34040, 아산시,045,40~44세,2018,28847,15925,12922,123.2,26421,14335,12086,118.6
34040, 아산시,045001, 40세,2018,5877,3285,2592,126.7,5328,2914,2414,120.7
34040, 아산시,045002, 41세,2018,5875,3272,2603,125.7,5375,2948,2427,121.5
34040, 아산시,045003, 42세,2018,5673,3071,2602,118,5171,2753,2418,113.9
34040, 아산시,045004, 43세,2018,5519,2998,2521,118.9,5082,2704,2378,113.7
34040, 아산시,045005, 44세,2018,5903,3299,2604,126.7,5465,3016,2449,123.2
34040, 아산시,050,45~49세,2018,28500,15860,12640,125.5,26179,14467,11712,123.5
34040, 아산시,050001, 45세,2018,5811,3173,2638,120.3,5370,2917,2453,118.9
34040, 아산시,050002, 46세,2018,5588,3172,2416,131.3,5082,2863,2219,129
34040, 아산시,050003, 47세,2018,6034,3400,2634,129.1,5539,3092,2447,126.4
34040, 아산시,050004, 48세,2018,5484,3071,2413,127.3,5022,2787,2235,124.7
34040, 아산시,050005, 49세,2018,5583,3044,2539,119.9,5166,2808,2358,119.1
34040, 아산시,055,50~54세,2018,23269,12539,10730,116.9,21590,11624,9966,116.6
34040, 아산시,055001, 50세,2018,5152,2686,2466,108.9,4799,2489,2310,107.7
34040, 아산시,055002, 51세,2018,4709,2553,2156,118.4,4391,2378,2013,118.1
34040, 아산시,055003, 52세,2018,4497,2476,2021,122.5,4166,2311,1855,124.6
34040, 아산시,055004, 53세,2018,4789,2596,2193,118.4,4402,2382,2020,117.9
34040, 아산시,055005, 54세,2018,4122,2228,1894,117.6,3832,2064,1768,116.7
34040, 아산시,060,55~59세,2018,21871,11532,10339,111.5,20745,10959,9786,112
34040, 아산시,060001, 55세,2018,4251,2311,1940,119.1,3915,2135,1780,119.9
34040, 아산시,060002, 56세,2018,4461,2395,2066,115.9,4219,2270,1949,116.5
34040, 아산시,060003, 57세,2018,4759,2541,2218,114.6,4584,2456,2128,115.4
34040, 아산시,060004, 58세,2018,4559,2362,2197,107.5,4339,2247,2092,107.4
34040, 아산시,060005, 59세,2018,3841,1923,1918,100.3,3688,1851,1837,100.8
34040, 아산시,065,60~64세,2018,16387,8131,8256,98.5,15598,7721,7877,98
34040, 아산시,065001, 60세,2018,3520,1774,1746,101.6,3337,1678,1659,101.1
34040, 아산시,065002, 61세,2018,3544,1763,1781,99,3353,1649,1704,96.8
34040, 아산시,065003, 62세,2018,3240,1614,1626,99.3,3088,1537,1551,99.1
34040, 아산시,065004, 63세,2018,3341,1657,1684,98.4,3206,1590,1616,98.4
34040, 아산시,065005, 64세,2018,2742,1323,1419,93.2,2614,1267,1347,94.1
34040, 아산시,070,65~69세,2018,11160,5276,5884,89.7,10819,5120,5699,89.8
34040, 아산시,070001, 65세,2018,2330,1140,1190,95.8,2252,1104,1148,96.2
34040, 아산시,070002, 66세,2018,2604,1212,1392,87.1,2517,1181,1336,88.4
34040, 아산시,070003, 67세,2018,1930,917,1013,90.5,1860,880,980,89.8
34040, 아산시,070004, 68세,2018,2160,994,1166,85.2,2111,973,1138,85.5
34040, 아산시,070005, 69세,2018,2136,1013,1123,90.2,2079,982,1097,89.5
34040, 아산시,075,70~74세,2018,8799,4027,4772,84.4,8671,3965,4706,84.3
34040, 아산시,075001, 70세,2018,2093,1002,1091,91.8,2060,988,1072,92.2
34040, 아산시,075002, 71세,2018,2052,966,1086,89,2020,944,1076,87.7
34040, 아산시,075003, 72세,2018,1528,692,836,82.8,1502,681,821,82.9
34040, 아산시,075004, 73세,2018,1508,661,847,78,1489,652,837,77.9
34040, 아산시,075005, 74세,2018,1618,706,912,77.4,1600,700,900,77.8
34040, 아산시,080,75~79세,2018,8085,3306,4779,69.2,8019,3289,4730,69.5
34040, 아산시,080001, 75세,2018,1661,691,970,71.2,1642,687,955,71.9
34040, 아산시,080002, 76세,2018,1977,833,1144,72.8,1969,831,1138,73
34040, 아산시,080003, 77세,2018,1532,651,881,73.9,1515,645,870,74.1
34040, 아산시,080004, 78세,2018,1394,537,857,62.7,1381,533,848,62.9
34040, 아산시,080005, 79세,2018,1521,594,927,64.1,1512,593,919,64.5
34040, 아산시,085,80~84세,2018,5809,2125,3684,57.7,5764,2113,3651,57.9
34040, 아산시,085001, 80세,2018,1339,525,814,64.5,1331,524,807,64.9
34040, 아산시,085002, 81세,2018,1353,494,859,57.5,1342,491,851,57.7
34040, 아산시,085003, 82세,2018,1158,439,719,61.1,1149,437,712,61.4
34040, 아산시,085004, 83세,2018,1082,376,706,53.3,1073,375,698,53.7
34040, 아산시,085005, 84세,2018,877,291,586,49.7,869,286,583,49.1
34040, 아산시,090,85~89세,2018,2716,812,1904,42.6,2707,810,1897,42.7
34040, 아산시,090001, 85세,2018,778,240,538,44.6,776,240,536,44.8
34040, 아산시,090002, 86세,2018,685,247,438,56.4,684,246,438,56.2
34040, 아산시,090003, 87세,2018,489,136,353,38.5,486,135,351,38.5
34040, 아산시,090004, 88세,2018,427,100,327,30.6,425,100,325,30.8
34040, 아산시,090005, 89세,2018,337,89,248,35.9,336,89,247,36
34040, 아산시,095,90~94세,2018,768,172,596,28.9,764,171,593,28.8
34040, 아산시,095001, 90세,2018,272,61,211,28.9,269,60,209,28.7
34040, 아산시,095002, 91세,2018,186,36,150,24,185,36,149,24.2
34040, 아산시,095003, 92세,2018,135,31,104,29.8,135,31,104,29.8
34040, 아산시,095004, 93세,2018,98,25,73,34.2,98,25,73,34.2
34040, 아산시,095005, 94세,2018,77,19,58,32.8,77,19,58,32.8
34040, 아산시,100,95~99세,2018,194,40,154,26,192,40,152,26.3
34040, 아산시,100001, 95세,2018,70,13,57,22.8,69,13,56,23.2
34040, 아산시,100002, 96세,2018,53,9,44,20.5,52,9,43,20.9
34040, 아산시,100003, 97세,2018,33,8,25,32,33,8,25,32
34040, 아산시,100004, 98세,2018,22,6,16,37.5,22,6,16,37.5
34040, 아산시,100005, 99세,2018,16,X,12,33.3,16,X,12,33.3
34040, 아산시,101,100세이상,2018,20,X,18,11.1,20,X,18,11.1
34040, 아산시,102,15세미만,2018,54562,27960,26602,105.1,53314,27317,25997,105.1
34040, 아산시,103,15~64세,2018,250159,136117,114042,119.4,226193,120870,105323,114.8
34040, 아산시,104,65세이상,2018,37551,15760,21791,72.3,36956,15510,21446,72.3
34040, 아산시,086,85세이상,2018,3698,1026,2672,38.4,3683,1023,2660,38.5
34040, 아산시,126,평균연령,2018,38.2,37.4,39.1,,38.4,37.5,39.3,
34040, 아산시,127,중위연령,2018,37.9,37.4,38.5,,38.3,37.9,38.7,
34050, 서산시,000,합계,2018,174177,90379,83798,107.9,167968,86869,81099,107.1
34050, 서산시,005,0~4세,2018,7853,4032,3821,105.5,7736,3979,3757,105.9
34050, 서산시,005001, 0세,2018,1369,678,691,98.1,1349,671,678,99
34050, 서산시,005002, 1세,2018,1444,747,697,107.2,1415,731,684,106.9
34050, 서산시,005003, 2세,2018,1638,842,796,105.8,1613,833,780,106.8
34050, 서산시,005004, 3세,2018,1686,861,825,104.4,1662,848,814,104.2
34050, 서산시,005005, 4세,2018,1716,904,812,111.3,1697,896,801,111.9
34050, 서산시,010,5~9세,2018,8685,4510,4175,108,8622,4481,4141,108.2
34050, 서산시,010001, 5세,2018,1687,834,853,97.8,1672,827,845,97.9
34050, 서산시,010002, 6세,2018,1836,962,874,110.1,1822,955,867,110.1
34050, 서산시,010003, 7세,2018,1748,930,818,113.7,1735,926,809,114.5
34050, 서산시,010004, 8세,2018,1752,904,848,106.6,1738,898,840,106.9
34050, 서산시,010005, 9세,2018,1662,880,782,112.5,1655,875,780,112.2
34050, 서산시,015,10~14세,2018,8347,4361,3986,109.4,8305,4338,3967,109.4
34050, 서산시,015001, 10세,2018,1744,912,832,109.6,1737,908,829,109.5
34050, 서산시,015002, 11세,2018,1815,940,875,107.4,1805,935,870,107.5
34050, 서산시,015003, 12세,2018,1602,814,788,103.3,1598,812,786,103.3
34050, 서산시,015004, 13세,2018,1469,763,706,108.1,1458,754,704,107.1
34050, 서산시,015005, 14세,2018,1717,932,785,118.7,1707,929,778,119.4
34050, 서산시,020,15~19세,2018,8983,4810,4173,115.3,8751,4686,4065,115.3
34050, 서산시,020001, 15세,2018,1636,870,766,113.6,1634,868,766,113.3
34050, 서산시,020002, 16세,2018,1669,920,749,122.8,1664,918,746,123.1
34050, 서산시,020003, 17세,2018,1924,982,942,104.2,1891,970,921,105.3
34050, 서산시,020004, 18세,2018,1976,1042,934,111.6,1904,999,905,110.4
34050, 서산시,020005, 19세,2018,1778,996,782,127.4,1658,931,727,128.1
34050, 서산시,025,20~24세,2018,9237,5226,4011,130.3,8334,4764,3570,133.4
34050, 서산시,025001, 20세,2018,1864,1084,780,139,1706,1017,689,147.6
34050, 서산시,025002, 21세,2018,1905,1071,834,128.4,1742,1004,738,136
34050, 서산시,025003, 22세,2018,1805,996,809,123.1,1600,888,712,124.7
34050, 서산시,025004, 23세,2018,1752,987,765,129,1554,869,685,126.9
34050, 서산시,025005, 24세,2018,1911,1088,823,132.2,1732,986,746,132.2
34050, 서산시,030,25~29세,2018,10285,6120,4165,146.9,9488,5636,3852,146.3
34050, 서산시,030001, 25세,2018,1966,1184,782,151.4,1831,1097,734,149.5
34050, 서산시,030002, 26세,2018,2117,1254,863,145.3,1950,1158,792,146.2
34050, 서산시,030003, 27세,2018,1948,1156,792,146,1782,1057,725,145.8
34050, 서산시,030004, 28세,2018,2083,1219,864,141.1,1910,1113,797,139.6
34050, 서산시,030005, 29세,2018,2171,1307,864,151.3,2015,1211,804,150.6
34050, 서산시,035,30~34세,2018,10859,6115,4744,128.9,9978,5622,4356,129.1
34050, 서산시,035001, 30세,2018,2100,1221,879,138.9,1928,1122,806,139.2
34050, 서산시,035002, 31세,2018,2155,1254,901,139.2,1984,1160,824,140.8
34050, 서산시,035003, 32세,2018,2099,1178,921,127.9,1933,1089,844,129
34050, 서산시,035004, 33세,2018,2121,1180,941,125.4,1942,1073,869,123.5
34050, 서산시,035005, 34세,2018,2384,1282,1102,116.3,2191,1178,1013,116.3
34050, 서산시,040,35~39세,2018,13712,7378,6334,116.5,12923,6866,6057,113.4
34050, 서산시,040001, 35세,2018,2532,1359,1173,115.9,2377,1264,1113,113.6
34050, 서산시,040002, 36세,2018,2807,1530,1277,119.8,2632,1416,1216,116.4
34050, 서산시,040003, 37세,2018,2724,1467,1257,116.7,2570,1377,1193,115.4
34050, 서산시,040004, 38세,2018,2903,1565,1338,117,2746,1456,1290,112.9
34050, 서산시,040005, 39세,2018,2746,1457,1289,113,2598,1353,1245,108.7
34050, 서산시,045,40~44세,2018,13463,7190,6273,114.6,12838,6798,6040,112.5
34050, 서산시,045001, 40세,2018,2675,1440,1235,116.6,2536,1353,1183,114.4
34050, 서산시,045002, 41세,2018,2638,1386,1252,110.7,2512,1305,1207,108.1
34050, 서산시,045003, 42세,2018,2555,1388,1167,118.9,2423,1304,1119,116.5
34050, 서산시,045004, 43세,2018,2680,1370,1310,104.6,2570,1303,1267,102.8
34050, 서산시,045005, 44세,2018,2915,1606,1309,122.7,2797,1533,1264,121.3
34050, 서산시,050,45~49세,2018,14840,8016,6824,117.5,14321,7719,6602,116.9
34050, 서산시,050001, 45세,2018,3031,1620,1411,114.8,2917,1552,1365,113.7
34050, 서산시,050002, 46세,2018,2791,1510,1281,117.9,2693,1449,1244,116.5
34050, 서산시,050003, 47세,2018,3095,1704,1391,122.5,2992,1646,1346,122.3
34050, 서산시,050004, 48세,2018,2828,1514,1314,115.2,2722,1455,1267,114.8
34050, 서산시,050005, 49세,2018,3095,1668,1427,116.9,2997,1617,1380,117.2
34050, 서산시,055,50~54세,2018,13622,7279,6343,114.8,13183,7056,6127,115.2
34050, 서산시,055001, 50세,2018,2974,1541,1433,107.5,2897,1496,1401,106.8
34050, 서산시,055002, 51세,2018,2728,1485,1243,119.5,2626,1439,1187,121.2
34050, 서산시,055003, 52세,2018,2583,1374,1209,113.6,2498,1331,1167,114.1
34050, 서산시,055004, 53세,2018,2860,1544,1316,117.3,2775,1506,1269,118.7
34050, 서산시,055005, 54세,2018,2477,1335,1142,116.9,2387,1284,1103,116.4
34050, 서산시,060,55~59세,2018,14130,7349,6781,108.4,13777,7153,6624,108
34050, 서산시,060001, 55세,2018,2585,1380,1205,114.5,2484,1325,1159,114.3
34050, 서산시,060002, 56세,2018,2804,1500,1304,115,2728,1454,1274,114.1
34050, 서산시,060003, 57세,2018,3153,1637,1516,108,3086,1608,1478,108.8
34050, 서산시,060004, 58세,2018,3039,1535,1504,102.1,2981,1500,1481,101.3
34050, 서산시,060005, 59세,2018,2549,1297,1252,103.6,2498,1266,1232,102.8
34050, 서산시,065,60~64세,2018,10808,5386,5422,99.3,10572,5262,5310,99.1
34050, 서산시,065001, 60세,2018,2363,1225,1138,107.6,2309,1198,1111,107.8
34050, 서산시,065002, 61세,2018,2286,1147,1139,100.7,2237,1121,1116,100.4
34050, 서산시,065003, 62세,2018,2163,1076,1087,99,2114,1048,1066,98.3
34050, 서산시,065004, 63세,2018,2119,1035,1084,95.5,2076,1014,1062,95.5
34050, 서산시,065005, 64세,2018,1877,903,974,92.7,1836,881,955,92.3
34050, 서산시,070,65~69세,2018,8350,4173,4177,99.9,8231,4112,4119,99.8
34050, 서산시,070001, 65세,2018,1585,805,780,103.2,1551,787,764,103
34050, 서산시,070002, 66세,2018,1871,922,949,97.2,1838,907,931,97.4
34050, 서산시,070003, 67세,2018,1457,724,733,98.8,1438,712,726,98.1
34050, 서산시,070004, 68세,2018,1680,825,855,96.5,1665,818,847,96.6
34050, 서산시,070005, 69세,2018,1757,897,860,104.3,1739,888,851,104.3
34050, 서산시,075,70~74세,2018,6502,3113,3389,91.9,6449,3089,3360,91.9
34050, 서산시,075001, 70세,2018,1568,783,785,99.7,1557,777,780,99.6
34050, 서산시,075002, 71세,2018,1457,680,777,87.5,1439,674,765,88.1
34050, 서산시,075003, 72세,2018,1190,595,595,100,1180,589,591,99.7
34050, 서산시,075004, 73세,2018,1078,513,565,90.8,1071,511,560,91.3
34050, 서산시,075005, 74세,2018,1209,542,667,81.3,1202,538,664,81
34050, 서산시,080,75~79세,2018,6283,2655,3628,73.2,6257,2646,3611,73.3
34050, 서산시,080001, 75세,2018,1255,594,661,89.9,1245,590,655,90.1
34050, 서산시,080002, 76세,2018,1725,701,1024,68.5,1718,699,1019,68.6
34050, 서산시,080003, 77세,2018,1133,471,662,71.1,1131,471,660,71.4
34050, 서산시,080004, 78세,2018,1025,424,601,70.5,1019,421,598,70.4
34050, 서산시,080005, 79세,2018,1145,465,680,68.4,1144,465,679,68.5
34050, 서산시,085,80~84세,2018,4835,1776,3059,58.1,4824,1773,3051,58.1
34050, 서산시,085001, 80세,2018,1155,460,695,66.2,1152,460,692,66.5
34050, 서산시,085002, 81세,2018,992,372,620,60,990,371,619,59.9
34050, 서산시,085003, 82세,2018,963,338,625,54.1,960,337,623,54.1
34050, 서산시,085004, 83세,2018,955,340,615,55.3,953,339,614,55.2
34050, 서산시,085005, 84세,2018,770,266,504,52.8,769,266,503,52.9
34050, 서산시,090,85~89세,2018,2399,694,1705,40.7,2396,694,1702,40.8
34050, 서산시,090001, 85세,2018,702,225,477,47.2,701,225,476,47.3
34050, 서산시,090002, 86세,2018,642,199,443,44.9,641,199,442,45
34050, 서산시,090003, 87세,2018,410,108,302,35.8,410,108,302,35.8
34050, 서산시,090004, 88세,2018,334,80,254,31.5,333,80,253,31.6
34050, 서산시,090005, 89세,2018,311,82,229,35.8,311,82,229,35.8
34050, 서산시,095,90~94세,2018,773,163,610,26.7,772,162,610,26.6
34050, 서산시,095001, 90세,2018,238,52,186,28,238,52,186,28
34050, 서산시,095002, 91세,2018,180,44,136,32.4,179,43,136,31.6
34050, 서산시,095003, 92세,2018,139,22,117,18.8,139,22,117,18.8
34050, 서산시,095004, 93세,2018,116,23,93,24.7,116,23,93,24.7
34050, 서산시,095005, 94세,2018,100,22,78,28.2,100,22,78,28.2
34050, 서산시,100,95~99세,2018,176,29,147,19.7,176,29,147,19.7
34050, 서산시,100001, 95세,2018,64,10,54,18.5,64,10,54,18.5
34050, 서산시,100002, 96세,2018,55,9,46,19.6,55,9,46,19.6
34050, 서산시,100003, 97세,2018,27,5,22,22.7,27,5,22,22.7
34050, 서산시,100004, 98세,2018,18,X,15,20,18,X,15,20
34050, 서산시,100005, 99세,2018,12,X,10,20,12,X,10,20
34050, 서산시,101,100세이상,2018,35,X,31,12.9,35,X,31,12.9
34050, 서산시,102,15세미만,2018,24885,12903,11982,107.7,24663,12798,11865,107.9
34050, 서산시,103,15~64세,2018,119939,64869,55070,117.8,114165,61562,52603,117
34050, 서산시,104,65세이상,2018,29353,12607,16746,75.3,29140,12509,16631,75.2
34050, 서산시,086,85세이상,2018,3383,890,2493,35.7,3379,889,2490,35.7
34050, 서산시,126,평균연령,2018,42.5,41,44.1,,42.7,41.2,44.3,
34050, 서산시,127,중위연령,2018,43.5,41.9,45.2,,43.9,42.3,45.5,
34060, 논산시,000,합계,2018,122843,61625,61218,100.7,117352,58763,58589,100.3
34060, 논산시,005,0~4세,2018,3635,1878,1757,106.9,3594,1860,1734,107.3
34060, 논산시,005001, 0세,2018,623,342,281,121.7,618,339,279,121.5
34060, 논산시,005002, 1세,2018,655,342,313,109.3,651,340,311,109.3
34060, 논산시,005003, 2세,2018,758,388,370,104.9,745,383,362,105.8
34060, 논산시,005004, 3세,2018,810,404,406,99.5,801,401,400,100.3
34060, 논산시,005005, 4세,2018,789,402,387,103.9,779,397,382,103.9
34060, 논산시,010,5~9세,2018,4362,2235,2127,105.1,4344,2226,2118,105.1
34060, 논산시,010001, 5세,2018,820,421,399,105.5,816,420,396,106.1
34060, 논산시,010002, 6세,2018,893,451,442,102,888,449,439,102.3
34060, 논산시,010003, 7세,2018,881,465,416,111.8,877,462,415,111.3
34060, 논산시,010004, 8세,2018,887,456,431,105.8,885,455,430,105.8
34060, 논산시,010005, 9세,2018,881,442,439,100.7,878,440,438,100.5
34060, 논산시,015,10~14세,2018,4855,2485,2370,104.9,4836,2476,2360,104.9
34060, 논산시,015001, 10세,2018,995,498,497,100.2,992,496,496,100
34060, 논산시,015002, 11세,2018,994,540,454,118.9,989,537,452,118.8
34060, 논산시,015003, 12세,2018,951,475,476,99.8,950,474,476,99.6
34060, 논산시,015004, 13세,2018,917,473,444,106.5,911,471,440,107
34060, 논산시,015005, 14세,2018,998,499,499,100,994,498,496,100.4
34060, 논산시,020,15~19세,2018,7412,4212,3200,131.6,7337,4172,3165,131.8
34060, 논산시,020001, 15세,2018,1110,606,504,120.2,1109,606,503,120.5
34060, 논산시,020002, 16세,2018,1381,808,573,141,1375,804,571,140.8
34060, 논산시,020003, 17세,2018,1623,982,641,153.2,1611,976,635,153.7
34060, 논산시,020004, 18세,2018,1724,1002,722,138.8,1713,994,719,138.2
34060, 논산시,020005, 19세,2018,1574,814,760,107.1,1529,792,737,107.5
34060, 논산시,025,20~24세,2018,8134,4312,3822,112.8,7060,3826,3234,118.3
34060, 논산시,025001, 20세,2018,1633,815,818,99.6,1514,763,751,101.6
34060, 논산시,025002, 21세,2018,1696,871,825,105.6,1517,797,720,110.7
34060, 논산시,025003, 22세,2018,1739,921,818,112.6,1494,816,678,120.4
34060, 논산시,025004, 23세,2018,1571,880,691,127.4,1305,754,551,136.8
34060, 논산시,025005, 24세,2018,1495,825,670,123.1,1230,696,534,130.3
34060, 논산시,030,25~29세,2018,6620,3699,2921,126.6,5356,3062,2294,133.5
34060, 논산시,030001, 25세,2018,1396,786,610,128.9,1132,649,483,134.4
34060, 논산시,030002, 26세,2018,1417,757,660,114.7,1134,624,510,122.4
34060, 논산시,030003, 27세,2018,1292,710,582,122,1042,590,452,130.5
34060, 논산시,030004, 28세,2018,1308,762,546,139.6,1067,646,421,153.4
34060, 논산시,030005, 29세,2018,1207,684,523,130.8,981,553,428,129.2
34060, 논산시,035,30~34세,2018,5974,3199,2775,115.3,4983,2626,2357,111.4
34060, 논산시,035001, 30세,2018,1256,694,562,123.5,1020,560,460,121.7
34060, 논산시,035002, 31세,2018,1132,614,518,118.5,938,489,449,108.9
34060, 논산시,035003, 32세,2018,1223,643,580,110.9,1023,542,481,112.7
34060, 논산시,035004, 33세,2018,1134,587,547,107.3,960,487,473,103
34060, 논산시,035005, 34세,2018,1229,661,568,116.4,1042,548,494,110.9
34060, 논산시,040,35~39세,2018,7124,3746,3378,110.9,6414,3353,3061,109.5
34060, 논산시,040001, 35세,2018,1369,737,632,116.6,1220,653,567,115.2
34060, 논산시,040002, 36세,2018,1386,750,636,117.9,1211,656,555,118.2
34060, 논산시,040003, 37세,2018,1475,756,719,105.1,1344,689,655,105.2
34060, 논산시,040004, 38세,2018,1470,747,723,103.3,1335,672,663,101.4
34060, 논산시,040005, 39세,2018,1424,756,668,113.2,1304,683,621,110
34060, 논산시,045,40~44세,2018,7335,3943,3392,116.2,6955,3727,3228,115.5
34060, 논산시,045001, 40세,2018,1278,682,596,114.4,1187,627,560,112
34060, 논산시,045002, 41세,2018,1440,722,718,100.6,1367,686,681,100.7
34060, 논산시,045003, 42세,2018,1388,766,622,123.2,1312,724,588,123.1
34060, 논산시,045004, 43세,2018,1540,831,709,117.2,1470,790,680,116.2
34060, 논산시,045005, 44세,2018,1689,942,747,126.1,1619,900,719,125.2
34060, 논산시,050,45~49세,2018,8861,4705,4156,113.2,8565,4551,4014,113.4
34060, 논산시,050001, 45세,2018,1702,898,804,111.7,1638,868,770,112.7
34060, 논산시,050002, 46세,2018,1700,909,791,114.9,1641,877,764,114.8
34060, 논산시,050003, 47세,2018,1880,985,895,110.1,1816,949,867,109.5
34060, 논산시,050004, 48세,2018,1714,938,776,120.9,1652,906,746,121.4
34060, 논산시,050005, 49세,2018,1865,975,890,109.6,1818,951,867,109.7
34060, 논산시,055,50~54세,2018,9169,4785,4384,109.1,8930,4666,4264,109.4
34060, 논산시,055001, 50세,2018,1904,1018,886,114.9,1843,984,859,114.6
34060, 논산시,055002, 51세,2018,1801,950,851,111.6,1757,925,832,111.2
34060, 논산시,055003, 52세,2018,1675,889,786,113.1,1631,872,759,114.9
34060, 논산시,055004, 53세,2018,1948,949,999,95,1909,927,982,94.4
34060, 논산시,055005, 54세,2018,1841,979,862,113.6,1790,958,832,115.1
34060, 논산시,060,55~59세,2018,10877,5532,5345,103.5,10691,5424,5267,103
34060, 논산시,060001, 55세,2018,1894,1004,890,112.8,1842,973,869,112
34060, 논산시,060002, 56세,2018,2073,1066,1007,105.9,2039,1047,992,105.5
34060, 논산시,060003, 57세,2018,2353,1179,1174,100.4,2320,1159,1161,99.8
34060, 논산시,060004, 58세,2018,2374,1184,1190,99.5,2336,1163,1173,99.1
34060, 논산시,060005, 59세,2018,2183,1099,1084,101.4,2154,1082,1072,100.9
34060, 논산시,065,60~64세,2018,10117,5150,4967,103.7,9996,5087,4909,103.6
34060, 논산시,065001, 60세,2018,2090,1066,1024,104.1,2061,1050,1011,103.9
34060, 논산시,065002, 61세,2018,2025,1059,966,109.6,1995,1043,952,109.6
34060, 논산시,065003, 62세,2018,2017,1009,1008,100.1,1990,1001,989,101.2
34060, 논산시,065004, 63세,2018,2069,1083,986,109.8,2051,1071,980,109.3
34060, 논산시,065005, 64세,2018,1916,933,983,94.9,1899,922,977,94.4
34060, 논산시,070,65~69세,2018,7452,3609,3843,93.9,7405,3583,3822,93.7
34060, 논산시,070001, 65세,2018,1535,764,771,99.1,1520,755,765,98.7
34060, 논산시,070002, 66세,2018,1560,747,813,91.9,1547,741,806,91.9
34060, 논산시,070003, 67세,2018,1341,651,690,94.3,1332,646,686,94.2
34060, 논산시,070004, 68세,2018,1528,756,772,97.9,1522,751,771,97.4
34060, 논산시,070005, 69세,2018,1488,691,797,86.7,1484,690,794,86.9
34060, 논산시,075,70~74세,2018,6063,2769,3294,84.1,6052,2765,3287,84.1
34060, 논산시,075001, 70세,2018,1415,661,754,87.7,1414,661,753,87.8
34060, 논산시,075002, 71세,2018,1390,671,719,93.3,1386,669,717,93.3
34060, 논산시,075003, 72세,2018,957,449,508,88.4,955,448,507,88.4
34060, 논산시,075004, 73세,2018,1102,484,618,78.3,1100,483,617,78.3
34060, 논산시,075005, 74세,2018,1199,504,695,72.5,1197,504,693,72.7
34060, 논산시,080,75~79세,2018,6377,2603,3774,69,6369,2602,3767,69.1
34060, 논산시,080001, 75세,2018,1187,526,661,79.6,1186,526,660,79.7
34060, 논산시,080002, 76세,2018,1593,679,914,74.3,1591,679,912,74.5
34060, 논산시,080003, 77세,2018,1236,463,773,59.9,1234,463,771,60.1
34060, 논산시,080004, 78세,2018,1122,446,676,66,1120,446,674,66.2
34060, 논산시,080005, 79세,2018,1239,489,750,65.2,1238,488,750,65.1
34060, 논산시,085,80~84세,2018,5028,1773,3255,54.5,5022,1769,3253,54.4
34060, 논산시,085001, 80세,2018,1122,385,737,52.2,1120,384,736,52.2
34060, 논산시,085002, 81세,2018,1098,417,681,61.2,1097,416,681,61.1
34060, 논산시,085003, 82세,2018,995,366,629,58.2,994,365,629,58
34060, 논산시,085004, 83세,2018,987,321,666,48.2,985,320,665,48.1
34060, 논산시,085005, 84세,2018,826,284,542,52.4,826,284,542,52.4
34060, 논산시,090,85~89세,2018,2414,742,1672,44.4,2410,740,1670,44.3
34060, 논산시,090001, 85세,2018,691,232,459,50.5,690,232,458,50.7
34060, 논산시,090002, 86세,2018,601,191,410,46.6,601,191,410,46.6
34060, 논산시,090003, 87세,2018,427,130,297,43.8,427,130,297,43.8
34060, 논산시,090004, 88세,2018,389,101,288,35.1,389,101,288,35.1
34060, 논산시,090005, 89세,2018,306,88,218,40.4,303,86,217,39.6
34060, 논산시,095,90~94세,2018,820,199,621,32,819,199,620,32.1
34060, 논산시,095001, 90세,2018,297,72,225,32,297,72,225,32
34060, 논산시,095002, 91세,2018,234,69,165,41.8,233,69,164,42.1
34060, 논산시,095003, 92세,2018,118,20,98,20.4,118,20,98,20.4
34060, 논산시,095004, 93세,2018,101,21,80,26.3,101,21,80,26.3
34060, 논산시,095005, 94세,2018,70,17,53,32.1,70,17,53,32.1
34060, 논산시,100,95~99세,2018,195,44,151,29.1,195,44,151,29.1
34060, 논산시,100001, 95세,2018,65,14,51,27.5,65,14,51,27.5
34060, 논산시,100002, 96세,2018,48,12,36,33.3,48,12,36,33.3
34060, 논산시,100003, 97세,2018,35,7,28,25,35,7,28,25
34060, 논산시,100004, 98세,2018,27,6,21,28.6,27,6,21,28.6
34060, 논산시,100005, 99세,2018,20,5,15,33.3,20,5,15,33.3
34060, 논산시,101,100세이상,2018,19,5,14,35.7,19,5,14,35.7
34060, 논산시,102,15세미만,2018,12852,6598,6254,105.5,12774,6562,6212,105.6
34060, 논산시,103,15~64세,2018,81623,43283,38340,112.9,76287,40494,35793,113.1
34060, 논산시,104,65세이상,2018,28368,11744,16624,70.6,28291,11707,16584,70.6
34060, 논산시,086,85세이상,2018,3448,990,2458,40.3,3443,988,2455,40.2
34060, 논산시,126,평균연령,2018,46.3,44.3,48.3,,46.9,44.8,49,
34060, 논산시,127,중위연령,2018,48.4,46.2,50.8,,49.6,47.3,52.1,
34070, 계룡시,000,합계,2018,41557,20621,20936,98.5,41322,20520,20802,98.6
34070, 계룡시,005,0~4세,2018,1821,893,928,96.2,1820,892,928,96.1
34070, 계룡시,005001, 0세,2018,267,129,138,93.5,267,129,138,93.5
34070, 계룡시,005002, 1세,2018,311,161,150,107.3,310,160,150,106.7
34070, 계룡시,005003, 2세,2018,401,203,198,102.5,401,203,198,102.5
34070, 계룡시,005004, 3세,2018,418,195,223,87.4,418,195,223,87.4
34070, 계룡시,005005, 4세,2018,424,205,219,93.6,424,205,219,93.6
34070, 계룡시,010,5~9세,2018,2646,1360,1286,105.8,2645,1360,1285,105.8
34070, 계룡시,010001, 5세,2018,468,239,229,104.4,468,239,229,104.4
34070, 계룡시,010002, 6세,2018,515,248,267,92.9,515,248,267,92.9
34070, 계룡시,010003, 7세,2018,560,299,261,114.6,560,299,261,114.6
34070, 계룡시,010004, 8세,2018,562,288,274,105.1,561,288,273,105.5
34070, 계룡시,010005, 9세,2018,541,286,255,112.2,541,286,255,112.2
34070, 계룡시,015,10~14세,2018,3108,1612,1496,107.8,3108,1612,1496,107.8
34070, 계룡시,015001, 10세,2018,569,303,266,113.9,569,303,266,113.9
34070, 계룡시,015002, 11세,2018,668,350,318,110.1,668,350,318,110.1
34070, 계룡시,015003, 12세,2018,656,337,319,105.6,656,337,319,105.6
34070, 계룡시,015004, 13세,2018,578,293,285,102.8,578,293,285,102.8
34070, 계룡시,015005, 14세,2018,637,329,308,106.8,637,329,308,106.8
34070, 계룡시,020,15~19세,2018,2886,1461,1425,102.5,2883,1460,1423,102.6
34070, 계룡시,020001, 15세,2018,648,323,325,99.4,648,323,325,99.4
34070, 계룡시,020002, 16세,2018,547,260,287,90.6,547,260,287,90.6
34070, 계룡시,020003, 17세,2018,658,315,343,91.8,657,314,343,91.5
34070, 계룡시,020004, 18세,2018,600,308,292,105.5,599,308,291,105.8
34070, 계룡시,020005, 19세,2018,433,255,178,143.3,432,255,177,144.1
34070, 계룡시,025,20~24세,2018,2232,1327,905,146.6,2202,1314,888,148
34070, 계룡시,025001, 20세,2018,440,262,178,147.2,437,260,177,146.9
34070, 계룡시,025002, 21세,2018,487,311,176,176.7,483,309,174,177.6
34070, 계룡시,025003, 22세,2018,458,275,183,150.3,454,274,180,152.2
34070, 계룡시,025004, 23세,2018,438,258,180,143.3,430,254,176,144.3
34070, 계룡시,025005, 24세,2018,409,221,188,117.6,398,217,181,119.9
34070, 계룡시,030,25~29세,2018,1782,971,811,119.7,1731,944,787,119.9
34070, 계룡시,030001, 25세,2018,379,199,180,110.6,374,196,178,110.1
34070, 계룡시,030002, 26세,2018,412,221,191,115.7,401,214,187,114.4
34070, 계룡시,030003, 27세,2018,322,163,159,102.5,308,157,151,104
34070, 계룡시,030004, 28세,2018,366,224,142,157.7,353,215,138,155.8
34070, 계룡시,030005, 29세,2018,303,164,139,118,295,162,133,121.8
34070, 계룡시,035,30~34세,2018,1828,903,925,97.6,1810,899,911,98.7
34070, 계룡시,035001, 30세,2018,328,169,159,106.3,322,168,154,109.1
34070, 계룡시,035002, 31세,2018,328,162,166,97.6,322,160,162,98.8
34070, 계룡시,035003, 32세,2018,367,190,177,107.3,362,189,173,109.2
34070, 계룡시,035004, 33세,2018,368,179,189,94.7,368,179,189,94.7
34070, 계룡시,035005, 34세,2018,437,203,234,86.8,436,203,233,87.1
34070, 계룡시,040,35~39세,2018,3325,1566,1759,89,3302,1558,1744,89.3
34070, 계룡시,040001, 35세,2018,516,247,269,91.8,510,246,264,93.2
34070, 계룡시,040002, 36세,2018,645,299,346,86.4,638,297,341,87.1
34070, 계룡시,040003, 37세,2018,685,335,350,95.7,683,334,349,95.7
34070, 계룡시,040004, 38세,2018,749,355,394,90.1,745,353,392,90.1
34070, 계룡시,040005, 39세,2018,730,330,400,82.5,726,328,398,82.4
34070, 계룡시,045,40~44세,2018,3985,1907,2078,91.8,3963,1896,2067,91.7
34070, 계룡시,045001, 40세,2018,667,317,350,90.6,663,317,346,91.6
34070, 계룡시,045002, 41세,2018,753,335,418,80.1,749,333,416,80
34070, 계룡시,045003, 42세,2018,757,356,401,88.8,751,352,399,88.2
34070, 계룡시,045004, 43세,2018,811,397,414,95.9,807,395,412,95.9
34070, 계룡시,045005, 44세,2018,997,502,495,101.4,993,499,494,101
34070, 계룡시,050,45~49세,2018,4728,2350,2378,98.8,4705,2340,2365,98.9
34070, 계룡시,050001, 45세,2018,897,408,489,83.4,893,406,487,83.4
34070, 계룡시,050002, 46세,2018,980,527,453,116.3,977,526,451,116.6
34070, 계룡시,050003, 47세,2018,1027,514,513,100.2,1023,513,510,100.6
34070, 계룡시,050004, 48세,2018,894,445,449,99.1,887,442,445,99.3
34070, 계룡시,050005, 49세,2018,930,456,474,96.2,925,453,472,96
34070, 계룡시,055,50~54세,2018,3530,1807,1723,104.9,3504,1797,1707,105.3
34070, 계룡시,055001, 50세,2018,869,429,440,97.5,865,427,438,97.5
34070, 계룡시,055002, 51세,2018,713,365,348,104.9,709,364,345,105.5
34070, 계룡시,055003, 52세,2018,686,374,312,119.9,681,372,309,120.4
34070, 계룡시,055004, 53세,2018,671,329,342,96.2,666,327,339,96.5
34070, 계룡시,055005, 54세,2018,591,310,281,110.3,583,307,276,111.2
34070, 계룡시,060,55~59세,2018,2993,1479,1514,97.7,2985,1477,1508,97.9
34070, 계룡시,060001, 55세,2018,600,302,298,101.3,594,300,294,102
34070, 계룡시,060002, 56세,2018,612,308,304,101.3,610,308,302,102
34070, 계룡시,060003, 57세,2018,640,322,318,101.3,640,322,318,101.3
34070, 계룡시,060004, 58세,2018,616,297,319,93.1,616,297,319,93.1
34070, 계룡시,060005, 59세,2018,525,250,275,90.9,525,250,275,90.9
34070, 계룡시,065,60~64세,2018,2327,1154,1173,98.4,2317,1149,1168,98.4
34070, 계룡시,065001, 60세,2018,532,255,277,92.1,530,254,276,92
34070, 계룡시,065002, 61세,2018,492,248,244,101.6,492,248,244,101.6
34070, 계룡시,065003, 62세,2018,459,224,235,95.3,456,221,235,94
34070, 계룡시,065004, 63세,2018,457,231,226,102.2,456,230,226,101.8
34070, 계룡시,065005, 64세,2018,387,196,191,102.6,383,196,187,104.8
34070, 계룡시,070,65~69세,2018,1440,714,726,98.3,1424,706,718,98.3
34070, 계룡시,070001, 65세,2018,372,197,175,112.6,369,197,172,114.5
34070, 계룡시,070002, 66세,2018,321,151,170,88.8,319,150,169,88.8
34070, 계룡시,070003, 67세,2018,228,115,113,101.8,226,114,112,101.8
34070, 계룡시,070004, 68세,2018,243,125,118,105.9,238,121,117,103.4
34070, 계룡시,070005, 69세,2018,276,126,150,84,272,124,148,83.8
34070, 계룡시,075,70~74세,2018,987,488,499,97.8,985,488,497,98.2
34070, 계룡시,075001, 70세,2018,243,114,129,88.4,243,114,129,88.4
34070, 계룡시,075002, 71세,2018,243,140,103,135.9,242,140,102,137.3
34070, 계룡시,075003, 72세,2018,147,73,74,98.6,146,73,73,100
34070, 계룡시,075004, 73세,2018,170,78,92,84.8,170,78,92,84.8
34070, 계룡시,075005, 74세,2018,184,83,101,82.2,184,83,101,82.2
34070, 계룡시,080,75~79세,2018,823,312,511,61.1,823,312,511,61.1
34070, 계룡시,080001, 75세,2018,183,78,105,74.3,183,78,105,74.3
34070, 계룡시,080002, 76세,2018,183,59,124,47.6,183,59,124,47.6
34070, 계룡시,080003, 77세,2018,148,51,97,52.6,148,51,97,52.6
34070, 계룡시,080004, 78세,2018,138,68,70,97.1,138,68,70,97.1
34070, 계룡시,080005, 79세,2018,171,56,115,48.7,171,56,115,48.7
34070, 계룡시,085,80~84세,2018,642,191,451,42.4,642,191,451,42.4
34070, 계룡시,085001, 80세,2018,141,48,93,51.6,141,48,93,51.6
34070, 계룡시,085002, 81세,2018,146,46,100,46,146,46,100,46
34070, 계룡시,085003, 82세,2018,125,31,94,33,125,31,94,33
34070, 계룡시,085004, 83세,2018,111,31,80,38.8,111,31,80,38.8
34070, 계룡시,085005, 84세,2018,119,35,84,41.7,119,35,84,41.7
34070, 계룡시,090,85~89세,2018,323,92,231,39.8,322,91,231,39.4
34070, 계룡시,090001, 85세,2018,97,28,69,40.6,97,28,69,40.6
34070, 계룡시,090002, 86세,2018,76,26,50,52,75,25,50,50
34070, 계룡시,090003, 87세,2018,56,13,43,30.2,56,13,43,30.2
34070, 계룡시,090004, 88세,2018,54,16,38,42.1,54,16,38,42.1
34070, 계룡시,090005, 89세,2018,40,9,31,29,40,9,31,29
34070, 계룡시,095,90~94세,2018,116,27,89,30.3,116,27,89,30.3
34070, 계룡시,095001, 90세,2018,37,9,28,32.1,37,9,28,32.1
34070, 계룡시,095002, 91세,2018,36,10,26,38.5,36,10,26,38.5
34070, 계룡시,095003, 92세,2018,18,6,12,50,18,6,12,50
34070, 계룡시,095004, 93세,2018,18,X,16,12.5,18,X,16,12.5
34070, 계룡시,095005, 94세,2018,7,X,7,0,7,X,7,0
34070, 계룡시,100,95~99세,2018,35,7,28,25,35,7,28,25
34070, 계룡시,100001, 95세,2018,17,X,14,21.4,17,X,14,21.4
34070, 계룡시,100002, 96세,2018,10,X,8,25,10,X,8,25
34070, 계룡시,100003, 97세,2018,X,X,X,100,X,X,X,100
34070, 계룡시,100004, 98세,2018,X,X,X,0,X,X,X,0
34070, 계룡시,100005, 99세,2018,X,X,X,33.3,X,X,X,33.3
34070, 계룡시,101,100세이상,2018,X,X,X,,X,X,X,
34070, 계룡시,102,15세미만,2018,7575,3865,3710,104.2,7573,3864,3709,104.2
34070, 계룡시,103,15~64세,2018,29616,14925,14691,101.6,29402,14834,14568,101.8
34070, 계룡시,104,65세이상,2018,4366,1831,2535,72.2,4347,1822,2525,72.2
34070, 계룡시,086,85세이상,2018,474,126,348,36.2,473,125,348,35.9
34070, 계룡시,126,평균연령,2018,39,37.9,40.1,,39,37.9,40.1,
34070, 계룡시,127,중위연령,2018,41.6,40.7,42.4,,41.7,40.7,42.4,
34080, 당진시,000,합계,2018,169965,90747,79218,114.6,161999,85437,76562,111.6
34080, 당진시,005,0~4세,2018,8374,4243,4131,102.7,8278,4194,4084,102.7
34080, 당진시,005001, 0세,2018,1426,725,701,103.4,1408,716,692,103.5
34080, 당진시,005002, 1세,2018,1621,841,780,107.8,1596,827,769,107.5
34080, 당진시,005003, 2세,2018,1684,844,840,100.5,1664,836,828,101
34080, 당진시,005004, 3세,2018,1840,922,918,100.4,1826,915,911,100.4
34080, 당진시,005005, 4세,2018,1803,911,892,102.1,1784,900,884,101.8
34080, 당진시,010,5~9세,2018,8972,4626,4346,106.4,8928,4601,4327,106.3
34080, 당진시,010001, 5세,2018,1782,911,871,104.6,1776,909,867,104.8
34080, 당진시,010002, 6세,2018,1846,944,902,104.7,1833,939,894,105
34080, 당진시,010003, 7세,2018,1878,984,894,110.1,1870,979,891,109.9
34080, 당진시,010004, 8세,2018,1782,944,838,112.6,1776,938,838,111.9
34080, 당진시,010005, 9세,2018,1684,843,841,100.2,1673,836,837,99.9
34080, 당진시,015,10~14세,2018,7771,4093,3678,111.3,7739,4074,3665,111.2
34080, 당진시,015001, 10세,2018,1681,887,794,111.7,1674,883,791,111.6
34080, 당진시,015002, 11세,2018,1692,912,780,116.9,1680,903,777,116.2
34080, 당진시,015003, 12세,2018,1463,782,681,114.8,1460,782,678,115.3
34080, 당진시,015004, 13세,2018,1416,735,681,107.9,1411,731,680,107.5
34080, 당진시,015005, 14세,2018,1519,777,742,104.7,1514,775,739,104.9
34080, 당진시,020,15~19세,2018,8179,4361,3818,114.2,8094,4309,3785,113.8
34080, 당진시,020001, 15세,2018,1373,740,633,116.9,1369,738,631,117
34080, 당진시,020002, 16세,2018,1420,784,636,123.3,1412,779,633,123.1
34080, 당진시,020003, 17세,2018,1705,884,821,107.7,1694,876,818,107.1
34080, 당진시,020004, 18세,2018,1821,962,859,112,1797,948,849,111.7
34080, 당진시,020005, 19세,2018,1860,991,869,114,1822,968,854,113.3
34080, 당진시,025,20~24세,2018,8758,5080,3678,138.1,8019,4553,3466,131.4
34080, 당진시,025001, 20세,2018,1749,952,797,119.4,1676,914,762,119.9
34080, 당진시,025002, 21세,2018,1746,969,777,124.7,1642,896,746,120.1
34080, 당진시,025003, 22세,2018,1762,1069,693,154.3,1618,961,657,146.3
34080, 당진시,025004, 23세,2018,1728,1033,695,148.6,1548,890,658,135.3
34080, 당진시,025005, 24세,2018,1773,1057,716,147.6,1535,892,643,138.7
34080, 당진시,030,25~29세,2018,9992,6090,3902,156.1,8685,5130,3555,144.3
34080, 당진시,030001, 25세,2018,1815,1056,759,139.1,1583,878,705,124.5
34080, 당진시,030002, 26세,2018,1939,1182,757,156.1,1696,1001,695,144
34080, 당진시,030003, 27세,2018,1964,1213,751,161.5,1727,1040,687,151.4
34080, 당진시,030004, 28세,2018,2068,1310,758,172.8,1785,1105,680,162.5
34080, 당진시,030005, 29세,2018,2206,1329,877,151.5,1894,1106,788,140.4
34080, 당진시,035,30~34세,2018,12019,7080,4939,143.3,10559,6033,4526,133.3
34080, 당진시,035001, 30세,2018,2263,1392,871,159.8,1951,1169,782,149.5
34080, 당진시,035002, 31세,2018,2340,1354,986,137.3,2033,1134,899,126.1
34080, 당진시,035003, 32세,2018,2300,1341,959,139.8,2010,1143,867,131.8
34080, 당진시,035004, 33세,2018,2500,1480,1020,145.1,2193,1253,940,133.3
34080, 당진시,035005, 34세,2018,2616,1513,1103,137.2,2372,1334,1038,128.5
34080, 당진시,040,35~39세,2018,14993,8481,6512,130.2,13949,7756,6193,125.2
34080, 당진시,040001, 35세,2018,2871,1674,1197,139.8,2633,1506,1127,133.6
34080, 당진시,040002, 36세,2018,3115,1778,1337,133,2882,1624,1258,129.1
34080, 당진시,040003, 37세,2018,3088,1726,1362,126.7,2889,1580,1309,120.7
34080, 당진시,040004, 38세,2018,3088,1710,1378,124.1,2882,1559,1323,117.8
34080, 당진시,040005, 39세,2018,2831,1593,1238,128.7,2663,1487,1176,126.4
34080, 당진시,045,40~44세,2018,13090,7395,5695,129.9,12333,6904,5429,127.2
34080, 당진시,045001, 40세,2018,2552,1434,1118,128.3,2387,1317,1070,123.1
34080, 당진시,045002, 41세,2018,2755,1532,1223,125.3,2582,1425,1157,123.2
34080, 당진시,045003, 42세,2018,2479,1355,1124,120.6,2338,1264,1074,117.7
34080, 당진시,045004, 43세,2018,2558,1467,1091,134.5,2424,1380,1044,132.2
34080, 당진시,045005, 44세,2018,2746,1607,1139,141.1,2602,1518,1084,140
34080, 당진시,050,45~49세,2018,13592,7719,5873,131.4,12807,7208,5599,128.7
34080, 당진시,050001, 45세,2018,2837,1571,1266,124.1,2678,1463,1215,120.4
34080, 당진시,050002, 46세,2018,2565,1490,1075,138.6,2405,1377,1028,133.9
34080, 당진시,050003, 47세,2018,2854,1666,1188,140.2,2672,1547,1125,137.5
34080, 당진시,050004, 48세,2018,2564,1428,1136,125.7,2401,1330,1071,124.2
34080, 당진시,050005, 49세,2018,2772,1564,1208,129.5,2651,1491,1160,128.5
34080, 당진시,055,50~54세,2018,12415,6943,5472,126.9,11805,6586,5219,126.2
34080, 당진시,055001, 50세,2018,2648,1508,1140,132.3,2513,1427,1086,131.4
34080, 당진시,055002, 51세,2018,2508,1361,1147,118.7,2406,1299,1107,117.3
34080, 당진시,055003, 52세,2018,2246,1257,989,127.1,2136,1199,937,128
34080, 당진시,055004, 53세,2018,2657,1481,1176,125.9,2522,1403,1119,125.4
34080, 당진시,055005, 54세,2018,2356,1336,1020,131,2228,1258,970,129.7
34080, 당진시,060,55~59세,2018,13000,6944,6056,114.7,12528,6689,5839,114.6
34080, 당진시,060001, 55세,2018,2398,1328,1070,124.1,2269,1254,1015,123.5
34080, 당진시,060002, 56세,2018,2586,1398,1188,117.7,2484,1346,1138,118.3
34080, 당진시,060003, 57세,2018,2829,1491,1338,111.4,2758,1450,1308,110.9
34080, 당진시,060004, 58세,2018,2789,1457,1332,109.4,2689,1411,1278,110.4
34080, 당진시,060005, 59세,2018,2398,1270,1128,112.6,2328,1228,1100,111.6
34080, 당진시,065,60~64세,2018,10598,5403,5195,104,10305,5232,5073,103.1
34080, 당진시,065001, 60세,2018,2228,1161,1067,108.8,2166,1121,1045,107.3
34080, 당진시,065002, 61세,2018,2284,1204,1080,111.5,2206,1157,1049,110.3
34080, 당진시,065003, 62세,2018,2139,1075,1064,101,2085,1041,1044,99.7
34080, 당진시,065004, 63세,2018,2181,1100,1081,101.8,2133,1075,1058,101.6
34080, 당진시,065005, 64세,2018,1766,863,903,95.6,1715,838,877,95.6
34080, 당진시,070,65~69세,2018,7913,3923,3990,98.3,7772,3840,3932,97.7
34080, 당진시,070001, 65세,2018,1502,752,750,100.3,1459,728,731,99.6
34080, 당진시,070002, 66세,2018,1816,910,906,100.4,1778,889,889,100
34080, 당진시,070003, 67세,2018,1381,704,677,104,1356,687,669,102.7
34080, 당진시,070004, 68세,2018,1629,764,865,88.3,1610,752,858,87.6
34080, 당진시,070005, 69세,2018,1585,793,792,100.1,1569,784,785,99.9
34080, 당진시,075,70~74세,2018,6135,3010,3125,96.3,6090,2994,3096,96.7
34080, 당진시,075001, 70세,2018,1454,720,734,98.1,1443,715,728,98.2
34080, 당진시,075002, 71세,2018,1470,748,722,103.6,1461,746,715,104.3
34080, 당진시,075003, 72세,2018,1065,525,540,97.2,1055,522,533,97.9
34080, 당진시,075004, 73세,2018,1017,506,511,99,1013,504,509,99
34080, 당진시,075005, 74세,2018,1129,511,618,82.7,1118,507,611,83
34080, 당진시,080,75~79세,2018,6210,2652,3558,74.5,6180,2639,3541,74.5
34080, 당진시,080001, 75세,2018,1163,544,619,87.9,1151,537,614,87.5
34080, 당진시,080002, 76세,2018,1610,692,918,75.4,1607,691,916,75.4
34080, 당진시,080003, 77세,2018,1152,486,666,73,1145,483,662,73
34080, 당진시,080004, 78세,2018,1076,444,632,70.3,1071,443,628,70.5
34080, 당진시,080005, 79세,2018,1209,486,723,67.2,1206,485,721,67.3
34080, 당진시,085,80~84세,2018,4874,1847,3027,61,4858,1843,3015,61.1
34080, 당진시,085001, 80세,2018,1160,474,686,69.1,1157,473,684,69.2
34080, 당진시,085002, 81세,2018,1034,378,656,57.6,1030,377,653,57.7
34080, 당진시,085003, 82세,2018,995,383,612,62.6,990,383,607,63.1
34080, 당진시,085004, 83세,2018,931,330,601,54.9,929,328,601,54.6
34080, 당진시,085005, 84세,2018,754,282,472,59.7,752,282,470,60
34080, 당진시,090,85~89세,2018,2178,632,1546,40.9,2169,628,1541,40.8
34080, 당진시,090001, 85세,2018,620,199,421,47.3,618,198,420,47.1
34080, 당진시,090002, 86세,2018,529,155,374,41.4,529,155,374,41.4
34080, 당진시,090003, 87세,2018,353,97,256,37.9,351,96,255,37.6
34080, 당진시,090004, 88세,2018,375,106,269,39.4,372,105,267,39.3
34080, 당진시,090005, 89세,2018,301,75,226,33.2,299,74,225,32.9
34080, 당진시,095,90~94세,2018,692,197,495,39.8,691,196,495,39.6
34080, 당진시,095001, 90세,2018,255,77,178,43.3,255,77,178,43.3
34080, 당진시,095002, 91세,2018,155,44,111,39.6,154,43,111,38.7
34080, 당진시,095003, 92세,2018,100,31,69,44.9,100,31,69,44.9
34080, 당진시,095004, 93세,2018,92,29,63,46,92,29,63,46
34080, 당진시,095005, 94세,2018,90,16,74,21.6,90,16,74,21.6
34080, 당진시,100,95~99세,2018,193,27,166,16.3,193,27,166,16.3
34080, 당진시,100001, 95세,2018,68,10,58,17.2,68,10,58,17.2
34080, 당진시,100002, 96세,2018,57,7,50,14,57,7,50,14
34080, 당진시,100003, 97세,2018,34,5,29,17.2,34,5,29,17.2
34080, 당진시,100004, 98세,2018,23,X,21,9.5,23,X,21,9.5
34080, 당진시,100005, 99세,2018,11,X,8,37.5,11,X,8,37.5
34080, 당진시,101,100세이상,2018,17,X,16,6.3,17,X,16,6.3
34080, 당진시,102,15세미만,2018,25117,12962,12155,106.6,24945,12869,12076,106.6
34080, 당진시,103,15~64세,2018,116636,65496,51140,128.1,109084,60400,48684,124.1
34080, 당진시,104,65세이상,2018,28212,12289,15923,77.2,27970,12168,15802,77
34080, 당진시,086,85세이상,2018,3080,857,2223,38.6,3070,852,2218,38.4
34080, 당진시,126,평균연령,2018,42.1,40.8,43.6,,42.3,41,43.7,
34080, 당진시,127,중위연령,2018,42.2,40.9,44,,42.8,41.5,44.3,
34310, 금산군,000,합계,2018,55015,27627,27388,100.9,52184,26171,26013,100.6
34310, 금산군,005,0~4세,2018,1249,609,640,95.2,1243,606,637,95.1
34310, 금산군,005001, 0세,2018,215,95,120,79.2,214,95,119,79.8
34310, 금산군,005002, 1세,2018,236,117,119,98.3,235,117,118,99.2
34310, 금산군,005003, 2세,2018,250,127,123,103.3,250,127,123,103.3
34310, 금산군,005004, 3세,2018,274,134,140,95.7,272,132,140,94.3
34310, 금산군,005005, 4세,2018,274,136,138,98.6,272,135,137,98.5
34310, 금산군,010,5~9세,2018,1783,937,846,110.8,1777,934,843,110.8
34310, 금산군,010001, 5세,2018,310,174,136,127.9,310,174,136,127.9
34310, 금산군,010002, 6세,2018,326,181,145,124.8,325,180,145,124.1
34310, 금산군,010003, 7세,2018,388,188,200,94,388,188,200,94
34310, 금산군,010004, 8세,2018,403,213,190,112.1,401,212,189,112.2
34310, 금산군,010005, 9세,2018,356,181,175,103.4,353,180,173,104
34310, 금산군,015,10~14세,2018,1978,1038,940,110.4,1977,1038,939,110.5
34310, 금산군,015001, 10세,2018,389,219,170,128.8,388,219,169,129.6
34310, 금산군,015002, 11세,2018,442,220,222,99.1,442,220,222,99.1
34310, 금산군,015003, 12세,2018,351,186,165,112.7,351,186,165,112.7
34310, 금산군,015004, 13세,2018,397,203,194,104.6,397,203,194,104.6
34310, 금산군,015005, 14세,2018,399,210,189,111.1,399,210,189,111.1
34310, 금산군,020,15~19세,2018,3203,1690,1513,111.7,3058,1607,1451,110.8
34310, 금산군,020001, 15세,2018,433,216,217,99.5,432,215,217,99.1
34310, 금산군,020002, 16세,2018,435,229,206,111.2,434,229,205,111.7
34310, 금산군,020003, 17세,2018,556,298,258,115.5,553,296,257,115.2
34310, 금산군,020004, 18세,2018,735,400,335,119.4,710,383,327,117.1
34310, 금산군,020005, 19세,2018,1044,547,497,110.1,929,484,445,108.8
34310, 금산군,025,20~24세,2018,4469,2476,1993,124.2,3613,2029,1584,128.1
34310, 금산군,025001, 20세,2018,980,470,510,92.2,787,351,436,80.5
34310, 금산군,025002, 21세,2018,918,447,471,94.9,747,356,391,91
34310, 금산군,025003, 22세,2018,938,494,444,111.3,774,420,354,118.6
34310, 금산군,025004, 23세,2018,840,547,293,186.7,691,477,214,222.9
34310, 금산군,025005, 24세,2018,793,518,275,188.4,614,425,189,224.9
34310, 금산군,030,25~29세,2018,2483,1405,1078,130.3,1899,1117,782,142.8
34310, 금산군,030001, 25세,2018,582,348,234,148.7,439,269,170,158.2
34310, 금산군,030002, 26세,2018,524,305,219,139.3,397,239,158,151.3
34310, 금산군,030003, 27세,2018,462,244,218,111.9,353,202,151,133.8
34310, 금산군,030004, 28세,2018,480,258,222,116.2,368,206,162,127.2
34310, 금산군,030005, 29세,2018,435,250,185,135.1,342,201,141,142.6
34310, 금산군,035,30~34세,2018,2105,1117,988,113.1,1735,928,807,115
34310, 금산군,035001, 30세,2018,456,248,208,119.2,357,199,158,125.9
34310, 금산군,035002, 31세,2018,379,203,176,115.3,312,163,149,109.4
34310, 금산군,035003, 32세,2018,423,219,204,107.4,356,189,167,113.2
34310, 금산군,035004, 33세,2018,402,214,188,113.8,332,180,152,118.4
34310, 금산군,035005, 34세,2018,445,233,212,109.9,378,197,181,108.8
34310, 금산군,040,35~39세,2018,2747,1464,1283,114.1,2459,1312,1147,114.4
34310, 금산군,040001, 35세,2018,467,251,216,116.2,405,214,191,112
34310, 금산군,040002, 36세,2018,555,290,265,109.4,494,263,231,113.9
34310, 금산군,040003, 37세,2018,587,317,270,117.4,524,283,241,117.4
34310, 금산군,040004, 38세,2018,558,291,267,109,520,277,243,114
34310, 금산군,040005, 39세,2018,580,315,265,118.9,516,275,241,114.1
34310, 금산군,045,40~44세,2018,2916,1615,1301,124.1,2752,1528,1224,124.8
34310, 금산군,045001, 40세,2018,520,286,234,122.2,487,270,217,124.4
34310, 금산군,045002, 41세,2018,548,300,248,121,516,283,233,121.5
34310, 금산군,045003, 42세,2018,581,301,280,107.5,546,281,265,106
34310, 금산군,045004, 43세,2018,625,361,264,136.7,589,341,248,137.5
34310, 금산군,045005, 44세,2018,642,367,275,133.5,614,353,261,135.2
34310, 금산군,050,45~49세,2018,3763,2104,1659,126.8,3619,2033,1586,128.2
34310, 금산군,050001, 45세,2018,699,388,311,124.8,666,367,299,122.7
34310, 금산군,050002, 46세,2018,695,399,296,134.8,668,388,280,138.6
34310, 금산군,050003, 47세,2018,797,435,362,120.2,766,420,346,121.4
34310, 금산군,050004, 48세,2018,806,443,363,122,772,430,342,125.7
34310, 금산군,050005, 49세,2018,766,439,327,134.3,747,428,319,134.2
34310, 금산군,055,50~54세,2018,4050,2158,1892,114.1,3931,2096,1835,114.2
34310, 금산군,055001, 50세,2018,790,418,372,112.4,766,409,357,114.6
34310, 금산군,055002, 51세,2018,858,446,412,108.3,833,431,402,107.2
34310, 금산군,055003, 52세,2018,729,398,331,120.2,705,381,324,117.6
34310, 금산군,055004, 53세,2018,859,470,389,120.8,835,460,375,122.7
34310, 금산군,055005, 54세,2018,814,426,388,109.8,792,415,377,110.1
34310, 금산군,060,55~59세,2018,4933,2549,2384,106.9,4861,2515,2346,107.2
34310, 금산군,060001, 55세,2018,861,471,390,120.8,844,462,382,120.9
34310, 금산군,060002, 56세,2018,918,501,417,120.1,904,493,411,120
34310, 금산군,060003, 57세,2018,1102,585,517,113.2,1084,577,507,113.8
34310, 금산군,060004, 58세,2018,1134,557,577,96.5,1121,550,571,96.3
34310, 금산군,060005, 59세,2018,918,435,483,90.1,908,433,475,91.2
34310, 금산군,065,60~64세,2018,4834,2459,2375,103.5,4786,2433,2353,103.4
34310, 금산군,065001, 60세,2018,972,465,507,91.7,961,458,503,91.1
34310, 금산군,065002, 61세,2018,1024,558,466,119.7,1017,556,461,120.6
34310, 금산군,065003, 62세,2018,919,479,440,108.9,912,474,438,108.2
34310, 금산군,065004, 63세,2018,963,472,491,96.1,948,464,484,95.9
34310, 금산군,065005, 64세,2018,956,485,471,103,948,481,467,103
34310, 금산군,070,65~69세,2018,3738,1850,1888,98,3721,1842,1879,98
34310, 금산군,070001, 65세,2018,712,331,381,86.9,706,328,378,86.8
34310, 금산군,070002, 66세,2018,861,437,424,103.1,859,437,422,103.6
34310, 금산군,070003, 67세,2018,690,332,358,92.7,685,329,356,92.4
34310, 금산군,070004, 68세,2018,756,381,375,101.6,754,380,374,101.6
34310, 금산군,070005, 69세,2018,719,369,350,105.4,717,368,349,105.4
34310, 금산군,075,70~74세,2018,3138,1433,1705,84,3132,1432,1700,84.2
34310, 금산군,075001, 70세,2018,715,339,376,90.2,713,339,374,90.6
34310, 금산군,075002, 71세,2018,735,345,390,88.5,733,345,388,88.9
34310, 금산군,075003, 72세,2018,569,281,288,97.6,569,281,288,97.6
34310, 금산군,075004, 73세,2018,543,227,316,71.8,543,227,316,71.8
34310, 금산군,075005, 74세,2018,576,241,335,71.9,574,240,334,71.9
34310, 금산군,080,75~79세,2018,3472,1372,2100,65.3,3469,1371,2098,65.3
34310, 금산군,080001, 75세,2018,681,285,396,72,681,285,396,72
34310, 금산군,080002, 76세,2018,895,375,520,72.1,893,374,519,72.1
34310, 금산군,080003, 77세,2018,597,228,369,61.8,596,228,368,62
34310, 금산군,080004, 78세,2018,625,235,390,60.3,625,235,390,60.3
34310, 금산군,080005, 79세,2018,674,249,425,58.6,674,249,425,58.6
34310, 금산군,085,80~84세,2018,2552,904,1648,54.9,2551,904,1647,54.9
34310, 금산군,085001, 80세,2018,627,231,396,58.3,626,231,395,58.5
34310, 금산군,085002, 81세,2018,503,186,317,58.7,503,186,317,58.7
34310, 금산군,085003, 82세,2018,520,180,340,52.9,520,180,340,52.9
34310, 금산군,085004, 83세,2018,498,170,328,51.8,498,170,328,51.8
34310, 금산군,085005, 84세,2018,404,137,267,51.3,404,137,267,51.3
34310, 금산군,090,85~89세,2018,1171,352,819,43,1170,351,819,42.9
34310, 금산군,090001, 85세,2018,337,110,227,48.5,336,109,227,48
34310, 금산군,090002, 86세,2018,315,102,213,47.9,315,102,213,47.9
34310, 금산군,090003, 87세,2018,210,62,148,41.9,210,62,148,41.9
34310, 금산군,090004, 88세,2018,183,37,146,25.3,183,37,146,25.3
34310, 금산군,090005, 89세,2018,126,41,85,48.2,126,41,85,48.2
34310, 금산군,095,90~94세,2018,342,80,262,30.5,342,80,262,30.5
34310, 금산군,095001, 90세,2018,117,25,92,27.2,117,25,92,27.2
34310, 금산군,095002, 91세,2018,104,27,77,35.1,104,27,77,35.1
34310, 금산군,095003, 92세,2018,50,14,36,38.9,50,14,36,38.9
34310, 금산군,095004, 93세,2018,47,8,39,20.5,47,8,39,20.5
34310, 금산군,095005, 94세,2018,24,6,18,33.3,24,6,18,33.3
34310, 금산군,100,95~99세,2018,82,13,69,18.8,82,13,69,18.8
34310, 금산군,100001, 95세,2018,35,6,29,20.7,35,6,29,20.7
34310, 금산군,100002, 96세,2018,22,X,19,15.8,22,X,19,15.8
34310, 금산군,100003, 97세,2018,11,X,9,22.2,11,X,9,22.2
34310, 금산군,100004, 98세,2018,10,X,8,25,10,X,8,25
34310, 금산군,100005, 99세,2018,X,X,X,0,X,X,X,0
34310, 금산군,101,100세이상,2018,7,X,5,40,7,X,5,40
34310, 금산군,102,15세미만,2018,5010,2584,2426,106.5,4997,2578,2419,106.6
34310, 금산군,103,15~64세,2018,35503,19037,16466,115.6,32713,17598,15115,116.4
34310, 금산군,104,65세이상,2018,14502,6006,8496,70.7,14474,5995,8479,70.7
34310, 금산군,086,85세이상,2018,1602,447,1155,38.7,1601,446,1155,38.6
34310, 금산군,126,평균연령,2018,48,45.9,50.1,,48.9,46.7,51.1,
34310, 금산군,127,중위연령,2018,51,48.5,53.9,,52.5,49.9,55.4,
34330, 부여군,000,합계,2018,66527,32997,33530,98.4,64769,32053,32716,98
34330, 부여군,005,0~4세,2018,1430,722,708,102,1425,721,704,102.4
34330, 부여군,005001, 0세,2018,226,113,113,100,225,113,112,100.9
34330, 부여군,005002, 1세,2018,253,129,124,104,252,129,123,104.9
34330, 부여군,005003, 2세,2018,295,145,150,96.7,295,145,150,96.7
34330, 부여군,005004, 3세,2018,327,164,163,100.6,325,164,161,101.9
34330, 부여군,005005, 4세,2018,329,171,158,108.2,328,170,158,107.6
34330, 부여군,010,5~9세,2018,1863,1013,850,119.2,1861,1011,850,118.9
34330, 부여군,010001, 5세,2018,339,182,157,115.9,339,182,157,115.9
34330, 부여군,010002, 6세,2018,393,209,184,113.6,392,208,184,113
34330, 부여군,010003, 7세,2018,359,200,159,125.8,359,200,159,125.8
34330, 부여군,010004, 8세,2018,402,218,184,118.5,401,217,184,117.9
34330, 부여군,010005, 9세,2018,370,204,166,122.9,370,204,166,122.9
34330, 부여군,015,10~14세,2018,2214,1155,1059,109.1,2213,1155,1058,109.2
34330, 부여군,015001, 10세,2018,414,204,210,97.1,414,204,210,97.1
34330, 부여군,015002, 11세,2018,426,227,199,114.1,425,227,198,114.6
34330, 부여군,015003, 12세,2018,448,236,212,111.3,448,236,212,111.3
34330, 부여군,015004, 13세,2018,467,236,231,102.2,467,236,231,102.2
34330, 부여군,015005, 14세,2018,459,252,207,121.7,459,252,207,121.7
34330, 부여군,020,15~19세,2018,2976,1603,1373,116.8,2959,1599,1360,117.6
34330, 부여군,020001, 15세,2018,544,304,240,126.7,544,304,240,126.7
34330, 부여군,020002, 16세,2018,560,306,254,120.5,559,306,253,120.9
34330, 부여군,020003, 17세,2018,619,344,275,125.1,618,344,274,125.5
34330, 부여군,020004, 18세,2018,707,352,355,99.2,704,350,354,98.9
34330, 부여군,020005, 19세,2018,546,297,249,119.3,534,295,239,123.4
34330, 부여군,025,20~24세,2018,3448,1977,1471,134.4,3262,1861,1401,132.8
34330, 부여군,025001, 20세,2018,643,379,264,143.6,628,372,256,145.3
34330, 부여군,025002, 21세,2018,685,413,272,151.8,658,394,264,149.2
34330, 부여군,025003, 22세,2018,724,391,333,117.4,691,371,320,115.9
34330, 부여군,025004, 23세,2018,695,384,311,123.5,646,358,288,124.3
34330, 부여군,025005, 24세,2018,701,410,291,140.9,639,366,273,134.1
34330, 부여군,030,25~29세,2018,2789,1574,1215,129.5,2381,1337,1044,128.1
34330, 부여군,030001, 25세,2018,606,333,273,122,529,294,235,125.1
34330, 부여군,030002, 26세,2018,619,359,260,138.1,540,308,232,132.8
34330, 부여군,030003, 27세,2018,536,288,248,116.1,461,244,217,112.4
34330, 부여군,030004, 28세,2018,556,325,231,140.7,459,269,190,141.6
34330, 부여군,030005, 29세,2018,472,269,203,132.5,392,222,170,130.6
34330, 부여군,035,30~34세,2018,2470,1338,1132,118.2,2092,1136,956,118.8
34330, 부여군,035001, 30세,2018,493,288,205,140.5,409,236,173,136.4
34330, 부여군,035002, 31세,2018,510,275,235,117,437,237,200,118.5
34330, 부여군,035003, 32세,2018,483,252,231,109.1,403,214,189,113.2
34330, 부여군,035004, 33세,2018,503,272,231,117.7,422,230,192,119.8
34330, 부여군,035005, 34세,2018,481,251,230,109.1,421,219,202,108.4
34330, 부여군,040,35~39세,2018,2885,1585,1300,121.9,2664,1475,1189,124.1
34330, 부여군,040001, 35세,2018,560,311,249,124.9,507,282,225,125.3
34330, 부여군,040002, 36세,2018,561,308,253,121.7,513,282,231,122.1
34330, 부여군,040003, 37세,2018,576,320,256,125,534,303,231,131.2
34330, 부여군,040004, 38세,2018,623,342,281,121.7,583,322,261,123.4
34330, 부여군,040005, 39세,2018,565,304,261,116.5,527,286,241,118.7
34330, 부여군,045,40~44세,2018,3422,1858,1564,118.8,3271,1785,1486,120.1
34330, 부여군,045001, 40세,2018,614,341,273,124.9,586,330,256,128.9
34330, 부여군,045002, 41세,2018,641,333,308,108.1,612,317,295,107.5
34330, 부여군,045003, 42세,2018,657,359,298,120.5,630,345,285,121.1
34330, 부여군,045004, 43세,2018,707,388,319,121.6,676,374,302,123.8
34330, 부여군,045005, 44세,2018,803,437,366,119.4,767,419,348,120.4
34330, 부여군,050,45~49세,2018,4367,2364,2003,118,4241,2295,1946,117.9
34330, 부여군,050001, 45세,2018,818,465,353,131.7,789,448,341,131.4
34330, 부여군,050002, 46세,2018,820,449,371,121,791,428,363,117.9
34330, 부여군,050003, 47세,2018,907,496,411,120.7,883,486,397,122.4
34330, 부여군,050004, 48세,2018,859,460,399,115.3,839,452,387,116.8
34330, 부여군,050005, 49세,2018,963,494,469,105.3,939,481,458,105
34330, 부여군,055,50~54세,2018,4890,2584,2306,112.1,4776,2523,2253,112
34330, 부여군,055001, 50세,2018,989,537,452,118.8,963,524,439,119.4
34330, 부여군,055002, 51세,2018,934,504,430,117.2,915,496,419,118.4
34330, 부여군,055003, 52세,2018,882,466,416,112,862,454,408,111.3
34330, 부여군,055004, 53세,2018,1043,555,488,113.7,1023,544,479,113.6
34330, 부여군,055005, 54세,2018,1042,522,520,100.4,1013,505,508,99.4
34330, 부여군,060,55~59세,2018,6465,3193,3272,97.6,6380,3155,3225,97.8
34330, 부여군,060001, 55세,2018,1043,507,536,94.6,1023,499,524,95.2
34330, 부여군,060002, 56세,2018,1204,627,577,108.7,1187,620,567,109.3
34330, 부여군,060003, 57세,2018,1440,721,719,100.3,1423,712,711,100.1
34330, 부여군,060004, 58세,2018,1485,704,781,90.1,1462,693,769,90.1
34330, 부여군,060005, 59세,2018,1293,634,659,96.2,1285,631,654,96.5
34330, 부여군,065,60~64세,2018,6585,3337,3248,102.7,6548,3317,3231,102.7
34330, 부여군,065001, 60세,2018,1285,646,639,101.1,1278,643,635,101.3
34330, 부여군,065002, 61세,2018,1350,716,634,112.9,1340,708,632,112
34330, 부여군,065003, 62세,2018,1372,705,667,105.7,1364,700,664,105.4
34330, 부여군,065004, 63세,2018,1338,659,679,97.1,1333,657,676,97.2
34330, 부여군,065005, 64세,2018,1240,611,629,97.1,1233,609,624,97.6
34330, 부여군,070,65~69세,2018,5239,2543,2696,94.3,5221,2534,2687,94.3
34330, 부여군,070001, 65세,2018,973,467,506,92.3,968,465,503,92.4
34330, 부여군,070002, 66세,2018,1096,545,551,98.9,1093,543,550,98.7
34330, 부여군,070003, 67세,2018,937,461,476,96.8,933,458,475,96.4
34330, 부여군,070004, 68세,2018,1097,537,560,95.9,1092,535,557,96.1
34330, 부여군,070005, 69세,2018,1136,533,603,88.4,1135,533,602,88.5
34330, 부여군,075,70~74세,2018,4308,2022,2286,88.5,4303,2020,2283,88.5
34330, 부여군,075001, 70세,2018,985,467,518,90.2,984,467,517,90.3
34330, 부여군,075002, 71세,2018,977,461,516,89.3,977,461,516,89.3
34330, 부여군,075003, 72세,2018,678,346,332,104.2,676,346,330,104.8
34330, 부여군,075004, 73세,2018,806,386,420,91.9,805,385,420,91.7
34330, 부여군,075005, 74세,2018,862,362,500,72.4,861,361,500,72.2
34330, 부여군,080,75~79세,2018,4681,1933,2748,70.3,4678,1933,2745,70.4
34330, 부여군,080001, 75세,2018,871,389,482,80.7,871,389,482,80.7
34330, 부여군,080002, 76세,2018,1116,473,643,73.6,1115,473,642,73.7
34330, 부여군,080003, 77세,2018,936,387,549,70.5,935,387,548,70.6
34330, 부여군,080004, 78세,2018,835,339,496,68.3,835,339,496,68.3
34330, 부여군,080005, 79세,2018,923,345,578,59.7,922,345,577,59.8
34330, 부여군,085,80~84세,2018,3793,1389,2404,57.8,3793,1389,2404,57.8
34330, 부여군,085001, 80세,2018,837,306,531,57.6,837,306,531,57.6
34330, 부여군,085002, 81세,2018,817,308,509,60.5,817,308,509,60.5
34330, 부여군,085003, 82세,2018,762,292,470,62.1,762,292,470,62.1
34330, 부여군,085004, 83세,2018,754,257,497,51.7,754,257,497,51.7
34330, 부여군,085005, 84세,2018,623,226,397,56.9,623,226,397,56.9
34330, 부여군,090,85~89세,2018,1894,624,1270,49.1,1893,624,1269,49.2
34330, 부여군,090001, 85세,2018,531,191,340,56.2,530,191,339,56.3
34330, 부여군,090002, 86세,2018,477,167,310,53.9,477,167,310,53.9
34330, 부여군,090003, 87세,2018,337,94,243,38.7,337,94,243,38.7
34330, 부여군,090004, 88세,2018,307,102,205,49.8,307,102,205,49.8
34330, 부여군,090005, 89세,2018,242,70,172,40.7,242,70,172,40.7
34330, 부여군,095,90~94세,2018,660,159,501,31.7,660,159,501,31.7
34330, 부여군,095001, 90세,2018,235,73,162,45.1,235,73,162,45.1
34330, 부여군,095002, 91세,2018,158,33,125,26.4,158,33,125,26.4
34330, 부여군,095003, 92세,2018,127,27,100,27,127,27,100,27
34330, 부여군,095004, 93세,2018,93,17,76,22.4,93,17,76,22.4
34330, 부여군,095005, 94세,2018,47,9,38,23.7,47,9,38,23.7
34330, 부여군,100,95~99세,2018,132,22,110,20,132,22,110,20
34330, 부여군,100001, 95세,2018,54,9,45,20,54,9,45,20
34330, 부여군,100002, 96세,2018,31,X,27,14.8,31,X,27,14.8
34330, 부여군,100003, 97세,2018,25,9,16,56.3,25,9,16,56.3
34330, 부여군,100004, 98세,2018,12,X,12,0,12,X,12,0
34330, 부여군,100005, 99세,2018,10,X,10,0,10,X,10,0
34330, 부여군,101,100세이상,2018,16,X,14,14.3,16,X,14,14.3
34330, 부여군,102,15세미만,2018,5507,2890,2617,110.4,5499,2887,2612,110.5
34330, 부여군,103,15~64세,2018,40297,21413,18884,113.4,38574,20483,18091,113.2
34330, 부여군,104,65세이상,2018,20723,8694,12029,72.3,20696,8683,12013,72.3
34330, 부여군,086,85세이상,2018,2702,807,1895,42.6,2701,807,1894,42.6
34330, 부여군,126,평균연령,2018,51.3,49,53.7,,51.8,49.4,54.1,
34330, 부여군,127,중위연령,2018,55.5,52.6,57.9,,56.2,53.3,58.4,
34340, 서천군,000,합계,2018,52604,26272,26332,99.8,50793,24951,25842,96.6
34340, 서천군,005,0~4세,2018,1136,578,558,103.6,1134,576,558,103.2
34340, 서천군,005001, 0세,2018,195,108,87,124.1,195,108,87,124.1
34340, 서천군,005002, 1세,2018,202,94,108,87,202,94,108,87
34340, 서천군,005003, 2세,2018,232,117,115,101.7,232,117,115,101.7
34340, 서천군,005004, 3세,2018,244,122,122,100,244,122,122,100
34340, 서천군,005005, 4세,2018,263,137,126,108.7,261,135,126,107.1
34340, 서천군,010,5~9세,2018,1463,737,726,101.5,1457,735,722,101.8
34340, 서천군,010001, 5세,2018,275,132,143,92.3,274,132,142,93
34340, 서천군,010002, 6세,2018,291,141,150,94,290,140,150,93.3
34340, 서천군,010003, 7세,2018,307,160,147,108.8,306,160,146,109.6
34340, 서천군,010004, 8세,2018,311,152,159,95.6,309,152,157,96.8
34340, 서천군,010005, 9세,2018,279,152,127,119.7,278,151,127,118.9
34340, 서천군,015,10~14세,2018,1596,794,802,99,1591,791,800,98.9
34340, 서천군,015001, 10세,2018,313,158,155,101.9,311,157,154,101.9
34340, 서천군,015002, 11세,2018,317,150,167,89.8,316,150,166,90.4
34340, 서천군,015003, 12세,2018,304,156,148,105.4,304,156,148,105.4
34340, 서천군,015004, 13세,2018,329,166,163,101.8,328,165,163,101.2
34340, 서천군,015005, 14세,2018,333,164,169,97,332,163,169,96.4
34340, 서천군,020,15~19세,2018,2070,1113,957,116.3,2055,1103,952,115.9
34340, 서천군,020001, 15세,2018,396,201,195,103.1,394,201,193,104.1
34340, 서천군,020002, 16세,2018,412,234,178,131.5,411,233,178,130.9
34340, 서천군,020003, 17세,2018,487,260,227,114.5,481,255,226,112.8
34340, 서천군,020004, 18세,2018,453,235,218,107.8,450,232,218,106.4
34340, 서천군,020005, 19세,2018,322,183,139,131.7,319,182,137,132.8
34340, 서천군,025,20~24세,2018,2092,1341,751,178.6,1883,1180,703,167.9
34340, 서천군,025001, 20세,2018,383,268,115,233,370,259,111,233.3
34340, 서천군,025002, 21세,2018,417,274,143,191.6,395,258,137,188.3
34340, 서천군,025003, 22세,2018,398,252,146,172.6,356,220,136,161.8
34340, 서천군,025004, 23세,2018,466,285,181,157.5,398,230,168,136.9
34340, 서천군,025005, 24세,2018,428,262,166,157.8,364,213,151,141.1
34340, 서천군,030,25~29세,2018,2182,1325,857,154.6,1727,979,748,130.9
34340, 서천군,030001, 25세,2018,471,282,189,149.2,391,218,173,126
34340, 서천군,030002, 26세,2018,439,270,169,159.8,351,200,151,132.5
34340, 서천군,030003, 27세,2018,473,293,180,162.8,355,208,147,141.5
34340, 서천군,030004, 28세,2018,388,226,162,139.5,311,174,137,127
34340, 서천군,030005, 29세,2018,411,254,157,161.8,319,179,140,127.9
34340, 서천군,035,30~34세,2018,1937,1183,754,156.9,1575,913,662,137.9
34340, 서천군,035001, 30세,2018,375,230,145,158.6,286,163,123,132.5
34340, 서천군,035002, 31세,2018,383,253,130,194.6,307,196,111,176.6
34340, 서천군,035003, 32세,2018,401,243,158,153.8,336,192,144,133.3
34340, 서천군,035004, 33세,2018,362,224,138,162.3,294,172,122,141
34340, 서천군,035005, 34세,2018,416,233,183,127.3,352,190,162,117.3
34340, 서천군,040,35~39세,2018,2450,1395,1055,132.2,2195,1203,992,121.3
34340, 서천군,040001, 35세,2018,450,254,196,129.6,388,214,174,123
34340, 서천군,040002, 36세,2018,502,293,209,140.2,443,246,197,124.9
34340, 서천군,040003, 37세,2018,503,295,208,141.8,452,255,197,129.4
34340, 서천군,040004, 38세,2018,501,278,223,124.7,462,246,216,113.9
34340, 서천군,040005, 39세,2018,494,275,219,125.6,450,242,208,116.3
34340, 서천군,045,40~44세,2018,2745,1549,1196,129.5,2553,1399,1154,121.2
34340, 서천군,045001, 40세,2018,479,285,194,146.9,434,245,189,129.6
34340, 서천군,045002, 41세,2018,508,278,230,120.9,471,249,222,112.2
34340, 서천군,045003, 42세,2018,566,347,219,158.4,533,321,212,151.4
34340, 서천군,045004, 43세,2018,549,301,248,121.4,513,277,236,117.4
34340, 서천군,045005, 44세,2018,643,338,305,110.8,602,307,295,104.1
34340, 서천군,050,45~49세,2018,3607,2014,1593,126.4,3455,1912,1543,123.9
34340, 서천군,050001, 45세,2018,654,366,288,127.1,614,341,273,124.9
34340, 서천군,050002, 46세,2018,650,347,303,114.5,625,331,294,112.6
34340, 서천군,050003, 47세,2018,776,441,335,131.6,746,416,330,126.1
34340, 서천군,050004, 48세,2018,753,420,333,126.1,727,405,322,125.8
34340, 서천군,050005, 49세,2018,774,440,334,131.7,743,419,324,129.3
34340, 서천군,055,50~54세,2018,3729,1997,1732,115.3,3663,1958,1705,114.8
34340, 서천군,055001, 50세,2018,744,378,366,103.3,725,367,358,102.5
34340, 서천군,055002, 51세,2018,758,410,348,117.8,738,397,341,116.4
34340, 서천군,055003, 52세,2018,634,353,281,125.6,626,348,278,125.2
34340, 서천군,055004, 53세,2018,824,430,394,109.1,816,427,389,109.8
34340, 서천군,055005, 54세,2018,769,426,343,124.2,758,419,339,123.6
34340, 서천군,060,55~59세,2018,4941,2509,2432,103.2,4901,2491,2410,103.4
34340, 서천군,060001, 55세,2018,827,463,364,127.2,813,458,355,129
34340, 서천군,060002, 56세,2018,954,510,444,114.9,950,510,440,115.9
34340, 서천군,060003, 57세,2018,1018,491,527,93.2,1010,487,523,93.1
34340, 서천군,060004, 58세,2018,1100,527,573,92,1089,520,569,91.4
34340, 서천군,060005, 59세,2018,1042,518,524,98.9,1039,516,523,98.7
34340, 서천군,065,60~64세,2018,5104,2511,2593,96.8,5075,2492,2583,96.5
34340, 서천군,065001, 60세,2018,1006,472,534,88.4,1002,470,532,88.3
34340, 서천군,065002, 61세,2018,955,500,455,109.9,944,494,450,109.8
34340, 서천군,065003, 62세,2018,1003,506,497,101.8,1000,504,496,101.6
34340, 서천군,065004, 63세,2018,1118,567,551,102.9,1111,561,550,102
34340, 서천군,065005, 64세,2018,1022,466,556,83.8,1018,463,555,83.4
34340, 서천군,070,65~69세,2018,4288,2033,2255,90.2,4278,2030,2248,90.3
34340, 서천군,070001, 65세,2018,753,344,409,84.1,749,342,407,84
34340, 서천군,070002, 66세,2018,935,445,490,90.8,935,445,490,90.8
34340, 서천군,070003, 67세,2018,815,394,421,93.6,813,393,420,93.6
34340, 서천군,070004, 68세,2018,926,444,482,92.1,924,444,480,92.5
34340, 서천군,070005, 69세,2018,859,406,453,89.6,857,406,451,90
34340, 서천군,075,70~74세,2018,3791,1775,2016,88,3785,1773,2012,88.1
34340, 서천군,075001, 70세,2018,897,429,468,91.7,896,429,467,91.9
34340, 서천군,075002, 71세,2018,966,482,484,99.6,965,481,484,99.4
34340, 서천군,075003, 72세,2018,589,271,318,85.2,588,271,317,85.5
34340, 서천군,075004, 73세,2018,666,317,349,90.8,665,317,348,91.1
34340, 서천군,075005, 74세,2018,673,276,397,69.5,671,275,396,69.4
34340, 서천군,080,75~79세,2018,4007,1572,2435,64.6,4006,1571,2435,64.5
34340, 서천군,080001, 75세,2018,818,320,498,64.3,818,320,498,64.3
34340, 서천군,080002, 76세,2018,950,398,552,72.1,950,398,552,72.1
34340, 서천군,080003, 77세,2018,736,286,450,63.6,736,286,450,63.6
34340, 서천군,080004, 78세,2018,704,261,443,58.9,703,260,443,58.7
34340, 서천군,080005, 79세,2018,799,307,492,62.4,799,307,492,62.4
34340, 서천군,085,80~84세,2018,3116,1179,1937,60.9,3110,1178,1932,61
34340, 서천군,085001, 80세,2018,731,268,463,57.9,727,267,460,58
34340, 서천군,085002, 81세,2018,671,273,398,68.6,670,273,397,68.8
34340, 서천군,085003, 82세,2018,652,253,399,63.4,652,253,399,63.4
34340, 서천군,085004, 83세,2018,586,207,379,54.6,586,207,379,54.6
34340, 서천군,085005, 84세,2018,476,178,298,59.7,475,178,297,59.9
34340, 서천군,090,85~89세,2018,1711,529,1182,44.8,1711,529,1182,44.8
34340, 서천군,090001, 85세,2018,457,156,301,51.8,457,156,301,51.8
34340, 서천군,090002, 86세,2018,442,143,299,47.8,442,143,299,47.8
34340, 서천군,090003, 87세,2018,281,90,191,47.1,281,90,191,47.1
34340, 서천군,090004, 88세,2018,289,79,210,37.6,289,79,210,37.6
34340, 서천군,090005, 89세,2018,242,61,181,33.7,242,61,181,33.7
34340, 서천군,095,90~94세,2018,510,118,392,30.1,510,118,392,30.1
34340, 서천군,095001, 90세,2018,166,41,125,32.8,166,41,125,32.8
34340, 서천군,095002, 91세,2018,150,35,115,30.4,150,35,115,30.4
34340, 서천군,095003, 92세,2018,91,18,73,24.7,91,18,73,24.7
34340, 서천군,095004, 93세,2018,62,14,48,29.2,62,14,48,29.2
34340, 서천군,095005, 94세,2018,41,10,31,32.3,41,10,31,32.3
34340, 서천군,100,95~99세,2018,114,17,97,17.5,114,17,97,17.5
34340, 서천군,100001, 95세,2018,53,9,44,20.5,53,9,44,20.5
34340, 서천군,100002, 96세,2018,29,5,24,20.8,29,5,24,20.8
34340, 서천군,100003, 97세,2018,13,X,11,18.2,13,X,11,18.2
34340, 서천군,100004, 98세,2018,11,X,11,0,11,X,11,0
34340, 서천군,100005, 99세,2018,8,X,7,14.3,8,X,7,14.3
34340, 서천군,101,100세이상,2018,15,X,12,25,15,X,12,25
34340, 서천군,102,15세미만,2018,4195,2109,2086,101.1,4182,2102,2080,101.1
34340, 서천군,103,15~64세,2018,30857,16937,13920,121.7,29082,15630,13452,116.2
34340, 서천군,104,65세이상,2018,17552,7226,10326,70,17529,7219,10310,70
34340, 서천군,086,85세이상,2018,2350,667,1683,39.6,2350,667,1683,39.6
34340, 서천군,126,평균연령,2018,52.5,49.7,55.2,,53.1,50.5,55.6,
34340, 서천군,127,중위연령,2018,56.5,52.9,59.5,,57.3,54.3,59.9,
34350, 청양군,000,합계,2018,31181,15739,15442,101.9,30335,15328,15007,102.1
34350, 청양군,005,0~4세,2018,609,308,301,102.3,609,308,301,102.3
34350, 청양군,005001, 0세,2018,109,55,54,101.9,109,55,54,101.9
34350, 청양군,005002, 1세,2018,111,60,51,117.6,111,60,51,117.6
34350, 청양군,005003, 2세,2018,116,61,55,110.9,116,61,55,110.9
34350, 청양군,005004, 3세,2018,132,65,67,97,132,65,67,97
34350, 청양군,005005, 4세,2018,141,67,74,90.5,141,67,74,90.5
34350, 청양군,010,5~9세,2018,824,421,403,104.5,823,421,402,104.7
34350, 청양군,010001, 5세,2018,151,84,67,125.4,151,84,67,125.4
34350, 청양군,010002, 6세,2018,167,85,82,103.7,167,85,82,103.7
34350, 청양군,010003, 7세,2018,171,91,80,113.8,171,91,80,113.8
34350, 청양군,010004, 8세,2018,178,81,97,83.5,178,81,97,83.5
34350, 청양군,010005, 9세,2018,157,80,77,103.9,156,80,76,105.3
34350, 청양군,015,10~14세,2018,857,438,419,104.5,855,438,417,105
34350, 청양군,015001, 10세,2018,167,92,75,122.7,167,92,75,122.7
34350, 청양군,015002, 11세,2018,169,81,88,92,169,81,88,92
34350, 청양군,015003, 12세,2018,175,93,82,113.4,175,93,82,113.4
34350, 청양군,015004, 13세,2018,161,79,82,96.3,161,79,82,96.3
34350, 청양군,015005, 14세,2018,185,93,92,101.1,183,93,90,103.3
34350, 청양군,020,15~19세,2018,1452,755,697,108.3,1448,754,694,108.6
34350, 청양군,020001, 15세,2018,179,90,89,101.1,179,90,89,101.1
34350, 청양군,020002, 16세,2018,220,108,112,96.4,220,108,112,96.4
34350, 청양군,020003, 17세,2018,276,161,115,140,276,161,115,140
34350, 청양군,020004, 18세,2018,348,187,161,116.1,347,186,161,115.5
34350, 청양군,020005, 19세,2018,429,209,220,95,426,209,217,96.3
34350, 청양군,025,20~24세,2018,1771,1034,737,140.3,1663,980,683,143.5
34350, 청양군,025001, 20세,2018,424,198,226,87.6,416,193,223,86.5
34350, 청양군,025002, 21세,2018,365,227,138,164.5,354,221,133,166.2
34350, 청양군,025003, 22세,2018,347,228,119,191.6,322,216,106,203.8
34350, 청양군,025004, 23세,2018,341,203,138,147.1,310,187,123,152
34350, 청양군,025005, 24세,2018,294,178,116,153.4,261,163,98,166.3
34350, 청양군,030,25~29세,2018,1314,753,561,134.2,1122,654,468,139.7
34350, 청양군,030001, 25세,2018,276,163,113,144.2,239,146,93,157
34350, 청양군,030002, 26세,2018,269,151,118,128,233,131,102,128.4
34350, 청양군,030003, 27세,2018,268,145,123,117.9,226,118,108,109.3
34350, 청양군,030004, 28세,2018,256,149,107,139.3,212,132,80,165
34350, 청양군,030005, 29세,2018,245,145,100,145,212,127,85,149.4
34350, 청양군,035,30~34세,2018,1166,694,472,147,996,599,397,150.9
34350, 청양군,035001, 30세,2018,248,151,97,155.7,201,127,74,171.6
34350, 청양군,035002, 31세,2018,245,141,104,135.6,214,124,90,137.8
34350, 청양군,035003, 32세,2018,233,136,97,140.2,204,121,83,145.8
34350, 청양군,035004, 33세,2018,205,117,88,133,168,94,74,127
34350, 청양군,035005, 34세,2018,235,149,86,173.3,209,133,76,175
34350, 청양군,040,35~39세,2018,1252,713,539,132.3,1163,664,499,133.1
34350, 청양군,040001, 35세,2018,246,130,116,112.1,222,116,106,109.4
34350, 청양군,040002, 36세,2018,233,137,96,142.7,217,125,92,135.9
34350, 청양군,040003, 37세,2018,258,148,110,134.5,247,144,103,139.8
34350, 청양군,040004, 38세,2018,248,142,106,134,232,136,96,141.7
34350, 청양군,040005, 39세,2018,267,156,111,140.5,245,143,102,140.2
34350, 청양군,045,40~44세,2018,1413,825,588,140.3,1350,791,559,141.5
34350, 청양군,045001, 40세,2018,232,141,91,154.9,218,133,85,156.5
34350, 청양군,045002, 41세,2018,267,149,118,126.3,256,144,112,128.6
34350, 청양군,045003, 42세,2018,314,195,119,163.9,293,182,111,164
34350, 청양군,045004, 43세,2018,302,161,141,114.2,294,158,136,116.2
34350, 청양군,045005, 44세,2018,298,179,119,150.4,289,174,115,151.3
34350, 청양군,050,45~49세,2018,1984,1120,864,129.6,1920,1100,820,134.1
34350, 청양군,050001, 45세,2018,367,214,153,139.9,354,211,143,147.6
34350, 청양군,050002, 46세,2018,378,199,179,111.2,367,198,169,117.2
34350, 청양군,050003, 47세,2018,388,225,163,138,375,220,155,141.9
34350, 청양군,050004, 48세,2018,415,233,182,128,404,228,176,129.5
34350, 청양군,050005, 49세,2018,436,249,187,133.2,420,243,177,137.3
34350, 청양군,055,50~54세,2018,2318,1278,1040,122.9,2255,1254,1001,125.3
34350, 청양군,055001, 50세,2018,469,258,211,122.3,454,251,203,123.6
34350, 청양군,055002, 51세,2018,411,233,178,130.9,397,225,172,130.8
34350, 청양군,055003, 52세,2018,416,234,182,128.6,405,232,173,134.1
34350, 청양군,055004, 53세,2018,527,288,239,120.5,518,288,230,125.2
34350, 청양군,055005, 54세,2018,495,265,230,115.2,481,258,223,115.7
34350, 청양군,060,55~59세,2018,3099,1589,1510,105.2,3056,1575,1481,106.3
34350, 청양군,060001, 55세,2018,464,230,234,98.3,457,229,228,100.4
34350, 청양군,060002, 56세,2018,588,299,289,103.5,578,295,283,104.2
34350, 청양군,060003, 57세,2018,700,356,344,103.5,694,355,339,104.7
34350, 청양군,060004, 58세,2018,717,387,330,117.3,707,384,323,118.9
34350, 청양군,060005, 59세,2018,630,317,313,101.3,620,312,308,101.3
34350, 청양군,065,60~64세,2018,3016,1497,1519,98.6,2993,1487,1506,98.7
34350, 청양군,065001, 60세,2018,577,269,308,87.3,573,266,307,86.6
34350, 청양군,065002, 61세,2018,627,315,312,101,623,314,309,101.6
34350, 청양군,065003, 62세,2018,581,283,298,95,576,282,294,95.9
34350, 청양군,065004, 63세,2018,667,336,331,101.5,661,333,328,101.5
34350, 청양군,065005, 64세,2018,564,294,270,108.9,560,292,268,109
34350, 청양군,070,65~69세,2018,2448,1249,1199,104.2,2435,1241,1194,103.9
34350, 청양군,070001, 65세,2018,468,247,221,111.8,464,244,220,110.9
34350, 청양군,070002, 66세,2018,496,242,254,95.3,495,242,253,95.7
34350, 청양군,070003, 67세,2018,438,240,198,121.2,437,239,198,120.7
34350, 청양군,070004, 68세,2018,529,264,265,99.6,525,262,263,99.6
34350, 청양군,070005, 69세,2018,517,256,261,98.1,514,254,260,97.7
34350, 청양군,075,70~74세,2018,2054,963,1091,88.3,2047,961,1086,88.5
34350, 청양군,075001, 70세,2018,498,249,249,100,498,249,249,100
34350, 청양군,075002, 71세,2018,427,197,230,85.7,424,196,228,86
34350, 청양군,075003, 72세,2018,349,175,174,100.6,347,175,172,101.7
34350, 청양군,075004, 73세,2018,371,178,193,92.2,370,178,192,92.7
34350, 청양군,075005, 74세,2018,409,164,245,66.9,408,163,245,66.5
34350, 청양군,080,75~79세,2018,2328,940,1388,67.7,2325,939,1386,67.7
34350, 청양군,080001, 75세,2018,408,172,236,72.9,407,172,235,73.2
34350, 청양군,080002, 76세,2018,575,232,343,67.6,575,232,343,67.6
34350, 청양군,080003, 77세,2018,462,195,267,73,460,194,266,72.9
34350, 청양군,080004, 78세,2018,414,146,268,54.5,414,146,268,54.5
34350, 청양군,080005, 79세,2018,469,195,274,71.2,469,195,274,71.2
34350, 청양군,085,80~84세,2018,2030,764,1266,60.3,2029,764,1265,60.4
34350, 청양군,085001, 80세,2018,418,163,255,63.9,418,163,255,63.9
34350, 청양군,085002, 81세,2018,432,147,285,51.6,432,147,285,51.6
34350, 청양군,085003, 82세,2018,431,176,255,69,431,176,255,69
34350, 청양군,085004, 83세,2018,403,140,263,53.2,402,140,262,53.4
34350, 청양군,085005, 84세,2018,346,138,208,66.3,346,138,208,66.3
34350, 청양군,090,85~89세,2018,934,321,613,52.4,934,321,613,52.4
34350, 청양군,090001, 85세,2018,262,111,151,73.5,262,111,151,73.5
34350, 청양군,090002, 86세,2018,244,83,161,51.6,244,83,161,51.6
34350, 청양군,090003, 87세,2018,160,40,120,33.3,160,40,120,33.3
34350, 청양군,090004, 88세,2018,143,50,93,53.8,143,50,93,53.8
34350, 청양군,090005, 89세,2018,125,37,88,42,125,37,88,42
34350, 청양군,095,90~94세,2018,260,65,195,33.3,260,65,195,33.3
34350, 청양군,095001, 90세,2018,87,18,69,26.1,87,18,69,26.1
34350, 청양군,095002, 91세,2018,56,10,46,21.7,56,10,46,21.7
34350, 청양군,095003, 92세,2018,52,16,36,44.4,52,16,36,44.4
34350, 청양군,095004, 93세,2018,42,17,25,68,42,17,25,68
34350, 청양군,095005, 94세,2018,23,X,19,21.1,23,X,19,21.1
34350, 청양군,100,95~99세,2018,44,11,33,33.3,44,11,33,33.3
34350, 청양군,100001, 95세,2018,11,X,8,37.5,11,X,8,37.5
34350, 청양군,100002, 96세,2018,22,X,18,22.2,22,X,18,22.2
34350, 청양군,100003, 97세,2018,X,X,X,200,X,X,X,200
34350, 청양군,100004, 98세,2018,6,X,X,50,6,X,X,50
34350, 청양군,100005, 99세,2018,X,X,X,0,X,X,X,0
34350, 청양군,101,100세이상,2018,8,X,7,14.3,8,X,7,14.3
34350, 청양군,102,15세미만,2018,2290,1167,1123,103.9,2287,1167,1120,104.2
34350, 청양군,103,15~64세,2018,18785,10258,8527,120.3,17966,9858,8108,121.6
34350, 청양군,104,65세이상,2018,10106,4314,5792,74.5,10082,4303,5779,74.5
34350, 청양군,086,85세이상,2018,1246,398,848,46.9,1246,398,848,46.9
34350, 청양군,126,평균연령,2018,52,49.7,54.3,,52.4,50,54.8,
34350, 청양군,127,중위연령,2018,56.3,53.3,58.7,,56.9,53.9,59.3,
34360, 홍성군,000,합계,2018,103044,51478,51566,99.8,99880,49379,50501,97.8
34360, 홍성군,005,0~4세,2018,3834,1966,1868,105.2,3798,1943,1855,104.7
34360, 홍성군,005001, 0세,2018,640,326,314,103.8,634,323,311,103.9
34360, 홍성군,005002, 1세,2018,747,370,377,98.1,742,368,374,98.4
34360, 홍성군,005003, 2세,2018,766,390,376,103.7,761,386,375,102.9
34360, 홍성군,005004, 3세,2018,847,433,414,104.6,839,427,412,103.6
34360, 홍성군,005005, 4세,2018,834,447,387,115.5,822,439,383,114.6
34360, 홍성군,010,5~9세,2018,4649,2397,2252,106.4,4624,2383,2241,106.3
34360, 홍성군,010001, 5세,2018,850,442,408,108.3,845,439,406,108.1
34360, 홍성군,010002, 6세,2018,946,501,445,112.6,941,500,441,113.4
34360, 홍성군,010003, 7세,2018,942,487,455,107,940,486,454,107
34360, 홍성군,010004, 8세,2018,960,486,474,102.5,953,482,471,102.3
34360, 홍성군,010005, 9세,2018,951,481,470,102.3,945,476,469,101.5
34360, 홍성군,015,10~14세,2018,4652,2363,2289,103.2,4633,2354,2279,103.3
34360, 홍성군,015001, 10세,2018,963,488,475,102.7,960,487,473,103
34360, 홍성군,015002, 11세,2018,990,489,501,97.6,985,487,498,97.8
34360, 홍성군,015003, 12세,2018,883,471,412,114.3,880,469,411,114.1
34360, 홍성군,015004, 13세,2018,839,417,422,98.8,838,417,421,99
34360, 홍성군,015005, 14세,2018,977,498,479,104,970,494,476,103.8
34360, 홍성군,020,15~19세,2018,6303,3217,3086,104.2,6270,3199,3071,104.2
34360, 홍성군,020001, 15세,2018,1015,542,473,114.6,1013,540,473,114.2
34360, 홍성군,020002, 16세,2018,1022,522,500,104.4,1012,516,496,104
34360, 홍성군,020003, 17세,2018,1243,677,566,119.6,1240,675,565,119.5
34360, 홍성군,020004, 18세,2018,1446,739,707,104.5,1441,737,704,104.7
34360, 홍성군,020005, 19세,2018,1577,737,840,87.7,1564,731,833,87.8
34360, 홍성군,025,20~24세,2018,6741,3615,3126,115.6,6352,3339,3013,110.8
34360, 홍성군,025001, 20세,2018,1481,652,829,78.6,1453,636,817,77.8
34360, 홍성군,025002, 21세,2018,1444,659,785,83.9,1390,628,762,82.4
34360, 홍성군,025003, 22세,2018,1344,723,621,116.4,1275,675,600,112.5
34360, 홍성군,025004, 23세,2018,1289,818,471,173.7,1174,733,441,166.2
34360, 홍성군,025005, 24세,2018,1183,763,420,181.7,1060,667,393,169.7
34360, 홍성군,030,25~29세,2018,5097,2864,2233,128.3,4457,2412,2045,117.9
34360, 홍성군,030001, 25세,2018,1042,609,433,140.6,925,527,398,132.4
34360, 홍성군,030002, 26세,2018,1080,601,479,125.5,955,517,438,118
34360, 홍성군,030003, 27세,2018,1004,554,450,123.1,873,458,415,110.4
34360, 홍성군,030004, 28세,2018,1018,562,456,123.2,872,452,420,107.6
34360, 홍성군,030005, 29세,2018,953,538,415,129.6,832,458,374,122.5
34360, 홍성군,035,30~34세,2018,5317,2887,2430,118.8,4707,2438,2269,107.4
34360, 홍성군,035001, 30세,2018,996,522,474,110.1,870,431,439,98.2
34360, 홍성군,035002, 31세,2018,996,554,442,125.3,866,454,412,110.2
34360, 홍성군,035003, 32세,2018,1046,582,464,125.4,924,496,428,115.9
34360, 홍성군,035004, 33세,2018,1126,612,514,119.1,994,510,484,105.4
34360, 홍성군,035005, 34세,2018,1153,617,536,115.1,1053,547,506,108.1
34360, 홍성군,040,35~39세,2018,6826,3517,3309,106.3,6397,3218,3179,101.2
34360, 홍성군,040001, 35세,2018,1226,678,548,123.7,1140,613,527,116.3
34360, 홍성군,040002, 36세,2018,1389,667,722,92.4,1292,603,689,87.5
34360, 홍성군,040003, 37세,2018,1407,751,656,114.5,1322,696,626,111.2
34360, 홍성군,040004, 38세,2018,1447,744,703,105.8,1364,686,678,101.2
34360, 홍성군,040005, 39세,2018,1357,677,680,99.6,1279,620,659,94.1
34360, 홍성군,045,40~44세,2018,6973,3606,3367,107.1,6712,3431,3281,104.6
34360, 홍성군,045001, 40세,2018,1318,680,638,106.6,1257,635,622,102.1
34360, 홍성군,045002, 41세,2018,1304,686,618,111,1248,644,604,106.6
34360, 홍성군,045003, 42세,2018,1311,668,643,103.9,1261,640,621,103.1
34360, 홍성군,045004, 43세,2018,1479,746,733,101.8,1436,719,717,100.3
34360, 홍성군,045005, 44세,2018,1561,826,735,112.4,1510,793,717,110.6
34360, 홍성군,050,45~49세,2018,7743,4206,3537,118.9,7545,4080,3465,117.7
34360, 홍성군,050001, 45세,2018,1534,823,711,115.8,1504,803,701,114.6
34360, 홍성군,050002, 46세,2018,1554,875,679,128.9,1504,843,661,127.5
34360, 홍성군,050003, 47세,2018,1590,869,721,120.5,1550,839,711,118
34360, 홍성군,050004, 48세,2018,1515,807,708,114,1473,782,691,113.2
34360, 홍성군,050005, 49세,2018,1550,832,718,115.9,1514,813,701,116
34360, 홍성군,055,50~54세,2018,7346,3790,3556,106.6,7168,3702,3466,106.8
34360, 홍성군,055001, 50세,2018,1600,847,753,112.5,1556,826,730,113.2
34360, 홍성군,055002, 51세,2018,1464,752,712,105.6,1428,734,694,105.8
34360, 홍성군,055003, 52세,2018,1258,636,622,102.3,1224,620,604,102.6
34360, 홍성군,055004, 53세,2018,1596,825,771,107,1553,803,750,107.1
34360, 홍성군,055005, 54세,2018,1428,730,698,104.6,1407,719,688,104.5
34360, 홍성군,060,55~59세,2018,8475,4302,4173,103.1,8323,4225,4098,103.1
34360, 홍성군,060001, 55세,2018,1584,820,764,107.3,1539,794,745,106.6
34360, 홍성군,060002, 56세,2018,1688,871,817,106.6,1643,850,793,107.2
34360, 홍성군,060003, 57세,2018,1822,915,907,100.9,1808,909,899,101.1
34360, 홍성군,060004, 58세,2018,1849,903,946,95.5,1821,887,934,95
34360, 홍성군,060005, 59세,2018,1532,793,739,107.3,1512,785,727,108
34360, 홍성군,065,60~64세,2018,7371,3651,3720,98.1,7258,3593,3665,98
34360, 홍성군,065001, 60세,2018,1502,742,760,97.6,1473,729,744,98
34360, 홍성군,065002, 61세,2018,1493,767,726,105.6,1463,748,715,104.6
34360, 홍성군,065003, 62세,2018,1449,705,744,94.8,1429,695,734,94.7
34360, 홍성군,065004, 63세,2018,1562,763,799,95.5,1545,752,793,94.8
34360, 홍성군,065005, 64세,2018,1365,674,691,97.5,1348,669,679,98.5
34360, 홍성군,070,65~69세,2018,5859,2797,3062,91.3,5812,2776,3036,91.4
34360, 홍성군,070001, 65세,2018,1082,535,547,97.8,1072,530,542,97.8
34360, 홍성군,070002, 66세,2018,1247,577,670,86.1,1237,573,664,86.3
34360, 홍성군,070003, 67세,2018,1109,532,577,92.2,1098,527,571,92.3
34360, 홍성군,070004, 68세,2018,1136,514,622,82.6,1126,509,617,82.5
34360, 홍성군,070005, 69세,2018,1285,639,646,98.9,1279,637,642,99.2
34360, 홍성군,075,70~74세,2018,4653,2186,2467,88.6,4635,2177,2458,88.6
34360, 홍성군,075001, 70세,2018,1117,532,585,90.9,1114,530,584,90.8
34360, 홍성군,075002, 71세,2018,1062,509,553,92,1058,506,552,91.7
34360, 홍성군,075003, 72세,2018,795,408,387,105.4,789,405,384,105.5
34360, 홍성군,075004, 73세,2018,744,344,400,86,740,344,396,86.9
34360, 홍성군,075005, 74세,2018,935,393,542,72.5,934,392,542,72.3
34360, 홍성군,080,75~79세,2018,4771,1927,2844,67.8,4765,1924,2841,67.7
34360, 홍성군,080001, 75세,2018,939,392,547,71.7,939,392,547,71.7
34360, 홍성군,080002, 76세,2018,1210,498,712,69.9,1208,497,711,69.9
34360, 홍성군,080003, 77세,2018,889,352,537,65.5,888,352,536,65.7
34360, 홍성군,080004, 78세,2018,799,316,483,65.4,796,314,482,65.1
34360, 홍성군,080005, 79세,2018,934,369,565,65.3,934,369,565,65.3
34360, 홍성군,085,80~84세,2018,3932,1456,2476,58.8,3924,1454,2470,58.9
34360, 홍성군,085001, 80세,2018,931,347,584,59.4,928,345,583,59.2
34360, 홍성군,085002, 81세,2018,785,297,488,60.9,782,297,485,61.2
34360, 홍성군,085003, 82세,2018,873,332,541,61.4,872,332,540,61.5
34360, 홍성군,085004, 83세,2018,726,258,468,55.1,726,258,468,55.1
34360, 홍성군,085005, 84세,2018,617,222,395,56.2,616,222,394,56.3
34360, 홍성군,090,85~89세,2018,1809,564,1245,45.3,1808,564,1244,45.3
34360, 홍성군,090001, 85세,2018,502,152,350,43.4,502,152,350,43.4
34360, 홍성군,090002, 86세,2018,470,166,304,54.6,470,166,304,54.6
34360, 홍성군,090003, 87세,2018,301,87,214,40.7,300,87,213,40.8
34360, 홍성군,090004, 88세,2018,289,89,200,44.5,289,89,200,44.5
34360, 홍성군,090005, 89세,2018,247,70,177,39.5,247,70,177,39.5
34360, 홍성군,095,90~94세,2018,533,140,393,35.6,532,140,392,35.7
34360, 홍성군,095001, 90세,2018,189,53,136,39,188,53,135,39.3
34360, 홍성군,095002, 91세,2018,118,29,89,32.6,118,29,89,32.6
34360, 홍성군,095003, 92세,2018,106,27,79,34.2,106,27,79,34.2
34360, 홍성군,095004, 93세,2018,68,20,48,41.7,68,20,48,41.7
34360, 홍성군,095005, 94세,2018,52,11,41,26.8,52,11,41,26.8
34360, 홍성군,100,95~99세,2018,146,25,121,20.7,146,25,121,20.7
34360, 홍성군,100001, 95세,2018,69,12,57,21.1,69,12,57,21.1
34360, 홍성군,100002, 96세,2018,44,8,36,22.2,44,8,36,22.2
34360, 홍성군,100003, 97세,2018,17,X,13,30.8,17,X,13,30.8
34360, 홍성군,100004, 98세,2018,8,X,7,14.3,8,X,7,14.3
34360, 홍성군,100005, 99세,2018,8,X,8,0,8,X,8,0
34360, 홍성군,101,100세이상,2018,14,X,12,16.7,14,X,12,16.7
34360, 홍성군,102,15세미만,2018,13135,6726,6409,104.9,13055,6680,6375,104.8
34360, 홍성군,103,15~64세,2018,68192,35655,32537,109.6,65189,33637,31552,106.6
34360, 홍성군,104,65세이상,2018,21717,9097,12620,72.1,21636,9062,12574,72.1
34360, 홍성군,086,85세이상,2018,2502,731,1771,41.3,2500,731,1769,41.3
34360, 홍성군,126,평균연령,2018,44.5,42.8,46.1,,44.7,43.1,46.3,
34360, 홍성군,127,중위연령,2018,45.7,44.2,47.6,,46.3,45,47.9,
34370, 예산군,000,합계,2018,79136,40273,38863,103.6,76004,38170,37834,100.9
34370, 예산군,005,0~4세,2018,1644,839,805,104.2,1621,824,797,103.4
34370, 예산군,005001, 0세,2018,273,131,142,92.3,267,127,140,90.7
34370, 예산군,005002, 1세,2018,286,135,151,89.4,280,133,147,90.5
34370, 예산군,005003, 2세,2018,324,169,155,109,319,166,153,108.5
34370, 예산군,005004, 3세,2018,375,207,168,123.2,372,204,168,121.4
34370, 예산군,005005, 4세,2018,386,197,189,104.2,383,194,189,102.6
34370, 예산군,010,5~9세,2018,2350,1226,1124,109.1,2334,1218,1116,109.1
34370, 예산군,010001, 5세,2018,419,205,214,95.8,415,203,212,95.8
34370, 예산군,010002, 6세,2018,474,256,218,117.4,471,254,217,117.1
34370, 예산군,010003, 7세,2018,498,268,230,116.5,494,266,228,116.7
34370, 예산군,010004, 8세,2018,495,252,243,103.7,492,251,241,104.1
34370, 예산군,010005, 9세,2018,464,245,219,111.9,462,244,218,111.9
34370, 예산군,015,10~14세,2018,2604,1332,1272,104.7,2598,1330,1268,104.9
34370, 예산군,015001, 10세,2018,479,245,234,104.7,479,245,234,104.7
34370, 예산군,015002, 11세,2018,595,326,269,121.2,594,325,269,120.8
34370, 예산군,015003, 12세,2018,506,235,271,86.7,504,234,270,86.7
34370, 예산군,015004, 13세,2018,499,256,243,105.3,497,256,241,106.2
34370, 예산군,015005, 14세,2018,525,270,255,105.9,524,270,254,106.3
34370, 예산군,020,15~19세,2018,3596,1892,1704,111,3576,1882,1694,111.1
34370, 예산군,020001, 15세,2018,577,287,290,99,575,287,288,99.7
34370, 예산군,020002, 16세,2018,709,384,325,118.2,709,384,325,118.2
34370, 예산군,020003, 17세,2018,760,408,352,115.9,759,408,351,116.2
34370, 예산군,020004, 18세,2018,787,410,377,108.8,780,406,374,108.6
34370, 예산군,020005, 19세,2018,763,403,360,111.9,753,397,356,111.5
34370, 예산군,025,20~24세,2018,4135,2340,1795,130.4,3843,2131,1712,124.5
34370, 예산군,025001, 20세,2018,782,404,378,106.9,760,391,369,106
34370, 예산군,025002, 21세,2018,816,444,372,119.4,780,419,361,116.1
34370, 예산군,025003, 22세,2018,888,515,373,138.1,828,474,354,133.9
34370, 예산군,025004, 23세,2018,865,524,341,153.7,777,460,317,145.1
34370, 예산군,025005, 24세,2018,784,453,331,136.9,698,387,311,124.4
34370, 예산군,030,25~29세,2018,3877,2391,1486,160.9,3203,1895,1308,144.9
34370, 예산군,030001, 25세,2018,874,501,373,134.3,747,411,336,122.3
34370, 예산군,030002, 26세,2018,805,502,303,165.7,680,412,268,153.7
34370, 예산군,030003, 27세,2018,780,492,288,170.8,643,386,257,150.2
34370, 예산군,030004, 28세,2018,741,470,271,173.4,600,363,237,153.2
34370, 예산군,030005, 29세,2018,677,426,251,169.7,533,323,210,153.8
34370, 예산군,035,30~34세,2018,3447,2063,1384,149.1,2824,1604,1220,131.5
34370, 예산군,035001, 30세,2018,687,426,261,163.2,547,317,230,137.8
34370, 예산군,035002, 31세,2018,695,412,283,145.6,566,313,253,123.7
34370, 예산군,035003, 32세,2018,651,406,245,165.7,534,318,216,147.2
34370, 예산군,035004, 33세,2018,669,387,282,137.2,553,310,243,127.6
34370, 예산군,035005, 34세,2018,745,432,313,138,624,346,278,124.5
34370, 예산군,040,35~39세,2018,3975,2255,1720,131.1,3555,1951,1604,121.6
34370, 예산군,040001, 35세,2018,724,428,296,144.6,627,354,273,129.7
34370, 예산군,040002, 36세,2018,789,450,339,132.7,692,379,313,121.1
34370, 예산군,040003, 37세,2018,802,461,341,135.2,726,412,314,131.2
34370, 예산군,040004, 38세,2018,862,480,382,125.7,777,416,361,115.2
34370, 예산군,040005, 39세,2018,798,436,362,120.4,733,390,343,113.7
34370, 예산군,045,40~44세,2018,4505,2492,2013,123.8,4208,2305,1903,121.1
34370, 예산군,045001, 40세,2018,760,431,329,131,697,390,307,127
34370, 예산군,045002, 41세,2018,822,472,350,134.9,750,423,327,129.4
34370, 예산군,045003, 42세,2018,909,511,398,128.4,849,472,377,125.2
34370, 예산군,045004, 43세,2018,926,513,413,124.2,875,484,391,123.8
34370, 예산군,045005, 44세,2018,1088,565,523,108,1037,536,501,107
34370, 예산군,050,45~49세,2018,5791,3256,2535,128.4,5528,3096,2432,127.3
34370, 예산군,050001, 45세,2018,1145,656,489,134.2,1092,621,471,131.8
34370, 예산군,050002, 46세,2018,1072,592,480,123.3,1019,559,460,121.5
34370, 예산군,050003, 47세,2018,1156,645,511,126.2,1103,615,488,126
34370, 예산군,050004, 48세,2018,1142,647,495,130.7,1092,616,476,129.4
34370, 예산군,050005, 49세,2018,1276,716,560,127.9,1222,685,537,127.6
34370, 예산군,055,50~54세,2018,6098,3247,2851,113.9,5898,3143,2755,114.1
34370, 예산군,055001, 50세,2018,1294,684,610,112.1,1251,658,593,111
34370, 예산군,055002, 51세,2018,1113,612,501,122.2,1079,593,486,122
34370, 예산군,055003, 52세,2018,1087,577,510,113.1,1041,547,494,110.7
34370, 예산군,055004, 53세,2018,1364,709,655,108.2,1321,697,624,111.7
34370, 예산군,055005, 54세,2018,1240,665,575,115.7,1206,648,558,116.1
34370, 예산군,060,55~59세,2018,7816,3894,3922,99.3,7670,3811,3859,98.8
34370, 예산군,060001, 55세,2018,1252,645,607,106.3,1207,622,585,106.3
34370, 예산군,060002, 56세,2018,1518,786,732,107.4,1476,757,719,105.3
34370, 예산군,060003, 57세,2018,1804,909,895,101.6,1789,899,890,101
34370, 예산군,060004, 58세,2018,1763,824,939,87.8,1736,810,926,87.5
34370, 예산군,060005, 59세,2018,1479,730,749,97.5,1462,723,739,97.8
34370, 예산군,065,60~64세,2018,7283,3655,3628,100.7,7190,3610,3580,100.8
34370, 예산군,065001, 60세,2018,1472,723,749,96.5,1442,709,733,96.7
34370, 예산군,065002, 61세,2018,1466,746,720,103.6,1445,733,712,102.9
34370, 예산군,065003, 62세,2018,1451,753,698,107.9,1430,745,685,108.8
34370, 예산군,065004, 63세,2018,1533,761,772,98.6,1521,756,765,98.8
34370, 예산군,065005, 64세,2018,1361,672,689,97.5,1352,667,685,97.4
34370, 예산군,070,65~69세,2018,5813,2796,3017,92.7,5790,2785,3005,92.7
34370, 예산군,070001, 65세,2018,1110,546,564,96.8,1103,542,561,96.6
34370, 예산군,070002, 66세,2018,1293,628,665,94.4,1288,626,662,94.6
34370, 예산군,070003, 67세,2018,1037,466,571,81.6,1031,463,568,81.5
34370, 예산군,070004, 68세,2018,1199,575,624,92.1,1199,575,624,92.1
34370, 예산군,070005, 69세,2018,1174,581,593,98,1169,579,590,98.1
34370, 예산군,075,70~74세,2018,4738,2218,2520,88,4720,2213,2507,88.3
34370, 예산군,075001, 70세,2018,1131,545,586,93,1128,545,583,93.5
34370, 예산군,075002, 71세,2018,1118,555,563,98.6,1114,554,560,98.9
34370, 예산군,075003, 72세,2018,767,382,385,99.2,762,381,381,100
34370, 예산군,075004, 73세,2018,788,329,459,71.7,783,326,457,71.3
34370, 예산군,075005, 74세,2018,934,407,527,77.2,933,407,526,77.4
34370, 예산군,080,75~79세,2018,5037,2129,2908,73.2,5030,2128,2902,73.3
34370, 예산군,080001, 75세,2018,958,441,517,85.3,956,440,516,85.3
34370, 예산군,080002, 76세,2018,1270,531,739,71.9,1270,531,739,71.9
34370, 예산군,080003, 77세,2018,961,401,560,71.6,958,401,557,72
34370, 예산군,080004, 78세,2018,882,373,509,73.3,880,373,507,73.6
34370, 예산군,080005, 79세,2018,966,383,583,65.7,966,383,583,65.7
34370, 예산군,085,80~84세,2018,4004,1553,2451,63.4,3995,1549,2446,63.3
34370, 예산군,085001, 80세,2018,939,355,584,60.8,936,355,581,61.1
34370, 예산군,085002, 81세,2018,864,355,509,69.7,860,352,508,69.3
34370, 예산군,085003, 82세,2018,825,325,500,65,824,324,500,64.8
34370, 예산군,085004, 83세,2018,736,272,464,58.6,736,272,464,58.6
34370, 예산군,085005, 84세,2018,640,246,394,62.4,639,246,393,62.6
34370, 예산군,090,85~89세,2018,1814,554,1260,44,1812,554,1258,44
34370, 예산군,090001, 85세,2018,560,188,372,50.5,559,188,371,50.7
34370, 예산군,090002, 86세,2018,463,145,318,45.6,463,145,318,45.6
34370, 예산군,090003, 87세,2018,314,94,220,42.7,314,94,220,42.7
34370, 예산군,090004, 88세,2018,254,61,193,31.6,253,61,192,31.8
34370, 예산군,090005, 89세,2018,223,66,157,42,223,66,157,42
34370, 예산군,095,90~94세,2018,480,118,362,32.6,480,118,362,32.6
34370, 예산군,095001, 90세,2018,165,35,130,26.9,165,35,130,26.9
34370, 예산군,095002, 91세,2018,129,44,85,51.8,129,44,85,51.8
34370, 예산군,095003, 92세,2018,77,21,56,37.5,77,21,56,37.5
34370, 예산군,095004, 93세,2018,70,16,54,29.6,70,16,54,29.6
34370, 예산군,095005, 94세,2018,39,X,37,5.4,39,X,37,5.4
34370, 예산군,100,95~99세,2018,117,21,96,21.9,117,21,96,21.9
34370, 예산군,100001, 95세,2018,46,10,36,27.8,46,10,36,27.8
34370, 예산군,100002, 96세,2018,25,X,24,4.2,25,X,24,4.2
34370, 예산군,100003, 97세,2018,28,8,20,40,28,8,20,40
34370, 예산군,100004, 98세,2018,12,X,10,20,12,X,10,20
34370, 예산군,100005, 99세,2018,6,X,6,0,6,X,6,0
34370, 예산군,101,100세이상,2018,12,X,10,20,12,X,10,20
34370, 예산군,102,15세미만,2018,6598,3397,3201,106.1,6553,3372,3181,106
34370, 예산군,103,15~64세,2018,50523,27485,23038,119.3,47495,25428,22067,115.2
34370, 예산군,104,65세이상,2018,22015,9391,12624,74.4,21956,9370,12586,74.4
34370, 예산군,086,85세이상,2018,2423,695,1728,40.2,2421,695,1726,40.3
34370, 예산군,126,평균연령,2018,49.8,47.6,52,,50.3,48.3,52.4,
34370, 예산군,127,중위연령,2018,53.1,50.1,56.2,,54,51.3,56.7,
34380, 태안군,000,합계,2018,60948,31253,29695,105.2,59188,30031,29157,103
34380, 태안군,005,0~4세,2018,1494,738,756,97.6,1488,733,755,97.1
34380, 태안군,005001, 0세,2018,258,132,126,104.8,256,130,126,103.2
34380, 태안군,005002, 1세,2018,253,129,124,104,253,129,124,104
34380, 태안군,005003, 2세,2018,327,161,166,97,325,159,166,95.8
34380, 태안군,005004, 3세,2018,330,163,167,97.6,329,162,167,97
34380, 태안군,005005, 4세,2018,326,153,173,88.4,325,153,172,89
34380, 태안군,010,5~9세,2018,1940,1012,928,109.1,1940,1012,928,109.1
34380, 태안군,010001, 5세,2018,384,197,187,105.3,384,197,187,105.3
34380, 태안군,010002, 6세,2018,399,193,206,93.7,399,193,206,93.7
34380, 태안군,010003, 7세,2018,402,211,191,110.5,402,211,191,110.5
34380, 태안군,010004, 8세,2018,354,192,162,118.5,354,192,162,118.5
34380, 태안군,010005, 9세,2018,401,219,182,120.3,401,219,182,120.3
34380, 태안군,015,10~14세,2018,2135,1070,1065,100.5,2134,1070,1064,100.6
34380, 태안군,015001, 10세,2018,450,227,223,101.8,450,227,223,101.8
34380, 태안군,015002, 11세,2018,432,224,208,107.7,432,224,208,107.7
34380, 태안군,015003, 12세,2018,426,221,205,107.8,426,221,205,107.8
34380, 태안군,015004, 13세,2018,415,195,220,88.6,415,195,220,88.6
34380, 태안군,015005, 14세,2018,412,203,209,97.1,411,203,208,97.6
34380, 태안군,020,15~19세,2018,2425,1271,1154,110.1,2412,1261,1151,109.6
34380, 태안군,020001, 15세,2018,458,235,223,105.4,456,233,223,104.5
34380, 태안군,020002, 16세,2018,441,217,224,96.9,440,216,224,96.4
34380, 태안군,020003, 17세,2018,495,223,272,82,493,221,272,81.3
34380, 태안군,020004, 18세,2018,524,266,258,103.1,523,265,258,102.7
34380, 태안군,020005, 19세,2018,507,330,177,186.4,500,326,174,187.4
34380, 태안군,025,20~24세,2018,2955,1996,959,208.1,2776,1869,907,206.1
34380, 태안군,025001, 20세,2018,567,396,171,231.6,551,386,165,233.9
34380, 태안군,025002, 21세,2018,596,397,199,199.5,571,380,191,199
34380, 태안군,025003, 22세,2018,574,386,188,205.3,543,365,178,205.1
34380, 태안군,025004, 23세,2018,647,428,219,195.4,606,399,207,192.8
34380, 태안군,025005, 24세,2018,571,389,182,213.7,505,339,166,204.2
34380, 태안군,030,25~29세,2018,2633,1593,1040,153.2,2303,1364,939,145.3
34380, 태안군,030001, 25세,2018,547,323,224,144.2,487,287,200,143.5
34380, 태안군,030002, 26세,2018,560,343,217,158.1,490,291,199,146.2
34380, 태안군,030003, 27세,2018,498,303,195,155.4,439,264,175,150.9
34380, 태안군,030004, 28세,2018,504,308,196,157.1,429,253,176,143.8
34380, 태안군,030005, 29세,2018,524,316,208,151.9,458,269,189,142.3
34380, 태안군,035,30~34세,2018,2577,1500,1077,139.3,2262,1272,990,128.5
34380, 태안군,035001, 30세,2018,495,285,210,135.7,432,243,189,128.6
34380, 태안군,035002, 31세,2018,496,290,206,140.8,439,249,190,131.1
34380, 태안군,035003, 32세,2018,508,314,194,161.9,433,258,175,147.4
34380, 태안군,035004, 33세,2018,542,313,229,136.7,477,267,210,127.1
34380, 태안군,035005, 34세,2018,536,298,238,125.2,481,255,226,112.8
34380, 태안군,040,35~39세,2018,3476,2009,1467,136.9,3179,1786,1393,128.2
34380, 태안군,040001, 35세,2018,660,388,272,142.6,591,341,250,136.4
34380, 태안군,040002, 36세,2018,701,384,317,121.1,640,334,306,109.2
34380, 태안군,040003, 37세,2018,678,399,279,143,622,356,266,133.8
34380, 태안군,040004, 38세,2018,783,453,330,137.3,731,414,317,130.6
34380, 태안군,040005, 39세,2018,654,385,269,143.1,595,341,254,134.3
34380, 태안군,045,40~44세,2018,3652,2077,1575,131.9,3459,1927,1532,125.8
34380, 태안군,045001, 40세,2018,704,406,298,136.2,653,363,290,125.2
34380, 태안군,045002, 41세,2018,693,395,298,132.6,653,365,288,126.7
34380, 태안군,045003, 42세,2018,708,418,290,144.1,683,396,287,138
34380, 태안군,045004, 43세,2018,729,419,310,135.2,687,387,300,129
34380, 태안군,045005, 44세,2018,818,439,379,115.8,783,416,367,113.4
34380, 태안군,050,45~49세,2018,4224,2393,1831,130.7,4057,2277,1780,127.9
34380, 태안군,050001, 45세,2018,839,481,358,134.4,799,453,346,130.9
34380, 태안군,050002, 46세,2018,803,471,332,141.9,757,440,317,138.8
34380, 태안군,050003, 47세,2018,839,485,354,137,806,458,348,131.6
34380, 태안군,050004, 48세,2018,846,470,376,125,822,455,367,124
34380, 태안군,050005, 49세,2018,897,486,411,118.2,873,471,402,117.2
34380, 태안군,055,50~54세,2018,4633,2442,2191,111.5,4549,2394,2155,111.1
34380, 태안군,055001, 50세,2018,920,498,422,118,903,486,417,116.5
34380, 태안군,055002, 51세,2018,873,464,409,113.4,853,454,399,113.8
34380, 태안군,055003, 52세,2018,880,451,429,105.1,861,443,418,106
34380, 태안군,055004, 53세,2018,1018,546,472,115.7,1007,541,466,116.1
34380, 태안군,055005, 54세,2018,942,483,459,105.2,925,470,455,103.3
34380, 태안군,060,55~59세,2018,5900,2960,2940,100.7,5831,2926,2905,100.7
34380, 태안군,060001, 55세,2018,1007,534,473,112.9,988,526,462,113.9
34380, 태안군,060002, 56세,2018,1080,546,534,102.2,1067,538,529,101.7
34380, 태안군,060003, 57세,2018,1303,645,658,98,1294,639,655,97.6
34380, 태안군,060004, 58세,2018,1332,673,659,102.1,1317,667,650,102.6
34380, 태안군,060005, 59세,2018,1178,562,616,91.2,1165,556,609,91.3
34380, 태안군,065,60~64세,2018,5742,2711,3031,89.4,5683,2682,3001,89.4
34380, 태안군,065001, 60세,2018,1210,599,611,98,1197,592,605,97.9
34380, 태안군,065002, 61세,2018,1157,523,634,82.5,1144,516,628,82.2
34380, 태안군,065003, 62세,2018,1160,535,625,85.6,1148,529,619,85.5
34380, 태안군,065004, 63세,2018,1170,555,615,90.2,1160,550,610,90.2
34380, 태안군,065005, 64세,2018,1045,499,546,91.4,1034,495,539,91.8
34380, 태안군,070,65~69세,2018,4890,2446,2444,100.1,4859,2428,2431,99.9
34380, 태안군,070001, 65세,2018,958,447,511,87.5,944,441,503,87.7
34380, 태안군,070002, 66세,2018,1052,519,533,97.4,1047,515,532,96.8
34380, 태안군,070003, 67세,2018,846,424,422,100.5,842,420,422,99.5
34380, 태안군,070004, 68세,2018,1007,529,478,110.7,1002,525,477,110.1
34380, 태안군,070005, 69세,2018,1027,527,500,105.4,1024,527,497,106
34380, 태안군,075,70~74세,2018,4131,2016,2115,95.3,4125,2013,2112,95.3
34380, 태안군,075001, 70세,2018,954,442,512,86.3,951,440,511,86.1
34380, 태안군,075002, 71세,2018,975,499,476,104.8,975,499,476,104.8
34380, 태안군,075003, 72세,2018,701,376,325,115.7,700,376,324,116
34380, 태안군,075004, 73세,2018,702,336,366,91.8,701,336,365,92.1
34380, 태안군,075005, 74세,2018,799,363,436,83.3,798,362,436,83
34380, 태안군,080,75~79세,2018,3788,1588,2200,72.2,3782,1586,2196,72.2
34380, 태안군,080001, 75세,2018,801,337,464,72.6,801,337,464,72.6
34380, 태안군,080002, 76세,2018,993,434,559,77.6,991,434,557,77.9
34380, 태안군,080003, 77세,2018,671,276,395,69.9,670,275,395,69.6
34380, 태안군,080004, 78세,2018,627,259,368,70.4,626,258,368,70.1
34380, 태안군,080005, 79세,2018,696,282,414,68.1,694,282,412,68.4
34380, 태안군,085,80~84세,2018,2556,947,1609,58.9,2555,947,1608,58.9
34380, 태안군,085001, 80세,2018,593,246,347,70.9,593,246,347,70.9
34380, 태안군,085002, 81세,2018,527,221,306,72.2,526,221,305,72.5
34380, 태안군,085003, 82세,2018,550,198,352,56.3,550,198,352,56.3
34380, 태안군,085004, 83세,2018,500,162,338,47.9,500,162,338,47.9
34380, 태안군,085005, 84세,2018,386,120,266,45.1,386,120,266,45.1
34380, 태안군,090,85~89세,2018,1297,379,918,41.3,1294,379,915,41.4
34380, 태안군,090001, 85세,2018,401,120,281,42.7,401,120,281,42.7
34380, 태안군,090002, 86세,2018,339,115,224,51.3,337,115,222,51.8
34380, 태안군,090003, 87세,2018,224,68,156,43.6,224,68,156,43.6
34380, 태안군,090004, 88세,2018,178,44,134,32.8,177,44,133,33.1
34380, 태안군,090005, 89세,2018,155,32,123,26,155,32,123,26
34380, 태안군,095,90~94세,2018,409,86,323,26.6,409,86,323,26.6
34380, 태안군,095001, 90세,2018,140,36,104,34.6,140,36,104,34.6
34380, 태안군,095002, 91세,2018,87,21,66,31.8,87,21,66,31.8
34380, 태안군,095003, 92세,2018,60,10,50,20,60,10,50,20
34380, 태안군,095004, 93세,2018,79,15,64,23.4,79,15,64,23.4
34380, 태안군,095005, 94세,2018,43,X,39,10.3,43,X,39,10.3
34380, 태안군,100,95~99세,2018,82,19,63,30.2,82,19,63,30.2
34380, 태안군,100001, 95세,2018,33,7,26,26.9,33,7,26,26.9
34380, 태안군,100002, 96세,2018,25,X,22,13.6,25,X,22,13.6
34380, 태안군,100003, 97세,2018,13,5,8,62.5,13,5,8,62.5
34380, 태안군,100004, 98세,2018,7,X,5,40,7,X,5,40
34380, 태안군,100005, 99세,2018,X,X,X,100,X,X,X,100
34380, 태안군,101,100세이상,2018,9,X,9,0,9,X,9,0
34380, 태안군,102,15세미만,2018,5569,2820,2749,102.6,5562,2815,2747,102.5
34380, 태안군,103,15~64세,2018,38217,20952,17265,121.4,36511,19758,16753,117.9
34380, 태안군,104,65세이상,2018,17162,7481,9681,77.3,17115,7458,9657,77.2
34380, 태안군,086,85세이상,2018,1797,484,1313,36.9,1794,484,1310,36.9
34380, 태안군,126,평균연령,2018,49.7,47.4,52.1,,50.1,47.9,52.4,
34380, 태안군,127,중위연령,2018,53.3,49.9,56.6,,54,50.9,57,
35,전라북도,000,합계,2018,1818157,907683,910474,99.7,1779026,886532,892494,99.3
35,전라북도,005,0~4세,2018,63571,32573,30998,105.1,63211,32378,30833,105
35,전라북도,005001, 0세,2018,10278,5251,5027,104.5,10208,5216,4992,104.5
35,전라북도,005002, 1세,2018,11519,5868,5651,103.8,11420,5814,5606,103.7
35,전라북도,005003, 2세,2018,13148,6746,6402,105.4,13084,6711,6373,105.3
35,전라북도,005004, 3세,2018,14282,7298,6984,104.5,14210,7258,6952,104.4
35,전라북도,005005, 4세,2018,14344,7410,6934,106.9,14289,7379,6910,106.8
35,전라북도,010,5~9세,2018,78863,40614,38249,106.2,78701,40523,38178,106.1
35,전라북도,010001, 5세,2018,14991,7786,7205,108.1,14953,7763,7190,108
35,전라북도,010002, 6세,2018,16374,8403,7971,105.4,16335,8380,7955,105.3
35,전라북도,010003, 7세,2018,16619,8501,8118,104.7,16590,8486,8104,104.7
35,전라북도,010004, 8세,2018,15683,8101,7582,106.8,15655,8087,7568,106.9
35,전라북도,010005, 9세,2018,15196,7823,7373,106.1,15168,7807,7361,106.1
35,전라북도,015,10~14세,2018,81024,42056,38968,107.9,80918,42004,38914,107.9
35,전라북도,015001, 10세,2018,16079,8337,7742,107.7,16057,8330,7727,107.8
35,전라북도,015002, 11세,2018,16691,8591,8100,106.1,16672,8580,8092,106
35,전라북도,015003, 12세,2018,15483,8060,7423,108.6,15467,8051,7416,108.6
35,전라북도,015004, 13세,2018,15710,8245,7465,110.4,15696,8237,7459,110.4
35,전라북도,015005, 14세,2018,17061,8823,8238,107.1,17026,8806,8220,107.1
35,전라북도,020,15~19세,2018,108439,57444,50995,112.6,106984,56674,50310,112.6
35,전라북도,020001, 15세,2018,17958,9285,8673,107.1,17928,9269,8659,107
35,전라북도,020002, 16세,2018,19256,10172,9084,112,19220,10156,9064,112
35,전라북도,020003, 17세,2018,22368,11610,10758,107.9,22297,11577,10720,108
35,전라북도,020004, 18세,2018,24874,13215,11659,113.3,24541,13029,11512,113.2
35,전라북도,020005, 19세,2018,23983,13162,10821,121.6,22998,12643,10355,122.1
35,전라북도,025,20~24세,2018,128024,71071,56953,124.8,120249,66772,53477,124.9
35,전라북도,025001, 20세,2018,25585,13909,11676,119.1,24085,13094,10991,119.1
35,전라북도,025002, 21세,2018,25985,14061,11924,117.9,24495,13220,11275,117.3
35,전라북도,025003, 22세,2018,26478,14701,11777,124.8,24991,13889,11102,125.1
35,전라북도,025004, 23세,2018,25396,14419,10977,131.4,23743,13498,10245,131.8
35,전라북도,025005, 24세,2018,24580,13981,10599,131.9,22935,13071,9864,132.5
35,전라북도,030,25~29세,2018,100946,54850,46096,119,93335,50492,42843,117.9
35,전라북도,030001, 25세,2018,22536,12497,10039,124.5,20933,11628,9305,125
35,전라북도,030002, 26세,2018,21471,11617,9854,117.9,19929,10735,9194,116.8
35,전라북도,030003, 27세,2018,20050,10772,9278,116.1,18498,9884,8614,114.7
35,전라북도,030004, 28세,2018,18870,10248,8622,118.9,17378,9387,7991,117.5
35,전라북도,030005, 29세,2018,18019,9716,8303,117,16597,8858,7739,114.5
35,전라북도,035,30~34세,2018,92655,48275,44380,108.8,86260,44536,41724,106.7
35,전라북도,035001, 30세,2018,17911,9422,8489,111,16442,8560,7882,108.6
35,전라북도,035002, 31세,2018,17848,9365,8483,110.4,16467,8534,7933,107.6
35,전라북도,035003, 32세,2018,18462,9631,8831,109.1,17223,8912,8311,107.2
35,전라북도,035004, 33세,2018,18329,9461,8868,106.7,17142,8777,8365,104.9
35,전라북도,035005, 34세,2018,20105,10396,9709,107.1,18986,9753,9233,105.6
35,전라북도,040,35~39세,2018,118600,61118,57482,106.3,114323,58725,55598,105.6
35,전라북도,040001, 35세,2018,21638,11143,10495,106.2,20669,10615,10054,105.6
35,전라북도,040002, 36세,2018,23848,12288,11560,106.3,22951,11774,11177,105.3
35,전라북도,040003, 37세,2018,23772,12351,11421,108.1,22969,11909,11060,107.7
35,전라북도,040004, 38세,2018,25232,12898,12334,104.6,24397,12432,11965,103.9
35,전라북도,040005, 39세,2018,24110,12438,11672,106.6,23337,11995,11342,105.8
35,전라북도,045,40~44세,2018,125991,64585,61406,105.2,123220,63137,60083,105.1
35,전라북도,045001, 40세,2018,23085,11795,11290,104.5,22445,11455,10990,104.2
35,전라북도,045002, 41세,2018,24076,12286,11790,104.2,23510,11986,11524,104
35,전라북도,045003, 42세,2018,24324,12556,11768,106.7,23765,12248,11517,106.3
35,전라북도,045004, 43세,2018,25319,12952,12367,104.7,24809,12694,12115,104.8
35,전라북도,045005, 44세,2018,29187,14996,14191,105.7,28691,14754,13937,105.9
35,전라북도,050,45~49세,2018,148594,76927,71667,107.3,146033,75651,70382,107.5
35,전라북도,050001, 45세,2018,28990,14784,14206,104.1,28457,14503,13954,103.9
35,전라북도,050002, 46세,2018,28647,14969,13678,109.4,28097,14702,13395,109.8
35,전라북도,050003, 47세,2018,31315,16346,14969,109.2,30798,16095,14703,109.5
35,전라북도,050004, 48세,2018,29557,15351,14206,108.1,29055,15100,13955,108.2
35,전라북도,050005, 49세,2018,30085,15477,14608,105.9,29626,15251,14375,106.1
35,전라북도,055,50~54세,2018,142504,73368,69136,106.1,140365,72421,67944,106.6
35,전라북도,055001, 50세,2018,30573,15736,14837,106.1,30101,15521,14580,106.5
35,전라북도,055002, 51세,2018,28087,14315,13772,103.9,27689,14143,13546,104.4
35,전라북도,055003, 52세,2018,28522,14877,13645,109,28091,14684,13407,109.5
35,전라북도,055004, 53세,2018,28610,14587,14023,104,28173,14410,13763,104.7
35,전라북도,055005, 54세,2018,26712,13853,12859,107.7,26311,13663,12648,108
35,전라북도,060,55~59세,2018,152161,76491,75670,101.1,150558,75790,74768,101.4
35,전라북도,060001, 55세,2018,28069,14432,13637,105.8,27660,14229,13431,105.9
35,전라북도,060002, 56세,2018,29789,15309,14480,105.7,29414,15150,14264,106.2
35,전라북도,060003, 57세,2018,31968,15966,16002,99.8,31715,15870,15845,100.2
35,전라북도,060004, 58세,2018,33551,16587,16964,97.8,33233,16449,16784,98
35,전라북도,060005, 59세,2018,28784,14197,14587,97.3,28536,14092,14444,97.6
35,전라북도,065,60~64세,2018,128339,63900,64439,99.2,127277,63395,63882,99.2
35,전라북도,065001, 60세,2018,26512,13245,13267,99.8,26252,13126,13126,100
35,전라북도,065002, 61세,2018,27141,13714,13427,102.1,26903,13603,13300,102.3
35,전라북도,065003, 62세,2018,25096,12552,12544,100.1,24889,12454,12435,100.2
35,전라북도,065004, 63세,2018,26474,13060,13414,97.4,26275,12959,13316,97.3
35,전라북도,065005, 64세,2018,23116,11329,11787,96.1,22958,11253,11705,96.1
35,전라북도,070,65~69세,2018,97155,46717,50438,92.6,96706,46511,50195,92.7
35,전라북도,070001, 65세,2018,18589,9038,9551,94.6,18463,8978,9485,94.7
35,전라북도,070002, 66세,2018,20784,10163,10621,95.7,20701,10118,10583,95.6
35,전라북도,070003, 67세,2018,18364,8915,9449,94.3,18270,8870,9400,94.4
35,전라북도,070004, 68세,2018,20682,9888,10794,91.6,20591,9851,10740,91.7
35,전라북도,070005, 69세,2018,18736,8713,10023,86.9,18681,8694,9987,87.1
35,전라북도,075,70~74세,2018,81196,37408,43788,85.4,80965,37298,43667,85.4
35,전라북도,075001, 70세,2018,18441,8719,9722,89.7,18381,8684,9697,89.6
35,전라북도,075002, 71세,2018,19983,9478,10505,90.2,19928,9452,10476,90.2
35,전라북도,075003, 72세,2018,15221,7182,8039,89.3,15173,7163,8010,89.4
35,전라북도,075004, 73세,2018,13711,6027,7684,78.4,13674,6004,7670,78.3
35,전라북도,075005, 74세,2018,13840,6002,7838,76.6,13809,5995,7814,76.7
35,전라북도,080,75~79세,2018,77832,31280,46552,67.2,77741,31256,46485,67.2
35,전라북도,080001, 75세,2018,14844,6206,8638,71.8,14824,6201,8623,71.9
35,전라북도,080002, 76세,2018,21002,8547,12455,68.6,20984,8542,12442,68.7
35,전라북도,080003, 77세,2018,14565,5870,8695,67.5,14552,5866,8686,67.5
35,전라북도,080004, 78세,2018,13398,5214,8184,63.7,13375,5208,8167,63.8
35,전라북도,080005, 79세,2018,14023,5443,8580,63.4,14006,5439,8567,63.5
35,전라북도,085,80~84세,2018,54685,19171,35514,54,54628,19149,35479,54
35,전라북도,085001, 80세,2018,12849,4708,8141,57.8,12836,4704,8132,57.8
35,전라북도,085002, 81세,2018,11792,4281,7511,57,11773,4274,7499,57
35,전라북도,085003, 82세,2018,10613,3748,6865,54.6,10602,3743,6859,54.6
35,전라북도,085004, 83세,2018,10494,3521,6973,50.5,10486,3517,6969,50.5
35,전라북도,085005, 84세,2018,8937,2913,6024,48.4,8931,2911,6020,48.4
35,전라북도,090,85~89세,2018,26724,7481,19243,38.9,26702,7468,19234,38.8
35,전라북도,090001, 85세,2018,7506,2315,5191,44.6,7502,2311,5191,44.5
35,전라북도,090002, 86세,2018,6308,1803,4505,40,6305,1801,4504,40
35,전라북도,090003, 87세,2018,4892,1326,3566,37.2,4888,1323,3565,37.1
35,전라북도,090004, 88세,2018,4459,1089,3370,32.3,4452,1085,3367,32.2
35,전라북도,090005, 89세,2018,3559,948,2611,36.3,3555,948,2607,36.4
35,전라북도,095,90~94세,2018,8587,1971,6616,29.8,8583,1969,6614,29.8
35,전라북도,095001, 90세,2018,3062,715,2347,30.5,3061,715,2346,30.5
35,전라북도,095002, 91세,2018,2351,531,1820,29.2,2350,531,1819,29.2
35,전라북도,095003, 92세,2018,1421,328,1093,30,1420,327,1093,29.9
35,전라북도,095004, 93세,2018,1016,229,787,29.1,1015,228,787,29
35,전라북도,095005, 94세,2018,737,168,569,29.5,737,168,569,29.5
35,전라북도,100,95~99세,2018,2021,347,1674,20.7,2021,347,1674,20.7
35,전라북도,100001, 95세,2018,772,130,642,20.2,772,130,642,20.2
35,전라북도,100002, 96세,2018,560,108,452,23.9,560,108,452,23.9
35,전라북도,100003, 97세,2018,303,54,249,21.7,303,54,249,21.7
35,전라북도,100004, 98세,2018,243,35,208,16.8,243,35,208,16.8
35,전라북도,100005, 99세,2018,143,20,123,16.3,143,20,123,16.3
35,전라북도,101,100세이상,2018,246,36,210,17.1,246,36,210,17.1
35,전라북도,102,15세미만,2018,223458,115243,108215,106.5,222830,114905,107925,106.5
35,전라북도,103,15~64세,2018,1246253,648029,598224,108.3,1208604,627593,581011,108
35,전라북도,104,65세이상,2018,348446,144411,204035,70.8,347592,144034,203558,70.8
35,전라북도,086,85세이상,2018,37578,9835,27743,35.5,37552,9820,27732,35.4
35,전라북도,126,평균연령,2018,43.9,42.2,45.6,,44.1,42.4,45.8,
35,전라북도,127,중위연령,2018,45.4,43.7,47.1,,45.8,44.2,47.5,
35004, 읍부,000,합계,2018,158711,79872,78839,101.3,153766,77233,76533,100.9
35004, 읍부,005,0~4세,2018,6083,3135,2948,106.3,6056,3120,2936,106.3
35004, 읍부,005001, 0세,2018,1044,522,522,100,1040,521,519,100.4
35004, 읍부,005002, 1세,2018,1116,574,542,105.9,1106,570,536,106.3
35004, 읍부,005003, 2세,2018,1248,644,604,106.6,1245,641,604,106.1
35004, 읍부,005004, 3세,2018,1351,695,656,105.9,1345,691,654,105.7
35004, 읍부,005005, 4세,2018,1324,700,624,112.2,1320,697,623,111.9
35004, 읍부,010,5~9세,2018,7638,3966,3672,108,7627,3960,3667,108
35004, 읍부,010001, 5세,2018,1474,761,713,106.7,1473,761,712,106.9
35004, 읍부,010002, 6세,2018,1570,814,756,107.7,1568,812,756,107.4
35004, 읍부,010003, 7세,2018,1624,843,781,107.9,1621,841,780,107.8
35004, 읍부,010004, 8세,2018,1502,827,675,122.5,1500,826,674,122.6
35004, 읍부,010005, 9세,2018,1468,721,747,96.5,1465,720,745,96.6
35004, 읍부,015,10~14세,2018,7319,3789,3530,107.3,7308,3781,3527,107.2
35004, 읍부,015001, 10세,2018,1543,804,739,108.8,1541,803,738,108.8
35004, 읍부,015002, 11세,2018,1530,770,760,101.3,1530,770,760,101.3
35004, 읍부,015003, 12세,2018,1423,746,677,110.2,1421,744,677,109.9
35004, 읍부,015004, 13세,2018,1392,696,696,100,1388,693,695,99.7
35004, 읍부,015005, 14세,2018,1431,773,658,117.5,1428,771,657,117.4
35004, 읍부,020,15~19세,2018,9593,5221,4372,119.4,9408,5096,4312,118.2
35004, 읍부,020001, 15세,2018,1502,773,729,106,1498,772,726,106.3
35004, 읍부,020002, 16세,2018,1720,914,806,113.4,1715,912,803,113.6
35004, 읍부,020003, 17세,2018,2025,1079,946,114.1,2021,1077,944,114.1
35004, 읍부,020004, 18세,2018,2186,1198,988,121.3,2147,1168,979,119.3
35004, 읍부,020005, 19세,2018,2160,1257,903,139.2,2027,1167,860,135.7
35004, 읍부,025,20~24세,2018,10370,6054,4316,140.3,9353,5488,3865,142
35004, 읍부,025001, 20세,2018,2255,1273,982,129.6,2097,1174,923,127.2
35004, 읍부,025002, 21세,2018,2189,1269,920,137.9,1995,1149,846,135.8
35004, 읍부,025003, 22세,2018,2044,1192,852,139.9,1814,1073,741,144.8
35004, 읍부,025004, 23세,2018,1959,1209,750,161.2,1734,1088,646,168.4
35004, 읍부,025005, 24세,2018,1923,1111,812,136.8,1713,1004,709,141.6
35004, 읍부,030,25~29세,2018,7691,4207,3484,120.8,6744,3683,3061,120.3
35004, 읍부,030001, 25세,2018,1680,957,723,132.4,1464,844,620,136.1
35004, 읍부,030002, 26세,2018,1592,851,741,114.8,1417,763,654,116.7
35004, 읍부,030003, 27세,2018,1527,843,684,123.2,1330,724,606,119.5
35004, 읍부,030004, 28세,2018,1459,802,657,122.1,1282,703,579,121.4
35004, 읍부,030005, 29세,2018,1433,754,679,111,1251,649,602,107.8
35004, 읍부,035,30~34세,2018,7837,3971,3866,102.7,7026,3537,3489,101.4
35004, 읍부,035001, 30세,2018,1491,764,727,105.1,1304,653,651,100.3
35004, 읍부,035002, 31세,2018,1518,778,740,105.1,1323,678,645,105.1
35004, 읍부,035003, 32세,2018,1559,797,762,104.6,1413,719,694,103.6
35004, 읍부,035004, 33세,2018,1563,779,784,99.4,1420,705,715,98.6
35004, 읍부,035005, 34세,2018,1706,853,853,100,1566,782,784,99.7
35004, 읍부,040,35~39세,2018,10491,5330,5161,103.3,9948,5045,4903,102.9
35004, 읍부,040001, 35세,2018,1808,904,904,100,1692,849,843,100.7
35004, 읍부,040002, 36세,2018,2096,1038,1058,98.1,1974,973,1001,97.2
35004, 읍부,040003, 37세,2018,2105,1074,1031,104.2,2004,1015,989,102.6
35004, 읍부,040004, 38세,2018,2291,1161,1130,102.7,2175,1100,1075,102.3
35004, 읍부,040005, 39세,2018,2191,1153,1038,111.1,2103,1108,995,111.4
35004, 읍부,045,40~44세,2018,10724,5751,4973,115.6,10387,5572,4815,115.7
35004, 읍부,045001, 40세,2018,1990,1026,964,106.4,1911,977,934,104.6
35004, 읍부,045002, 41세,2018,2099,1111,988,112.4,2036,1083,953,113.6
35004, 읍부,045003, 42세,2018,2086,1142,944,121,2015,1104,911,121.2
35004, 읍부,045004, 43세,2018,2064,1113,951,117,2005,1082,923,117.2
35004, 읍부,045005, 44세,2018,2485,1359,1126,120.7,2420,1326,1094,121.2
35004, 읍부,050,45~49세,2018,11943,6500,5443,119.4,11648,6351,5297,119.9
35004, 읍부,050001, 45세,2018,2369,1276,1093,116.7,2307,1235,1072,115.2
35004, 읍부,050002, 46세,2018,2329,1259,1070,117.7,2252,1228,1024,119.9
35004, 읍부,050003, 47세,2018,2560,1401,1159,120.9,2502,1372,1130,121.4
35004, 읍부,050004, 48세,2018,2307,1258,1049,119.9,2265,1234,1031,119.7
35004, 읍부,050005, 49세,2018,2378,1306,1072,121.8,2322,1282,1040,123.3
35004, 읍부,055,50~54세,2018,11581,6292,5289,119,11303,6168,5135,120.1
35004, 읍부,055001, 50세,2018,2536,1377,1159,118.8,2483,1355,1128,120.1
35004, 읍부,055002, 51세,2018,2259,1213,1046,116,2207,1190,1017,117
35004, 읍부,055003, 52세,2018,2284,1247,1037,120.3,2220,1218,1002,121.6
35004, 읍부,055004, 53세,2018,2308,1273,1035,123,2250,1250,1000,125
35004, 읍부,055005, 54세,2018,2194,1182,1012,116.8,2143,1155,988,116.9
35004, 읍부,060,55~59세,2018,12524,6403,6121,104.6,12293,6297,5996,105
35004, 읍부,060001, 55세,2018,2186,1141,1045,109.2,2126,1116,1010,110.5
35004, 읍부,060002, 56세,2018,2446,1294,1152,112.3,2400,1271,1129,112.6
35004, 읍부,060003, 57세,2018,2635,1315,1320,99.6,2594,1297,1297,100
35004, 읍부,060004, 58세,2018,2823,1412,1411,100.1,2778,1390,1388,100.1
35004, 읍부,060005, 59세,2018,2434,1241,1193,104,2395,1223,1172,104.4
35004, 읍부,065,60~64세,2018,11233,5608,5625,99.7,11106,5542,5564,99.6
35004, 읍부,065001, 60세,2018,2243,1155,1088,106.2,2211,1135,1076,105.5
35004, 읍부,065002, 61세,2018,2332,1175,1157,101.6,2301,1161,1140,101.8
35004, 읍부,065003, 62세,2018,2273,1149,1124,102.2,2249,1138,1111,102.4
35004, 읍부,065004, 63세,2018,2334,1132,1202,94.2,2314,1122,1192,94.1
35004, 읍부,065005, 64세,2018,2051,997,1054,94.6,2031,986,1045,94.4
35004, 읍부,070,65~69세,2018,8723,4185,4538,92.2,8656,4157,4499,92.4
35004, 읍부,070001, 65세,2018,1656,848,808,105,1636,840,796,105.5
35004, 읍부,070002, 66세,2018,1844,897,947,94.7,1834,894,940,95.1
35004, 읍부,070003, 67세,2018,1641,763,878,86.9,1623,754,869,86.8
35004, 읍부,070004, 68세,2018,1852,886,966,91.7,1843,883,960,92
35004, 읍부,070005, 69세,2018,1730,791,939,84.2,1720,786,934,84.2
35004, 읍부,075,70~74세,2018,7568,3473,4095,84.8,7531,3454,4077,84.7
35004, 읍부,075001, 70세,2018,1715,806,909,88.7,1707,799,908,88
35004, 읍부,075002, 71세,2018,1840,873,967,90.3,1828,870,958,90.8
35004, 읍부,075003, 72세,2018,1409,666,743,89.6,1402,663,739,89.7
35004, 읍부,075004, 73세,2018,1293,551,742,74.3,1288,547,741,73.8
35004, 읍부,075005, 74세,2018,1311,577,734,78.6,1306,575,731,78.7
35004, 읍부,080,75~79세,2018,7594,2955,4639,63.7,7580,2954,4626,63.9
35004, 읍부,080001, 75세,2018,1353,539,814,66.2,1349,539,810,66.5
35004, 읍부,080002, 76세,2018,1972,781,1191,65.6,1970,781,1189,65.7
35004, 읍부,080003, 77세,2018,1450,577,873,66.1,1446,576,870,66.2
35004, 읍부,080004, 78세,2018,1379,520,859,60.5,1377,520,857,60.7
35004, 읍부,080005, 79세,2018,1440,538,902,59.6,1438,538,900,59.8
35004, 읍부,085,80~84세,2018,5745,1992,3753,53.1,5740,1989,3751,53
35004, 읍부,085001, 80세,2018,1341,522,819,63.7,1340,521,819,63.6
35004, 읍부,085002, 81세,2018,1151,393,758,51.8,1150,392,758,51.7
35004, 읍부,085003, 82세,2018,1169,405,764,53,1168,404,764,52.9
35004, 읍부,085004, 83세,2018,1116,376,740,50.8,1115,376,739,50.9
35004, 읍부,085005, 84세,2018,968,296,672,44,967,296,671,44.1
35004, 읍부,090,85~89세,2018,2831,789,2042,38.6,2829,788,2041,38.6
35004, 읍부,090001, 85세,2018,780,249,531,46.9,780,249,531,46.9
35004, 읍부,090002, 86세,2018,675,188,487,38.6,675,188,487,38.6
35004, 읍부,090003, 87세,2018,486,132,354,37.3,486,132,354,37.3
35004, 읍부,090004, 88세,2018,487,121,366,33.1,486,120,366,32.8
35004, 읍부,090005, 89세,2018,403,99,304,32.6,402,99,303,32.7
35004, 읍부,095,90~94세,2018,969,207,762,27.2,969,207,762,27.2
35004, 읍부,095001, 90세,2018,319,74,245,30.2,319,74,245,30.2
35004, 읍부,095002, 91세,2018,282,56,226,24.8,282,56,226,24.8
35004, 읍부,095003, 92세,2018,162,30,132,22.7,162,30,132,22.7
35004, 읍부,095004, 93세,2018,126,28,98,28.6,126,28,98,28.6
35004, 읍부,095005, 94세,2018,80,19,61,31.1,80,19,61,31.1
35004, 읍부,100,95~99세,2018,229,41,188,21.8,229,41,188,21.8
35004, 읍부,100001, 95세,2018,91,13,78,16.7,91,13,78,16.7
35004, 읍부,100002, 96세,2018,69,14,55,25.5,69,14,55,25.5
35004, 읍부,100003, 97세,2018,24,7,17,41.2,24,7,17,41.2
35004, 읍부,100004, 98세,2018,26,5,21,23.8,26,5,21,23.8
35004, 읍부,100005, 99세,2018,19,X,17,11.8,19,X,17,11.8
35004, 읍부,101,100세이상,2018,25,X,22,13.6,25,X,22,13.6
35004, 읍부,102,15세미만,2018,21040,10890,10150,107.3,20991,10861,10130,107.2
35004, 읍부,103,15~64세,2018,103987,55337,48650,113.7,99216,52779,46437,113.7
35004, 읍부,104,65세이상,2018,33684,13645,20039,68.1,33559,13593,19966,68.1
35004, 읍부,086,85세이상,2018,4054,1040,3014,34.5,4052,1039,3013,34.5
35004, 읍부,126,평균연령,2018,44.4,42.3,46.4,,44.7,42.6,46.7,
35004, 읍부,127,중위연령,2018,45.7,43.9,47.8,,46.3,44.5,48.5,
35005, 면부,000,합계,2018,368494,184244,184250,100,357633,177844,179789,98.9
35005, 면부,005,0~4세,2018,7586,3903,3683,106,7569,3893,3676,105.9
35005, 면부,005001, 0세,2018,1291,680,611,111.3,1289,680,609,111.7
35005, 면부,005002, 1세,2018,1443,738,705,104.7,1439,736,703,104.7
35005, 면부,005003, 2세,2018,1499,749,750,99.9,1493,744,749,99.3
35005, 면부,005004, 3세,2018,1650,856,794,107.8,1647,854,793,107.7
35005, 면부,005005, 4세,2018,1703,880,823,106.9,1701,879,822,106.9
35005, 면부,010,5~9세,2018,8846,4668,4178,111.7,8824,4657,4167,111.8
35005, 면부,010001, 5세,2018,1681,866,815,106.3,1674,862,812,106.2
35005, 면부,010002, 6세,2018,1810,959,851,112.7,1804,955,849,112.5
35005, 면부,010003, 7세,2018,1873,1027,846,121.4,1872,1027,845,121.5
35005, 면부,010004, 8세,2018,1750,901,849,106.1,1746,900,846,106.4
35005, 면부,010005, 9세,2018,1732,915,817,112,1728,913,815,112
35005, 면부,015,10~14세,2018,9169,4871,4298,113.3,9158,4864,4294,113.3
35005, 면부,015001, 10세,2018,1765,907,858,105.7,1765,907,858,105.7
35005, 면부,015002, 11세,2018,1872,993,879,113,1867,989,878,112.6
35005, 면부,015003, 12세,2018,1688,904,784,115.3,1686,903,783,115.3
35005, 면부,015004, 13세,2018,1762,913,849,107.5,1761,912,849,107.4
35005, 면부,015005, 14세,2018,2082,1154,928,124.4,2079,1153,926,124.5
35005, 면부,020,15~19세,2018,13467,7551,5916,127.6,13328,7481,5847,127.9
35005, 면부,020001, 15세,2018,2192,1189,1003,118.5,2184,1183,1001,118.2
35005, 면부,020002, 16세,2018,2475,1332,1143,116.5,2469,1332,1137,117.2
35005, 면부,020003, 17세,2018,2953,1637,1316,124.4,2943,1633,1310,124.7
35005, 면부,020004, 18세,2018,3144,1804,1340,134.6,3118,1786,1332,134.1
35005, 면부,020005, 19세,2018,2703,1589,1114,142.6,2614,1547,1067,145
35005, 면부,025,20~24세,2018,16619,9926,6693,148.3,14750,8779,5971,147
35005, 면부,025001, 20세,2018,3131,1882,1249,150.7,2861,1717,1144,150.1
35005, 면부,025002, 21세,2018,3326,1988,1338,148.6,3036,1812,1224,148
35005, 면부,025003, 22세,2018,3465,1990,1475,134.9,3100,1767,1333,132.6
35005, 면부,025004, 23세,2018,3378,2063,1315,156.9,2929,1783,1146,155.6
35005, 면부,025005, 24세,2018,3319,2003,1316,152.2,2824,1700,1124,151.2
35005, 면부,030,25~29세,2018,15052,8811,6241,141.2,12537,7157,5380,133
35005, 면부,030001, 25세,2018,3077,1783,1294,137.8,2603,1491,1112,134.1
35005, 면부,030002, 26세,2018,3005,1768,1237,142.9,2507,1431,1076,133
35005, 면부,030003, 27세,2018,3094,1799,1295,138.9,2558,1457,1101,132.3
35005, 면부,030004, 28세,2018,3056,1792,1264,141.8,2538,1452,1086,133.7
35005, 면부,030005, 29세,2018,2820,1669,1151,145,2331,1326,1005,131.9
35005, 면부,035,30~34세,2018,13875,7963,5912,134.7,11707,6550,5157,127
35005, 면부,035001, 30세,2018,2855,1665,1190,139.9,2339,1327,1012,131.1
35005, 면부,035002, 31세,2018,2732,1595,1137,140.3,2264,1268,996,127.3
35005, 면부,035003, 32세,2018,2789,1592,1197,133,2373,1325,1048,126.4
35005, 면부,035004, 33세,2018,2627,1478,1149,128.6,2216,1218,998,122
35005, 면부,035005, 34세,2018,2872,1633,1239,131.8,2515,1412,1103,128
35005, 면부,040,35~39세,2018,15292,8861,6431,137.8,13947,8064,5883,137.1
35005, 면부,040001, 35세,2018,2841,1591,1250,127.3,2529,1404,1125,124.8
35005, 면부,040002, 36세,2018,3111,1807,1304,138.6,2824,1637,1187,137.9
35005, 면부,040003, 37세,2018,3111,1824,1287,141.7,2863,1677,1186,141.4
35005, 면부,040004, 38세,2018,3193,1829,1364,134.1,2938,1677,1261,133
35005, 면부,040005, 39세,2018,3036,1810,1226,147.6,2793,1669,1124,148.5
35005, 면부,045,40~44세,2018,16814,10046,6768,148.4,16041,9639,6402,150.6
35005, 면부,045001, 40세,2018,3028,1812,1216,149,2834,1703,1131,150.6
35005, 면부,045002, 41세,2018,3109,1847,1262,146.4,2942,1748,1194,146.4
35005, 면부,045003, 42세,2018,3314,1979,1335,148.2,3156,1897,1259,150.7
35005, 면부,045004, 43세,2018,3382,2029,1353,150,3248,1968,1280,153.8
35005, 면부,045005, 44세,2018,3981,2379,1602,148.5,3861,2323,1538,151
35005, 면부,050,45~49세,2018,22470,13124,9346,140.4,21820,12825,8995,142.6
35005, 면부,050001, 45세,2018,4170,2477,1693,146.3,4035,2410,1625,148.3
35005, 면부,050002, 46세,2018,4177,2455,1722,142.6,4038,2399,1639,146.4
35005, 면부,050003, 47세,2018,4655,2763,1892,146,4516,2700,1816,148.7
35005, 면부,050004, 48세,2018,4457,2597,1860,139.6,4339,2538,1801,140.9
35005, 면부,050005, 49세,2018,5011,2832,2179,130,4892,2778,2114,131.4
35005, 면부,055,50~54세,2018,27653,15195,12458,122,27092,14958,12134,123.3
35005, 면부,055001, 50세,2018,5458,3077,2381,129.2,5330,3020,2310,130.7
35005, 면부,055002, 51세,2018,5186,2835,2351,120.6,5081,2793,2288,122.1
35005, 면부,055003, 52세,2018,5551,3081,2470,124.7,5453,3039,2414,125.9
35005, 면부,055004, 53세,2018,5808,3143,2665,117.9,5687,3097,2590,119.6
35005, 면부,055005, 54세,2018,5650,3059,2591,118.1,5541,3009,2532,118.8
35005, 면부,060,55~59세,2018,36293,18749,17544,106.9,35932,18598,17334,107.3
35005, 면부,060001, 55세,2018,5999,3214,2785,115.4,5899,3161,2738,115.4
35005, 면부,060002, 56세,2018,6961,3671,3290,111.6,6880,3645,3235,112.7
35005, 면부,060003, 57세,2018,7717,3987,3730,106.9,7658,3964,3694,107.3
35005, 면부,060004, 58세,2018,8324,4189,4135,101.3,8254,4158,4096,101.5
35005, 면부,060005, 59세,2018,7292,3688,3604,102.3,7241,3670,3571,102.8
35005, 면부,065,60~64세,2018,35830,18197,17633,103.2,35580,18086,17494,103.4
35005, 면부,065001, 60세,2018,6967,3504,3463,101.2,6919,3482,3437,101.3
35005, 면부,065002, 61세,2018,7401,3862,3539,109.1,7346,3842,3504,109.6
35005, 면부,065003, 62세,2018,7086,3631,3455,105.1,7031,3605,3426,105.2
35005, 면부,065004, 63세,2018,7518,3785,3733,101.4,7461,3755,3706,101.3
35005, 면부,065005, 64세,2018,6858,3415,3443,99.2,6823,3402,3421,99.4
35005, 면부,070,65~69세,2018,30257,14633,15624,93.7,30160,14584,15576,93.6
35005, 면부,070001, 65세,2018,5452,2713,2739,99.1,5425,2698,2727,98.9
35005, 면부,070002, 66세,2018,6347,3053,3294,92.7,6323,3040,3283,92.6
35005, 면부,070003, 67세,2018,5811,2797,3014,92.8,5796,2791,3005,92.9
35005, 면부,070004, 68세,2018,6593,3217,3376,95.3,6571,3206,3365,95.3
35005, 면부,070005, 69세,2018,6054,2853,3201,89.1,6045,2849,3196,89.1
35005, 면부,075,70~74세,2018,28041,12922,15119,85.5,27991,12900,15091,85.5
35005, 면부,075001, 70세,2018,6198,3031,3167,95.7,6182,3020,3162,95.5
35005, 면부,075002, 71세,2018,6692,3181,3511,90.6,6682,3177,3505,90.6
35005, 면부,075003, 72세,2018,5215,2455,2760,88.9,5205,2452,2753,89.1
35005, 면부,075004, 73세,2018,4877,2131,2746,77.6,4870,2127,2743,77.5
35005, 면부,075005, 74세,2018,5059,2124,2935,72.4,5052,2124,2928,72.5
35005, 면부,080,75~79세,2018,31813,12350,19463,63.5,31796,12345,19451,63.5
35005, 면부,080001, 75세,2018,5769,2371,3398,69.8,5766,2369,3397,69.7
35005, 면부,080002, 76세,2018,8529,3346,5183,64.6,8526,3346,5180,64.6
35005, 면부,080003, 77세,2018,5998,2322,3676,63.2,5995,2322,3673,63.2
35005, 면부,080004, 78세,2018,5466,2058,3408,60.4,5460,2056,3404,60.4
35005, 면부,080005, 79세,2018,6051,2253,3798,59.3,6049,2252,3797,59.3
35005, 면부,085,80~84세,2018,23543,8144,15399,52.9,23533,8139,15394,52.9
35005, 면부,085001, 80세,2018,5460,1941,3519,55.2,5457,1941,3516,55.2
35005, 면부,085002, 81세,2018,5092,1824,3268,55.8,5090,1823,3267,55.8
35005, 면부,085003, 82세,2018,4562,1593,2969,53.7,4560,1592,2968,53.6
35005, 면부,085004, 83세,2018,4525,1480,3045,48.6,4524,1479,3045,48.6
35005, 면부,085005, 84세,2018,3904,1306,2598,50.3,3902,1304,2598,50.2
35005, 면부,090,85~89세,2018,11363,3255,8108,40.1,11358,3250,8108,40.1
35005, 면부,090001, 85세,2018,3238,996,2242,44.4,3237,995,2242,44.4
35005, 면부,090002, 86세,2018,2705,787,1918,41,2705,787,1918,41
35005, 면부,090003, 87세,2018,2130,601,1529,39.3,2129,600,1529,39.2
35005, 면부,090004, 88세,2018,1849,467,1382,33.8,1846,464,1382,33.6
35005, 면부,090005, 89세,2018,1441,404,1037,39,1441,404,1037,39
35005, 면부,095,90~94세,2018,3582,905,2677,33.8,3581,905,2676,33.8
35005, 면부,095001, 90세,2018,1290,318,972,32.7,1289,318,971,32.7
35005, 면부,095002, 91세,2018,979,247,732,33.7,979,247,732,33.7
35005, 면부,095003, 92세,2018,594,160,434,36.9,594,160,434,36.9
35005, 면부,095004, 93세,2018,435,108,327,33,435,108,327,33
35005, 면부,095005, 94세,2018,284,72,212,34,284,72,212,34
35005, 면부,100,95~99세,2018,837,158,679,23.3,837,158,679,23.3
35005, 면부,100001, 95세,2018,303,60,243,24.7,303,60,243,24.7
35005, 면부,100002, 96세,2018,231,46,185,24.9,231,46,185,24.9
35005, 면부,100003, 97세,2018,132,24,108,22.2,132,24,108,22.2
35005, 면부,100004, 98세,2018,115,16,99,16.2,115,16,99,16.2
35005, 면부,100005, 99세,2018,56,12,44,27.3,56,12,44,27.3
35005, 면부,101,100세이상,2018,92,12,80,15,92,12,80,15
35005, 면부,102,15세미만,2018,25601,13442,12159,110.6,25551,13414,12137,110.5
35005, 면부,103,15~64세,2018,213365,118423,94942,124.7,202734,112137,90597,123.8
35005, 면부,104,65세이상,2018,129528,52379,77149,67.9,129348,52293,77055,67.9
35005, 면부,086,85세이상,2018,15874,4330,11544,37.5,15868,4325,11543,37.5
35005, 면부,126,평균연령,2018,53.5,50.5,56.5,,54,51.1,57,
35005, 면부,127,중위연령,2018,57.6,54.1,60.8,,58.2,55,61.3,
35003, 동부,000,합계,2018,1290952,643567,647385,99.4,1267627,631455,636172,99.3
35003, 동부,005,0~4세,2018,49902,25535,24367,104.8,49586,25365,24221,104.7
35003, 동부,005001, 0세,2018,7943,4049,3894,104,7879,4015,3864,103.9
35003, 동부,005002, 1세,2018,8960,4556,4404,103.5,8875,4508,4367,103.2
35003, 동부,005003, 2세,2018,10401,5353,5048,106,10346,5326,5020,106.1
35003, 동부,005004, 3세,2018,11281,5747,5534,103.8,11218,5713,5505,103.8
35003, 동부,005005, 4세,2018,11317,5830,5487,106.3,11268,5803,5465,106.2
35003, 동부,010,5~9세,2018,62379,31980,30399,105.2,62250,31906,30344,105.1
35003, 동부,010001, 5세,2018,11836,6159,5677,108.5,11806,6140,5666,108.4
35003, 동부,010002, 6세,2018,12994,6630,6364,104.2,12963,6613,6350,104.1
35003, 동부,010003, 7세,2018,13122,6631,6491,102.2,13097,6618,6479,102.1
35003, 동부,010004, 8세,2018,12431,6373,6058,105.2,12409,6361,6048,105.2
35003, 동부,010005, 9세,2018,11996,6187,5809,106.5,11975,6174,5801,106.4
35003, 동부,015,10~14세,2018,64536,33396,31140,107.2,64452,33359,31093,107.3
35003, 동부,015001, 10세,2018,12771,6626,6145,107.8,12751,6620,6131,108
35003, 동부,015002, 11세,2018,13289,6828,6461,105.7,13275,6821,6454,105.7
35003, 동부,015003, 12세,2018,12372,6410,5962,107.5,12360,6404,5956,107.5
35003, 동부,015004, 13세,2018,12556,6636,5920,112.1,12547,6632,5915,112.1
35003, 동부,015005, 14세,2018,13548,6896,6652,103.7,13519,6882,6637,103.7
35003, 동부,020,15~19세,2018,85379,44672,40707,109.7,84248,44097,40151,109.8
35003, 동부,020001, 15세,2018,14264,7323,6941,105.5,14246,7314,6932,105.5
35003, 동부,020002, 16세,2018,15061,7926,7135,111.1,15036,7912,7124,111.1
35003, 동부,020003, 17세,2018,17390,8894,8496,104.7,17333,8867,8466,104.7
35003, 동부,020004, 18세,2018,19544,10213,9331,109.5,19276,10075,9201,109.5
35003, 동부,020005, 19세,2018,19120,10316,8804,117.2,18357,9929,8428,117.8
35003, 동부,025,20~24세,2018,101035,55091,45944,119.9,96146,52505,43641,120.3
35003, 동부,025001, 20세,2018,20199,10754,9445,113.9,19127,10203,8924,114.3
35003, 동부,025002, 21세,2018,20470,10804,9666,111.8,19464,10259,9205,111.5
35003, 동부,025003, 22세,2018,20969,11519,9450,121.9,20077,11049,9028,122.4
35003, 동부,025004, 23세,2018,20059,11147,8912,125.1,19080,10627,8453,125.7
35003, 동부,025005, 24세,2018,19338,10867,8471,128.3,18398,10367,8031,129.1
35003, 동부,030,25~29세,2018,78203,41832,36371,115,74054,39652,34402,115.3
35003, 동부,030001, 25세,2018,17779,9757,8022,121.6,16866,9293,7573,122.7
35003, 동부,030002, 26세,2018,16874,8998,7876,114.2,16005,8541,7464,114.4
35003, 동부,030003, 27세,2018,15429,8130,7299,111.4,14610,7703,6907,111.5
35003, 동부,030004, 28세,2018,14355,7654,6701,114.2,13558,7232,6326,114.3
35003, 동부,030005, 29세,2018,13766,7293,6473,112.7,13015,6883,6132,112.2
35003, 동부,035,30~34세,2018,70943,36341,34602,105,67527,34449,33078,104.1
35003, 동부,035001, 30세,2018,13565,6993,6572,106.4,12799,6580,6219,105.8
35003, 동부,035002, 31세,2018,13598,6992,6606,105.8,12880,6588,6292,104.7
35003, 동부,035003, 32세,2018,14114,7242,6872,105.4,13437,6868,6569,104.6
35003, 동부,035004, 33세,2018,14139,7204,6935,103.9,13506,6854,6652,103
35003, 동부,035005, 34세,2018,15527,7910,7617,103.8,14905,7559,7346,102.9
35003, 동부,040,35~39세,2018,92817,46927,45890,102.3,90428,45616,44812,101.8
35003, 동부,040001, 35세,2018,16989,8648,8341,103.7,16448,8362,8086,103.4
35003, 동부,040002, 36세,2018,18641,9443,9198,102.7,18153,9164,8989,101.9
35003, 동부,040003, 37세,2018,18556,9453,9103,103.8,18102,9217,8885,103.7
35003, 동부,040004, 38세,2018,19748,9908,9840,100.7,19284,9655,9629,100.3
35003, 동부,040005, 39세,2018,18883,9475,9408,100.7,18441,9218,9223,99.9
35003, 동부,045,40~44세,2018,98453,48788,49665,98.2,96792,47926,48866,98.1
35003, 동부,045001, 40세,2018,18067,8957,9110,98.3,17700,8775,8925,98.3
35003, 동부,045002, 41세,2018,18868,9328,9540,97.8,18532,9155,9377,97.6
35003, 동부,045003, 42세,2018,18924,9435,9489,99.4,18594,9247,9347,98.9
35003, 동부,045004, 43세,2018,19873,9810,10063,97.5,19556,9644,9912,97.3
35003, 동부,045005, 44세,2018,22721,11258,11463,98.2,22410,11105,11305,98.2
35003, 동부,050,45~49세,2018,114181,57303,56878,100.7,112565,56475,56090,100.7
35003, 동부,050001, 45세,2018,22451,11031,11420,96.6,22115,10858,11257,96.5
35003, 동부,050002, 46세,2018,22141,11255,10886,103.4,21807,11075,10732,103.2
35003, 동부,050003, 47세,2018,24100,12182,11918,102.2,23780,12023,11757,102.3
35003, 동부,050004, 48세,2018,22793,11496,11297,101.8,22451,11328,11123,101.8
35003, 동부,050005, 49세,2018,22696,11339,11357,99.8,22412,11191,11221,99.7
35003, 동부,055,50~54세,2018,103270,51881,51389,101,101970,51295,50675,101.2
35003, 동부,055001, 50세,2018,22579,11282,11297,99.9,22288,11146,11142,100
35003, 동부,055002, 51세,2018,20642,10267,10375,99,20401,10160,10241,99.2
35003, 동부,055003, 52세,2018,20687,10549,10138,104.1,20418,10427,9991,104.4
35003, 동부,055004, 53세,2018,20494,10171,10323,98.5,20236,10063,10173,98.9
35003, 동부,055005, 54세,2018,18868,9612,9256,103.8,18627,9499,9128,104.1
35003, 동부,060,55~59세,2018,103344,51339,52005,98.7,102333,50895,51438,98.9
35003, 동부,060001, 55세,2018,19884,10077,9807,102.8,19635,9952,9683,102.8
35003, 동부,060002, 56세,2018,20382,10344,10038,103,20134,10234,9900,103.4
35003, 동부,060003, 57세,2018,21616,10664,10952,97.4,21463,10609,10854,97.7
35003, 동부,060004, 58세,2018,22404,10986,11418,96.2,22201,10901,11300,96.5
35003, 동부,060005, 59세,2018,19058,9268,9790,94.7,18900,9199,9701,94.8
35003, 동부,065,60~64세,2018,81276,40095,41181,97.4,80591,39767,40824,97.4
35003, 동부,065001, 60세,2018,17302,8586,8716,98.5,17122,8509,8613,98.8
35003, 동부,065002, 61세,2018,17408,8677,8731,99.4,17256,8600,8656,99.4
35003, 동부,065003, 62세,2018,15737,7772,7965,97.6,15609,7711,7898,97.6
35003, 동부,065004, 63세,2018,16622,8143,8479,96,16500,8082,8418,96
35003, 동부,065005, 64세,2018,14207,6917,7290,94.9,14104,6865,7239,94.8
35003, 동부,070,65~69세,2018,58175,27899,30276,92.1,57890,27770,30120,92.2
35003, 동부,070001, 65세,2018,11481,5477,6004,91.2,11402,5440,5962,91.2
35003, 동부,070002, 66세,2018,12593,6213,6380,97.4,12544,6184,6360,97.2
35003, 동부,070003, 67세,2018,10912,5355,5557,96.4,10851,5325,5526,96.4
35003, 동부,070004, 68세,2018,12237,5785,6452,89.7,12177,5762,6415,89.8
35003, 동부,070005, 69세,2018,10952,5069,5883,86.2,10916,5059,5857,86.4
35003, 동부,075,70~74세,2018,45587,21013,24574,85.5,45443,20944,24499,85.5
35003, 동부,075001, 70세,2018,10528,4882,5646,86.5,10492,4865,5627,86.5
35003, 동부,075002, 71세,2018,11451,5424,6027,90,11418,5405,6013,89.9
35003, 동부,075003, 72세,2018,8597,4061,4536,89.5,8566,4048,4518,89.6
35003, 동부,075004, 73세,2018,7541,3345,4196,79.7,7516,3330,4186,79.6
35003, 동부,075005, 74세,2018,7470,3301,4169,79.2,7451,3296,4155,79.3
35003, 동부,080,75~79세,2018,38425,15975,22450,71.2,38365,15957,22408,71.2
35003, 동부,080001, 75세,2018,7722,3296,4426,74.5,7709,3293,4416,74.6
35003, 동부,080002, 76세,2018,10501,4420,6081,72.7,10488,4415,6073,72.7
35003, 동부,080003, 77세,2018,7117,2971,4146,71.7,7111,2968,4143,71.6
35003, 동부,080004, 78세,2018,6553,2636,3917,67.3,6538,2632,3906,67.4
35003, 동부,080005, 79세,2018,6532,2652,3880,68.4,6519,2649,3870,68.4
35003, 동부,085,80~84세,2018,25397,9035,16362,55.2,25355,9021,16334,55.2
35003, 동부,085001, 80세,2018,6048,2245,3803,59,6039,2242,3797,59
35003, 동부,085002, 81세,2018,5549,2064,3485,59.2,5533,2059,3474,59.3
35003, 동부,085003, 82세,2018,4882,1750,3132,55.9,4874,1747,3127,55.9
35003, 동부,085004, 83세,2018,4853,1665,3188,52.2,4847,1662,3185,52.2
35003, 동부,085005, 84세,2018,4065,1311,2754,47.6,4062,1311,2751,47.7
35003, 동부,090,85~89세,2018,12530,3437,9093,37.8,12515,3430,9085,37.8
35003, 동부,090001, 85세,2018,3488,1070,2418,44.3,3485,1067,2418,44.1
35003, 동부,090002, 86세,2018,2928,828,2100,39.4,2925,826,2099,39.4
35003, 동부,090003, 87세,2018,2276,593,1683,35.2,2273,591,1682,35.1
35003, 동부,090004, 88세,2018,2123,501,1622,30.9,2120,501,1619,30.9
35003, 동부,090005, 89세,2018,1715,445,1270,35,1712,445,1267,35.1
35003, 동부,095,90~94세,2018,4036,859,3177,27,4033,857,3176,27
35003, 동부,095001, 90세,2018,1453,323,1130,28.6,1453,323,1130,28.6
35003, 동부,095002, 91세,2018,1090,228,862,26.5,1089,228,861,26.5
35003, 동부,095003, 92세,2018,665,138,527,26.2,664,137,527,26
35003, 동부,095004, 93세,2018,455,93,362,25.7,454,92,362,25.4
35003, 동부,095005, 94세,2018,373,77,296,26,373,77,296,26
35003, 동부,100,95~99세,2018,955,148,807,18.3,955,148,807,18.3
35003, 동부,100001, 95세,2018,378,57,321,17.8,378,57,321,17.8
35003, 동부,100002, 96세,2018,260,48,212,22.6,260,48,212,22.6
35003, 동부,100003, 97세,2018,147,23,124,18.5,147,23,124,18.5
35003, 동부,100004, 98세,2018,102,14,88,15.9,102,14,88,15.9
35003, 동부,100005, 99세,2018,68,6,62,9.7,68,6,62,9.7
35003, 동부,101,100세이상,2018,129,21,108,19.4,129,21,108,19.4
35003, 동부,102,15세미만,2018,176817,90911,85906,105.8,176288,90630,85658,105.8
35003, 동부,103,15~64세,2018,928901,474269,454632,104.3,906654,462677,443977,104.2
35003, 동부,104,65세이상,2018,185234,78387,106847,73.4,184685,78148,106537,73.4
35003, 동부,086,85세이상,2018,17650,4465,13185,33.9,17632,4456,13176,33.8
35003, 동부,126,평균연령,2018,41.1,39.8,42.4,,41.2,39.9,42.5,
35003, 동부,127,중위연령,2018,42.2,40.7,43.6,,42.5,41,43.9,
35010, 전주시,000,합계,2018,658912,325610,333302,97.7,649368,321103,328265,97.8
35010, 전주시,005,0~4세,2018,25417,13043,12374,105.4,25235,12947,12288,105.4
35010, 전주시,005001, 0세,2018,3975,2056,1919,107.1,3936,2033,1903,106.8
35010, 전주시,005002, 1세,2018,4586,2358,2228,105.8,4536,2329,2207,105.5
35010, 전주시,005003, 2세,2018,5334,2778,2556,108.7,5298,2760,2538,108.7
35010, 전주시,005004, 3세,2018,5736,2879,2857,100.8,5703,2861,2842,100.7
35010, 전주시,005005, 4세,2018,5786,2972,2814,105.6,5762,2964,2798,105.9
35010, 전주시,010,5~9세,2018,31714,16272,15442,105.4,31652,16232,15420,105.3
35010, 전주시,010001, 5세,2018,5965,3111,2854,109,5954,3103,2851,108.8
35010, 전주시,010002, 6세,2018,6593,3325,3268,101.7,6577,3316,3261,101.7
35010, 전주시,010003, 7세,2018,6598,3349,3249,103.1,6585,3340,3245,102.9
35010, 전주시,010004, 8세,2018,6433,3333,3100,107.5,6418,3325,3093,107.5
35010, 전주시,010005, 9세,2018,6125,3154,2971,106.2,6118,3148,2970,106
35010, 전주시,015,10~14세,2018,33189,17262,15927,108.4,33161,17249,15912,108.4
35010, 전주시,015001, 10세,2018,6576,3397,3179,106.9,6568,3395,3173,107
35010, 전주시,015002, 11세,2018,6787,3552,3235,109.8,6783,3549,3234,109.7
35010, 전주시,015003, 12세,2018,6333,3313,3020,109.7,6330,3311,3019,109.7
35010, 전주시,015004, 13세,2018,6505,3447,3058,112.7,6503,3445,3058,112.7
35010, 전주시,015005, 14세,2018,6988,3553,3435,103.4,6977,3549,3428,103.5
35010, 전주시,020,15~19세,2018,44754,23218,21536,107.8,44069,22878,21191,108
35010, 전주시,020001, 15세,2018,7355,3812,3543,107.6,7348,3809,3539,107.6
35010, 전주시,020002, 16세,2018,7762,4044,3718,108.8,7755,4039,3716,108.7
35010, 전주시,020003, 17세,2018,8828,4486,4342,103.3,8804,4476,4328,103.4
35010, 전주시,020004, 18세,2018,10479,5405,5074,106.5,10291,5320,4971,107
35010, 전주시,020005, 19세,2018,10330,5471,4859,112.6,9871,5234,4637,112.9
35010, 전주시,025,20~24세,2018,53670,28488,25182,113.1,51201,27265,23936,113.9
35010, 전주시,025001, 20세,2018,10727,5584,5143,108.6,10170,5301,4869,108.9
35010, 전주시,025002, 21세,2018,10900,5594,5306,105.4,10339,5310,5029,105.6
35010, 전주시,025003, 22세,2018,11037,5938,5099,116.5,10582,5719,4863,117.6
35010, 전주시,025004, 23세,2018,10679,5752,4927,116.7,10210,5523,4687,117.8
35010, 전주시,025005, 24세,2018,10327,5620,4707,119.4,9900,5412,4488,120.6
35010, 전주시,030,25~29세,2018,42562,22392,20170,111,40873,21604,19269,112.1
35010, 전주시,030001, 25세,2018,9649,5199,4450,116.8,9235,5004,4231,118.3
35010, 전주시,030002, 26세,2018,9253,4858,4395,110.5,8890,4694,4196,111.9
35010, 전주시,030003, 27세,2018,8448,4389,4059,108.1,8129,4244,3885,109.2
35010, 전주시,030004, 28세,2018,7816,4121,3695,111.5,7523,3987,3536,112.8
35010, 전주시,030005, 29세,2018,7396,3825,3571,107.1,7096,3675,3421,107.4
35010, 전주시,035,30~34세,2018,37588,18920,18668,101.3,36321,18332,17989,101.9
35010, 전주시,035001, 30세,2018,7271,3713,3558,104.4,6979,3571,3408,104.8
35010, 전주시,035002, 31세,2018,7310,3653,3657,99.9,7026,3525,3501,100.7
35010, 전주시,035003, 32세,2018,7502,3769,3733,101,7246,3654,3592,101.7
35010, 전주시,035004, 33세,2018,7427,3778,3649,103.5,7199,3680,3519,104.6
35010, 전주시,035005, 34세,2018,8078,4007,4071,98.4,7871,3902,3969,98.3
35010, 전주시,040,35~39세,2018,47602,23702,23900,99.2,46788,23317,23471,99.3
35010, 전주시,040001, 35세,2018,8837,4474,4363,102.5,8649,4393,4256,103.2
35010, 전주시,040002, 36세,2018,9608,4762,4846,98.3,9445,4679,4766,98.2
35010, 전주시,040003, 37세,2018,9412,4705,4707,100,9257,4640,4617,100.5
35010, 전주시,040004, 38세,2018,10066,4960,5106,97.1,9903,4881,5022,97.2
35010, 전주시,040005, 39세,2018,9679,4801,4878,98.4,9534,4724,4810,98.2
35010, 전주시,045,40~44세,2018,49997,24383,25614,95.2,49434,24117,25317,95.3
35010, 전주시,045001, 40세,2018,9218,4483,4735,94.7,9097,4431,4666,95
35010, 전주시,045002, 41세,2018,9635,4727,4908,96.3,9522,4678,4844,96.6
35010, 전주시,045003, 42세,2018,9567,4666,4901,95.2,9456,4605,4851,94.9
35010, 전주시,045004, 43세,2018,10167,4968,5199,95.6,10064,4917,5147,95.5
35010, 전주시,045005, 44세,2018,11410,5539,5871,94.3,11295,5486,5809,94.4
35010, 전주시,050,45~49세,2018,58217,28641,29576,96.8,57668,28386,29282,96.9
35010, 전주시,050001, 45세,2018,11484,5464,6020,90.8,11359,5407,5952,90.8
35010, 전주시,050002, 46세,2018,11238,5613,5625,99.8,11125,5554,5571,99.7
35010, 전주시,050003, 47세,2018,12311,6148,6163,99.8,12203,6097,6106,99.9
35010, 전주시,050004, 48세,2018,11655,5781,5874,98.4,11543,5735,5808,98.7
35010, 전주시,050005, 49세,2018,11529,5635,5894,95.6,11438,5593,5845,95.7
35010, 전주시,055,50~54세,2018,52827,26071,26756,97.4,52350,25872,26478,97.7
35010, 전주시,055001, 50세,2018,11479,5646,5833,96.8,11377,5594,5783,96.7
35010, 전주시,055002, 51세,2018,10511,5180,5331,97.2,10416,5144,5272,97.6
35010, 전주시,055003, 52세,2018,10620,5295,5325,99.4,10531,5260,5271,99.8
35010, 전주시,055004, 53세,2018,10599,5141,5458,94.2,10496,5098,5398,94.4
35010, 전주시,055005, 54세,2018,9618,4809,4809,100,9530,4776,4754,100.5
35010, 전주시,060,55~59세,2018,52059,25566,26493,96.5,51737,25434,26303,96.7
35010, 전주시,060001, 55세,2018,10046,5020,5026,99.9,9967,4980,4987,99.9
35010, 전주시,060002, 56세,2018,10279,5143,5136,100.1,10203,5109,5094,100.3
35010, 전주시,060003, 57세,2018,10802,5289,5513,95.9,10755,5274,5481,96.2
35010, 전주시,060004, 58세,2018,11353,5550,5803,95.6,11284,5524,5760,95.9
35010, 전주시,060005, 59세,2018,9579,4564,5015,91,9528,4547,4981,91.3
35010, 전주시,065,60~64세,2018,39786,19462,20324,95.8,39532,19356,20176,95.9
35010, 전주시,065001, 60세,2018,8355,4144,4211,98.4,8284,4119,4165,98.9
35010, 전주시,065002, 61세,2018,8528,4150,4378,94.8,8475,4126,4349,94.9
35010, 전주시,065003, 62세,2018,7727,3792,3935,96.4,7683,3775,3908,96.6
35010, 전주시,065004, 63세,2018,8191,3984,4207,94.7,8137,3957,4180,94.7
35010, 전주시,065005, 64세,2018,6985,3392,3593,94.4,6953,3379,3574,94.5
35010, 전주시,070,65~69세,2018,28640,13564,15076,90,28552,13526,15026,90
35010, 전주시,070001, 65세,2018,5823,2718,3105,87.5,5793,2701,3092,87.4
35010, 전주시,070002, 66세,2018,6171,2986,3185,93.8,6159,2980,3179,93.7
35010, 전주시,070003, 67세,2018,5213,2562,2651,96.6,5191,2554,2637,96.9
35010, 전주시,070004, 68세,2018,6055,2836,3219,88.1,6042,2831,3211,88.2
35010, 전주시,070005, 69세,2018,5378,2462,2916,84.4,5367,2460,2907,84.6
35010, 전주시,075,70~74세,2018,21979,10190,11789,86.4,21925,10164,11761,86.4
35010, 전주시,075001, 70세,2018,5171,2397,2774,86.4,5160,2393,2767,86.5
35010, 전주시,075002, 71세,2018,5493,2608,2885,90.4,5477,2598,2879,90.2
35010, 전주시,075003, 72세,2018,4173,1964,2209,88.9,4162,1959,2203,88.9
35010, 전주시,075004, 73세,2018,3580,1613,1967,82,3574,1609,1965,81.9
35010, 전주시,075005, 74세,2018,3562,1608,1954,82.3,3552,1605,1947,82.4
35010, 전주시,080,75~79세,2018,18456,7830,10626,73.7,18433,7823,10610,73.7
35010, 전주시,080001, 75세,2018,3695,1603,2092,76.6,3689,1603,2086,76.8
35010, 전주시,080002, 76세,2018,5070,2172,2898,74.9,5064,2169,2895,74.9
35010, 전주시,080003, 77세,2018,3409,1451,1958,74.1,3406,1450,1956,74.1
35010, 전주시,080004, 78세,2018,3085,1278,1807,70.7,3082,1276,1806,70.7
35010, 전주시,080005, 79세,2018,3197,1326,1871,70.9,3192,1325,1867,71
35010, 전주시,085,80~84세,2018,12128,4392,7736,56.8,12118,4391,7727,56.8
35010, 전주시,085001, 80세,2018,2856,1083,1773,61.1,2852,1082,1770,61.1
35010, 전주시,085002, 81세,2018,2703,1036,1667,62.1,2699,1036,1663,62.3
35010, 전주시,085003, 82세,2018,2383,852,1531,55.6,2382,852,1530,55.7
35010, 전주시,085004, 83세,2018,2265,784,1481,52.9,2264,784,1480,53
35010, 전주시,085005, 84세,2018,1921,637,1284,49.6,1921,637,1284,49.6
35010, 전주시,090,85~89세,2018,5906,1702,4204,40.5,5898,1698,4200,40.4
35010, 전주시,090001, 85세,2018,1597,510,1087,46.9,1595,508,1087,46.7
35010, 전주시,090002, 86세,2018,1433,425,1008,42.2,1431,424,1007,42.1
35010, 전주시,090003, 87세,2018,1078,310,768,40.4,1077,309,768,40.2
35010, 전주시,090004, 88세,2018,991,240,751,32,989,240,749,32
35010, 전주시,090005, 89세,2018,807,217,590,36.8,806,217,589,36.8
35010, 전주시,095,90~94세,2018,1883,433,1450,29.9,1883,433,1450,29.9
35010, 전주시,095001, 90세,2018,686,171,515,33.2,686,171,515,33.2
35010, 전주시,095002, 91세,2018,513,127,386,32.9,513,127,386,32.9
35010, 전주시,095003, 92세,2018,313,61,252,24.2,313,61,252,24.2
35010, 전주시,095004, 93세,2018,212,48,164,29.3,212,48,164,29.3
35010, 전주시,095005, 94세,2018,159,26,133,19.5,159,26,133,19.5
35010, 전주시,100,95~99세,2018,474,71,403,17.6,474,71,403,17.6
35010, 전주시,100001, 95세,2018,181,30,151,19.9,181,30,151,19.9
35010, 전주시,100002, 96세,2018,134,26,108,24.1,134,26,108,24.1
35010, 전주시,100003, 97세,2018,71,7,64,10.9,71,7,64,10.9
35010, 전주시,100004, 98세,2018,47,5,42,11.9,47,5,42,11.9
35010, 전주시,100005, 99세,2018,41,X,38,7.9,41,X,38,7.9
35010, 전주시,101,100세이상,2018,64,8,56,14.3,64,8,56,14.3
35010, 전주시,102,15세미만,2018,90320,46577,43743,106.5,90048,46428,43620,106.4
35010, 전주시,103,15~64세,2018,479062,240843,238219,101.1,469973,236561,233412,101.3
35010, 전주시,104,65세이상,2018,89530,38190,51340,74.4,89347,38114,51233,74.4
35010, 전주시,086,85세이상,2018,8327,2214,6113,36.2,8319,2210,6109,36.2
35010, 전주시,126,평균연령,2018,40.6,39.3,41.8,,40.7,39.4,41.9,
35010, 전주시,127,중위연령,2018,41.4,39.9,42.8,,41.7,40.2,43.1,
35011, 완산구,000,합계,2018,348108,170114,177994,95.6,344000,168177,175823,95.7
35011, 완산구,005,0~4세,2018,12090,6179,5911,104.5,12046,6155,5891,104.5
35011, 완산구,005001, 0세,2018,1889,992,897,110.6,1878,987,891,110.8
35011, 완산구,005002, 1세,2018,2197,1115,1082,103,2184,1106,1078,102.6
35011, 완산구,005003, 2세,2018,2542,1322,1220,108.4,2533,1317,1216,108.3
35011, 완산구,005004, 3세,2018,2660,1301,1359,95.7,2653,1299,1354,95.9
35011, 완산구,005005, 4세,2018,2802,1449,1353,107.1,2798,1446,1352,107
35011, 완산구,010,5~9세,2018,15277,7902,7375,107.1,15260,7890,7370,107.1
35011, 완산구,010001, 5세,2018,2812,1452,1360,106.8,2807,1449,1358,106.7
35011, 완산구,010002, 6세,2018,3139,1589,1550,102.5,3136,1587,1549,102.5
35011, 완산구,010003, 7세,2018,3180,1629,1551,105,3177,1626,1551,104.8
35011, 완산구,010004, 8세,2018,3128,1653,1475,112.1,3126,1652,1474,112.1
35011, 완산구,010005, 9세,2018,3018,1579,1439,109.7,3014,1576,1438,109.6
35011, 완산구,015,10~14세,2018,16741,8686,8055,107.8,16729,8680,8049,107.8
35011, 완산구,015001, 10세,2018,3212,1657,1555,106.6,3207,1656,1551,106.8
35011, 완산구,015002, 11세,2018,3341,1712,1629,105.1,3340,1711,1629,105
35011, 완산구,015003, 12세,2018,3198,1655,1543,107.3,3196,1653,1543,107.1
35011, 완산구,015004, 13세,2018,3359,1777,1582,112.3,3359,1777,1582,112.3
35011, 완산구,015005, 14세,2018,3631,1885,1746,108,3627,1883,1744,108
35011, 완산구,020,15~19세,2018,24972,13063,11909,109.7,24511,12819,11692,109.6
35011, 완산구,020001, 15세,2018,4025,2150,1875,114.7,4022,2148,1874,114.6
35011, 완산구,020002, 16세,2018,4411,2341,2070,113.1,4409,2339,2070,113
35011, 완산구,020003, 17세,2018,5073,2653,2420,109.6,5061,2645,2416,109.5
35011, 완산구,020004, 18세,2018,5949,3081,2868,107.4,5805,3014,2791,108
35011, 완산구,020005, 19세,2018,5514,2838,2676,106.1,5214,2673,2541,105.2
35011, 완산구,025,20~24세,2018,27918,14420,13498,106.8,26779,13822,12957,106.7
35011, 완산구,025001, 20세,2018,5713,2887,2826,102.2,5444,2747,2697,101.9
35011, 완산구,025002, 21세,2018,5701,2887,2814,102.6,5433,2731,2702,101.1
35011, 완산구,025003, 22세,2018,5762,3024,2738,110.4,5534,2913,2621,111.1
35011, 완산구,025004, 23세,2018,5471,2862,2609,109.7,5267,2754,2513,109.6
35011, 완산구,025005, 24세,2018,5271,2760,2511,109.9,5101,2677,2424,110.4
35011, 완산구,030,25~29세,2018,22136,11489,10647,107.9,21554,11222,10332,108.6
35011, 완산구,030001, 25세,2018,4944,2550,2394,106.5,4803,2483,2320,107
35011, 완산구,030002, 26세,2018,4823,2500,2323,107.6,4699,2441,2258,108.1
35011, 완산구,030003, 27세,2018,4453,2299,2154,106.7,4331,2245,2086,107.6
35011, 완산구,030004, 28세,2018,4066,2153,1913,112.5,3972,2117,1855,114.1
35011, 완산구,030005, 29세,2018,3850,1987,1863,106.7,3749,1936,1813,106.8
35011, 완산구,035,30~34세,2018,19228,9689,9539,101.6,18746,9486,9260,102.4
35011, 완산구,035001, 30세,2018,3818,1893,1925,98.3,3705,1845,1860,99.2
35011, 완산구,035002, 31세,2018,3798,1905,1893,100.6,3686,1863,1823,102.2
35011, 완산구,035003, 32세,2018,3798,1935,1863,103.9,3699,1891,1808,104.6
35011, 완산구,035004, 33세,2018,3711,1907,1804,105.7,3624,1869,1755,106.5
35011, 완산구,035005, 34세,2018,4103,2049,2054,99.8,4032,2018,2014,100.2
35011, 완산구,040,35~39세,2018,23398,11603,11795,98.4,23068,11466,11602,98.8
35011, 완산구,040001, 35세,2018,4381,2200,2181,100.9,4314,2176,2138,101.8
35011, 완산구,040002, 36세,2018,4682,2332,2350,99.2,4618,2304,2314,99.6
35011, 완산구,040003, 37세,2018,4621,2356,2265,104,4548,2330,2218,105
35011, 완산구,040004, 38세,2018,4985,2400,2585,92.8,4922,2375,2547,93.2
35011, 완산구,040005, 39세,2018,4729,2315,2414,95.9,4666,2281,2385,95.6
35011, 완산구,045,40~44세,2018,25417,12133,13284,91.3,25177,12020,13157,91.4
35011, 완산구,045001, 40세,2018,4516,2210,2306,95.8,4476,2194,2282,96.1
35011, 완산구,045002, 41세,2018,4821,2288,2533,90.3,4774,2273,2501,90.9
35011, 완산구,045003, 42세,2018,4848,2335,2513,92.9,4797,2301,2496,92.2
35011, 완산구,045004, 43세,2018,5273,2511,2762,90.9,5229,2491,2738,91
35011, 완산구,045005, 44세,2018,5959,2789,3170,88,5901,2761,3140,87.9
35011, 완산구,050,45~49세,2018,31312,15083,16229,92.9,31091,14984,16107,93
35011, 완산구,050001, 45세,2018,6045,2802,3243,86.4,5994,2779,3215,86.4
35011, 완산구,050002, 46세,2018,5946,2891,3055,94.6,5907,2872,3035,94.6
35011, 완산구,050003, 47세,2018,6712,3242,3470,93.4,6672,3221,3451,93.3
35011, 완산구,050004, 48세,2018,6327,3134,3193,98.2,6285,3119,3166,98.5
35011, 완산구,050005, 49세,2018,6282,3014,3268,92.2,6233,2993,3240,92.4
35011, 완산구,055,50~54세,2018,29083,14224,14859,95.7,28846,14129,14717,96
35011, 완산구,055001, 50세,2018,6320,3091,3229,95.7,6277,3069,3208,95.7
35011, 완산구,055002, 51세,2018,5744,2799,2945,95,5701,2787,2914,95.6
35011, 완산구,055003, 52세,2018,5807,2863,2944,97.2,5755,2841,2914,97.5
35011, 완산구,055004, 53세,2018,5886,2837,3049,93,5829,2811,3018,93.1
35011, 완산구,055005, 54세,2018,5326,2634,2692,97.8,5284,2621,2663,98.4
35011, 완산구,060,55~59세,2018,28857,13899,14958,92.9,28707,13836,14871,93
35011, 완산구,060001, 55세,2018,5613,2716,2897,93.8,5572,2693,2879,93.5
35011, 완산구,060002, 56세,2018,5598,2780,2818,98.7,5570,2767,2803,98.7
35011, 완산구,060003, 57세,2018,6056,2913,3143,92.7,6033,2905,3128,92.9
35011, 완산구,060004, 58세,2018,6224,2972,3252,91.4,6185,2958,3227,91.7
35011, 완산구,060005, 59세,2018,5366,2518,2848,88.4,5347,2513,2834,88.7
35011, 완산구,065,60~64세,2018,22390,10885,11505,94.6,22274,10841,11433,94.8
35011, 완산구,065001, 60세,2018,4756,2339,2417,96.8,4722,2327,2395,97.2
35011, 완산구,065002, 61세,2018,4838,2338,2500,93.5,4819,2329,2490,93.5
35011, 완산구,065003, 62세,2018,4295,2082,2213,94.1,4272,2074,2198,94.4
35011, 완산구,065004, 63세,2018,4557,2221,2336,95.1,4533,2211,2322,95.2
35011, 완산구,065005, 64세,2018,3944,1905,2039,93.4,3928,1900,2028,93.7
35011, 완산구,070,65~69세,2018,15885,7496,8389,89.4,15851,7482,8369,89.4
35011, 완산구,070001, 65세,2018,3238,1487,1751,84.9,3224,1481,1743,85
35011, 완산구,070002, 66세,2018,3471,1690,1781,94.9,3467,1689,1778,95
35011, 완산구,070003, 67세,2018,2860,1387,1473,94.2,2854,1383,1471,94
35011, 완산구,070004, 68세,2018,3338,1568,1770,88.6,3333,1566,1767,88.6
35011, 완산구,070005, 69세,2018,2978,1364,1614,84.5,2973,1363,1610,84.7
35011, 완산구,075,70~74세,2018,11963,5573,6390,87.2,11937,5559,6378,87.2
35011, 완산구,075001, 70세,2018,2811,1339,1472,91,2808,1337,1471,90.9
35011, 완산구,075002, 71세,2018,2995,1413,1582,89.3,2987,1409,1578,89.3
35011, 완산구,075003, 72세,2018,2282,1098,1184,92.7,2274,1093,1181,92.5
35011, 완산구,075004, 73세,2018,1965,866,1099,78.8,1963,864,1099,78.6
35011, 완산구,075005, 74세,2018,1910,857,1053,81.4,1905,856,1049,81.6
35011, 완산구,080,75~79세,2018,9951,4184,5767,72.6,9940,4181,5759,72.6
35011, 완산구,080001, 75세,2018,2026,870,1156,75.3,2026,870,1156,75.3
35011, 완산구,080002, 76세,2018,2716,1151,1565,73.5,2712,1150,1562,73.6
35011, 완산구,080003, 77세,2018,1863,787,1076,73.1,1862,786,1076,73
35011, 완산구,080004, 78세,2018,1645,670,975,68.7,1644,670,974,68.8
35011, 완산구,080005, 79세,2018,1701,706,995,71,1696,705,991,71.1
35011, 완산구,085,80~84세,2018,6681,2363,4318,54.7,6678,2363,4315,54.8
35011, 완산구,085001, 80세,2018,1544,551,993,55.5,1544,551,993,55.5
35011, 완산구,085002, 81세,2018,1487,569,918,62,1485,569,916,62.1
35011, 완산구,085003, 82세,2018,1288,455,833,54.6,1287,455,832,54.7
35011, 완산구,085004, 83세,2018,1274,426,848,50.2,1274,426,848,50.2
35011, 완산구,085005, 84세,2018,1088,362,726,49.9,1088,362,726,49.9
35011, 완산구,090,85~89세,2018,3364,956,2408,39.7,3361,955,2406,39.7
35011, 완산구,090001, 85세,2018,917,287,630,45.6,916,286,630,45.4
35011, 완산구,090002, 86세,2018,816,245,571,42.9,816,245,571,42.9
35011, 완산구,090003, 87세,2018,615,168,447,37.6,615,168,447,37.6
35011, 완산구,090004, 88세,2018,574,136,438,31.1,572,136,436,31.2
35011, 완산구,090005, 89세,2018,442,120,322,37.3,442,120,322,37.3
35011, 완산구,095,90~94세,2018,1118,238,880,27,1118,238,880,27
35011, 완산구,095001, 90세,2018,406,91,315,28.9,406,91,315,28.9
35011, 완산구,095002, 91세,2018,317,72,245,29.4,317,72,245,29.4
35011, 완산구,095003, 92세,2018,187,35,152,23,187,35,152,23
35011, 완산구,095004, 93세,2018,117,27,90,30,117,27,90,30
35011, 완산구,095005, 94세,2018,91,13,78,16.7,91,13,78,16.7
35011, 완산구,100,95~99세,2018,284,43,241,17.8,284,43,241,17.8
35011, 완산구,100001, 95세,2018,111,18,93,19.4,111,18,93,19.4
35011, 완산구,100002, 96세,2018,75,16,59,27.1,75,16,59,27.1
35011, 완산구,100003, 97세,2018,44,X,40,10,44,X,40,10
35011, 완산구,100004, 98세,2018,28,X,25,12,28,X,25,12
35011, 완산구,100005, 99세,2018,26,X,24,8.3,26,X,24,8.3
35011, 완산구,101,100세이상,2018,43,6,37,16.2,43,6,37,16.2
35011, 완산구,102,15세미만,2018,44108,22767,21341,106.7,44035,22725,21310,106.6
35011, 완산구,103,15~64세,2018,254711,126488,128223,98.6,250753,124625,126128,98.8
35011, 완산구,104,65세이상,2018,49289,20859,28430,73.4,49212,20827,28385,73.4
35011, 완산구,086,85세이상,2018,4809,1243,3566,34.9,4806,1242,3564,34.8
35011, 완산구,126,평균연령,2018,41.3,40,42.5,,41.4,40.1,42.7,
35011, 완산구,127,중위연령,2018,42.6,40.9,44,,42.8,41.2,44.2,
35012, 덕진구,000,합계,2018,310804,155496,155308,100.1,305368,152926,152442,100.3
35012, 덕진구,005,0~4세,2018,13327,6864,6463,106.2,13189,6792,6397,106.2
35012, 덕진구,005001, 0세,2018,2086,1064,1022,104.1,2058,1046,1012,103.4
35012, 덕진구,005002, 1세,2018,2389,1243,1146,108.5,2352,1223,1129,108.3
35012, 덕진구,005003, 2세,2018,2792,1456,1336,109,2765,1443,1322,109.2
35012, 덕진구,005004, 3세,2018,3076,1578,1498,105.3,3050,1562,1488,105
35012, 덕진구,005005, 4세,2018,2984,1523,1461,104.2,2964,1518,1446,105
35012, 덕진구,010,5~9세,2018,16437,8370,8067,103.8,16392,8342,8050,103.6
35012, 덕진구,010001, 5세,2018,3153,1659,1494,111,3147,1654,1493,110.8
35012, 덕진구,010002, 6세,2018,3454,1736,1718,101,3441,1729,1712,101
35012, 덕진구,010003, 7세,2018,3418,1720,1698,101.3,3408,1714,1694,101.2
35012, 덕진구,010004, 8세,2018,3305,1680,1625,103.4,3292,1673,1619,103.3
35012, 덕진구,010005, 9세,2018,3107,1575,1532,102.8,3104,1572,1532,102.6
35012, 덕진구,015,10~14세,2018,16448,8576,7872,108.9,16432,8569,7863,109
35012, 덕진구,015001, 10세,2018,3364,1740,1624,107.1,3361,1739,1622,107.2
35012, 덕진구,015002, 11세,2018,3446,1840,1606,114.6,3443,1838,1605,114.5
35012, 덕진구,015003, 12세,2018,3135,1658,1477,112.3,3134,1658,1476,112.3
35012, 덕진구,015004, 13세,2018,3146,1670,1476,113.1,3144,1668,1476,113
35012, 덕진구,015005, 14세,2018,3357,1668,1689,98.8,3350,1666,1684,98.9
35012, 덕진구,020,15~19세,2018,19782,10155,9627,105.5,19558,10059,9499,105.9
35012, 덕진구,020001, 15세,2018,3330,1662,1668,99.6,3326,1661,1665,99.8
35012, 덕진구,020002, 16세,2018,3351,1703,1648,103.3,3346,1700,1646,103.3
35012, 덕진구,020003, 17세,2018,3755,1833,1922,95.4,3743,1831,1912,95.8
35012, 덕진구,020004, 18세,2018,4530,2324,2206,105.3,4486,2306,2180,105.8
35012, 덕진구,020005, 19세,2018,4816,2633,2183,120.6,4657,2561,2096,122.2
35012, 덕진구,025,20~24세,2018,25752,14068,11684,120.4,24422,13443,10979,122.4
35012, 덕진구,025001, 20세,2018,5014,2697,2317,116.4,4726,2554,2172,117.6
35012, 덕진구,025002, 21세,2018,5199,2707,2492,108.6,4906,2579,2327,110.8
35012, 덕진구,025003, 22세,2018,5275,2914,2361,123.4,5048,2806,2242,125.2
35012, 덕진구,025004, 23세,2018,5208,2890,2318,124.7,4943,2769,2174,127.4
35012, 덕진구,025005, 24세,2018,5056,2860,2196,130.2,4799,2735,2064,132.5
35012, 덕진구,030,25~29세,2018,20426,10903,9523,114.5,19319,10382,8937,116.2
35012, 덕진구,030001, 25세,2018,4705,2649,2056,128.8,4432,2521,1911,131.9
35012, 덕진구,030002, 26세,2018,4430,2358,2072,113.8,4191,2253,1938,116.3
35012, 덕진구,030003, 27세,2018,3995,2090,1905,109.7,3798,1999,1799,111.1
35012, 덕진구,030004, 28세,2018,3750,1968,1782,110.4,3551,1870,1681,111.2
35012, 덕진구,030005, 29세,2018,3546,1838,1708,107.6,3347,1739,1608,108.1
35012, 덕진구,035,30~34세,2018,18360,9231,9129,101.1,17575,8846,8729,101.3
35012, 덕진구,035001, 30세,2018,3453,1820,1633,111.5,3274,1726,1548,111.5
35012, 덕진구,035002, 31세,2018,3512,1748,1764,99.1,3340,1662,1678,99
35012, 덕진구,035003, 32세,2018,3704,1834,1870,98.1,3547,1763,1784,98.8
35012, 덕진구,035004, 33세,2018,3716,1871,1845,101.4,3575,1811,1764,102.7
35012, 덕진구,035005, 34세,2018,3975,1958,2017,97.1,3839,1884,1955,96.4
35012, 덕진구,040,35~39세,2018,24204,12099,12105,100,23720,11851,11869,99.8
35012, 덕진구,040001, 35세,2018,4456,2274,2182,104.2,4335,2217,2118,104.7
35012, 덕진구,040002, 36세,2018,4926,2430,2496,97.4,4827,2375,2452,96.9
35012, 덕진구,040003, 37세,2018,4791,2349,2442,96.2,4709,2310,2399,96.3
35012, 덕진구,040004, 38세,2018,5081,2560,2521,101.5,4981,2506,2475,101.3
35012, 덕진구,040005, 39세,2018,4950,2486,2464,100.9,4868,2443,2425,100.7
35012, 덕진구,045,40~44세,2018,24580,12250,12330,99.4,24257,12097,12160,99.5
35012, 덕진구,045001, 40세,2018,4702,2273,2429,93.6,4621,2237,2384,93.8
35012, 덕진구,045002, 41세,2018,4814,2439,2375,102.7,4748,2405,2343,102.6
35012, 덕진구,045003, 42세,2018,4719,2331,2388,97.6,4659,2304,2355,97.8
35012, 덕진구,045004, 43세,2018,4894,2457,2437,100.8,4835,2426,2409,100.7
35012, 덕진구,045005, 44세,2018,5451,2750,2701,101.8,5394,2725,2669,102.1
35012, 덕진구,050,45~49세,2018,26905,13558,13347,101.6,26577,13402,13175,101.7
35012, 덕진구,050001, 45세,2018,5439,2662,2777,95.9,5365,2628,2737,96
35012, 덕진구,050002, 46세,2018,5292,2722,2570,105.9,5218,2682,2536,105.8
35012, 덕진구,050003, 47세,2018,5599,2906,2693,107.9,5531,2876,2655,108.3
35012, 덕진구,050004, 48세,2018,5328,2647,2681,98.7,5258,2616,2642,99
35012, 덕진구,050005, 49세,2018,5247,2621,2626,99.8,5205,2600,2605,99.8
35012, 덕진구,055,50~54세,2018,23744,11847,11897,99.6,23504,11743,11761,99.8
35012, 덕진구,055001, 50세,2018,5159,2555,2604,98.1,5100,2525,2575,98.1
35012, 덕진구,055002, 51세,2018,4767,2381,2386,99.8,4715,2357,2358,100
35012, 덕진구,055003, 52세,2018,4813,2432,2381,102.1,4776,2419,2357,102.6
35012, 덕진구,055004, 53세,2018,4713,2304,2409,95.6,4667,2287,2380,96.1
35012, 덕진구,055005, 54세,2018,4292,2175,2117,102.7,4246,2155,2091,103.1
35012, 덕진구,060,55~59세,2018,23202,11667,11535,101.1,23030,11598,11432,101.5
35012, 덕진구,060001, 55세,2018,4433,2304,2129,108.2,4395,2287,2108,108.5
35012, 덕진구,060002, 56세,2018,4681,2363,2318,101.9,4633,2342,2291,102.2
35012, 덕진구,060003, 57세,2018,4746,2376,2370,100.3,4722,2369,2353,100.7
35012, 덕진구,060004, 58세,2018,5129,2578,2551,101.1,5099,2566,2533,101.3
35012, 덕진구,060005, 59세,2018,4213,2046,2167,94.4,4181,2034,2147,94.7
35012, 덕진구,065,60~64세,2018,17396,8577,8819,97.3,17258,8515,8743,97.4
35012, 덕진구,065001, 60세,2018,3599,1805,1794,100.6,3562,1792,1770,101.2
35012, 덕진구,065002, 61세,2018,3690,1812,1878,96.5,3656,1797,1859,96.7
35012, 덕진구,065003, 62세,2018,3432,1710,1722,99.3,3411,1701,1710,99.5
35012, 덕진구,065004, 63세,2018,3634,1763,1871,94.2,3604,1746,1858,94
35012, 덕진구,065005, 64세,2018,3041,1487,1554,95.7,3025,1479,1546,95.7
35012, 덕진구,070,65~69세,2018,12755,6068,6687,90.7,12701,6044,6657,90.8
35012, 덕진구,070001, 65세,2018,2585,1231,1354,90.9,2569,1220,1349,90.4
35012, 덕진구,070002, 66세,2018,2700,1296,1404,92.3,2692,1291,1401,92.1
35012, 덕진구,070003, 67세,2018,2353,1175,1178,99.7,2337,1171,1166,100.4
35012, 덕진구,070004, 68세,2018,2717,1268,1449,87.5,2709,1265,1444,87.6
35012, 덕진구,070005, 69세,2018,2400,1098,1302,84.3,2394,1097,1297,84.6
35012, 덕진구,075,70~74세,2018,10016,4617,5399,85.5,9988,4605,5383,85.5
35012, 덕진구,075001, 70세,2018,2360,1058,1302,81.3,2352,1056,1296,81.5
35012, 덕진구,075002, 71세,2018,2498,1195,1303,91.7,2490,1189,1301,91.4
35012, 덕진구,075003, 72세,2018,1891,866,1025,84.5,1888,866,1022,84.7
35012, 덕진구,075004, 73세,2018,1615,747,868,86.1,1611,745,866,86
35012, 덕진구,075005, 74세,2018,1652,751,901,83.4,1647,749,898,83.4
35012, 덕진구,080,75~79세,2018,8505,3646,4859,75,8493,3642,4851,75.1
35012, 덕진구,080001, 75세,2018,1669,733,936,78.3,1663,733,930,78.8
35012, 덕진구,080002, 76세,2018,2354,1021,1333,76.6,2352,1019,1333,76.4
35012, 덕진구,080003, 77세,2018,1546,664,882,75.3,1544,664,880,75.5
35012, 덕진구,080004, 78세,2018,1440,608,832,73.1,1438,606,832,72.8
35012, 덕진구,080005, 79세,2018,1496,620,876,70.8,1496,620,876,70.8
35012, 덕진구,085,80~84세,2018,5447,2029,3418,59.4,5440,2028,3412,59.4
35012, 덕진구,085001, 80세,2018,1312,532,780,68.2,1308,531,777,68.3
35012, 덕진구,085002, 81세,2018,1216,467,749,62.3,1214,467,747,62.5
35012, 덕진구,085003, 82세,2018,1095,397,698,56.9,1095,397,698,56.9
35012, 덕진구,085004, 83세,2018,991,358,633,56.6,990,358,632,56.6
35012, 덕진구,085005, 84세,2018,833,275,558,49.3,833,275,558,49.3
35012, 덕진구,090,85~89세,2018,2542,746,1796,41.5,2537,743,1794,41.4
35012, 덕진구,090001, 85세,2018,680,223,457,48.8,679,222,457,48.6
35012, 덕진구,090002, 86세,2018,617,180,437,41.2,615,179,436,41.1
35012, 덕진구,090003, 87세,2018,463,142,321,44.2,462,141,321,43.9
35012, 덕진구,090004, 88세,2018,417,104,313,33.2,417,104,313,33.2
35012, 덕진구,090005, 89세,2018,365,97,268,36.2,364,97,267,36.3
35012, 덕진구,095,90~94세,2018,765,195,570,34.2,765,195,570,34.2
35012, 덕진구,095001, 90세,2018,280,80,200,40,280,80,200,40
35012, 덕진구,095002, 91세,2018,196,55,141,39,196,55,141,39
35012, 덕진구,095003, 92세,2018,126,26,100,26,126,26,100,26
35012, 덕진구,095004, 93세,2018,95,21,74,28.4,95,21,74,28.4
35012, 덕진구,095005, 94세,2018,68,13,55,23.6,68,13,55,23.6
35012, 덕진구,100,95~99세,2018,190,28,162,17.3,190,28,162,17.3
35012, 덕진구,100001, 95세,2018,70,12,58,20.7,70,12,58,20.7
35012, 덕진구,100002, 96세,2018,59,10,49,20.4,59,10,49,20.4
35012, 덕진구,100003, 97세,2018,27,X,24,12.5,27,X,24,12.5
35012, 덕진구,100004, 98세,2018,19,X,17,11.8,19,X,17,11.8
35012, 덕진구,100005, 99세,2018,15,X,14,7.1,15,X,14,7.1
35012, 덕진구,101,100세이상,2018,21,X,19,10.5,21,X,19,10.5
35012, 덕진구,102,15세미만,2018,46212,23810,22402,106.3,46013,23703,22310,106.2
35012, 덕진구,103,15~64세,2018,224351,114355,109996,104,219220,111936,107284,104.3
35012, 덕진구,104,65세이상,2018,40241,17331,22910,75.6,40135,17287,22848,75.7
35012, 덕진구,086,85세이상,2018,3518,971,2547,38.1,3513,968,2545,38
35012, 덕진구,126,평균연령,2018,39.7,38.6,40.8,,39.9,38.7,41,
35012, 덕진구,127,중위연령,2018,40.1,39,41.3,,40.4,39.3,41.6,
35020, 군산시,000,합계,2018,272204,139076,133128,104.5,264977,134448,130529,103
35020, 군산시,005,0~4세,2018,10624,5406,5218,103.6,10558,5368,5190,103.4
35020, 군산시,005001, 0세,2018,1640,838,802,104.5,1628,832,796,104.5
35020, 군산시,005002, 1세,2018,1874,958,916,104.6,1855,945,910,103.8
35020, 군산시,005003, 2세,2018,2168,1080,1088,99.3,2161,1079,1082,99.7
35020, 군산시,005004, 3세,2018,2481,1246,1235,100.9,2465,1237,1228,100.7
35020, 군산시,005005, 4세,2018,2461,1284,1177,109.1,2449,1275,1174,108.6
35020, 군산시,010,5~9세,2018,13195,6748,6447,104.7,13158,6729,6429,104.7
35020, 군산시,010001, 5세,2018,2637,1346,1291,104.3,2626,1341,1285,104.4
35020, 군산시,010002, 6세,2018,2711,1403,1308,107.3,2701,1397,1304,107.1
35020, 군산시,010003, 7세,2018,2770,1445,1325,109.1,2764,1442,1322,109.1
35020, 군산시,010004, 8세,2018,2588,1293,1295,99.8,2585,1292,1293,99.9
35020, 군산시,010005, 9세,2018,2489,1261,1228,102.7,2482,1257,1225,102.6
35020, 군산시,015,10~14세,2018,12527,6489,6038,107.5,12499,6479,6020,107.6
35020, 군산시,015001, 10세,2018,2501,1342,1159,115.8,2494,1340,1154,116.1
35020, 군산시,015002, 11세,2018,2645,1330,1315,101.1,2640,1328,1312,101.2
35020, 군산시,015003, 12세,2018,2417,1254,1163,107.8,2411,1252,1159,108
35020, 군산시,015004, 13세,2018,2369,1242,1127,110.2,2367,1242,1125,110.4
35020, 군산시,015005, 14세,2018,2595,1321,1274,103.7,2587,1317,1270,103.7
35020, 군산시,020,15~19세,2018,15791,8330,7461,111.6,15617,8226,7391,111.3
35020, 군산시,020001, 15세,2018,2640,1345,1295,103.9,2633,1340,1293,103.6
35020, 군산시,020002, 16세,2018,2690,1413,1277,110.6,2682,1408,1274,110.5
35020, 군산시,020003, 17세,2018,3311,1687,1624,103.9,3299,1680,1619,103.8
35020, 군산시,020004, 18세,2018,3385,1740,1645,105.8,3351,1716,1635,105
35020, 군산시,020005, 19세,2018,3765,2145,1620,132.4,3652,2082,1570,132.6
35020, 군산시,025,20~24세,2018,18603,10581,8022,131.9,17663,9981,7682,129.9
35020, 군산시,025001, 20세,2018,3837,2077,1760,118,3693,2004,1689,118.7
35020, 군산시,025002, 21세,2018,3800,2109,1691,124.7,3657,2017,1640,123
35020, 군산시,025003, 22세,2018,3963,2230,1733,128.7,3760,2104,1656,127.1
35020, 군산시,025004, 23세,2018,3622,2127,1495,142.3,3404,1983,1421,139.5
35020, 군산시,025005, 24세,2018,3381,2038,1343,151.7,3149,1873,1276,146.8
35020, 군산시,030,25~29세,2018,14635,8209,6426,127.7,13264,7250,6014,120.6
35020, 군산시,030001, 25세,2018,3169,1808,1361,132.8,2939,1652,1287,128.4
35020, 군산시,030002, 26세,2018,3128,1769,1359,130.2,2854,1579,1275,123.8
35020, 군산시,030003, 27세,2018,2862,1608,1254,128.2,2562,1403,1159,121.1
35020, 군산시,030004, 28세,2018,2736,1525,1211,125.9,2434,1315,1119,117.5
35020, 군산시,030005, 29세,2018,2740,1499,1241,120.8,2475,1301,1174,110.8
35020, 군산시,035,30~34세,2018,15000,8199,6801,120.6,13661,7216,6445,112
35020, 군산시,035001, 30세,2018,2749,1485,1264,117.5,2435,1268,1167,108.7
35020, 군산시,035002, 31세,2018,2868,1620,1248,129.8,2572,1381,1191,116
35020, 군산시,035003, 32세,2018,2968,1633,1335,122.3,2706,1446,1260,114.8
35020, 군산시,035004, 33세,2018,3027,1620,1407,115.1,2790,1444,1346,107.3
35020, 군산시,035005, 34세,2018,3388,1841,1547,119,3158,1677,1481,113.2
35020, 군산시,040,35~39세,2018,20841,11075,9766,113.4,19916,10453,9463,110.5
35020, 군산시,040001, 35세,2018,3779,1999,1780,112.3,3565,1858,1707,108.8
35020, 군산시,040002, 36세,2018,4324,2292,2032,112.8,4116,2145,1971,108.8
35020, 군산시,040003, 37세,2018,4235,2246,1989,112.9,4079,2144,1935,110.8
35020, 군산시,040004, 38세,2018,4354,2330,2024,115.1,4184,2214,1970,112.4
35020, 군산시,040005, 39세,2018,4149,2208,1941,113.8,3972,2092,1880,111.3
35020, 군산시,045,40~44세,2018,20888,10841,10047,107.9,20273,10476,9797,106.9
35020, 군산시,045001, 40세,2018,3873,2034,1839,110.6,3744,1962,1782,110.1
35020, 군산시,045002, 41세,2018,4028,2099,1929,108.8,3901,2019,1882,107.3
35020, 군산시,045003, 42세,2018,3918,2030,1888,107.5,3790,1951,1839,106.1
35020, 군산시,045004, 43세,2018,4262,2192,2070,105.9,4147,2123,2024,104.9
35020, 군산시,045005, 44세,2018,4807,2486,2321,107.1,4691,2421,2270,106.7
35020, 군산시,050,45~49세,2018,23676,12643,11033,114.6,23112,12298,10814,113.7
35020, 군산시,050001, 45세,2018,4613,2452,2161,113.5,4499,2377,2122,112
35020, 군산시,050002, 46세,2018,4711,2561,2150,119.1,4583,2484,2099,118.3
35020, 군산시,050003, 47세,2018,5026,2680,2346,114.2,4923,2621,2302,113.9
35020, 군산시,050004, 48세,2018,4782,2547,2235,114,4659,2468,2191,112.6
35020, 군산시,050005, 49세,2018,4544,2403,2141,112.2,4448,2348,2100,111.8
35020, 군산시,055,50~54세,2018,20836,10868,9968,109,20426,10657,9769,109.1
35020, 군산시,055001, 50세,2018,4587,2414,2173,111.1,4499,2372,2127,111.5
35020, 군산시,055002, 51세,2018,4097,2060,2037,101.1,4019,2018,2001,100.8
35020, 군산시,055003, 52세,2018,4143,2191,1952,112.2,4055,2143,1912,112.1
35020, 군산시,055004, 53세,2018,4053,2091,1962,106.6,3975,2057,1918,107.2
35020, 군산시,055005, 54세,2018,3956,2112,1844,114.5,3878,2067,1811,114.1
35020, 군산시,060,55~59세,2018,22088,11102,10986,101.1,21727,10934,10793,101.3
35020, 군산시,060001, 55세,2018,4142,2135,2007,106.4,4044,2082,1962,106.1
35020, 군산시,060002, 56세,2018,4319,2243,2076,108,4230,2204,2026,108.8
35020, 군산시,060003, 57세,2018,4632,2350,2282,103,4577,2326,2251,103.3
35020, 군산시,060004, 58세,2018,4728,2291,2437,94,4665,2262,2403,94.1
35020, 군산시,060005, 59세,2018,4267,2083,2184,95.4,4211,2060,2151,95.8
35020, 군산시,065,60~64세,2018,19026,9567,9459,101.1,18832,9461,9371,101
35020, 군산시,065001, 60세,2018,4027,1968,2059,95.6,3979,1942,2037,95.3
35020, 군산시,065002, 61세,2018,4017,2073,1944,106.6,3975,2050,1925,106.5
35020, 군산시,065003, 62세,2018,3684,1851,1833,101,3645,1827,1818,100.5
35020, 군산시,065004, 63세,2018,3855,1930,1925,100.3,3827,1915,1912,100.2
35020, 군산시,065005, 64세,2018,3443,1745,1698,102.8,3406,1727,1679,102.9
35020, 군산시,070,65~69세,2018,13810,6791,7019,96.8,13708,6747,6961,96.9
35020, 군산시,070001, 65세,2018,2641,1296,1345,96.4,2616,1286,1330,96.7
35020, 군산시,070002, 66세,2018,2983,1519,1464,103.8,2964,1507,1457,103.4
35020, 군산시,070003, 67세,2018,2769,1363,1406,96.9,2747,1353,1394,97.1
35020, 군산시,070004, 68세,2018,2874,1405,1469,95.6,2853,1398,1455,96.1
35020, 군산시,070005, 69세,2018,2543,1208,1335,90.5,2528,1203,1325,90.8
35020, 군산시,075,70~74세,2018,11199,5219,5980,87.3,11137,5184,5953,87.1
35020, 군산시,075001, 70세,2018,2464,1154,1310,88.1,2449,1144,1305,87.7
35020, 군산시,075002, 71세,2018,2798,1329,1469,90.5,2785,1321,1464,90.2
35020, 군산시,075003, 72세,2018,2127,1040,1087,95.7,2113,1033,1080,95.6
35020, 군산시,075004, 73세,2018,1905,865,1040,83.2,1891,856,1035,82.7
35020, 군산시,075005, 74세,2018,1905,831,1074,77.4,1899,830,1069,77.6
35020, 군산시,080,75~79세,2018,9190,3834,5356,71.6,9173,3827,5346,71.6
35020, 군산시,080001, 75세,2018,1874,828,1046,79.2,1871,825,1046,78.9
35020, 군산시,080002, 76세,2018,2553,1063,1490,71.3,2550,1062,1488,71.4
35020, 군산시,080003, 77세,2018,1642,674,968,69.6,1641,674,967,69.7
35020, 군산시,080004, 78세,2018,1584,617,967,63.8,1579,616,963,64
35020, 군산시,080005, 79세,2018,1537,652,885,73.7,1532,650,882,73.7
35020, 군산시,085,80~84세,2018,5934,2123,3811,55.7,5916,2114,3802,55.6
35020, 군산시,085001, 80세,2018,1474,516,958,53.9,1471,514,957,53.7
35020, 군산시,085002, 81세,2018,1278,500,778,64.3,1273,497,776,64
35020, 군산시,085003, 82세,2018,1160,429,731,58.7,1156,427,729,58.6
35020, 군산시,085004, 83세,2018,1125,374,751,49.8,1121,372,749,49.7
35020, 군산시,085005, 84세,2018,897,304,593,51.3,895,304,591,51.4
35020, 군산시,090,85~89세,2018,3133,823,2310,35.6,3130,820,2310,35.5
35020, 군산시,090001, 85세,2018,892,276,616,44.8,891,275,616,44.6
35020, 군산시,090002, 86세,2018,749,190,559,34,748,189,559,33.8
35020, 군산시,090003, 87세,2018,562,130,432,30.1,561,129,432,29.9
35020, 군산시,090004, 88세,2018,535,120,415,28.9,535,120,415,28.9
35020, 군산시,090005, 89세,2018,395,107,288,37.2,395,107,288,37.2
35020, 군산시,095,90~94세,2018,959,178,781,22.8,958,178,780,22.8
35020, 군산시,095001, 90세,2018,340,59,281,21,340,59,281,21
35020, 군산시,095002, 91세,2018,252,50,202,24.8,251,50,201,24.9
35020, 군산시,095003, 92세,2018,165,34,131,26,165,34,131,26
35020, 군산시,095004, 93세,2018,114,19,95,20,114,19,95,20
35020, 군산시,095005, 94세,2018,88,16,72,22.2,88,16,72,22.2
35020, 군산시,100,95~99세,2018,221,44,177,24.9,221,44,177,24.9
35020, 군산시,100001, 95세,2018,102,21,81,25.9,102,21,81,25.9
35020, 군산시,100002, 96세,2018,50,7,43,16.3,50,7,43,16.3
35020, 군산시,100003, 97세,2018,29,6,23,26.1,29,6,23,26.1
35020, 군산시,100004, 98세,2018,24,6,18,33.3,24,6,18,33.3
35020, 군산시,100005, 99세,2018,16,X,12,33.3,16,X,12,33.3
35020, 군산시,101,100세이상,2018,28,6,22,27.3,28,6,22,27.3
35020, 군산시,102,15세미만,2018,36346,18643,17703,105.3,36215,18576,17639,105.3
35020, 군산시,103,15~64세,2018,191384,101415,89969,112.7,184491,96952,87539,110.8
35020, 군산시,104,65세이상,2018,44474,19018,25456,74.7,44271,18920,25351,74.6
35020, 군산시,086,85세이상,2018,4341,1051,3290,31.9,4337,1048,3289,31.9
35020, 군산시,126,평균연령,2018,42.4,41,43.9,,42.6,41.2,44,
35020, 군산시,127,중위연령,2018,43.7,42.2,45.2,,44.1,42.8,45.4,
35030, 익산시,000,합계,2018,294787,147902,146885,100.7,288139,144492,143647,100.6
35030, 익산시,005,0~4세,2018,9846,5005,4841,103.4,9805,4982,4823,103.3
35030, 익산시,005001, 0세,2018,1608,793,815,97.3,1599,790,809,97.7
35030, 익산시,005002, 1세,2018,1790,869,921,94.4,1778,863,915,94.3
35030, 익산시,005003, 2세,2018,2070,1042,1028,101.4,2063,1038,1025,101.3
35030, 익산시,005004, 3세,2018,2231,1179,1052,112.1,2225,1175,1050,111.9
35030, 익산시,005005, 4세,2018,2147,1122,1025,109.5,2140,1116,1024,109
35030, 익산시,010,5~9세,2018,12429,6343,6086,104.2,12401,6329,6072,104.2
35030, 익산시,010001, 5세,2018,2307,1210,1097,110.3,2299,1204,1095,110
35030, 익산시,010002, 6세,2018,2688,1383,1305,106,2684,1381,1303,106
35030, 익산시,010003, 7세,2018,2635,1320,1315,100.4,2629,1319,1310,100.7
35030, 익산시,010004, 8세,2018,2412,1204,1208,99.7,2409,1202,1207,99.6
35030, 익산시,010005, 9세,2018,2387,1226,1161,105.6,2380,1223,1157,105.7
35030, 익산시,015,10~14세,2018,13071,6697,6374,105.1,13057,6688,6369,105
35030, 익산시,015001, 10세,2018,2578,1297,1281,101.2,2578,1297,1281,101.2
35030, 익산시,015002, 11세,2018,2682,1378,1304,105.7,2677,1374,1303,105.4
35030, 익산시,015003, 12세,2018,2484,1267,1217,104.1,2482,1265,1217,103.9
35030, 익산시,015004, 13세,2018,2544,1348,1196,112.7,2542,1347,1195,112.7
35030, 익산시,015005, 14세,2018,2783,1407,1376,102.3,2778,1405,1373,102.3
35030, 익산시,020,15~19세,2018,18897,10209,8688,117.5,18746,10138,8608,117.8
35030, 익산시,020001, 15세,2018,2948,1500,1448,103.6,2944,1498,1446,103.6
35030, 익산시,020002, 16세,2018,3190,1738,1452,119.7,3185,1736,1449,119.8
35030, 익산시,020003, 17세,2018,3798,2035,1763,115.4,3783,2029,1754,115.7
35030, 익산시,020004, 18세,2018,4328,2402,1926,124.7,4302,2387,1915,124.6
35030, 익산시,020005, 19세,2018,4633,2534,2099,120.7,4532,2488,2044,121.7
35030, 익산시,025,20~24세,2018,24949,13807,11142,123.9,23385,12993,10392,125
35030, 익산시,025001, 20세,2018,4897,2535,2362,107.3,4550,2353,2197,107.1
35030, 익산시,025002, 21세,2018,4964,2523,2441,103.4,4674,2376,2298,103.4
35030, 익산시,025003, 22세,2018,5207,2904,2303,126.1,4939,2763,2176,127
35030, 익산시,025004, 23세,2018,5000,2963,2037,145.5,4689,2798,1891,148
35030, 익산시,025005, 24세,2018,4881,2882,1999,144.2,4533,2703,1830,147.7
35030, 익산시,030,25~29세,2018,17975,10032,7943,126.3,16602,9281,7321,126.8
35030, 익산시,030001, 25세,2018,4272,2474,1798,137.6,3973,2327,1646,141.4
35030, 익산시,030002, 26세,2018,3853,2086,1767,118.1,3574,1935,1639,118.1
35030, 익산시,030003, 27세,2018,3541,1893,1648,114.9,3271,1748,1523,114.8
35030, 익산시,030004, 28세,2018,3238,1808,1430,126.4,2970,1652,1318,125.3
35030, 익산시,030005, 29세,2018,3071,1771,1300,136.2,2814,1619,1195,135.5
35030, 익산시,035,30~34세,2018,14873,7809,7064,110.5,13855,7241,6614,109.5
35030, 익산시,035001, 30세,2018,2966,1610,1356,118.7,2722,1470,1252,117.4
35030, 익산시,035002, 31세,2018,2817,1495,1322,113.1,2616,1384,1232,112.3
35030, 익산시,035003, 32세,2018,2986,1545,1441,107.2,2792,1441,1351,106.7
35030, 익산시,035004, 33세,2018,2906,1494,1412,105.8,2707,1388,1319,105.2
35030, 익산시,035005, 34세,2018,3198,1665,1533,108.6,3018,1558,1460,106.7
35030, 익산시,040,35~39세,2018,18586,9628,8958,107.5,17882,9261,8621,107.4
35030, 익산시,040001, 35세,2018,3462,1770,1692,104.6,3311,1691,1620,104.4
35030, 익산시,040002, 36세,2018,3652,1934,1718,112.6,3513,1866,1647,113.3
35030, 익산시,040003, 37세,2018,3722,1938,1784,108.6,3581,1874,1707,109.8
35030, 익산시,040004, 38세,2018,3979,2051,1928,106.4,3845,1976,1869,105.7
35030, 익산시,040005, 39세,2018,3771,1935,1836,105.4,3632,1854,1778,104.3
35030, 익산시,045,40~44세,2018,20235,10345,9890,104.6,19798,10128,9670,104.7
35030, 익산시,045001, 40세,2018,3683,1873,1810,103.5,3580,1815,1765,102.8
35030, 익산시,045002, 41세,2018,3816,1937,1879,103.1,3725,1895,1830,103.6
35030, 익산시,045003, 42세,2018,3978,2082,1896,109.8,3890,2036,1854,109.8
35030, 익산시,045004, 43세,2018,3985,2029,1956,103.7,3901,1988,1913,103.9
35030, 익산시,045005, 44세,2018,4773,2424,2349,103.2,4702,2394,2308,103.7
35030, 익산시,050,45~49세,2018,24174,12128,12046,100.7,23781,11949,11832,101
35030, 익산시,050001, 45세,2018,4689,2334,2355,99.1,4602,2295,2307,99.5
35030, 익산시,050002, 46세,2018,4545,2276,2269,100.3,4475,2246,2229,100.8
35030, 익산시,050003, 47세,2018,5116,2610,2506,104.2,5028,2570,2458,104.6
35030, 익산시,050004, 48세,2018,4808,2407,2401,100.2,4736,2375,2361,100.6
35030, 익산시,050005, 49세,2018,5016,2501,2515,99.4,4940,2463,2477,99.4
35030, 익산시,055,50~54세,2018,23877,12065,11812,102.1,23512,11903,11609,102.5
35030, 익산시,055001, 50세,2018,5058,2505,2553,98.1,4979,2471,2508,98.5
35030, 익산시,055002, 51세,2018,4766,2337,2429,96.2,4700,2309,2391,96.6
35030, 익산시,055003, 52세,2018,4769,2508,2261,110.9,4688,2468,2220,111.2
35030, 익산시,055004, 53세,2018,4769,2396,2373,101,4700,2370,2330,101.7
35030, 익산시,055005, 54세,2018,4515,2319,2196,105.6,4445,2285,2160,105.8
35030, 익산시,060,55~59세,2018,25147,12631,12516,100.9,24862,12512,12350,101.3
35030, 익산시,060001, 55세,2018,4728,2419,2309,104.8,4661,2388,2273,105.1
35030, 익산시,060002, 56세,2018,4981,2546,2435,104.6,4907,2514,2393,105.1
35030, 익산시,060003, 57세,2018,5235,2586,2649,97.6,5192,2572,2620,98.2
35030, 익산시,060004, 58세,2018,5526,2722,2804,97.1,5472,2702,2770,97.5
35030, 익산시,060005, 59세,2018,4677,2358,2319,101.7,4630,2336,2294,101.8
35030, 익산시,065,60~64세,2018,20653,10280,10373,99.1,20502,10218,10284,99.4
35030, 익산시,065001, 60세,2018,4277,2145,2132,100.6,4241,2129,2112,100.8
35030, 익산시,065002, 61세,2018,4428,2239,2189,102.3,4392,2225,2167,102.7
35030, 익산시,065003, 62세,2018,4160,2120,2040,103.9,4132,2108,2024,104.2
35030, 익산시,065004, 63세,2018,4210,2065,2145,96.3,4179,2052,2127,96.5
35030, 익산시,065005, 64세,2018,3578,1711,1867,91.6,3558,1704,1854,91.9
35030, 익산시,070,65~69세,2018,14933,7259,7674,94.6,14863,7223,7640,94.5
35030, 익산시,070001, 65세,2018,2933,1468,1465,100.2,2911,1458,1453,100.3
35030, 익산시,070002, 66세,2018,3247,1583,1664,95.1,3234,1573,1661,94.7
35030, 익산시,070003, 67세,2018,2829,1398,1431,97.7,2817,1392,1425,97.7
35030, 익산시,070004, 68세,2018,3172,1526,1646,92.7,3155,1518,1637,92.7
35030, 익산시,070005, 69세,2018,2752,1284,1468,87.5,2746,1282,1464,87.6
35030, 익산시,075,70~74세,2018,11593,5380,6213,86.6,11569,5368,6201,86.6
35030, 익산시,075001, 70세,2018,2715,1275,1440,88.5,2706,1270,1436,88.4
35030, 익산시,075002, 71세,2018,2880,1397,1483,94.2,2876,1394,1482,94.1
35030, 익산시,075003, 72세,2018,2131,994,1137,87.4,2125,992,1133,87.6
35030, 익산시,075004, 73세,2018,1940,874,1066,82,1938,872,1066,81.8
35030, 익산시,075005, 74세,2018,1927,840,1087,77.3,1924,840,1084,77.5
35030, 익산시,080,75~79세,2018,10799,4340,6459,67.2,10778,4338,6440,67.4
35030, 익산시,080001, 75세,2018,2160,902,1258,71.7,2157,902,1255,71.9
35030, 익산시,080002, 76세,2018,3022,1277,1745,73.2,3019,1277,1742,73.3
35030, 익산시,080003, 77세,2018,1940,776,1164,66.7,1938,775,1163,66.6
35030, 익산시,080004, 78세,2018,1776,671,1105,60.7,1767,670,1097,61.1
35030, 익산시,080005, 79세,2018,1901,714,1187,60.2,1897,714,1183,60.4
35030, 익산시,085,80~84세,2018,7357,2561,4796,53.4,7351,2558,4793,53.4
35030, 익산시,085001, 80세,2018,1741,619,1122,55.2,1740,619,1121,55.2
35030, 익산시,085002, 81세,2018,1614,559,1055,53,1612,558,1054,52.9
35030, 익산시,085003, 82세,2018,1392,493,899,54.8,1391,492,899,54.7
35030, 익산시,085004, 83세,2018,1399,478,921,51.9,1398,477,921,51.8
35030, 익산시,085005, 84세,2018,1211,412,799,51.6,1210,412,798,51.6
35030, 익산시,090,85~89세,2018,3894,1057,2837,37.3,3891,1056,2835,37.2
35030, 익산시,090001, 85세,2018,1124,327,797,41,1124,327,797,41
35030, 익산시,090002, 86세,2018,886,268,618,43.4,886,268,618,43.4
35030, 익산시,090003, 87세,2018,721,166,555,29.9,720,166,554,30
35030, 익산시,090004, 88세,2018,617,154,463,33.3,616,153,463,33
35030, 익산시,090005, 89세,2018,546,142,404,35.1,545,142,403,35.2
35030, 익산시,095,90~94세,2018,1207,281,926,30.3,1207,281,926,30.3
35030, 익산시,095001, 90세,2018,412,97,315,30.8,412,97,315,30.8
35030, 익산시,095002, 91세,2018,329,69,260,26.5,329,69,260,26.5
35030, 익산시,095003, 92세,2018,202,55,147,37.4,202,55,147,37.4
35030, 익산시,095004, 93세,2018,149,27,122,22.1,149,27,122,22.1
35030, 익산시,095005, 94세,2018,115,33,82,40.2,115,33,82,40.2
35030, 익산시,100,95~99세,2018,257,38,219,17.4,257,38,219,17.4
35030, 익산시,100001, 95세,2018,96,8,88,9.1,96,8,88,9.1
35030, 익산시,100002, 96세,2018,80,16,64,25,80,16,64,25
35030, 익산시,100003, 97세,2018,35,6,29,20.7,35,6,29,20.7
35030, 익산시,100004, 98세,2018,33,6,27,22.2,33,6,27,22.2
35030, 익산시,100005, 99세,2018,13,X,11,18.2,13,X,11,18.2
35030, 익산시,101,100세이상,2018,35,7,28,25,35,7,28,25
35030, 익산시,102,15세미만,2018,35346,18045,17301,104.3,35263,17999,17264,104.3
35030, 익산시,103,15~64세,2018,209366,108934,100432,108.5,202925,105624,97301,108.6
35030, 익산시,104,65세이상,2018,50075,20923,29152,71.8,49951,20869,29082,71.8
35030, 익산시,086,85세이상,2018,5393,1383,4010,34.5,5390,1382,4008,34.5
35030, 익산시,126,평균연령,2018,42.8,41.2,44.4,,43,41.4,44.6,
35030, 익산시,127,중위연령,2018,44.3,42.3,46,,44.7,42.8,46.5,
35040, 정읍시,000,합계,2018,108271,53890,54381,99.1,104996,51936,53060,97.9
35040, 정읍시,005,0~4세,2018,3151,1611,1540,104.6,3134,1605,1529,105
35040, 정읍시,005001, 0세,2018,538,253,285,88.8,533,252,281,89.7
35040, 정읍시,005002, 1세,2018,540,287,253,113.4,538,287,251,114.3
35040, 정읍시,005003, 2세,2018,642,336,306,109.8,640,335,305,109.8
35040, 정읍시,005004, 3세,2018,690,368,322,114.3,685,366,319,114.7
35040, 정읍시,005005, 4세,2018,741,367,374,98.1,738,365,373,97.9
35040, 정읍시,010,5~9세,2018,4038,2130,1908,111.6,4034,2127,1907,111.5
35040, 정읍시,010001, 5세,2018,721,374,347,107.8,719,372,347,107.2
35040, 정읍시,010002, 6세,2018,879,451,428,105.4,878,450,428,105.1
35040, 정읍시,010003, 7세,2018,879,457,422,108.3,878,457,421,108.6
35040, 정읍시,010004, 8세,2018,789,428,361,118.6,789,428,361,118.6
35040, 정읍시,010005, 9세,2018,770,420,350,120,770,420,350,120
35040, 정읍시,015,10~14세,2018,4467,2355,2112,111.5,4457,2350,2107,111.5
35040, 정읍시,015001, 10세,2018,861,450,411,109.5,859,449,410,109.5
35040, 정읍시,015002, 11세,2018,919,457,462,98.9,917,456,461,98.9
35040, 정읍시,015003, 12세,2018,843,458,385,119,842,458,384,119.3
35040, 정읍시,015004, 13세,2018,865,445,420,106,864,444,420,105.7
35040, 정읍시,015005, 14세,2018,979,545,434,125.6,975,543,432,125.7
35040, 정읍시,020,15~19세,2018,5717,2981,2736,109,5579,2906,2673,108.7
35040, 정읍시,020001, 15세,2018,1033,560,473,118.4,1030,558,472,118.2
35040, 정읍시,020002, 16세,2018,1209,645,564,114.4,1205,643,562,114.4
35040, 정읍시,020003, 17세,2018,1260,643,617,104.2,1254,639,615,103.9
35040, 정읍시,020004, 18세,2018,1303,665,638,104.2,1275,646,629,102.7
35040, 정읍시,020005, 19세,2018,912,468,444,105.4,815,420,395,106.3
35040, 정읍시,025,20~24세,2018,5835,3381,2454,137.8,5251,2990,2261,132.2
35040, 정읍시,025001, 20세,2018,1136,651,485,134.2,1056,608,448,135.7
35040, 정읍시,025002, 21세,2018,1217,721,496,145.4,1099,633,466,135.8
35040, 정읍시,025003, 22세,2018,1198,704,494,142.5,1093,633,460,137.6
35040, 정읍시,025004, 23세,2018,1157,662,495,133.7,992,554,438,126.5
35040, 정읍시,025005, 24세,2018,1127,643,484,132.9,1011,562,449,125.2
35040, 정읍시,030,25~29세,2018,4904,2706,2198,123.1,4274,2311,1963,117.7
35040, 정읍시,030001, 25세,2018,1016,531,485,109.5,883,450,433,103.9
35040, 정읍시,030002, 26세,2018,1019,558,461,121,893,479,414,115.7
35040, 정읍시,030003, 27세,2018,1011,587,424,138.4,887,500,387,129.2
35040, 정읍시,030004, 28세,2018,954,530,424,125,831,453,378,119.8
35040, 정읍시,030005, 29세,2018,904,500,404,123.8,780,429,351,122.2
35040, 정읍시,035,30~34세,2018,4650,2552,2098,121.6,4068,2190,1878,116.6
35040, 정읍시,035001, 30세,2018,942,524,418,125.4,804,440,364,120.9
35040, 정읍시,035002, 31세,2018,898,502,396,126.8,771,419,352,119
35040, 정읍시,035003, 32세,2018,915,514,401,128.2,821,452,369,122.5
35040, 정읍시,035004, 33세,2018,884,463,421,110,775,392,383,102.3
35040, 정읍시,035005, 34세,2018,1011,549,462,118.8,897,487,410,118.8
35040, 정읍시,040,35~39세,2018,5932,3145,2787,112.8,5550,2912,2638,110.4
35040, 정읍시,040001, 35세,2018,1037,559,478,116.9,954,508,446,113.9
35040, 정읍시,040002, 36세,2018,1147,602,545,110.5,1068,552,516,107
35040, 정읍시,040003, 37세,2018,1195,649,546,118.9,1117,599,518,115.6
35040, 정읍시,040004, 38세,2018,1268,664,604,109.9,1191,622,569,109.3
35040, 정읍시,040005, 39세,2018,1285,671,614,109.3,1220,631,589,107.1
35040, 정읍시,045,40~44세,2018,6997,3681,3316,111,6779,3546,3233,109.7
35040, 정읍시,045001, 40세,2018,1248,649,599,108.3,1192,611,581,105.2
35040, 정읍시,045002, 41세,2018,1308,679,629,107.9,1264,650,614,105.9
35040, 정읍시,045003, 42세,2018,1351,726,625,116.2,1306,696,610,114.1
35040, 정읍시,045004, 43세,2018,1450,739,711,103.9,1408,720,688,104.7
35040, 정읍시,045005, 44세,2018,1640,888,752,118.1,1609,869,740,117.4
35040, 정읍시,050,45~49세,2018,8481,4537,3944,115,8281,4435,3846,115.3
35040, 정읍시,050001, 45세,2018,1647,875,772,113.3,1602,849,753,112.7
35040, 정읍시,050002, 46세,2018,1611,871,740,117.7,1578,851,727,117.1
35040, 정읍시,050003, 47세,2018,1776,927,849,109.2,1734,909,825,110.2
35040, 정읍시,050004, 48세,2018,1666,901,765,117.8,1624,882,742,118.9
35040, 정읍시,050005, 49세,2018,1781,963,818,117.7,1743,944,799,118.1
35040, 정읍시,055,50~54세,2018,8598,4605,3993,115.3,8420,4512,3908,115.5
35040, 정읍시,055001, 50세,2018,1775,948,827,114.6,1732,925,807,114.6
35040, 정읍시,055002, 51세,2018,1672,910,762,119.4,1641,893,748,119.4
35040, 정읍시,055003, 52세,2018,1685,921,764,120.5,1653,904,749,120.7
35040, 정읍시,055004, 53세,2018,1784,951,833,114.2,1747,935,812,115.1
35040, 정읍시,055005, 54세,2018,1682,875,807,108.4,1647,855,792,108
35040, 정읍시,060,55~59세,2018,9429,4903,4526,108.3,9297,4841,4456,108.6
35040, 정읍시,060001, 55세,2018,1715,909,806,112.8,1685,892,793,112.5
35040, 정읍시,060002, 56세,2018,1777,960,817,117.5,1748,945,803,117.7
35040, 정읍시,060003, 57세,2018,2115,1069,1046,102.2,2092,1062,1030,103.1
35040, 정읍시,060004, 58세,2018,2039,1010,1029,98.2,2003,993,1010,98.3
35040, 정읍시,060005, 59세,2018,1783,955,828,115.3,1769,949,820,115.7
35040, 정읍시,065,60~64세,2018,8451,4208,4243,99.2,8336,4151,4185,99.2
35040, 정읍시,065001, 60세,2018,1713,849,864,98.3,1680,836,844,99.1
35040, 정읍시,065002, 61세,2018,1862,999,863,115.8,1840,989,851,116.2
35040, 정읍시,065003, 62세,2018,1547,773,774,99.9,1526,763,763,100
35040, 정읍시,065004, 63세,2018,1810,871,939,92.8,1788,859,929,92.5
35040, 정읍시,065005, 64세,2018,1519,716,803,89.2,1502,704,798,88.2
35040, 정읍시,070,65~69세,2018,6710,3153,3557,88.6,6661,3128,3533,88.5
35040, 정읍시,070001, 65세,2018,1187,537,650,82.6,1173,530,643,82.4
35040, 정읍시,070002, 66세,2018,1399,671,728,92.2,1391,667,724,92.1
35040, 정읍시,070003, 67세,2018,1237,577,660,87.4,1227,570,657,86.8
35040, 정읍시,070004, 68세,2018,1429,687,742,92.6,1420,684,736,92.9
35040, 정읍시,070005, 69세,2018,1458,681,777,87.6,1450,677,773,87.6
35040, 정읍시,075,70~74세,2018,6245,2860,3385,84.5,6226,2855,3371,84.7
35040, 정읍시,075001, 70세,2018,1383,692,691,100.1,1378,691,687,100.6
35040, 정읍시,075002, 71세,2018,1510,712,798,89.2,1506,710,796,89.2
35040, 정읍시,075003, 72세,2018,1146,546,600,91,1143,546,597,91.5
35040, 정읍시,075004, 73세,2018,1089,442,647,68.3,1085,441,644,68.5
35040, 정읍시,075005, 74세,2018,1117,468,649,72.1,1114,467,647,72.2
35040, 정읍시,080,75~79세,2018,6569,2571,3998,64.3,6561,2570,3991,64.4
35040, 정읍시,080001, 75세,2018,1222,498,724,68.8,1220,498,722,69
35040, 정읍시,080002, 76세,2018,1721,672,1049,64.1,1718,671,1047,64.1
35040, 정읍시,080003, 77세,2018,1241,484,757,63.9,1240,484,756,64
35040, 정읍시,080004, 78세,2018,1191,468,723,64.7,1189,468,721,64.9
35040, 정읍시,080005, 79세,2018,1194,449,745,60.3,1194,449,745,60.3
35040, 정읍시,085,80~84세,2018,4879,1714,3165,54.2,4872,1711,3161,54.1
35040, 정읍시,085001, 80세,2018,1114,421,693,60.8,1114,421,693,60.8
35040, 정읍시,085002, 81세,2018,1029,384,645,59.5,1024,381,643,59.3
35040, 정읍시,085003, 82세,2018,945,334,611,54.7,943,334,609,54.8
35040, 정읍시,085004, 83세,2018,983,314,669,46.9,983,314,669,46.9
35040, 정읍시,085005, 84세,2018,808,261,547,47.7,808,261,547,47.7
35040, 정읍시,090,85~89세,2018,2298,603,1695,35.6,2296,602,1694,35.5
35040, 정읍시,090001, 85세,2018,672,207,465,44.5,672,207,465,44.5
35040, 정읍시,090002, 86세,2018,522,128,394,32.5,522,128,394,32.5
35040, 정읍시,090003, 87세,2018,409,101,308,32.8,409,101,308,32.8
35040, 정읍시,090004, 88세,2018,389,87,302,28.8,388,86,302,28.5
35040, 정읍시,090005, 89세,2018,306,80,226,35.4,305,80,225,35.6
35040, 정읍시,095,90~94세,2018,725,162,563,28.8,725,162,563,28.8
35040, 정읍시,095001, 90세,2018,291,62,229,27.1,291,62,229,27.1
35040, 정읍시,095002, 91세,2018,204,38,166,22.9,204,38,166,22.9
35040, 정읍시,095003, 92세,2018,95,24,71,33.8,95,24,71,33.8
35040, 정읍시,095004, 93세,2018,73,19,54,35.2,73,19,54,35.2
35040, 정읍시,095005, 94세,2018,62,19,43,44.2,62,19,43,44.2
35040, 정읍시,100,95~99세,2018,181,30,151,19.9,181,30,151,19.9
35040, 정읍시,100001, 95세,2018,65,8,57,14,65,8,57,14
35040, 정읍시,100002, 96세,2018,45,10,35,28.6,45,10,35,28.6
35040, 정읍시,100003, 97세,2018,39,10,29,34.5,39,10,29,34.5
35040, 정읍시,100004, 98세,2018,20,X,19,5.3,20,X,19,5.3
35040, 정읍시,100005, 99세,2018,12,X,11,9.1,12,X,11,9.1
35040, 정읍시,101,100세이상,2018,14,X,12,16.7,14,X,12,16.7
35040, 정읍시,102,15세미만,2018,11656,6096,5560,109.6,11625,6082,5543,109.7
35040, 정읍시,103,15~64세,2018,68994,36699,32295,113.6,65835,34794,31041,112.1
35040, 정읍시,104,65세이상,2018,27621,11095,16526,67.1,27536,11060,16476,67.1
35040, 정읍시,086,85세이상,2018,3218,797,2421,32.9,3216,796,2420,32.9
35040, 정읍시,126,평균연령,2018,47.6,45.3,50,,48,45.7,50.3,
35040, 정읍시,127,중위연령,2018,50,47.7,52.7,,50.6,48.5,53.2,
35050, 남원시,000,합계,2018,78487,38400,40087,95.8,77190,37844,39346,96.2
35050, 남원시,005,0~4세,2018,2408,1289,1119,115.2,2402,1286,1116,115.2
35050, 남원시,005001, 0세,2018,454,267,187,142.8,454,267,187,142.8
35050, 남원시,005002, 1세,2018,444,229,215,106.5,444,229,215,106.5
35050, 남원시,005003, 2세,2018,481,244,237,103,480,243,237,102.5
35050, 남원시,005004, 3세,2018,495,274,221,124,493,273,220,124.1
35050, 남원시,005005, 4세,2018,534,275,259,106.2,531,274,257,106.6
35050, 남원시,010,5~9세,2018,3012,1613,1399,115.3,3010,1613,1397,115.5
35050, 남원시,010001, 5세,2018,582,309,273,113.2,581,309,272,113.6
35050, 남원시,010002, 6세,2018,578,319,259,123.2,578,319,259,123.2
35050, 남원시,010003, 7세,2018,665,338,327,103.4,665,338,327,103.4
35050, 남원시,010004, 8세,2018,587,302,285,106,587,302,285,106
35050, 남원시,010005, 9세,2018,600,345,255,135.3,599,345,254,135.8
35050, 남원시,015,10~14세,2018,3359,1721,1638,105.1,3354,1718,1636,105
35050, 남원시,015001, 10세,2018,665,351,314,111.8,664,351,313,112.1
35050, 남원시,015002, 11세,2018,656,325,331,98.2,656,325,331,98.2
35050, 남원시,015003, 12세,2018,651,332,319,104.1,651,332,319,104.1
35050, 남원시,015004, 13세,2018,674,337,337,100,673,337,336,100.3
35050, 남원시,015005, 14세,2018,713,376,337,111.6,710,373,337,110.7
35050, 남원시,020,15~19세,2018,3811,1995,1816,109.9,3788,1987,1801,110.3
35050, 남원시,020001, 15세,2018,781,405,376,107.7,780,405,375,108
35050, 남원시,020002, 16세,2018,787,386,401,96.3,785,386,399,96.7
35050, 남원시,020003, 17세,2018,940,473,467,101.3,936,471,465,101.3
35050, 남원시,020004, 18세,2018,807,426,381,111.8,805,425,380,111.8
35050, 남원시,020005, 19세,2018,496,305,191,159.7,482,300,182,164.8
35050, 남원시,025,20~24세,2018,3907,2310,1597,144.6,3723,2221,1502,147.9
35050, 남원시,025001, 20세,2018,759,518,241,214.9,741,509,232,219.4
35050, 남원시,025002, 21세,2018,813,514,299,171.9,781,499,282,177
35050, 남원시,025003, 22세,2018,851,478,373,128.2,821,462,359,128.7
35050, 남원시,025004, 23세,2018,744,405,339,119.5,694,382,312,122.4
35050, 남원시,025005, 24세,2018,740,395,345,114.5,686,369,317,116.4
35050, 남원시,030,25~29세,2018,3190,1685,1505,112,2975,1595,1380,115.6
35050, 남원시,030001, 25세,2018,692,377,315,119.7,640,353,287,123
35050, 남원시,030002, 26세,2018,646,362,284,127.5,607,343,264,129.9
35050, 남원시,030003, 27세,2018,618,320,298,107.4,578,311,267,116.5
35050, 남원시,030004, 28세,2018,625,313,312,100.3,581,295,286,103.1
35050, 남원시,030005, 29세,2018,609,313,296,105.7,569,293,276,106.2
35050, 남원시,035,30~34세,2018,3103,1589,1514,105,2909,1502,1407,106.8
35050, 남원시,035001, 30세,2018,610,314,296,106.1,568,296,272,108.8
35050, 남원시,035002, 31세,2018,599,320,279,114.7,559,300,259,115.8
35050, 남원시,035003, 32세,2018,611,297,314,94.6,573,280,293,95.6
35050, 남원시,035004, 33세,2018,610,306,304,100.7,572,289,283,102.1
35050, 남원시,035005, 34세,2018,673,352,321,109.7,637,337,300,112.3
35050, 남원시,040,35~39세,2018,3993,2003,1990,100.7,3851,1951,1900,102.7
35050, 남원시,040001, 35세,2018,722,373,349,106.9,686,356,330,107.9
35050, 남원시,040002, 36세,2018,763,390,373,104.6,728,380,348,109.2
35050, 남원시,040003, 37세,2018,799,420,379,110.8,777,412,365,112.9
35050, 남원시,040004, 38세,2018,870,406,464,87.5,842,399,443,90.1
35050, 남원시,040005, 39세,2018,839,414,425,97.4,818,404,414,97.6
35050, 남원시,045,40~44세,2018,4910,2465,2445,100.8,4783,2410,2373,101.6
35050, 남원시,045001, 40세,2018,830,409,421,97.1,802,396,406,97.5
35050, 남원시,045002, 41세,2018,914,437,477,91.6,889,423,466,90.8
35050, 남원시,045003, 42세,2018,971,494,477,103.6,949,487,462,105.4
35050, 남원시,045004, 43세,2018,981,479,502,95.4,957,471,486,96.9
35050, 남원시,045005, 44세,2018,1214,646,568,113.7,1186,633,553,114.5
35050, 남원시,050,45~49세,2018,6282,3374,2908,116,6155,3321,2834,117.2
35050, 남원시,050001, 45세,2018,1195,645,550,117.3,1175,635,540,117.6
35050, 남원시,050002, 46세,2018,1200,634,566,112,1164,623,541,115.2
35050, 남원시,050003, 47세,2018,1300,670,630,106.3,1279,661,618,107
35050, 남원시,050004, 48세,2018,1198,674,524,128.6,1174,662,512,129.3
35050, 남원시,050005, 49세,2018,1389,751,638,117.7,1363,740,623,118.8
35050, 남원시,055,50~54세,2018,6204,3251,2953,110.1,6111,3217,2894,111.2
35050, 남원시,055001, 50세,2018,1351,693,658,105.3,1331,685,646,106
35050, 남원시,055002, 51세,2018,1270,658,612,107.5,1254,651,603,108
35050, 남원시,055003, 52세,2018,1275,652,623,104.7,1260,649,611,106.2
35050, 남원시,055004, 53세,2018,1254,661,593,111.5,1227,653,574,113.8
35050, 남원시,055005, 54세,2018,1054,587,467,125.7,1039,579,460,125.9
35050, 남원시,060,55~59세,2018,7171,3673,3498,105,7107,3645,3462,105.3
35050, 남원시,060001, 55세,2018,1241,670,571,117.3,1223,661,562,117.6
35050, 남원시,060002, 56세,2018,1430,758,672,112.8,1422,757,665,113.8
35050, 남원시,060003, 57세,2018,1510,731,779,93.8,1497,725,772,93.9
35050, 남원시,060004, 58세,2018,1624,839,785,106.9,1611,832,779,106.8
35050, 남원시,060005, 59세,2018,1366,675,691,97.7,1354,670,684,98
35050, 남원시,065,60~64세,2018,6266,3121,3145,99.2,6192,3085,3107,99.3
35050, 남원시,065001, 60세,2018,1272,653,619,105.5,1254,646,608,106.3
35050, 남원시,065002, 61세,2018,1270,650,620,104.8,1253,638,615,103.7
35050, 남원시,065003, 62세,2018,1238,573,665,86.2,1221,567,654,86.7
35050, 남원시,065004, 63세,2018,1322,651,671,97,1308,645,663,97.3
35050, 남원시,065005, 64세,2018,1164,594,570,104.2,1156,589,567,103.9
35050, 남원시,070,65~69세,2018,5110,2467,2643,93.3,5088,2455,2633,93.2
35050, 남원시,070001, 65세,2018,971,501,470,106.6,969,499,470,106.2
35050, 남원시,070002, 66세,2018,1106,544,562,96.8,1101,540,561,96.3
35050, 남원시,070003, 67세,2018,970,473,497,95.2,965,471,494,95.3
35050, 남원시,070004, 68세,2018,1053,508,545,93.2,1045,505,540,93.5
35050, 남원시,070005, 69세,2018,1010,441,569,77.5,1008,440,568,77.5
35050, 남원시,075,70~74세,2018,4600,2039,2561,79.6,4588,2036,2552,79.8
35050, 남원시,075001, 70세,2018,1100,476,624,76.3,1099,476,623,76.4
35050, 남원시,075002, 71세,2018,1172,566,606,93.4,1168,566,602,94
35050, 남원시,075003, 72세,2018,848,392,456,86,845,391,454,86.1
35050, 남원시,075004, 73세,2018,745,311,434,71.7,743,310,433,71.6
35050, 남원시,075005, 74세,2018,735,294,441,66.7,733,293,440,66.6
35050, 남원시,080,75~79세,2018,4865,1862,3003,62,4862,1861,3001,62
35050, 남원시,080001, 75세,2018,837,338,499,67.7,837,338,499,67.7
35050, 남원시,080002, 76세,2018,1345,482,863,55.9,1344,482,862,55.9
35050, 남원시,080003, 77세,2018,970,396,574,69,969,395,574,68.8
35050, 남원시,080004, 78세,2018,828,324,504,64.3,828,324,504,64.3
35050, 남원시,080005, 79세,2018,885,322,563,57.2,884,322,562,57.3
35050, 남원시,085,80~84세,2018,3734,1242,2492,49.8,3733,1242,2491,49.9
35050, 남원시,085001, 80세,2018,816,300,516,58.1,815,300,515,58.3
35050, 남원시,085002, 81세,2018,818,272,546,49.8,818,272,546,49.8
35050, 남원시,085003, 82세,2018,688,257,431,59.6,688,257,431,59.6
35050, 남원시,085004, 83세,2018,738,225,513,43.9,738,225,513,43.9
35050, 남원시,085005, 84세,2018,674,188,486,38.7,674,188,486,38.7
35050, 남원시,090,85~89세,2018,1712,502,1210,41.5,1711,502,1209,41.5
35050, 남원시,090001, 85세,2018,456,145,311,46.6,456,145,311,46.6
35050, 남원시,090002, 86세,2018,434,133,301,44.2,434,133,301,44.2
35050, 남원시,090003, 87세,2018,323,90,233,38.6,323,90,233,38.6
35050, 남원시,090004, 88세,2018,276,75,201,37.3,276,75,201,37.3
35050, 남원시,090005, 89세,2018,223,59,164,36,222,59,163,36.2
35050, 남원시,095,90~94세,2018,659,153,506,30.2,657,151,506,29.8
35050, 남원시,095001, 90세,2018,250,62,188,33,250,62,188,33
35050, 남원시,095002, 91세,2018,171,44,127,34.6,171,44,127,34.6
35050, 남원시,095003, 92세,2018,121,23,98,23.5,120,22,98,22.4
35050, 남원시,095004, 93세,2018,61,14,47,29.8,60,13,47,27.7
35050, 남원시,095005, 94세,2018,56,10,46,21.7,56,10,46,21.7
35050, 남원시,100,95~99세,2018,168,45,123,36.6,168,45,123,36.6
35050, 남원시,100001, 95세,2018,67,23,44,52.3,67,23,44,52.3
35050, 남원시,100002, 96세,2018,45,13,32,40.6,45,13,32,40.6
35050, 남원시,100003, 97세,2018,27,5,22,22.7,27,5,22,22.7
35050, 남원시,100004, 98세,2018,19,X,16,18.8,19,X,16,18.8
35050, 남원시,100005, 99세,2018,10,X,9,11.1,10,X,9,11.1
35050, 남원시,101,100세이상,2018,23,X,22,4.5,23,X,22,4.5
35050, 남원시,102,15세미만,2018,8779,4623,4156,111.2,8766,4617,4149,111.3
35050, 남원시,103,15~64세,2018,48837,25466,23371,109,47594,24934,22660,110
35050, 남원시,104,65세이상,2018,20871,8311,12560,66.2,20830,8293,12537,66.1
35050, 남원시,086,85세이상,2018,2562,701,1861,37.7,2559,699,1860,37.6
35050, 남원시,126,평균연령,2018,48.3,45.9,50.6,,48.5,46,50.9,
35050, 남원시,127,중위연령,2018,50.9,48.9,53.4,,51.3,49.1,53.8,
35060, 김제시,000,합계,2018,81410,40538,40872,99.2,78900,38848,40052,97
35060, 김제시,005,0~4세,2018,2146,1096,1050,104.4,2134,1091,1043,104.6
35060, 김제시,005001, 0세,2018,354,181,173,104.6,352,180,172,104.7
35060, 김제시,005002, 1세,2018,399,194,205,94.6,394,193,201,96
35060, 김제시,005003, 2세,2018,431,224,207,108.2,429,222,207,107.2
35060, 김제시,005004, 3세,2018,468,234,234,100,467,234,233,100.4
35060, 김제시,005005, 4세,2018,494,263,231,113.9,492,262,230,113.9
35060, 김제시,010,5~9세,2018,2828,1453,1375,105.7,2818,1448,1370,105.7
35060, 김제시,010001, 5세,2018,516,278,238,116.8,515,277,238,116.4
35060, 김제시,010002, 6세,2018,581,299,282,106,578,298,280,106.4
35060, 김제시,010003, 7세,2018,612,291,321,90.7,611,291,320,90.9
35060, 김제시,010004, 8세,2018,548,284,264,107.6,545,282,263,107.2
35060, 김제시,010005, 9세,2018,571,301,270,111.5,569,300,269,111.5
35060, 김제시,015,10~14세,2018,2732,1415,1317,107.4,2726,1413,1313,107.6
35060, 김제시,015001, 10세,2018,537,280,257,108.9,535,279,256,109
35060, 김제시,015002, 11세,2018,586,305,281,108.5,585,305,280,108.9
35060, 김제시,015003, 12세,2018,534,278,256,108.6,534,278,256,108.6
35060, 김제시,015004, 13세,2018,530,287,243,118.1,529,287,242,118.6
35060, 김제시,015005, 14세,2018,545,265,280,94.6,543,264,279,94.6
35060, 김제시,020,15~19세,2018,3354,1765,1589,111.1,3341,1756,1585,110.8
35060, 김제시,020001, 15세,2018,583,287,296,97,582,286,296,96.6
35060, 김제시,020002, 16세,2018,643,329,314,104.8,642,329,313,105.1
35060, 김제시,020003, 17세,2018,767,389,378,102.9,765,388,377,102.9
35060, 김제시,020004, 18세,2018,795,427,368,116,792,425,367,115.8
35060, 김제시,020005, 19세,2018,566,333,233,142.9,560,328,232,141.4
35060, 김제시,025,20~24세,2018,3986,2432,1554,156.5,3685,2226,1459,152.6
35060, 김제시,025001, 20세,2018,700,448,252,177.8,682,434,248,175
35060, 김제시,025002, 21세,2018,748,488,260,187.7,717,464,253,183.4
35060, 김제시,025003, 22세,2018,817,481,336,143.2,745,438,307,142.7
35060, 김제시,025004, 23세,2018,843,492,351,140.2,763,436,327,133.3
35060, 김제시,025005, 24세,2018,878,523,355,147.3,778,454,324,140.1
35060, 김제시,030,25~29세,2018,3772,2182,1590,137.2,3184,1753,1431,122.5
35060, 김제시,030001, 25세,2018,808,469,339,138.3,698,387,311,124.4
35060, 김제시,030002, 26세,2018,748,432,316,136.7,620,332,288,115.3
35060, 김제시,030003, 27세,2018,752,415,337,123.1,639,340,299,113.7
35060, 김제시,030004, 28세,2018,779,470,309,152.1,654,376,278,135.3
35060, 김제시,030005, 29세,2018,685,396,289,137,573,318,255,124.7
35060, 김제시,035,30~34세,2018,3546,1985,1561,127.2,2992,1575,1417,111.2
35060, 김제시,035001, 30세,2018,708,387,321,120.6,579,299,280,106.8
35060, 김제시,035002, 31세,2018,680,379,301,125.9,568,293,275,106.5
35060, 김제시,035003, 32세,2018,708,419,289,145,596,322,274,117.5
35060, 김제시,035004, 33세,2018,689,376,313,120.1,579,299,280,106.8
35060, 김제시,035005, 34세,2018,761,424,337,125.8,670,362,308,117.5
35060, 김제시,040,35~39세,2018,4307,2383,1924,123.9,3904,2098,1806,116.2
35060, 김제시,040001, 35세,2018,753,403,350,115.1,658,339,319,106.3
35060, 김제시,040002, 36세,2018,885,510,375,136,804,452,352,128.4
35060, 김제시,040003, 37세,2018,917,527,390,135.1,843,469,374,125.4
35060, 김제시,040004, 38세,2018,904,483,421,114.7,822,428,394,108.6
35060, 김제시,040005, 39세,2018,848,460,388,118.6,777,410,367,111.7
35060, 김제시,045,40~44세,2018,4647,2645,2002,132.1,4447,2504,1943,128.9
35060, 김제시,045001, 40세,2018,845,489,356,137.4,786,448,338,132.5
35060, 김제시,045002, 41세,2018,907,493,414,119.1,856,457,399,114.5
35060, 김제시,045003, 42세,2018,927,547,380,143.9,895,520,375,138.7
35060, 김제시,045004, 43세,2018,899,507,392,129.3,869,486,383,126.9
35060, 김제시,045005, 44세,2018,1069,609,460,132.4,1041,593,448,132.4
35060, 김제시,050,45~49세,2018,5523,3093,2430,127.3,5375,3014,2361,127.7
35060, 김제시,050001, 45세,2018,1063,587,476,123.3,1033,569,464,122.6
35060, 김제시,050002, 46세,2018,1082,610,472,129.2,1047,595,452,131.6
35060, 김제시,050003, 47세,2018,1086,628,458,137.1,1052,608,444,136.9
35060, 김제시,050004, 48세,2018,1150,644,506,127.3,1123,628,495,126.9
35060, 김제시,050005, 49세,2018,1142,624,518,120.5,1120,614,506,121.3
35060, 김제시,055,50~54세,2018,6022,3235,2787,116.1,5899,3182,2717,117.1
35060, 김제시,055001, 50세,2018,1267,684,583,117.3,1236,671,565,118.8
35060, 김제시,055002, 51세,2018,1152,634,518,122.4,1132,626,506,123.7
35060, 김제시,055003, 52세,2018,1159,629,530,118.7,1136,619,517,119.7
35060, 김제시,055004, 53세,2018,1224,646,578,111.8,1201,635,566,112.2
35060, 김제시,055005, 54세,2018,1220,642,578,111.1,1194,631,563,112.1
35060, 김제시,060,55~59세,2018,7427,3720,3707,100.4,7356,3692,3664,100.8
35060, 김제시,060001, 55세,2018,1299,659,640,103,1282,651,631,103.2
35060, 김제시,060002, 56세,2018,1384,696,688,101.2,1370,693,677,102.4
35060, 김제시,060003, 57세,2018,1570,810,760,106.6,1560,807,753,107.2
35060, 김제시,060004, 58세,2018,1733,854,879,97.2,1716,848,868,97.7
35060, 김제시,060005, 59세,2018,1441,701,740,94.7,1428,693,735,94.3
35060, 김제시,065,60~64세,2018,7096,3532,3564,99.1,7055,3513,3542,99.2
35060, 김제시,065001, 60세,2018,1424,694,730,95.1,1418,690,728,94.8
35060, 김제시,065002, 61세,2018,1455,750,705,106.4,1444,746,698,106.9
35060, 김제시,065003, 62세,2018,1431,732,699,104.7,1428,730,698,104.6
35060, 김제시,065004, 63세,2018,1482,732,750,97.6,1473,727,746,97.5
35060, 김제시,065005, 64세,2018,1304,624,680,91.8,1292,620,672,92.3
35060, 김제시,070,65~69세,2018,5883,2758,3125,88.3,5855,2744,3111,88.2
35060, 김제시,070001, 65세,2018,1031,508,523,97.1,1027,507,520,97.5
35060, 김제시,070002, 66세,2018,1218,575,643,89.4,1209,571,638,89.5
35060, 김제시,070003, 67세,2018,1169,557,612,91,1164,555,609,91.1
35060, 김제시,070004, 68세,2018,1330,600,730,82.2,1322,594,728,81.6
35060, 김제시,070005, 69세,2018,1135,518,617,84,1133,517,616,83.9
35060, 김제시,075,70~74세,2018,5231,2378,2853,83.4,5225,2375,2850,83.3
35060, 김제시,075001, 70세,2018,1108,555,553,100.4,1106,554,552,100.4
35060, 김제시,075002, 71세,2018,1337,603,734,82.2,1336,603,733,82.3
35060, 김제시,075003, 72세,2018,964,452,512,88.3,962,451,511,88.3
35060, 김제시,075004, 73세,2018,908,394,514,76.7,907,393,514,76.5
35060, 김제시,075005, 74세,2018,914,374,540,69.3,914,374,540,69.3
35060, 김제시,080,75~79세,2018,5606,2207,3399,64.9,5606,2207,3399,64.9
35060, 김제시,080001, 75세,2018,1019,423,596,71,1019,423,596,71
35060, 김제시,080002, 76세,2018,1523,623,900,69.2,1523,623,900,69.2
35060, 김제시,080003, 77세,2018,1026,414,612,67.6,1026,414,612,67.6
35060, 김제시,080004, 78세,2018,984,370,614,60.3,984,370,614,60.3
35060, 김제시,080005, 79세,2018,1054,377,677,55.7,1054,377,677,55.7
35060, 김제시,085,80~84세,2018,4214,1442,2772,52,4211,1441,2770,52
35060, 김제시,085001, 80세,2018,962,342,620,55.2,962,342,620,55.2
35060, 김제시,085002, 81세,2018,896,322,574,56.1,894,322,572,56.3
35060, 김제시,085003, 82세,2018,802,260,542,48,802,260,542,48
35060, 김제시,085004, 83세,2018,829,290,539,53.8,828,289,539,53.6
35060, 김제시,085005, 84세,2018,725,228,497,45.9,725,228,497,45.9
35060, 김제시,090,85~89세,2018,2262,625,1637,38.2,2260,624,1636,38.1
35060, 김제시,090001, 85세,2018,687,192,495,38.8,686,191,495,38.6
35060, 김제시,090002, 86세,2018,504,135,369,36.6,504,135,369,36.6
35060, 김제시,090003, 87세,2018,381,117,264,44.3,381,117,264,44.3
35060, 김제시,090004, 88세,2018,389,96,293,32.8,388,96,292,32.9
35060, 김제시,090005, 89세,2018,301,85,216,39.4,301,85,216,39.4
35060, 김제시,095,90~94세,2018,684,170,514,33.1,683,170,513,33.1
35060, 김제시,095001, 90세,2018,248,57,191,29.8,247,57,190,30
35060, 김제시,095002, 91세,2018,176,42,134,31.3,176,42,134,31.3
35060, 김제시,095003, 92세,2018,119,35,84,41.7,119,35,84,41.7
35060, 김제시,095004, 93세,2018,77,18,59,30.5,77,18,59,30.5
35060, 김제시,095005, 94세,2018,64,18,46,39.1,64,18,46,39.1
35060, 김제시,100,95~99세,2018,136,21,115,18.3,136,21,115,18.3
35060, 김제시,100001, 95세,2018,45,7,38,18.4,45,7,38,18.4
35060, 김제시,100002, 96세,2018,41,7,34,20.6,41,7,34,20.6
35060, 김제시,100003, 97세,2018,24,X,21,14.3,24,X,21,14.3
35060, 김제시,100004, 98세,2018,20,X,16,25,20,X,16,25
35060, 김제시,100005, 99세,2018,6,X,6,0,6,X,6,0
35060, 김제시,101,100세이상,2018,8,X,7,14.3,8,X,7,14.3
35060, 김제시,102,15세미만,2018,7706,3964,3742,105.9,7678,3952,3726,106.1
35060, 김제시,103,15~64세,2018,49680,26972,22708,118.8,47238,25313,21925,115.5
35060, 김제시,104,65세이상,2018,24024,9602,14422,66.6,23984,9583,14401,66.5
35060, 김제시,086,85세이상,2018,3090,817,2273,35.9,3087,816,2271,35.9
35060, 김제시,126,평균연령,2018,50,47.2,52.7,,50.5,47.8,53,
35060, 김제시,127,중위연령,2018,53.2,49.7,56.9,,54.1,50.8,57.4,
35310, 완주군,000,합계,2018,98002,50411,47591,105.9,93876,48012,45864,104.7
35310, 완주군,005,0~4세,2018,3848,1898,1950,97.3,3819,1879,1940,96.9
35310, 완주군,005001, 0세,2018,576,267,309,86.4,573,266,307,86.6
35310, 완주군,005002, 1세,2018,704,340,364,93.4,695,336,359,93.6
35310, 완주군,005003, 2세,2018,791,399,392,101.8,785,393,392,100.3
35310, 완주군,005004, 3세,2018,928,469,459,102.2,920,464,456,101.8
35310, 완주군,005005, 4세,2018,849,423,426,99.3,846,420,426,98.6
35310, 완주군,010,5~9세,2018,4536,2356,2180,108.1,4524,2349,2175,108
35310, 완주군,010001, 5세,2018,908,457,451,101.3,905,456,449,101.6
35310, 완주군,010002, 6세,2018,960,492,468,105.1,957,489,468,104.5
35310, 완주군,010003, 7세,2018,914,489,425,115.1,912,487,425,114.6
35310, 완주군,010004, 8세,2018,933,511,422,121.1,931,511,420,121.7
35310, 완주군,010005, 9세,2018,821,407,414,98.3,819,406,413,98.3
35310, 완주군,015,10~14세,2018,4159,2192,1967,111.4,4149,2185,1964,111.3
35310, 완주군,015001, 10세,2018,867,452,415,108.9,866,451,415,108.7
35310, 완주군,015002, 11세,2018,872,447,425,105.2,871,447,424,105.4
35310, 완주군,015003, 12세,2018,792,425,367,115.8,790,423,367,115.3
35310, 완주군,015004, 13세,2018,759,382,377,101.3,755,379,376,100.8
35310, 완주군,015005, 14세,2018,869,486,383,126.9,867,485,382,127
35310, 완주군,020,15~19세,2018,6120,3314,2806,118.1,5888,3167,2721,116.4
35310, 완주군,020001, 15세,2018,885,467,418,111.7,883,467,416,112.3
35310, 완주군,020002, 16세,2018,965,509,456,111.6,961,508,453,112.1
35310, 완주군,020003, 17세,2018,1012,510,502,101.6,1008,509,499,102
35310, 완주군,020004, 18세,2018,1398,799,599,133.4,1351,763,588,129.8
35310, 완주군,020005, 19세,2018,1860,1029,831,123.8,1685,920,765,120.3
35310, 완주군,025,20~24세,2018,7724,4501,3223,139.7,6516,3754,2762,135.9
35310, 완주군,025001, 20세,2018,1788,954,834,114.4,1512,772,740,104.3
35310, 완주군,025002, 21세,2018,1636,910,726,125.3,1377,739,638,115.8
35310, 완주군,025003, 22세,2018,1531,868,663,130.9,1285,726,559,129.9
35310, 완주군,025004, 23세,2018,1412,912,500,182.4,1182,772,410,188.3
35310, 완주군,025005, 24세,2018,1357,857,500,171.4,1160,745,415,179.5
35310, 완주군,030,25~29세,2018,5043,2865,2178,131.5,4228,2371,1857,127.7
35310, 완주군,030001, 25세,2018,1149,673,476,141.4,958,563,395,142.5
35310, 완주군,030002, 26세,2018,1058,615,443,138.8,894,515,379,135.9
35310, 완주군,030003, 27세,2018,1000,571,429,133.1,831,466,365,127.7
35310, 완주군,030004, 28세,2018,939,521,418,124.6,789,431,358,120.4
35310, 완주군,030005, 29세,2018,897,485,412,117.7,756,396,360,110
35310, 완주군,035,30~34세,2018,5188,2683,2505,107.1,4590,2347,2243,104.6
35310, 완주군,035001, 30세,2018,966,489,477,102.5,827,406,421,96.4
35310, 완주군,035002, 31세,2018,974,494,480,102.9,837,425,412,103.2
35310, 완주군,035003, 32세,2018,1006,524,482,108.7,893,466,427,109.1
35310, 완주군,035004, 33세,2018,1102,572,530,107.9,998,506,492,102.8
35310, 완주군,035005, 34세,2018,1140,604,536,112.7,1035,544,491,110.8
35310, 완주군,040,35~39세,2018,6923,3621,3302,109.7,6553,3419,3134,109.1
35310, 완주군,040001, 35세,2018,1185,571,614,93,1106,537,569,94.4
35310, 완주군,040002, 36세,2018,1442,753,689,109.3,1353,701,652,107.5
35310, 완주군,040003, 37세,2018,1406,739,667,110.8,1337,695,642,108.3
35310, 완주군,040004, 38세,2018,1522,813,709,114.7,1444,769,675,113.9
35310, 완주군,040005, 39세,2018,1368,745,623,119.6,1313,717,596,120.3
35310, 완주군,045,40~44세,2018,6539,3602,2937,122.6,6299,3479,2820,123.4
35310, 완주군,045001, 40세,2018,1254,680,574,118.5,1203,653,550,118.7
35310, 완주군,045002, 41세,2018,1259,674,585,115.2,1215,652,563,115.8
35310, 완주군,045003, 42세,2018,1311,720,591,121.8,1249,688,561,122.6
35310, 완주군,045004, 43세,2018,1283,715,568,125.9,1245,699,546,128
35310, 완주군,045005, 44세,2018,1432,813,619,131.3,1387,787,600,131.2
35310, 완주군,050,45~49세,2018,7085,3962,3123,126.9,6889,3858,3031,127.3
35310, 완주군,050001, 45세,2018,1411,784,627,125,1370,764,606,126.1
35310, 완주군,050002, 46세,2018,1441,818,623,131.3,1394,792,602,131.6
35310, 완주군,050003, 47세,2018,1535,867,668,129.8,1493,845,648,130.4
35310, 완주군,050004, 48세,2018,1334,756,578,130.8,1302,737,565,130.4
35310, 완주군,050005, 49세,2018,1364,737,627,117.5,1330,720,610,118
35310, 완주군,055,50~54세,2018,6981,3845,3136,122.6,6816,3764,3052,123.3
35310, 완주군,055001, 50세,2018,1552,870,682,127.6,1521,856,665,128.7
35310, 완주군,055002, 51세,2018,1328,724,604,119.9,1289,705,584,120.7
35310, 완주군,055003, 52세,2018,1400,770,630,122.2,1365,751,614,122.3
35310, 완주군,055004, 53세,2018,1383,742,641,115.8,1346,725,621,116.7
35310, 완주군,055005, 54세,2018,1318,739,579,127.6,1295,727,568,128
35310, 완주군,060,55~59세,2018,7791,4059,3732,108.8,7679,3995,3684,108.4
35310, 완주군,060001, 55세,2018,1402,741,661,112.1,1371,722,649,111.2
35310, 완주군,060002, 56세,2018,1549,825,724,114,1523,812,711,114.2
35310, 완주군,060003, 57세,2018,1658,857,801,107,1640,847,793,106.8
35310, 완주군,060004, 58세,2018,1727,879,848,103.7,1710,867,843,102.8
35310, 완주군,060005, 59세,2018,1455,757,698,108.5,1435,747,688,108.6
35310, 완주군,065,60~64세,2018,6818,3449,3369,102.4,6739,3403,3336,102
35310, 완주군,065001, 60세,2018,1338,690,648,106.5,1319,675,644,104.8
35310, 완주군,065002, 61세,2018,1392,690,702,98.3,1374,680,694,98
35310, 완주군,065003, 62세,2018,1395,726,669,108.5,1375,718,657,109.3
35310, 완주군,065004, 63세,2018,1416,722,694,104,1402,714,688,103.8
35310, 완주군,065005, 64세,2018,1277,621,656,94.7,1269,616,653,94.3
35310, 완주군,070,65~69세,2018,5148,2575,2573,100.1,5115,2564,2551,100.5
35310, 완주군,070001, 65세,2018,966,514,452,113.7,957,512,445,115.1
35310, 완주군,070002, 66세,2018,1088,546,542,100.7,1083,545,538,101.3
35310, 완주군,070003, 67세,2018,978,490,488,100.4,972,487,485,100.4
35310, 완주군,070004, 68세,2018,1132,554,578,95.8,1126,553,573,96.5
35310, 완주군,070005, 69세,2018,984,471,513,91.8,977,467,510,91.6
35310, 완주군,075,70~74세,2018,4373,2092,2281,91.7,4356,2084,2272,91.7
35310, 완주군,075001, 70세,2018,962,477,485,98.4,958,474,484,97.9
35310, 완주군,075002, 71세,2018,1060,524,536,97.8,1055,522,533,97.9
35310, 완주군,075003, 72세,2018,843,428,415,103.1,840,427,413,103.4
35310, 완주군,075004, 73세,2018,734,316,418,75.6,731,314,417,75.3
35310, 완주군,075005, 74세,2018,774,347,427,81.3,772,347,425,81.6
35310, 완주군,080,75~79세,2018,4271,1688,2583,65.4,4265,1687,2578,65.4
35310, 완주군,080001, 75세,2018,766,319,447,71.4,763,318,445,71.5
35310, 완주군,080002, 76세,2018,1176,468,708,66.1,1175,468,707,66.2
35310, 완주군,080003, 77세,2018,799,320,479,66.8,797,320,477,67.1
35310, 완주군,080004, 78세,2018,739,279,460,60.7,739,279,460,60.7
35310, 완주군,080005, 79세,2018,791,302,489,61.8,791,302,489,61.8
35310, 완주군,085,80~84세,2018,3221,1139,2082,54.7,3218,1138,2080,54.7
35310, 완주군,085001, 80세,2018,790,292,498,58.6,789,292,497,58.8
35310, 완주군,085002, 81세,2018,659,230,429,53.6,658,230,428,53.7
35310, 완주군,085003, 82세,2018,650,232,418,55.5,650,232,418,55.5
35310, 완주군,085004, 83세,2018,627,213,414,51.4,627,213,414,51.4
35310, 완주군,085005, 84세,2018,495,172,323,53.3,494,171,323,52.9
35310, 완주군,090,85~89세,2018,1533,418,1115,37.5,1532,417,1115,37.4
35310, 완주군,090001, 85세,2018,422,133,289,46,422,133,289,46
35310, 완주군,090002, 86세,2018,338,101,237,42.6,338,101,237,42.6
35310, 완주군,090003, 87세,2018,300,82,218,37.6,299,81,218,37.2
35310, 완주군,090004, 88세,2018,271,64,207,30.9,271,64,207,30.9
35310, 완주군,090005, 89세,2018,202,38,164,23.2,202,38,164,23.2
35310, 완주군,095,90~94세,2018,550,121,429,28.2,550,121,429,28.2
35310, 완주군,095001, 90세,2018,170,46,124,37.1,170,46,124,37.1
35310, 완주군,095002, 91세,2018,165,37,128,28.9,165,37,128,28.9
35310, 완주군,095003, 92세,2018,92,15,77,19.5,92,15,77,19.5
35310, 완주군,095004, 93세,2018,82,15,67,22.4,82,15,67,22.4
35310, 완주군,095005, 94세,2018,41,8,33,24.2,41,8,33,24.2
35310, 완주군,100,95~99세,2018,133,25,108,23.1,133,25,108,23.1
35310, 완주군,100001, 95세,2018,59,7,52,13.5,59,7,52,13.5
35310, 완주군,100002, 96세,2018,32,7,25,28,32,7,25,28
35310, 완주군,100003, 97세,2018,15,X,12,25,15,X,12,25
35310, 완주군,100004, 98세,2018,19,6,13,46.2,19,6,13,46.2
35310, 완주군,100005, 99세,2018,8,X,6,33.3,8,X,6,33.3
35310, 완주군,101,100세이상,2018,18,6,12,50,18,6,12,50
35310, 완주군,102,15세미만,2018,12543,6446,6097,105.7,12492,6413,6079,105.5
35310, 완주군,103,15~64세,2018,66212,35901,30311,118.4,62197,33557,28640,117.2
35310, 완주군,104,65세이상,2018,19247,8064,11183,72.1,19187,8042,11145,72.2
35310, 완주군,086,85세이상,2018,2234,570,1664,34.3,2233,569,1664,34.2
35310, 완주군,126,평균연령,2018,43.5,41.7,45.3,,44,42.3,45.7,
35310, 완주군,127,중위연령,2018,44.2,42.6,46.2,,45.3,43.8,47.2,
35320, 진안군,000,합계,2018,23306,11594,11712,99,22874,11428,11446,99.8
35320, 진안군,005,0~4세,2018,738,366,372,98.4,737,366,371,98.7
35320, 진안군,005001, 0세,2018,168,80,88,90.9,168,80,88,90.9
35320, 진안군,005002, 1세,2018,141,85,56,151.8,140,85,55,154.5
35320, 진안군,005003, 2세,2018,148,71,77,92.2,148,71,77,92.2
35320, 진안군,005004, 3세,2018,141,64,77,83.1,141,64,77,83.1
35320, 진안군,005005, 4세,2018,140,66,74,89.2,140,66,74,89.2
35320, 진안군,010,5~9세,2018,721,365,356,102.5,719,364,355,102.5
35320, 진안군,010001, 5세,2018,132,61,71,85.9,132,61,71,85.9
35320, 진안군,010002, 6세,2018,145,71,74,95.9,144,71,73,97.3
35320, 진안군,010003, 7세,2018,156,84,72,116.7,156,84,72,116.7
35320, 진안군,010004, 8세,2018,154,82,72,113.9,154,82,72,113.9
35320, 진안군,010005, 9세,2018,134,67,67,100,133,66,67,98.5
35320, 진안군,015,10~14세,2018,679,356,323,110.2,678,355,323,109.9
35320, 진안군,015001, 10세,2018,130,67,63,106.3,130,67,63,106.3
35320, 진안군,015002, 11세,2018,133,68,65,104.6,132,67,65,103.1
35320, 진안군,015003, 12세,2018,146,72,74,97.3,146,72,74,97.3
35320, 진안군,015004, 13세,2018,130,74,56,132.1,130,74,56,132.1
35320, 진안군,015005, 14세,2018,140,75,65,115.4,140,75,65,115.4
35320, 진안군,020,15~19세,2018,895,491,404,121.5,886,489,397,123.2
35320, 진안군,020001, 15세,2018,156,82,74,110.8,154,80,74,108.1
35320, 진안군,020002, 16세,2018,175,92,83,110.8,173,92,81,113.6
35320, 진안군,020003, 17세,2018,214,117,97,120.6,213,117,96,121.9
35320, 진안군,020004, 18세,2018,201,108,93,116.1,200,108,92,117.4
35320, 진안군,020005, 19세,2018,149,92,57,161.4,146,92,54,170.4
35320, 진안군,025,20~24세,2018,899,523,376,139.1,839,496,343,144.6
35320, 진안군,025001, 20세,2018,161,106,55,192.7,152,101,51,198
35320, 진안군,025002, 21세,2018,202,121,81,149.4,198,119,79,150.6
35320, 진안군,025003, 22세,2018,194,111,83,133.7,175,103,72,143.1
35320, 진안군,025004, 23세,2018,180,98,82,119.5,168,94,74,127
35320, 진안군,025005, 24세,2018,162,87,75,116,146,79,67,117.9
35320, 진안군,030,25~29세,2018,826,434,392,110.7,737,397,340,116.8
35320, 진안군,030001, 25세,2018,164,84,80,105,147,77,70,110
35320, 진안군,030002, 26세,2018,165,86,79,108.9,151,83,68,122.1
35320, 진안군,030003, 27세,2018,182,104,78,133.3,152,84,68,123.5
35320, 진안군,030004, 28세,2018,167,89,78,114.1,152,84,68,123.5
35320, 진안군,030005, 29세,2018,148,71,77,92.2,135,69,66,104.5
35320, 진안군,035,30~34세,2018,829,378,451,83.8,755,351,404,86.9
35320, 진안군,035001, 30세,2018,153,71,82,86.6,140,66,74,89.2
35320, 진안군,035002, 31세,2018,153,68,85,80,142,65,77,84.4
35320, 진안군,035003, 32세,2018,166,73,93,78.5,150,67,83,80.7
35320, 진안군,035004, 33세,2018,178,79,99,79.8,159,72,87,82.8
35320, 진안군,035005, 34세,2018,179,87,92,94.6,164,81,83,97.6
35320, 진안군,040,35~39세,2018,1016,527,489,107.8,967,504,463,108.9
35320, 진안군,040001, 35세,2018,181,93,88,105.7,169,86,83,103.6
35320, 진안군,040002, 36세,2018,190,90,100,90,181,86,95,90.5
35320, 진안군,040003, 37세,2018,199,104,95,109.5,191,100,91,109.9
35320, 진안군,040004, 38세,2018,241,123,118,104.2,234,120,114,105.3
35320, 진안군,040005, 39세,2018,205,117,88,133,192,112,80,140
35320, 진안군,045,40~44세,2018,1161,673,488,137.9,1128,664,464,143.1
35320, 진안군,045001, 40세,2018,183,105,78,134.6,177,102,75,136
35320, 진안군,045002, 41세,2018,240,147,93,158.1,231,145,86,168.6
35320, 진안군,045003, 42세,2018,222,118,104,113.5,219,118,101,116.8
35320, 진안군,045004, 43세,2018,213,118,95,124.2,205,115,90,127.8
35320, 진안군,045005, 44세,2018,303,185,118,156.8,296,184,112,164.3
35320, 진안군,050,45~49세,2018,1502,859,643,133.6,1472,850,622,136.7
35320, 진안군,050001, 45세,2018,276,149,127,117.3,270,146,124,117.7
35320, 진안군,050002, 46세,2018,288,178,110,161.8,283,178,105,169.5
35320, 진안군,050003, 47세,2018,298,174,124,140.3,292,173,119,145.4
35320, 진안군,050004, 48세,2018,315,165,150,110,307,162,145,111.7
35320, 진안군,050005, 49세,2018,325,193,132,146.2,320,191,129,148.1
35320, 진안군,055,50~54세,2018,1801,1026,775,132.4,1772,1015,757,134.1
35320, 진안군,055001, 50세,2018,335,187,148,126.4,332,185,147,125.9
35320, 진안군,055002, 51세,2018,354,215,139,154.7,351,215,136,158.1
35320, 진안군,055003, 52세,2018,376,217,159,136.5,369,216,153,141.2
35320, 진안군,055004, 53세,2018,388,220,168,131,378,215,163,131.9
35320, 진안군,055005, 54세,2018,348,187,161,116.1,342,184,158,116.5
35320, 진안군,060,55~59세,2018,2335,1234,1101,112.1,2307,1224,1083,113
35320, 진안군,060001, 55세,2018,374,200,174,114.9,366,199,167,119.2
35320, 진안군,060002, 56세,2018,432,230,202,113.9,420,225,195,115.4
35320, 진안군,060003, 57세,2018,513,281,232,121.1,510,280,230,121.7
35320, 진안군,060004, 58세,2018,544,281,263,106.8,540,278,262,106.1
35320, 진안군,060005, 59세,2018,472,242,230,105.2,471,242,229,105.7
35320, 진안군,065,60~64세,2018,2164,1122,1042,107.7,2152,1120,1032,108.5
35320, 진안군,065001, 60세,2018,416,204,212,96.2,415,204,211,96.7
35320, 진안군,065002, 61세,2018,433,235,198,118.7,430,235,195,120.5
35320, 진안군,065003, 62세,2018,423,219,204,107.4,422,219,203,107.9
35320, 진안군,065004, 63세,2018,468,237,231,102.6,465,237,228,103.9
35320, 진안군,065005, 64세,2018,424,227,197,115.2,420,225,195,115.4
35320, 진안군,070,65~69세,2018,1867,917,950,96.5,1859,914,945,96.7
35320, 진안군,070001, 65세,2018,350,165,185,89.2,349,165,184,89.7
35320, 진안군,070002, 66세,2018,397,211,186,113.4,394,210,184,114.1
35320, 진안군,070003, 67세,2018,310,151,159,95,308,150,158,94.9
35320, 진안군,070004, 68세,2018,421,203,218,93.1,420,202,218,92.7
35320, 진안군,070005, 69세,2018,389,187,202,92.6,388,187,201,93
35320, 진안군,075,70~74세,2018,1718,817,901,90.7,1711,813,898,90.5
35320, 진안군,075001, 70세,2018,393,192,201,95.5,390,189,201,94
35320, 진안군,075002, 71세,2018,378,177,201,88.1,378,177,201,88.1
35320, 진안군,075003, 72세,2018,316,155,161,96.3,313,154,159,96.9
35320, 진안군,075004, 73세,2018,343,162,181,89.5,342,162,180,90
35320, 진안군,075005, 74세,2018,288,131,157,83.4,288,131,157,83.4
35320, 진안군,080,75~79세,2018,1886,768,1118,68.7,1886,768,1118,68.7
35320, 진안군,080001, 75세,2018,347,135,212,63.7,347,135,212,63.7
35320, 진안군,080002, 76세,2018,486,222,264,84.1,486,222,264,84.1
35320, 진안군,080003, 77세,2018,354,146,208,70.2,354,146,208,70.2
35320, 진안군,080004, 78세,2018,339,134,205,65.4,339,134,205,65.4
35320, 진안군,080005, 79세,2018,360,131,229,57.2,360,131,229,57.2
35320, 진안군,085,80~84세,2018,1401,482,919,52.4,1401,482,919,52.4
35320, 진안군,085001, 80세,2018,310,106,204,52,310,106,204,52
35320, 진안군,085002, 81세,2018,300,102,198,51.5,300,102,198,51.5
35320, 진안군,085003, 82세,2018,296,109,187,58.3,296,109,187,58.3
35320, 진안군,085004, 83세,2018,262,89,173,51.4,262,89,173,51.4
35320, 진안군,085005, 84세,2018,233,76,157,48.4,233,76,157,48.4
35320, 진안군,090,85~89세,2018,632,191,441,43.3,632,191,441,43.3
35320, 진안군,090001, 85세,2018,196,66,130,50.8,196,66,130,50.8
35320, 진안군,090002, 86세,2018,145,46,99,46.5,145,46,99,46.5
35320, 진안군,090003, 87세,2018,102,25,77,32.5,102,25,77,32.5
35320, 진안군,090004, 88세,2018,100,23,77,29.9,100,23,77,29.9
35320, 진안군,090005, 89세,2018,89,31,58,53.4,89,31,58,53.4
35320, 진안군,095,90~94세,2018,191,56,135,41.5,191,56,135,41.5
35320, 진안군,095001, 90세,2018,51,13,38,34.2,51,13,38,34.2
35320, 진안군,095002, 91세,2018,60,20,40,50,60,20,40,50
35320, 진안군,095003, 92세,2018,31,8,23,34.8,31,8,23,34.8
35320, 진안군,095004, 93세,2018,28,10,18,55.6,28,10,18,55.6
35320, 진안군,095005, 94세,2018,21,5,16,31.3,21,5,16,31.3
35320, 진안군,100,95~99세,2018,40,9,31,29,40,9,31,29
35320, 진안군,100001, 95세,2018,15,X,13,15.4,15,X,13,15.4
35320, 진안군,100002, 96세,2018,13,X,9,44.4,13,X,9,44.4
35320, 진안군,100003, 97세,2018,6,X,X,50,6,X,X,50
35320, 진안군,100004, 98세,2018,6,X,5,20,6,X,5,20
35320, 진안군,100005, 99세,2018,X,X,X,,X,X,X,
35320, 진안군,101,100세이상,2018,5,X,5,0,5,X,5,0
35320, 진안군,102,15세미만,2018,2138,1087,1051,103.4,2134,1085,1049,103.4
35320, 진안군,103,15~64세,2018,13428,7267,6161,118,13015,7110,5905,120.4
35320, 진안군,104,65세이상,2018,7740,3240,4500,72,7725,3233,4492,72
35320, 진안군,086,85세이상,2018,868,256,612,41.8,868,256,612,41.8
35320, 진안군,126,평균연령,2018,52.1,50,54.1,,52.4,50.2,54.5,
35320, 진안군,127,중위연령,2018,56.5,53.9,58.7,,56.9,54.3,59.1,
35330, 무주군,000,합계,2018,23058,11436,11622,98.4,22742,11334,11408,99.4
35330, 무주군,005,0~4세,2018,569,319,250,127.6,569,319,250,127.6
35330, 무주군,005001, 0세,2018,79,43,36,119.4,79,43,36,119.4
35330, 무주군,005002, 1세,2018,104,49,55,89.1,104,49,55,89.1
35330, 무주군,005003, 2세,2018,115,64,51,125.5,115,64,51,125.5
35330, 무주군,005004, 3세,2018,127,69,58,119,127,69,58,119
35330, 무주군,005005, 4세,2018,144,94,50,188,144,94,50,188
35330, 무주군,010,5~9세,2018,788,404,384,105.2,787,404,383,105.5
35330, 무주군,010001, 5세,2018,140,74,66,112.1,139,74,65,113.8
35330, 무주군,010002, 6세,2018,147,80,67,119.4,147,80,67,119.4
35330, 무주군,010003, 7세,2018,183,99,84,117.9,183,99,84,117.9
35330, 무주군,010004, 8세,2018,143,74,69,107.2,143,74,69,107.2
35330, 무주군,010005, 9세,2018,175,77,98,78.6,175,77,98,78.6
35330, 무주군,015,10~14세,2018,821,415,406,102.2,821,415,406,102.2
35330, 무주군,015001, 10세,2018,162,87,75,116,162,87,75,116
35330, 무주군,015002, 11세,2018,184,87,97,89.7,184,87,97,89.7
35330, 무주군,015003, 12세,2018,156,84,72,116.7,156,84,72,116.7
35330, 무주군,015004, 13세,2018,163,74,89,83.1,163,74,89,83.1
35330, 무주군,015005, 14세,2018,156,83,73,113.7,156,83,73,113.7
35330, 무주군,020,15~19세,2018,873,481,392,122.7,869,479,390,122.8
35330, 무주군,020001, 15세,2018,146,75,71,105.6,146,75,71,105.6
35330, 무주군,020002, 16세,2018,195,93,102,91.2,195,93,102,91.2
35330, 무주군,020003, 17세,2018,232,129,103,125.2,231,128,103,124.3
35330, 무주군,020004, 18세,2018,193,114,79,144.3,193,114,79,144.3
35330, 무주군,020005, 19세,2018,107,70,37,189.2,104,69,35,197.1
35330, 무주군,025,20~24세,2018,870,545,325,167.7,838,532,306,173.9
35330, 무주군,025001, 20세,2018,147,102,45,226.7,146,102,44,231.8
35330, 무주군,025002, 21세,2018,169,103,66,156.1,164,102,62,164.5
35330, 무주군,025003, 22세,2018,166,112,54,207.4,158,107,51,209.8
35330, 무주군,025004, 23세,2018,207,129,78,165.4,197,123,74,166.2
35330, 무주군,025005, 24세,2018,181,99,82,120.7,173,98,75,130.7
35330, 무주군,030,25~29세,2018,850,466,384,121.4,797,447,350,127.7
35330, 무주군,030001, 25세,2018,180,92,88,104.5,167,87,80,108.8
35330, 무주군,030002, 26세,2018,161,78,83,94,153,75,78,96.2
35330, 무주군,030003, 27세,2018,186,104,82,126.8,174,100,74,135.1
35330, 무주군,030004, 28세,2018,168,97,71,136.6,159,95,64,148.4
35330, 무주군,030005, 29세,2018,155,95,60,158.3,144,90,54,166.7
35330, 무주군,035,30~34세,2018,825,409,416,98.3,768,396,372,106.5
35330, 무주군,035001, 30세,2018,169,91,78,116.7,153,85,68,125
35330, 무주군,035002, 31세,2018,177,87,90,96.7,161,85,76,111.8
35330, 무주군,035003, 32세,2018,156,84,72,116.7,145,81,64,126.6
35330, 무주군,035004, 33세,2018,151,74,77,96.1,144,73,71,102.8
35330, 무주군,035005, 34세,2018,172,73,99,73.7,165,72,93,77.4
35330, 무주군,040,35~39세,2018,1062,561,501,112,1028,553,475,116.4
35330, 무주군,040001, 35세,2018,199,109,90,121.1,191,108,83,130.1
35330, 무주군,040002, 36세,2018,191,108,83,130.1,182,107,75,142.7
35330, 무주군,040003, 37세,2018,219,107,112,95.5,210,104,106,98.1
35330, 무주군,040004, 38세,2018,220,110,110,100,217,109,108,100.9
35330, 무주군,040005, 39세,2018,233,127,106,119.8,228,125,103,121.4
35330, 무주군,045,40~44세,2018,1317,699,618,113.1,1283,691,592,116.7
35330, 무주군,045001, 40세,2018,208,100,108,92.6,200,100,100,100
35330, 무주군,045002, 41세,2018,246,129,117,110.3,242,127,115,110.4
35330, 무주군,045003, 42세,2018,269,141,128,110.2,259,138,121,114
35330, 무주군,045004, 43세,2018,266,158,108,146.3,258,156,102,152.9
35330, 무주군,045005, 44세,2018,328,171,157,108.9,324,170,154,110.4
35330, 무주군,050,45~49세,2018,1573,902,671,134.4,1543,891,652,136.7
35330, 무주군,050001, 45세,2018,318,188,130,144.6,311,183,128,143
35330, 무주군,050002, 46세,2018,274,158,116,136.2,268,158,110,143.6
35330, 무주군,050003, 47세,2018,331,179,152,117.8,325,178,147,121.1
35330, 무주군,050004, 48세,2018,311,190,121,157,306,188,118,159.3
35330, 무주군,050005, 49세,2018,339,187,152,123,333,184,149,123.5
35330, 무주군,055,50~54세,2018,1812,1012,800,126.5,1784,1004,780,128.7
35330, 무주군,055001, 50세,2018,372,224,148,151.4,366,223,143,155.9
35330, 무주군,055002, 51세,2018,374,203,171,118.7,370,202,168,120.2
35330, 무주군,055003, 52세,2018,369,202,167,121,363,200,163,122.7
35330, 무주군,055004, 53세,2018,369,204,165,123.6,366,204,162,125.9
35330, 무주군,055005, 54세,2018,328,179,149,120.1,319,175,144,121.5
35330, 무주군,060,55~59세,2018,2236,1184,1052,112.5,2218,1177,1041,113.1
35330, 무주군,060001, 55세,2018,362,210,152,138.2,357,208,149,139.6
35330, 무주군,060002, 56세,2018,476,245,231,106.1,472,245,227,107.9
35330, 무주군,060003, 57세,2018,466,246,220,111.8,466,246,220,111.8
35330, 무주군,060004, 58세,2018,486,251,235,106.8,479,247,232,106.5
35330, 무주군,060005, 59세,2018,446,232,214,108.4,444,231,213,108.5
35330, 무주군,065,60~64세,2018,2151,1116,1035,107.8,2133,1107,1026,107.9
35330, 무주군,065001, 60세,2018,434,217,217,100,430,216,214,100.9
35330, 무주군,065002, 61세,2018,460,238,222,107.2,456,236,220,107.3
35330, 무주군,065003, 62세,2018,388,208,180,115.6,384,206,178,115.7
35330, 무주군,065004, 63세,2018,439,226,213,106.1,437,225,212,106.1
35330, 무주군,065005, 64세,2018,430,227,203,111.8,426,224,202,110.9
35330, 무주군,070,65~69세,2018,1640,776,864,89.8,1637,775,862,89.9
35330, 무주군,070001, 65세,2018,287,139,148,93.9,286,138,148,93.2
35330, 무주군,070002, 66세,2018,379,179,200,89.5,379,179,200,89.5
35330, 무주군,070003, 67세,2018,328,147,181,81.2,327,147,180,81.7
35330, 무주군,070004, 68세,2018,366,168,198,84.8,365,168,197,85.3
35330, 무주군,070005, 69세,2018,280,143,137,104.4,280,143,137,104.4
35330, 무주군,075,70~74세,2018,1550,673,877,76.7,1548,671,877,76.5
35330, 무주군,075001, 70세,2018,348,161,187,86.1,347,160,187,85.6
35330, 무주군,075002, 71세,2018,348,153,195,78.5,348,153,195,78.5
35330, 무주군,075003, 72세,2018,314,129,185,69.7,314,129,185,69.7
35330, 무주군,075004, 73세,2018,263,105,158,66.5,263,105,158,66.5
35330, 무주군,075005, 74세,2018,277,125,152,82.2,276,124,152,81.6
35330, 무주군,080,75~79세,2018,1886,740,1146,64.6,1884,739,1145,64.5
35330, 무주군,080001, 75세,2018,350,127,223,57,348,126,222,56.8
35330, 무주군,080002, 76세,2018,472,181,291,62.2,472,181,291,62.2
35330, 무주군,080003, 77세,2018,393,166,227,73.1,393,166,227,73.1
35330, 무주군,080004, 78세,2018,337,143,194,73.7,337,143,194,73.7
35330, 무주군,080005, 79세,2018,334,123,211,58.3,334,123,211,58.3
35330, 무주군,085,80~84세,2018,1345,481,864,55.7,1345,481,864,55.7
35330, 무주군,085001, 80세,2018,321,126,195,64.6,321,126,195,64.6
35330, 무주군,085002, 81세,2018,289,103,186,55.4,289,103,186,55.4
35330, 무주군,085003, 82세,2018,272,100,172,58.1,272,100,172,58.1
35330, 무주군,085004, 83세,2018,249,87,162,53.7,249,87,162,53.7
35330, 무주군,085005, 84세,2018,214,65,149,43.6,214,65,149,43.6
35330, 무주군,090,85~89세,2018,625,190,435,43.7,625,190,435,43.7
35330, 무주군,090001, 85세,2018,186,58,128,45.3,186,58,128,45.3
35330, 무주군,090002, 86세,2018,151,52,99,52.5,151,52,99,52.5
35330, 무주군,090003, 87세,2018,116,38,78,48.7,116,38,78,48.7
35330, 무주군,090004, 88세,2018,95,24,71,33.8,95,24,71,33.8
35330, 무주군,090005, 89세,2018,77,18,59,30.5,77,18,59,30.5
35330, 무주군,095,90~94세,2018,209,51,158,32.3,209,51,158,32.3
35330, 무주군,095001, 90세,2018,70,16,54,29.6,70,16,54,29.6
35330, 무주군,095002, 91세,2018,51,15,36,41.7,51,15,36,41.7
35330, 무주군,095003, 92세,2018,43,8,35,22.9,43,8,35,22.9
35330, 무주군,095004, 93세,2018,31,8,23,34.8,31,8,23,34.8
35330, 무주군,095005, 94세,2018,14,X,10,40,14,X,10,40
35330, 무주군,100,95~99세,2018,49,11,38,28.9,49,11,38,28.9
35330, 무주군,100001, 95세,2018,10,X,7,42.9,10,X,7,42.9
35330, 무주군,100002, 96세,2018,14,X,10,40,14,X,10,40
35330, 무주군,100003, 97세,2018,9,X,7,28.6,9,X,7,28.6
35330, 무주군,100004, 98세,2018,12,X,11,9.1,12,X,11,9.1
35330, 무주군,100005, 99세,2018,X,X,X,33.3,X,X,X,33.3
35330, 무주군,101,100세이상,2018,7,X,6,16.7,7,X,6,16.7
35330, 무주군,102,15세미만,2018,2178,1138,1040,109.4,2177,1138,1039,109.5
35330, 무주군,103,15~64세,2018,13569,7375,6194,119.1,13261,7277,5984,121.6
35330, 무주군,104,65세이상,2018,7311,2923,4388,66.6,7304,2919,4385,66.6
35330, 무주군,086,85세이상,2018,890,253,637,39.7,890,253,637,39.7
35330, 무주군,126,평균연령,2018,51.6,49,54.2,,51.8,49.1,54.5,
35330, 무주군,127,중위연령,2018,55.5,52.4,58.3,,55.8,52.6,58.7,
35340, 장수군,000,합계,2018,21281,10526,10755,97.9,20780,10287,10493,98
35340, 장수군,005,0~4세,2018,541,284,257,110.5,540,283,257,110.1
35340, 장수군,005001, 0세,2018,83,47,36,130.6,83,47,36,130.6
35340, 장수군,005002, 1세,2018,95,45,50,90,95,45,50,90
35340, 장수군,005003, 2세,2018,113,68,45,151.1,112,67,45,148.9
35340, 장수군,005004, 3세,2018,118,60,58,103.4,118,60,58,103.4
35340, 장수군,005005, 4세,2018,132,64,68,94.1,132,64,68,94.1
35340, 장수군,010,5~9세,2018,773,407,366,111.2,773,407,366,111.2
35340, 장수군,010001, 5세,2018,157,84,73,115.1,157,84,73,115.1
35340, 장수군,010002, 6세,2018,144,74,70,105.7,144,74,70,105.7
35340, 장수군,010003, 7세,2018,169,86,83,103.6,169,86,83,103.6
35340, 장수군,010004, 8세,2018,159,81,78,103.8,159,81,78,103.8
35340, 장수군,010005, 9세,2018,144,82,62,132.3,144,82,62,132.3
35340, 장수군,015,10~14세,2018,788,385,403,95.5,788,385,403,95.5
35340, 장수군,015001, 10세,2018,172,84,88,95.5,172,84,88,95.5
35340, 장수군,015002, 11세,2018,169,80,89,89.9,169,80,89,89.9
35340, 장수군,015003, 12세,2018,134,69,65,106.2,134,69,65,106.2
35340, 장수군,015004, 13세,2018,163,82,81,101.2,163,82,81,101.2
35340, 장수군,015005, 14세,2018,150,70,80,87.5,150,70,80,87.5
35340, 장수군,020,15~19세,2018,883,445,438,101.6,881,443,438,101.1
35340, 장수군,020001, 15세,2018,155,74,81,91.4,155,74,81,91.4
35340, 장수군,020002, 16세,2018,162,84,78,107.7,162,84,78,107.7
35340, 장수군,020003, 17세,2018,227,115,112,102.7,227,115,112,102.7
35340, 장수군,020004, 18세,2018,226,102,124,82.3,226,102,124,82.3
35340, 장수군,020005, 19세,2018,113,70,43,162.8,111,68,43,158.1
35340, 장수군,025,20~24세,2018,876,527,349,151,808,495,313,158.1
35340, 장수군,025001, 20세,2018,174,119,55,216.4,165,115,50,230
35340, 장수군,025002, 21세,2018,168,110,58,189.7,160,107,53,201.9
35340, 장수군,025003, 22세,2018,181,99,82,120.7,163,87,76,114.5
35340, 장수군,025004, 23세,2018,172,98,74,132.4,160,95,65,146.2
35340, 장수군,025005, 24세,2018,181,101,80,126.3,160,91,69,131.9
35340, 장수군,030,25~29세,2018,816,455,361,126,702,391,311,125.7
35340, 장수군,030001, 25세,2018,157,97,60,161.7,138,87,51,170.6
35340, 장수군,030002, 26세,2018,145,77,68,113.2,129,70,59,118.6
35340, 장수군,030003, 27세,2018,171,95,76,125,143,76,67,113.4
35340, 장수군,030004, 28세,2018,166,91,75,121.3,142,77,65,118.5
35340, 장수군,030005, 29세,2018,177,95,82,115.9,150,81,69,117.4
35340, 장수군,035,30~34세,2018,815,427,388,110.1,721,383,338,113.3
35340, 장수군,035001, 30세,2018,153,86,67,128.4,136,75,61,123
35340, 장수군,035002, 31세,2018,159,78,81,96.3,140,68,72,94.4
35340, 장수군,035003, 32세,2018,187,106,81,130.9,170,95,75,126.7
35340, 장수군,035004, 33세,2018,138,67,71,94.4,123,63,60,105
35340, 장수군,035005, 34세,2018,178,90,88,102.3,152,82,70,117.1
35340, 장수군,040,35~39세,2018,1011,550,461,119.3,948,516,432,119.4
35340, 장수군,040001, 35세,2018,174,106,68,155.9,165,100,65,153.8
35340, 장수군,040002, 36세,2018,195,99,96,103.1,178,90,88,102.3
35340, 장수군,040003, 37세,2018,193,93,100,93,177,87,90,96.7
35340, 장수군,040004, 38세,2018,242,130,112,116.1,231,122,109,111.9
35340, 장수군,040005, 39세,2018,207,122,85,143.5,197,117,80,146.3
35340, 장수군,045,40~44세,2018,1088,604,484,124.8,1059,589,470,125.3
35340, 장수군,045001, 40세,2018,199,106,93,114,194,104,90,115.6
35340, 장수군,045002, 41세,2018,229,137,92,148.9,226,136,90,151.1
35340, 장수군,045003, 42세,2018,198,104,94,110.6,189,101,88,114.8
35340, 장수군,045004, 43세,2018,218,127,91,139.6,212,121,91,133
35340, 장수군,045005, 44세,2018,244,130,114,114,238,127,111,114.4
35340, 장수군,050,45~49세,2018,1418,802,616,130.2,1375,784,591,132.7
35340, 장수군,050001, 45세,2018,281,165,116,142.2,275,161,114,141.2
35340, 장수군,050002, 46세,2018,266,142,124,114.5,252,138,114,121.1
35340, 장수군,050003, 47세,2018,296,170,126,134.9,288,166,122,136.1
35340, 장수군,050004, 48세,2018,262,154,108,142.6,253,150,103,145.6
35340, 장수군,050005, 49세,2018,313,171,142,120.4,307,169,138,122.5
35340, 장수군,055,50~54세,2018,1637,890,747,119.1,1608,882,726,121.5
35340, 장수군,055001, 50세,2018,346,183,163,112.3,337,180,157,114.6
35340, 장수군,055002, 51세,2018,313,174,139,125.2,310,174,136,127.9
35340, 장수군,055003, 52세,2018,316,170,146,116.4,308,169,139,121.6
35340, 장수군,055004, 53세,2018,372,213,159,134,366,210,156,134.6
35340, 장수군,055005, 54세,2018,290,150,140,107.1,287,149,138,108
35340, 장수군,060,55~59세,2018,1981,1037,944,109.9,1950,1028,922,111.5
35340, 장수군,060001, 55세,2018,301,163,138,118.1,294,160,134,119.4
35340, 장수군,060002, 56세,2018,387,210,177,118.6,378,208,170,122.4
35340, 장수군,060003, 57세,2018,422,218,204,106.9,416,217,199,109
35340, 장수군,060004, 58세,2018,488,259,229,113.1,482,256,226,113.3
35340, 장수군,060005, 59세,2018,383,187,196,95.4,380,187,193,96.9
35340, 장수군,065,60~64세,2018,1916,956,960,99.6,1902,950,952,99.8
35340, 장수군,065001, 60세,2018,370,191,179,106.7,368,190,178,106.7
35340, 장수군,065002, 61세,2018,377,179,198,90.4,375,178,197,90.4
35340, 장수군,065003, 62세,2018,379,185,194,95.4,377,184,193,95.3
35340, 장수군,065004, 63세,2018,431,219,212,103.3,427,218,209,104.3
35340, 장수군,065005, 64세,2018,359,182,177,102.8,355,180,175,102.9
35340, 장수군,070,65~69세,2018,1698,863,835,103.4,1692,860,832,103.4
35340, 장수군,070001, 65세,2018,332,175,157,111.5,329,172,157,109.6
35340, 장수군,070002, 66세,2018,377,183,194,94.3,377,183,194,94.3
35340, 장수군,070003, 67세,2018,334,160,174,92,333,160,173,92.5
35340, 장수군,070004, 68세,2018,341,183,158,115.8,340,183,157,116.6
35340, 장수군,070005, 69세,2018,314,162,152,106.6,313,162,151,107.3
35340, 장수군,075,70~74세,2018,1404,636,768,82.8,1401,634,767,82.7
35340, 장수군,075001, 70세,2018,356,165,191,86.4,355,164,191,85.9
35340, 장수군,075002, 71세,2018,309,150,159,94.3,309,150,159,94.3
35340, 장수군,075003, 72세,2018,232,111,121,91.7,231,110,121,90.9
35340, 장수군,075004, 73세,2018,234,101,133,75.9,234,101,133,75.9
35340, 장수군,075005, 74세,2018,273,109,164,66.5,272,109,163,66.9
35340, 장수군,080,75~79세,2018,1689,626,1063,58.9,1686,625,1061,58.9
35340, 장수군,080001, 75세,2018,290,113,177,63.8,290,113,177,63.8
35340, 장수군,080002, 76세,2018,413,157,256,61.3,412,157,255,61.6
35340, 장수군,080003, 77세,2018,333,118,215,54.9,333,118,215,54.9
35340, 장수군,080004, 78세,2018,310,121,189,64,309,120,189,63.5
35340, 장수군,080005, 79세,2018,343,117,226,51.8,342,117,225,52
35340, 장수군,085,80~84세,2018,1208,404,804,50.2,1207,404,803,50.3
35340, 장수군,085001, 80세,2018,259,91,168,54.2,258,91,167,54.5
35340, 장수군,085002, 81세,2018,243,81,162,50,243,81,162,50
35340, 장수군,085003, 82세,2018,251,86,165,52.1,251,86,165,52.1
35340, 장수군,085004, 83세,2018,229,66,163,40.5,229,66,163,40.5
35340, 장수군,085005, 84세,2018,226,80,146,54.8,226,80,146,54.8
35340, 장수군,090,85~89세,2018,522,165,357,46.2,522,165,357,46.2
35340, 장수군,090001, 85세,2018,145,50,95,52.6,145,50,95,52.6
35340, 장수군,090002, 86세,2018,156,51,105,48.6,156,51,105,48.6
35340, 장수군,090003, 87세,2018,88,34,54,63,88,34,54,63
35340, 장수군,090004, 88세,2018,86,20,66,30.3,86,20,66,30.3
35340, 장수군,090005, 89세,2018,47,10,37,27,47,10,37,27
35340, 장수군,095,90~94세,2018,178,57,121,47.1,178,57,121,47.1
35340, 장수군,095001, 90세,2018,65,26,39,66.7,65,26,39,66.7
35340, 장수군,095002, 91세,2018,51,13,38,34.2,51,13,38,34.2
35340, 장수군,095003, 92세,2018,22,6,16,37.5,22,6,16,37.5
35340, 장수군,095004, 93세,2018,26,10,16,62.5,26,10,16,62.5
35340, 장수군,095005, 94세,2018,14,X,12,16.7,14,X,12,16.7
35340, 장수군,100,95~99세,2018,36,5,31,16.1,36,5,31,16.1
35340, 장수군,100001, 95세,2018,11,X,9,22.2,11,X,9,22.2
35340, 장수군,100002, 96세,2018,11,X,9,22.2,11,X,9,22.2
35340, 장수군,100003, 97세,2018,6,X,5,20,6,X,5,20
35340, 장수군,100004, 98세,2018,6,X,6,0,6,X,6,0
35340, 장수군,100005, 99세,2018,X,X,X,0,X,X,X,0
35340, 장수군,101,100세이상,2018,X,X,X,50,X,X,X,50
35340, 장수군,102,15세미만,2018,2102,1076,1026,104.9,2101,1075,1026,104.8
35340, 장수군,103,15~64세,2018,12441,6693,5748,116.4,11954,6461,5493,117.6
35340, 장수군,104,65세이상,2018,6738,2757,3981,69.3,6725,2751,3974,69.2
35340, 장수군,086,85세이상,2018,739,228,511,44.6,739,228,511,44.6
35340, 장수군,126,평균연령,2018,51,48.6,53.3,,51.3,48.9,53.7,
35340, 장수군,127,중위연령,2018,55,52.1,57.9,,55.6,52.7,58.4,
35350, 임실군,000,합계,2018,26377,13238,13139,100.8,25900,13040,12860,101.4
35350, 임실군,005,0~4세,2018,773,411,362,113.5,772,411,361,113.9
35350, 임실군,005001, 0세,2018,144,88,56,157.1,144,88,56,157.1
35350, 임실군,005002, 1세,2018,177,93,84,110.7,177,93,84,110.7
35350, 임실군,005003, 2세,2018,148,71,77,92.2,147,71,76,93.4
35350, 임실군,005004, 3세,2018,155,79,76,103.9,155,79,76,103.9
35350, 임실군,005005, 4세,2018,149,80,69,115.9,149,80,69,115.9
35350, 임실군,010,5~9세,2018,762,397,365,108.8,761,397,364,109.1
35350, 임실군,010001, 5세,2018,157,72,85,84.7,157,72,85,84.7
35350, 임실군,010002, 6세,2018,150,79,71,111.3,150,79,71,111.3
35350, 임실군,010003, 7세,2018,148,85,63,134.9,148,85,63,134.9
35350, 임실군,010004, 8세,2018,149,77,72,106.9,148,77,71,108.5
35350, 임실군,010005, 9세,2018,158,84,74,113.5,158,84,74,113.5
35350, 임실군,015,10~14세,2018,793,432,361,119.7,793,432,361,119.7
35350, 임실군,015001, 10세,2018,183,98,85,115.3,183,98,85,115.3
35350, 임실군,015002, 11세,2018,174,97,77,126,174,97,77,126
35350, 임실군,015003, 12세,2018,141,65,76,85.5,141,65,76,85.5
35350, 임실군,015004, 13세,2018,136,77,59,130.5,136,77,59,130.5
35350, 임실군,015005, 14세,2018,159,95,64,148.4,159,95,64,148.4
35350, 임실군,020,15~19세,2018,994,546,448,121.9,990,545,445,122.5
35350, 임실군,020001, 15세,2018,158,83,75,110.7,158,83,75,110.7
35350, 임실군,020002, 16세,2018,152,87,65,133.8,152,87,65,133.8
35350, 임실군,020003, 17세,2018,216,118,98,120.4,215,117,98,119.4
35350, 임실군,020004, 18세,2018,206,114,92,123.9,206,114,92,123.9
35350, 임실군,020005, 19세,2018,262,144,118,122,259,144,115,125.2
35350, 임실군,025,20~24세,2018,1364,769,595,129.2,1301,741,560,132.3
35350, 임실군,025001, 20세,2018,279,163,116,140.5,271,159,112,142
35350, 임실군,025002, 21세,2018,287,153,134,114.2,279,151,128,118
35350, 임실군,025003, 22세,2018,285,144,141,102.1,272,136,136,100
35350, 임실군,025004, 23세,2018,281,173,108,160.2,266,165,101,163.4
35350, 임실군,025005, 24세,2018,232,136,96,141.7,213,130,83,156.6
35350, 임실군,030,25~29세,2018,1128,632,496,127.4,1045,596,449,132.7
35350, 임실군,030001, 25세,2018,209,117,92,127.2,194,109,85,128.2
35350, 임실군,030002, 26세,2018,245,131,114,114.9,224,122,102,119.6
35350, 임실군,030003, 27세,2018,227,129,98,131.6,208,121,87,139.1
35350, 임실군,030004, 28세,2018,221,127,94,135.1,205,121,84,144
35350, 임실군,030005, 29세,2018,226,128,98,130.6,214,123,91,135.2
35350, 임실군,035,30~34세,2018,1061,565,496,113.9,971,526,445,118.2
35350, 임실군,035001, 30세,2018,220,113,107,105.6,199,103,96,107.3
35350, 임실군,035002, 31세,2018,208,115,93,123.7,185,101,84,120.2
35350, 임실군,035003, 32세,2018,209,111,98,113.3,193,106,87,121.8
35350, 임실군,035004, 33세,2018,196,102,94,108.5,179,97,82,118.3
35350, 임실군,035005, 34세,2018,228,124,104,119.2,215,119,96,124
35350, 임실군,040,35~39세,2018,1132,612,520,117.7,1073,594,479,124
35350, 임실군,040001, 35세,2018,201,95,106,89.6,186,93,93,100
35350, 임실군,040002, 36세,2018,231,129,102,126.5,219,126,93,135.5
35350, 임실군,040003, 37세,2018,230,127,103,123.3,217,120,97,123.7
35350, 임실군,040004, 38세,2018,226,124,102,121.6,215,120,95,126.3
35350, 임실군,040005, 39세,2018,244,137,107,128,236,135,101,133.7
35350, 임실군,045,40~44세,2018,1237,730,507,144,1196,712,484,147.1
35350, 임실군,045001, 40세,2018,264,157,107,146.7,253,150,103,145.6
35350, 임실군,045002, 41세,2018,218,137,81,169.1,210,133,77,172.7
35350, 임실군,045003, 42세,2018,251,149,102,146.1,246,147,99,148.5
35350, 임실군,045004, 43세,2018,241,137,104,131.7,229,134,95,141.1
35350, 임실군,045005, 44세,2018,263,150,113,132.7,258,148,110,134.5
35350, 임실군,050,45~49세,2018,1640,959,681,140.8,1600,943,657,143.5
35350, 임실군,050001, 45세,2018,300,176,124,141.9,294,174,120,145
35350, 임실군,050002, 46세,2018,309,193,116,166.4,303,190,113,168.1
35350, 임실군,050003, 47세,2018,334,211,123,171.5,325,209,116,180.2
35350, 임실군,050004, 48세,2018,328,182,146,124.7,320,179,141,127
35350, 임실군,050005, 49세,2018,369,197,172,114.5,358,191,167,114.4
35350, 임실군,055,50~54세,2018,1975,1108,867,127.8,1939,1095,844,129.7
35350, 임실군,055001, 50세,2018,416,242,174,139.1,404,237,167,141.9
35350, 임실군,055002, 51세,2018,376,209,167,125.1,370,208,162,128.4
35350, 임실군,055003, 52세,2018,387,204,183,111.5,384,202,182,111
35350, 임실군,055004, 53세,2018,414,242,172,140.7,407,240,167,143.7
35350, 임실군,055005, 54세,2018,382,211,171,123.4,374,208,166,125.3
35350, 임실군,060,55~59세,2018,2402,1257,1145,109.8,2376,1246,1130,110.3
35350, 임실군,060001, 55세,2018,409,226,183,123.5,403,224,179,125.1
35350, 임실군,060002, 56세,2018,437,231,206,112.1,434,229,205,111.7
35350, 임실군,060003, 57세,2018,491,263,228,115.4,481,259,222,116.7
35350, 임실군,060004, 58세,2018,570,298,272,109.6,565,296,269,110
35350, 임실군,060005, 59세,2018,495,239,256,93.4,493,238,255,93.3
35350, 임실군,065,60~64세,2018,2215,1189,1026,115.9,2193,1178,1015,116.1
35350, 임실군,065001, 60세,2018,422,227,195,116.4,417,225,192,117.2
35350, 임실군,065002, 61세,2018,455,249,206,120.9,452,248,204,121.6
35350, 임실군,065003, 62세,2018,467,247,220,112.3,461,244,217,112.4
35350, 임실군,065004, 63세,2018,444,246,198,124.2,439,242,197,122.8
35350, 임실군,065005, 64세,2018,427,220,207,106.3,424,219,205,106.8
35350, 임실군,070,65~69세,2018,1980,956,1024,93.4,1974,952,1022,93.2
35350, 임실군,070001, 65세,2018,351,185,166,111.4,348,183,165,110.9
35350, 임실군,070002, 66세,2018,395,197,198,99.5,395,197,198,99.5
35350, 임실군,070003, 67세,2018,385,172,213,80.8,383,170,213,79.8
35350, 임실군,070004, 68세,2018,458,231,227,101.8,458,231,227,101.8
35350, 임실군,070005, 69세,2018,391,171,220,77.7,390,171,219,78.1
35350, 임실군,075,70~74세,2018,1869,870,999,87.1,1867,870,997,87.3
35350, 임실군,075001, 70세,2018,435,211,224,94.2,435,211,224,94.2
35350, 임실군,075002, 71세,2018,457,222,235,94.5,456,222,234,94.9
35350, 임실군,075003, 72세,2018,333,156,177,88.1,333,156,177,88.1
35350, 임실군,075004, 73세,2018,335,139,196,70.9,334,139,195,71.3
35350, 임실군,075005, 74세,2018,309,142,167,85,309,142,167,85
35350, 임실군,080,75~79세,2018,2236,863,1373,62.9,2235,862,1373,62.8
35350, 임실군,080001, 75세,2018,379,151,228,66.2,379,151,228,66.2
35350, 임실군,080002, 76세,2018,579,220,359,61.3,579,220,359,61.3
35350, 임실군,080003, 77세,2018,430,172,258,66.7,430,172,258,66.7
35350, 임실군,080004, 78세,2018,416,147,269,54.6,416,147,269,54.6
35350, 임실군,080005, 79세,2018,432,173,259,66.8,431,172,259,66.4
35350, 임실군,085,80~84세,2018,1708,612,1096,55.8,1707,611,1096,55.7
35350, 임실군,085001, 80세,2018,370,140,230,60.9,369,139,230,60.4
35350, 임실군,085002, 81세,2018,404,144,260,55.4,404,144,260,55.4
35350, 임실군,085003, 82세,2018,330,125,205,61,330,125,205,61
35350, 임실군,085004, 83세,2018,313,107,206,51.9,313,107,206,51.9
35350, 임실군,085005, 84세,2018,291,96,195,49.2,291,96,195,49.2
35350, 임실군,090,85~89세,2018,775,254,521,48.8,774,253,521,48.6
35350, 임실군,090001, 85세,2018,201,66,135,48.9,201,66,135,48.9
35350, 임실군,090002, 86세,2018,187,64,123,52,187,64,123,52
35350, 임실군,090003, 87세,2018,153,47,106,44.3,153,47,106,44.3
35350, 임실군,090004, 88세,2018,107,34,73,46.6,106,33,73,45.2
35350, 임실군,090005, 89세,2018,127,43,84,51.2,127,43,84,51.2
35350, 임실군,095,90~94세,2018,272,66,206,32,272,66,206,32
35350, 임실군,095001, 90세,2018,103,26,77,33.8,103,26,77,33.8
35350, 임실군,095002, 91세,2018,73,20,53,37.7,73,20,53,37.7
35350, 임실군,095003, 92세,2018,50,11,39,28.2,50,11,39,28.2
35350, 임실군,095004, 93세,2018,30,6,24,25,30,6,24,25
35350, 임실군,095005, 94세,2018,16,X,13,23.1,16,X,13,23.1
35350, 임실군,100,95~99세,2018,50,10,40,25,50,10,40,25
35350, 임실군,100001, 95세,2018,19,5,14,35.7,19,5,14,35.7
35350, 임실군,100002, 96세,2018,16,X,15,6.7,16,X,15,6.7
35350, 임실군,100003, 97세,2018,X,X,X,33.3,X,X,X,33.3
35350, 임실군,100004, 98세,2018,X,X,X,0,X,X,X,0
35350, 임실군,100005, 99세,2018,7,X,X,75,7,X,X,75
35350, 임실군,101,100세이상,2018,11,X,11,0,11,X,11,0
35350, 임실군,102,15세미만,2018,2328,1240,1088,114,2326,1240,1086,114.2
35350, 임실군,103,15~64세,2018,15148,8367,6781,123.4,14684,8176,6508,125.6
35350, 임실군,104,65세이상,2018,8901,3631,5270,68.9,8890,3624,5266,68.8
35350, 임실군,086,85세이상,2018,1108,330,778,42.4,1107,329,778,42.3
35350, 임실군,126,평균연령,2018,51.8,49.1,54.5,,52,49.3,54.8,
35350, 임실군,127,중위연령,2018,55.8,52.6,58.9,,56.2,52.9,59.4,
35360, 순창군,000,합계,2018,27136,12961,14175,91.4,26699,12810,13889,92.2
35360, 순창군,005,0~4세,2018,915,480,435,110.3,915,480,435,110.3
35360, 순창군,005001, 0세,2018,220,115,105,109.5,220,115,105,109.5
35360, 순창군,005002, 1세,2018,176,94,82,114.6,176,94,82,114.6
35360, 순창군,005003, 2세,2018,206,102,104,98.1,206,102,104,98.1
35360, 순창군,005004, 3세,2018,169,98,71,138,169,98,71,138
35360, 순창군,005005, 4세,2018,144,71,73,97.3,144,71,73,97.3
35360, 순창군,010,5~9세,2018,877,455,422,107.8,877,455,422,107.8
35360, 순창군,010001, 5세,2018,176,96,80,120,176,96,80,120
35360, 순창군,010002, 6세,2018,171,84,87,96.6,171,84,87,96.6
35360, 순창군,010003, 7세,2018,166,83,83,100,166,83,83,100
35360, 순창군,010004, 8세,2018,180,96,84,114.3,180,96,84,114.3
35360, 순창군,010005, 9세,2018,184,96,88,109.1,184,96,88,109.1
35360, 순창군,015,10~14세,2018,1009,513,496,103.4,1009,513,496,103.4
35360, 순창군,015001, 10세,2018,190,89,101,88.1,190,89,101,88.1
35360, 순창군,015002, 11세,2018,221,109,112,97.3,221,109,112,97.3
35360, 순창군,015003, 12세,2018,207,116,91,127.5,207,116,91,127.5
35360, 순창군,015004, 13세,2018,187,98,89,110.1,187,98,89,110.1
35360, 순창군,015005, 14세,2018,204,101,103,98.1,204,101,103,98.1
35360, 순창군,020,15~19세,2018,1085,555,530,104.7,1084,554,530,104.5
35360, 순창군,020001, 15세,2018,208,102,106,96.2,208,102,106,96.2
35360, 순창군,020002, 16세,2018,238,123,115,107,238,123,115,107
35360, 순창군,020003, 17세,2018,253,135,118,114.4,253,135,118,114.4
35360, 순창군,020004, 18세,2018,260,114,146,78.1,260,114,146,78.1
35360, 순창군,020005, 19세,2018,126,81,45,180,125,80,45,177.8
35360, 순창군,025,20~24세,2018,1027,598,429,139.4,958,570,388,146.9
35360, 순창군,025001, 20세,2018,184,124,60,206.7,176,120,56,214.3
35360, 순창군,025002, 21세,2018,219,129,90,143.3,211,125,86,145.3
35360, 순창군,025003, 22세,2018,195,121,74,163.5,184,117,67,174.6
35360, 순창군,025004, 23세,2018,211,114,97,117.5,194,104,90,115.6
35360, 순창군,025005, 24세,2018,218,110,108,101.9,193,104,89,116.9
35360, 순창군,030,25~29세,2018,964,443,521,85,874,415,459,90.4
35360, 순창군,030001, 25세,2018,192,92,100,92,171,87,84,103.6
35360, 순창군,030002, 26세,2018,204,99,105,94.3,190,91,99,91.9
35360, 순창군,030003, 27세,2018,197,91,106,85.8,178,86,92,93.5
35360, 순창군,030004, 28세,2018,203,92,111,82.9,184,87,97,89.7
35360, 순창군,030005, 29세,2018,168,69,99,69.7,151,64,87,73.6
35360, 순창군,035,30~34세,2018,1056,494,562,87.9,988,468,520,90
35360, 순창군,035001, 30세,2018,206,96,110,87.3,185,86,99,86.9
35360, 순창군,035002, 31세,2018,199,101,98,103.1,184,96,88,109.1
35360, 순창군,035003, 32세,2018,223,96,127,75.6,210,91,119,76.5
35360, 순창군,035004, 33세,2018,204,95,109,87.2,196,93,103,90.3
35360, 순창군,035005, 34세,2018,224,106,118,89.8,213,102,111,91.9
35360, 순창군,040,35~39세,2018,1322,676,646,104.6,1285,664,621,106.9
35360, 순창군,040001, 35세,2018,230,107,123,87,224,104,120,86.7
35360, 순창군,040002, 36세,2018,258,132,126,104.8,254,131,123,106.5
35360, 순창군,040003, 37세,2018,260,145,115,126.1,250,142,108,131.5
35360, 순창군,040004, 38세,2018,285,144,141,102.1,278,141,137,102.9
35360, 순창군,040005, 39세,2018,289,148,141,105,279,146,133,109.8
35360, 순창군,045,40~44세,2018,1445,802,643,124.7,1414,797,617,129.2
35360, 순창군,045001, 40세,2018,260,143,117,122.2,249,140,109,128.4
35360, 순창군,045002, 41세,2018,276,138,138,100,268,137,131,104.6
35360, 순창군,045003, 42세,2018,271,166,105,158.1,264,165,99,166.7
35360, 순창군,045004, 43세,2018,282,161,121,133.1,282,161,121,133.1
35360, 순창군,045005, 44세,2018,356,194,162,119.8,351,194,157,123.6
35360, 순창군,050,45~49세,2018,1837,1060,777,136.4,1793,1042,751,138.7
35360, 순창군,050001, 45세,2018,340,200,140,142.9,326,192,134,143.3
35360, 순창군,050002, 46세,2018,350,203,147,138.1,345,202,143,141.3
35360, 순창군,050003, 47세,2018,399,226,173,130.6,390,224,166,134.9
35360, 순창군,050004, 48세,2018,319,183,136,134.6,310,179,131,136.6
35360, 순창군,050005, 49세,2018,429,248,181,137,422,245,177,138.4
35360, 순창군,055,50~54세,2018,1951,1044,907,115.1,1911,1031,880,117.2
35360, 순창군,055001, 50세,2018,426,250,176,142,417,247,170,145.3
35360, 순창군,055002, 51세,2018,380,205,175,117.1,376,204,172,118.6
35360, 순창군,055003, 52세,2018,399,207,192,107.8,387,204,183,111.5
35360, 순창군,055004, 53세,2018,373,192,181,106.1,367,189,178,106.2
35360, 순창군,055005, 54세,2018,373,190,183,103.8,364,187,177,105.6
35360, 순창군,060,55~59세,2018,2435,1262,1173,107.6,2403,1252,1151,108.8
35360, 순창군,060001, 55세,2018,391,208,183,113.7,380,207,173,119.7
35360, 순창군,060002, 56세,2018,462,238,224,106.3,456,236,220,107.3
35360, 순창군,060003, 57세,2018,491,261,230,113.5,486,260,226,115
35360, 순창군,060004, 58세,2018,603,306,297,103,600,305,295,103.4
35360, 순창군,060005, 59세,2018,488,249,239,104.2,481,244,237,103
35360, 순창군,065,60~64세,2018,2268,1138,1130,100.7,2256,1133,1123,100.9
35360, 순창군,065001, 60세,2018,452,235,217,108.3,449,233,216,107.9
35360, 순창군,065002, 61세,2018,439,225,214,105.1,434,224,210,106.7
35360, 순창군,065003, 62세,2018,451,220,231,95.2,449,219,230,95.2
35360, 순창군,065004, 63세,2018,478,241,237,101.7,476,240,236,101.7
35360, 순창군,065005, 64세,2018,448,217,231,93.9,448,217,231,93.9
35360, 순창군,070,65~69세,2018,1881,888,993,89.4,1875,885,990,89.4
35360, 순창군,070001, 65세,2018,353,164,189,86.8,353,164,189,86.8
35360, 순창군,070002, 66세,2018,400,186,214,86.9,397,184,213,86.4
35360, 순창군,070003, 67세,2018,335,166,169,98.2,333,165,168,98.2
35360, 순창군,070004, 68세,2018,383,191,192,99.5,382,191,191,100
35360, 순창군,070005, 69세,2018,410,181,229,79,410,181,229,79
35360, 순창군,075,70~74세,2018,1929,827,1102,75,1926,826,1100,75.1
35360, 순창군,075001, 70세,2018,424,191,233,82,422,190,232,81.9
35360, 순창군,075002, 71세,2018,442,195,247,78.9,441,195,246,79.3
35360, 순창군,075003, 72세,2018,375,163,212,76.9,375,163,212,76.9
35360, 순창군,075004, 73세,2018,336,144,192,75,336,144,192,75
35360, 순창군,075005, 74세,2018,352,134,218,61.5,352,134,218,61.5
35360, 순창군,080,75~79세,2018,2331,829,1502,55.2,2329,829,1500,55.3
35360, 순창군,080001, 75세,2018,388,132,256,51.6,388,132,256,51.6
35360, 순창군,080002, 76세,2018,596,203,393,51.7,596,203,393,51.7
35360, 순창군,080003, 77세,2018,472,176,296,59.5,472,176,296,59.5
35360, 순창군,080004, 78세,2018,436,157,279,56.3,434,157,277,56.7
35360, 순창군,080005, 79세,2018,439,161,278,57.9,439,161,278,57.9
35360, 순창군,085,80~84세,2018,1708,594,1114,53.3,1706,593,1113,53.3
35360, 순창군,085001, 80세,2018,428,150,278,54,428,150,278,54
35360, 순창군,085002, 81세,2018,338,126,212,59.4,338,126,212,59.4
35360, 순창군,085003, 82세,2018,347,125,222,56.3,346,125,221,56.6
35360, 순창군,085004, 83세,2018,328,123,205,60,328,123,205,60
35360, 순창군,085005, 84세,2018,267,70,197,35.5,266,69,197,35
35360, 순창군,090,85~89세,2018,729,219,510,42.9,729,219,510,42.9
35360, 순창군,090001, 85세,2018,180,60,120,50,180,60,120,50
35360, 순창군,090002, 86세,2018,189,54,135,40,189,54,135,40
35360, 순창군,090003, 87세,2018,133,43,90,47.8,133,43,90,47.8
35360, 순창군,090004, 88세,2018,131,31,100,31,131,31,100,31
35360, 순창군,090005, 89세,2018,96,31,65,47.7,96,31,65,47.7
35360, 순창군,095,90~94세,2018,277,70,207,33.8,277,70,207,33.8
35360, 순창군,095001, 90세,2018,87,23,64,35.9,87,23,64,35.9
35360, 순창군,095002, 91세,2018,82,17,65,26.2,82,17,65,26.2
35360, 순창군,095003, 92세,2018,38,14,24,58.3,38,14,24,58.3
35360, 순창군,095004, 93세,2018,39,11,28,39.3,39,11,28,39.3
35360, 순창군,095005, 94세,2018,31,5,26,19.2,31,5,26,19.2
35360, 순창군,100,95~99세,2018,79,13,66,19.7,79,13,66,19.7
35360, 순창군,100001, 95세,2018,28,5,23,21.7,28,5,23,21.7
35360, 순창군,100002, 96세,2018,22,X,20,10,22,X,20,10
35360, 순창군,100003, 97세,2018,14,X,10,40,14,X,10,40
35360, 순창군,100004, 98세,2018,9,X,8,12.5,9,X,8,12.5
35360, 순창군,100005, 99세,2018,6,X,5,20,6,X,5,20
35360, 순창군,101,100세이상,2018,11,X,10,10,11,X,10,10
35360, 순창군,102,15세미만,2018,2801,1448,1353,107,2801,1448,1353,107
35360, 순창군,103,15~64세,2018,15390,8072,7318,110.3,14966,7926,7040,112.6
35360, 순창군,104,65세이상,2018,8945,3441,5504,62.5,8932,3436,5496,62.5
35360, 순창군,086,85세이상,2018,1096,303,793,38.2,1096,303,793,38.2
35360, 순창군,126,평균연령,2018,51.3,48.6,53.8,,51.5,48.8,54.1,
35360, 순창군,127,중위연령,2018,55.2,51.8,58.3,,55.6,52,58.7,
35370, 고창군,000,합계,2018,54425,27004,27421,98.5,53104,26326,26778,98.3
35370, 고창군,005,0~4세,2018,1304,678,626,108.3,1300,674,626,107.7
35370, 고창군,005001, 0세,2018,221,114,107,106.5,221,114,107,106.5
35370, 고창군,005002, 1세,2018,240,120,120,100,239,119,120,99.2
35370, 고창군,005003, 2세,2018,236,126,110,114.5,235,125,110,113.6
35370, 고창군,005004, 3세,2018,273,134,139,96.4,272,133,139,95.7
35370, 고창군,005005, 4세,2018,334,184,150,122.7,333,183,150,122
35370, 고창군,010,5~9세,2018,1642,871,771,113,1641,870,771,112.8
35370, 고창군,010001, 5세,2018,291,157,134,117.2,291,157,134,117.2
35370, 고창군,010002, 6세,2018,314,174,140,124.3,313,173,140,123.6
35370, 고창군,010003, 7세,2018,382,199,183,108.7,382,199,183,108.7
35370, 고창군,010004, 8세,2018,315,174,141,123.4,315,174,141,123.4
35370, 고창군,010005, 9세,2018,340,167,173,96.5,340,167,173,96.5
35370, 고창군,015,10~14세,2018,1848,992,856,115.9,1846,990,856,115.7
35370, 고창군,015001, 10세,2018,364,192,172,111.6,364,192,172,111.6
35370, 고창군,015002, 11세,2018,331,177,154,114.9,331,177,154,114.9
35370, 고창군,015003, 12세,2018,346,178,168,106,345,177,168,105.4
35370, 고창군,015004, 13세,2018,369,196,173,113.3,368,195,173,112.7
35370, 고창군,015005, 14세,2018,438,249,189,131.7,438,249,189,131.7
35370, 고창군,020,15~19세,2018,3065,1823,1242,146.8,3059,1820,1239,146.9
35370, 고창군,020001, 15세,2018,542,306,236,129.7,541,306,235,130.2
35370, 고창군,020002, 16세,2018,652,382,270,141.5,650,381,269,141.6
35370, 고창군,020003, 17세,2018,762,425,337,126.1,762,425,337,126.1
35370, 고창군,020004, 18세,2018,757,479,278,172.3,756,478,278,171.9
35370, 고창군,020005, 19세,2018,352,231,121,190.9,350,230,120,191.7
35370, 고창군,025,20~24세,2018,2236,1347,889,151.5,2103,1289,814,158.4
35370, 고창군,025001, 20세,2018,416,286,130,220,408,281,127,221.3
35370, 고창군,025002, 21세,2018,454,302,152,198.7,445,299,146,204.8
35370, 고창군,025003, 22세,2018,423,248,175,141.7,398,240,158,151.9
35370, 고창군,025004, 23세,2018,463,261,202,129.2,426,244,182,134.1
35370, 고창군,025005, 24세,2018,480,250,230,108.7,426,225,201,111.9
35370, 고창군,030,25~29세,2018,2219,1234,985,125.3,1918,1068,850,125.6
35370, 고창군,030001, 25세,2018,447,259,188,137.8,398,238,160,148.8
35370, 고창군,030002, 26세,2018,441,250,191,130.9,379,213,166,128.3
35370, 고창군,030003, 27세,2018,434,245,189,129.6,371,207,164,126.2
35370, 고창군,030004, 28세,2018,474,249,225,110.7,412,219,193,113.5
35370, 고창군,030005, 29세,2018,423,231,192,120.3,358,191,167,114.4
35370, 고창군,035,30~34세,2018,2127,1149,978,117.5,1864,1003,861,116.5
35370, 고창군,035001, 30세,2018,417,220,197,111.7,372,194,178,109
35370, 고창군,035002, 31세,2018,406,220,186,118.3,349,182,167,109
35370, 고창군,035003, 32세,2018,410,231,179,129.1,355,204,151,135.1
35370, 고창군,035004, 33세,2018,448,231,217,106.5,389,199,190,104.7
35370, 고창군,035005, 34세,2018,446,247,199,124.1,399,224,175,128
35370, 고창군,040,35~39세,2018,2407,1326,1081,122.7,2243,1238,1005,123.2
35370, 고창군,040001, 35세,2018,436,248,188,131.9,394,223,171,130.4
35370, 고창군,040002, 36세,2018,475,251,224,112.1,441,231,210,110
35370, 고창군,040003, 37세,2018,516,289,227,127.3,490,274,216,126.9
35370, 고창군,040004, 38세,2018,483,253,230,110,449,238,211,112.8
35370, 고창군,040005, 39세,2018,497,285,212,134.4,469,272,197,138.1
35370, 고창군,045,40~44세,2018,2767,1556,1211,128.5,2661,1503,1158,129.8
35370, 고창군,045001, 40세,2018,500,283,217,130.4,474,268,206,130.1
35370, 고창군,045002, 41세,2018,516,278,238,116.8,496,268,228,117.5
35370, 고창군,045003, 42세,2018,529,291,238,122.3,508,282,226,124.8
35370, 고창군,045004, 43세,2018,561,335,226,148.2,538,322,216,149.1
35370, 고창군,045005, 44세,2018,661,369,292,126.4,645,363,282,128.7
35370, 고창군,050,45~49세,2018,3707,2044,1663,122.9,3607,2004,1603,125
35370, 고창군,050001, 45세,2018,724,420,304,138.2,707,414,293,141.3
35370, 고창군,050002, 46세,2018,687,363,324,112,665,357,308,115.9
35370, 고창군,050003, 47세,2018,765,444,321,138.3,741,431,310,139
35370, 고창군,050004, 48세,2018,725,391,334,117.1,710,386,324,119.1
35370, 고창군,050005, 49세,2018,806,426,380,112.1,784,416,368,113
35370, 고창군,055,50~54세,2018,4071,2238,1833,122.1,3976,2200,1776,123.9
35370, 고창군,055001, 50세,2018,836,462,374,123.5,813,453,360,125.8
35370, 고창군,055002, 51세,2018,747,415,332,125,729,406,323,125.7
35370, 고창군,055003, 52세,2018,822,467,355,131.5,808,461,347,132.9
35370, 고창군,055004, 53세,2018,850,457,393,116.3,834,453,381,118.9
35370, 고창군,055005, 54세,2018,816,437,379,115.3,792,427,365,117
35370, 고창군,060,55~59세,2018,4931,2496,2435,102.5,4866,2464,2402,102.6
35370, 고창군,060001, 55세,2018,837,445,392,113.5,821,433,388,111.6
35370, 고창군,060002, 56세,2018,940,478,462,103.5,930,473,457,103.5
35370, 고창군,060003, 57세,2018,1091,566,525,107.8,1079,561,518,108.3
35370, 고창군,060004, 58세,2018,1092,529,563,94,1078,524,554,94.6
35370, 고창군,060005, 59세,2018,971,478,493,97,958,473,485,97.5
35370, 고창군,065,60~64세,2018,4850,2410,2440,98.8,4808,2381,2427,98.1
35370, 고창군,065001, 60세,2018,1048,541,507,106.7,1042,536,506,105.9
35370, 고창군,065002, 61세,2018,1026,507,519,97.7,1014,501,513,97.7
35370, 고창군,065003, 62세,2018,923,451,472,95.6,910,441,469,94
35370, 고창군,065004, 63세,2018,977,487,490,99.4,972,483,489,98.8
35370, 고창군,065005, 64세,2018,876,424,452,93.8,870,420,450,93.3
35370, 고창군,070,65~69세,2018,3957,1884,2073,90.9,3939,1876,2063,90.9
35370, 고창군,070001, 65세,2018,704,332,372,89.2,697,328,369,88.9
35370, 고창군,070002, 66세,2018,804,383,421,91,799,382,417,91.6
35370, 고창군,070003, 67세,2018,745,352,393,89.6,744,351,393,89.3
35370, 고창군,070004, 68세,2018,836,410,426,96.2,832,408,424,96.2
35370, 고창군,070005, 69세,2018,868,407,461,88.3,867,407,460,88.5
35370, 고창군,075,70~74세,2018,3848,1747,2101,83.2,3834,1740,2094,83.1
35370, 고창군,075001, 70세,2018,817,385,432,89.1,814,382,432,88.4
35370, 고창군,075002, 71세,2018,910,440,470,93.6,906,439,467,94
35370, 고창군,075003, 72세,2018,720,331,389,85.1,718,331,387,85.5
35370, 고창군,075004, 73세,2018,668,278,390,71.3,665,275,390,70.5
35370, 고창군,075005, 74세,2018,733,313,420,74.5,731,313,418,74.9
35370, 고창군,080,75~79세,2018,4399,1698,2701,62.9,4394,1696,2698,62.9
35370, 고창군,080001, 75세,2018,816,340,476,71.4,815,340,475,71.6
35370, 고창군,080002, 76세,2018,1117,433,684,63.3,1117,433,684,63.3
35370, 고창군,080003, 77세,2018,877,330,547,60.3,874,329,545,60.4
35370, 고창군,080004, 78세,2018,756,271,485,55.9,755,270,485,55.7
35370, 고창군,080005, 79세,2018,833,324,509,63.7,833,324,509,63.7
35370, 고창군,085,80~84세,2018,3073,1033,2040,50.6,3071,1032,2039,50.6
35370, 고창군,085001, 80세,2018,755,276,479,57.6,754,276,478,57.7
35370, 고창군,085002, 81세,2018,635,199,436,45.6,635,199,436,45.6
35370, 고창군,085003, 82세,2018,564,175,389,45,563,174,389,44.7
35370, 고창군,085004, 83세,2018,615,210,405,51.9,615,210,405,51.9
35370, 고창군,085005, 84세,2018,504,173,331,52.3,504,173,331,52.3
35370, 고창군,090,85~89세,2018,1414,375,1039,36.1,1414,375,1039,36.1
35370, 고창군,090001, 85세,2018,352,103,249,41.4,352,103,249,41.4
35370, 고창군,090002, 86세,2018,342,91,251,36.3,342,91,251,36.3
35370, 고창군,090003, 87세,2018,275,73,202,36.1,275,73,202,36.1
35370, 고창군,090004, 88세,2018,266,65,201,32.3,266,65,201,32.3
35370, 고창군,090005, 89세,2018,179,43,136,31.6,179,43,136,31.6
35370, 고창군,095,90~94세,2018,436,93,343,27.1,436,93,343,27.1
35370, 고창군,095001, 90세,2018,153,32,121,26.4,153,32,121,26.4
35370, 고창군,095002, 91세,2018,116,18,98,18.4,116,18,98,18.4
35370, 고창군,095003, 92세,2018,85,19,66,28.8,85,19,66,28.8
35370, 고창군,095004, 93세,2018,50,13,37,35.1,50,13,37,35.1
35370, 고창군,095005, 94세,2018,32,11,21,52.4,32,11,21,52.4
35370, 고창군,100,95~99세,2018,119,10,109,9.2,119,10,109,9.2
35370, 고창군,100001, 95세,2018,43,6,37,16.2,43,6,37,16.2
35370, 고창군,100002, 96세,2018,38,X,36,5.6,38,X,36,5.6
35370, 고창군,100003, 97세,2018,16,X,14,14.3,16,X,14,14.3
35370, 고창군,100004, 98세,2018,12,X,12,0,12,X,12,0
35370, 고창군,100005, 99세,2018,10,X,10,0,10,X,10,0
35370, 고창군,101,100세이상,2018,5,X,5,0,5,X,5,0
35370, 고창군,102,15세미만,2018,4794,2541,2253,112.8,4787,2534,2253,112.5
35370, 고창군,103,15~64세,2018,32380,17623,14757,119.4,31105,16970,14135,120.1
35370, 고창군,104,65세이상,2018,17251,6840,10411,65.7,17212,6822,10390,65.7
35370, 고창군,086,85세이상,2018,1974,478,1496,32,1974,478,1496,32
35370, 고창군,126,평균연령,2018,51,47.8,54,,51.3,48.1,54.4,
35370, 고창군,127,중위연령,2018,54.8,51,58.3,,55.4,51.6,58.8,
35380, 부안군,000,합계,2018,50501,25097,25404,98.8,49481,24624,24857,99.1
35380, 부안군,005,0~4세,2018,1291,687,604,113.7,1291,687,604,113.7
35380, 부안군,005001, 0세,2018,218,109,109,100,218,109,109,100
35380, 부안군,005002, 1세,2018,249,147,102,144.1,249,147,102,144.1
35380, 부안군,005003, 2세,2018,265,141,124,113.7,265,141,124,113.7
35380, 부안군,005004, 3세,2018,270,145,125,116,270,145,125,116
35380, 부안군,005005, 4세,2018,289,145,144,100.7,289,145,144,100.7
35380, 부안군,010,5~9세,2018,1548,800,748,107,1546,799,747,107
35380, 부안군,010001, 5세,2018,302,157,145,108.3,302,157,145,108.3
35380, 부안군,010002, 6세,2018,313,169,144,117.4,313,169,144,117.4
35380, 부안군,010003, 7세,2018,342,176,166,106,342,176,166,106
35380, 부안군,010004, 8세,2018,293,162,131,123.7,292,161,131,122.9
35380, 부안군,010005, 9세,2018,298,136,162,84,297,136,161,84.5
35380, 부안군,015,10~14세,2018,1582,832,750,110.9,1580,832,748,111.2
35380, 부안군,015001, 10세,2018,293,151,142,106.3,292,151,141,107.1
35380, 부안군,015002, 11세,2018,332,179,153,117,332,179,153,117
35380, 부안군,015003, 12세,2018,299,149,150,99.3,298,149,149,100
35380, 부안군,015004, 13세,2018,316,156,160,97.5,316,156,160,97.5
35380, 부안군,015005, 14세,2018,342,197,145,135.9,342,197,145,135.9
35380, 부안군,020,15~19세,2018,2200,1291,909,142,2187,1286,901,142.7
35380, 부안군,020001, 15세,2018,368,187,181,103.3,366,186,180,103.3
35380, 부안군,020002, 16세,2018,436,247,189,130.7,435,247,188,131.4
35380, 부안군,020003, 17세,2018,548,348,200,174,547,348,199,174.9
35380, 부안군,020004, 18세,2018,536,320,216,148.1,533,317,216,146.8
35380, 부안군,020005, 19세,2018,312,189,123,153.7,306,188,118,159.3
35380, 부안군,025,20~24세,2018,2078,1262,816,154.7,1978,1219,759,160.6
35380, 부안군,025001, 20세,2018,380,242,138,175.4,363,235,128,183.6
35380, 부안군,025002, 21세,2018,408,284,124,229,394,279,115,242.6
35380, 부안군,025003, 22세,2018,430,263,167,157.5,416,254,162,156.8
35380, 부안군,025004, 23세,2018,425,233,192,121.4,398,225,173,130.1
35380, 부안군,025005, 24세,2018,435,240,195,123.1,407,226,181,124.9
35380, 부안군,030,25~29세,2018,2062,1115,947,117.7,1862,1013,849,119.3
35380, 부안군,030001, 25세,2018,432,225,207,108.7,392,207,185,111.9
35380, 부안군,030002, 26세,2018,405,216,189,114.3,371,204,167,122.2
35380, 부안군,030003, 27세,2018,421,221,200,110.5,375,198,177,111.9
35380, 부안군,030004, 28세,2018,384,215,169,127.2,342,195,147,132.7
35380, 부안군,030005, 29세,2018,420,238,182,130.8,382,209,173,120.8
35380, 부안군,035,30~34세,2018,1994,1116,878,127.1,1797,1006,791,127.2
35380, 부안군,035001, 30세,2018,381,223,158,141.1,343,201,142,141.5
35380, 부안군,035002, 31세,2018,400,233,167,139.5,357,210,147,142.9
35380, 부안군,035003, 32세,2018,415,229,186,123.1,373,207,166,124.7
35380, 부안군,035004, 33세,2018,369,204,165,123.6,332,182,150,121.3
35380, 부안군,035005, 34세,2018,429,227,202,112.4,392,206,186,110.8
35380, 부안군,040,35~39세,2018,2466,1309,1157,113.1,2335,1245,1090,114.2
35380, 부안군,040001, 35세,2018,442,236,206,114.6,411,219,192,114.1
35380, 부안군,040002, 36세,2018,487,236,251,94,469,228,241,94.6
35380, 부안군,040003, 37세,2018,469,262,207,126.6,443,249,194,128.4
35380, 부안군,040004, 38세,2018,572,307,265,115.8,542,293,249,117.7
35380, 부안군,040005, 39세,2018,496,268,228,117.5,470,256,214,119.6
35380, 부안군,045,40~44세,2018,2763,1559,1204,129.5,2666,1521,1145,132.8
35380, 부안군,045001, 40세,2018,520,284,236,120.3,494,275,219,125.6
35380, 부안군,045002, 41세,2018,484,274,210,130.5,465,266,199,133.7
35380, 부안군,045003, 42세,2018,561,322,239,134.7,545,314,231,135.9
35380, 부안군,045004, 43세,2018,511,287,224,128.1,494,281,213,131.9
35380, 부안군,045005, 44세,2018,687,392,295,132.9,668,385,283,136
35380, 부안군,050,45~49세,2018,3479,1923,1556,123.6,3382,1876,1506,124.6
35380, 부안군,050001, 45세,2018,649,345,304,113.5,634,337,297,113.5
35380, 부안군,050002, 46세,2018,645,349,296,117.9,615,334,281,118.9
35380, 부안군,050003, 47세,2018,742,412,330,124.8,725,403,322,125.2
35380, 부안군,050004, 48세,2018,704,376,328,114.6,688,369,319,115.7
35380, 부안군,050005, 49세,2018,739,441,298,148,720,433,287,150.9
35380, 부안군,055,50~54세,2018,3912,2110,1802,117.1,3841,2087,1754,119
35380, 부안군,055001, 50세,2018,773,428,345,124.1,757,422,335,126
35380, 부안군,055002, 51세,2018,747,391,356,109.8,732,388,344,112.8
35380, 부안군,055003, 52세,2018,802,444,358,124,784,438,346,126.6
35380, 부안군,055004, 53세,2018,778,431,347,124.2,763,426,337,126.4
35380, 부안군,055005, 54세,2018,812,416,396,105.1,805,413,392,105.4
35380, 부안군,060,55~59세,2018,4729,2367,2362,100.2,4673,2346,2327,100.8
35380, 부안군,060001, 55세,2018,822,427,395,108.1,806,422,384,109.9
35380, 부안군,060002, 56세,2018,936,506,430,117.7,921,500,421,118.8
35380, 부안군,060003, 57세,2018,972,439,533,82.4,964,434,530,81.9
35380, 부안군,060004, 58세,2018,1038,518,520,99.6,1028,515,513,100.4
35380, 부안군,060005, 59세,2018,961,477,484,98.6,954,475,479,99.2
35380, 부안군,065,60~64세,2018,4679,2350,2329,100.9,4645,2339,2306,101.4
35380, 부안군,065001, 60세,2018,964,487,477,102.1,956,485,471,103
35380, 부안군,065002, 61세,2018,999,530,469,113,989,527,462,114.1
35380, 부안군,065003, 62세,2018,883,455,428,106.3,876,453,423,107.1
35380, 부안군,065004, 63세,2018,951,449,502,89.4,945,445,500,89
35380, 부안군,065005, 64세,2018,882,429,453,94.7,879,429,450,95.3
35380, 부안군,070,65~69세,2018,3898,1866,2032,91.8,3888,1862,2026,91.9
35380, 부안군,070001, 65세,2018,660,336,324,103.7,655,335,320,104.7
35380, 부안군,070002, 66세,2018,820,400,420,95.2,819,400,419,95.5
35380, 부안군,070003, 67세,2018,762,347,415,83.6,759,345,414,83.3
35380, 부안군,070004, 68세,2018,832,386,446,86.5,831,385,446,86.3
35380, 부안군,070005, 69세,2018,824,397,427,93,824,397,427,93
35380, 부안군,075,70~74세,2018,3658,1680,1978,84.9,3652,1678,1974,85
35380, 부안군,075001, 70세,2018,765,388,377,102.9,762,386,376,102.7
35380, 부안군,075002, 71세,2018,889,402,487,82.5,887,402,485,82.9
35380, 부안군,075003, 72세,2018,699,321,378,84.9,699,321,378,84.9
35380, 부안군,075004, 73세,2018,631,283,348,81.3,631,283,348,81.3
35380, 부안군,075005, 74세,2018,674,286,388,73.7,673,286,387,73.9
35380, 부안군,080,75~79세,2018,3649,1424,2225,64,3649,1424,2225,64
35380, 부안군,080001, 75세,2018,701,297,404,73.5,701,297,404,73.5
35380, 부안군,080002, 76세,2018,929,374,555,67.4,929,374,555,67.4
35380, 부안군,080003, 77세,2018,679,247,432,57.2,679,247,432,57.2
35380, 부안군,080004, 78세,2018,617,234,383,61.1,617,234,383,61.1
35380, 부안군,080005, 79세,2018,723,272,451,60.3,723,272,451,60.3
35380, 부안군,085,80~84세,2018,2775,952,1823,52.2,2772,951,1821,52.2
35380, 부안군,085001, 80세,2018,653,246,407,60.4,653,246,407,60.4
35380, 부안군,085002, 81세,2018,586,223,363,61.4,586,223,363,61.4
35380, 부안군,085003, 82세,2018,533,171,362,47.2,532,170,362,47
35380, 부안군,085004, 83세,2018,532,161,371,43.4,531,161,370,43.5
35380, 부안군,085005, 84세,2018,471,151,320,47.2,470,151,319,47.3
35380, 부안군,090,85~89세,2018,1289,357,932,38.3,1288,356,932,38.2
35380, 부안군,090001, 85세,2018,396,122,274,44.5,396,122,274,44.5
35380, 부안군,090002, 86세,2018,272,65,207,31.4,272,65,207,31.4
35380, 부안군,090003, 87세,2018,251,70,181,38.7,251,70,181,38.7
35380, 부안군,090004, 88세,2018,206,56,150,37.3,205,55,150,36.7
35380, 부안군,090005, 89세,2018,164,44,120,36.7,164,44,120,36.7
35380, 부안군,095,90~94세,2018,357,80,277,28.9,357,80,277,28.9
35380, 부안군,095001, 90세,2018,136,25,111,22.5,136,25,111,22.5
35380, 부안군,095002, 91세,2018,108,21,87,24.1,108,21,87,24.1
35380, 부안군,095003, 92세,2018,45,15,30,50,45,15,30,50
35380, 부안군,095004, 93세,2018,44,11,33,33.3,44,11,33,33.3
35380, 부안군,095005, 94세,2018,24,8,16,50,24,8,16,50
35380, 부안군,100,95~99세,2018,78,15,63,23.8,78,15,63,23.8
35380, 부안군,100001, 95세,2018,31,X,28,10.7,31,X,28,10.7
35380, 부안군,100002, 96세,2018,19,7,12,58.3,19,7,12,58.3
35380, 부안군,100003, 97세,2018,8,X,6,33.3,8,X,6,33.3
35380, 부안군,100004, 98세,2018,12,X,11,9.1,12,X,11,9.1
35380, 부안군,100005, 99세,2018,8,X,6,33.3,8,X,6,33.3
35380, 부안군,101,100세이상,2018,14,X,12,16.7,14,X,12,16.7
35380, 부안군,102,15세미만,2018,4421,2319,2102,110.3,4417,2318,2099,110.4
35380, 부안군,103,15~64세,2018,30362,16402,13960,117.5,29366,15938,13428,118.7
35380, 부안군,104,65세이상,2018,15718,6376,9342,68.3,15698,6368,9330,68.3
35380, 부안군,086,85세이상,2018,1738,454,1284,35.4,1737,453,1284,35.3
35380, 부안군,126,평균연령,2018,51.1,48.3,53.8,,51.4,48.6,54.2,
35380, 부안군,127,중위연령,2018,54.8,51.6,57.9,,55.3,52,58.4,
36,전라남도,000,합계,2018,1790352,900154,890198,101.1,1747832,874149,873683,100.1
36,전라남도,005,0~4세,2018,65729,33631,32098,104.8,65542,33539,32003,104.8
36,전라남도,005001, 0세,2018,11329,5798,5531,104.8,11286,5775,5511,104.8
36,전라남도,005002, 1세,2018,12191,6299,5892,106.9,12145,6278,5867,107
36,전라남도,005003, 2세,2018,13618,6922,6696,103.4,13580,6902,6678,103.4
36,전라남도,005004, 3세,2018,14358,7369,6989,105.4,14328,7354,6974,105.4
36,전라남도,005005, 4세,2018,14233,7243,6990,103.6,14203,7230,6973,103.7
36,전라남도,010,5~9세,2018,77366,39559,37807,104.6,77246,39505,37741,104.7
36,전라남도,010001, 5세,2018,15042,7727,7315,105.6,15017,7716,7301,105.7
36,전라남도,010002, 6세,2018,16235,8178,8057,101.5,16205,8159,8046,101.4
36,전라남도,010003, 7세,2018,16342,8251,8091,102,16319,8245,8074,102.1
36,전라남도,010004, 8세,2018,15072,7873,7199,109.4,15051,7862,7189,109.4
36,전라남도,010005, 9세,2018,14675,7530,7145,105.4,14654,7523,7131,105.5
36,전라남도,015,10~14세,2018,76336,39451,36885,107,76224,39391,36833,106.9
36,전라남도,015001, 10세,2018,15317,7878,7439,105.9,15293,7865,7428,105.9
36,전라남도,015002, 11세,2018,15774,8119,7655,106.1,15751,8106,7645,106
36,전라남도,015003, 12세,2018,14695,7583,7112,106.6,14679,7575,7104,106.6
36,전라남도,015004, 13세,2018,14416,7439,6977,106.6,14395,7425,6970,106.5
36,전라남도,015005, 14세,2018,16134,8432,7702,109.5,16106,8420,7686,109.5
36,전라남도,020,15~19세,2018,95929,51413,44516,115.5,95089,50960,44129,115.5
36,전라남도,020001, 15세,2018,16608,8632,7976,108.2,16583,8623,7960,108.3
36,전라남도,020002, 16세,2018,17966,9337,8629,108.2,17932,9322,8610,108.3
36,전라남도,020003, 17세,2018,21080,11063,10017,110.4,21021,11031,9990,110.4
36,전라남도,020004, 18세,2018,22145,11806,10339,114.2,21907,11671,10236,114
36,전라남도,020005, 19세,2018,18130,10575,7555,140,17646,10313,7333,140.6
36,전라남도,025,20~24세,2018,100089,58859,41230,142.8,94154,55034,39120,140.7
36,전라남도,025001, 20세,2018,19736,11943,7793,153.3,19067,11554,7513,153.8
36,전라남도,025002, 21세,2018,20778,12408,8370,148.2,19873,11876,7997,148.5
36,전라남도,025003, 22세,2018,20364,12054,8310,145.1,19203,11299,7904,143
36,전라남도,025004, 23세,2018,19864,11465,8399,136.5,18339,10451,7888,132.5
36,전라남도,025005, 24세,2018,19347,10989,8358,131.5,17672,9854,7818,126
36,전라남도,030,25~29세,2018,89241,49052,40189,122.1,79527,42528,36999,114.9
36,전라남도,030001, 25세,2018,18837,10418,8419,123.7,16896,9118,7778,117.2
36,전라남도,030002, 26세,2018,18966,10277,8689,118.3,16950,8901,8049,110.6
36,전라남도,030003, 27세,2018,17550,9745,7805,124.9,15576,8401,7175,117.1
36,전라남도,030004, 28세,2018,17494,9615,7879,122,15500,8301,7199,115.3
36,전라남도,030005, 29세,2018,16394,8997,7397,121.6,14605,7807,6798,114.8
36,전라남도,035,30~34세,2018,87812,46449,41363,112.3,80139,41508,38631,107.4
36,전라남도,035001, 30세,2018,16179,8656,7523,115.1,14449,7537,6912,109
36,전라남도,035002, 31세,2018,16714,8800,7914,111.2,15084,7756,7328,105.8
36,전라남도,035003, 32세,2018,17427,9247,8180,113,15836,8226,7610,108.1
36,전라남도,035004, 33세,2018,17931,9485,8446,112.3,16515,8573,7942,107.9
36,전라남도,035005, 34세,2018,19561,10261,9300,110.3,18255,9416,8839,106.5
36,전라남도,040,35~39세,2018,116372,61577,54795,112.4,110994,58082,52912,109.8
36,전라남도,040001, 35세,2018,21726,11477,10249,112,20474,10632,9842,108
36,전라남도,040002, 36세,2018,23803,12705,11098,114.5,22650,11959,10691,111.9
36,전라남도,040003, 37세,2018,22870,12286,10584,116.1,21756,11557,10199,113.3
36,전라남도,040004, 38세,2018,24386,12740,11646,109.4,23450,12163,11287,107.8
36,전라남도,040005, 39세,2018,23587,12369,11218,110.3,22664,11771,10893,108.1
36,전라남도,045,40~44세,2018,117596,62349,55247,112.9,113944,60098,53846,111.6
36,전라남도,045001, 40세,2018,21979,11640,10339,112.6,21160,11115,10045,110.7
36,전라남도,045002, 41세,2018,22944,11982,10962,109.3,22198,11497,10701,107.4
36,전라남도,045003, 42세,2018,22747,12220,10527,116.1,21976,11764,10212,115.2
36,전라남도,045004, 43세,2018,23575,12478,11097,112.4,22883,12059,10824,111.4
36,전라남도,045005, 44세,2018,26351,14029,12322,113.9,25727,13663,12064,113.3
36,전라남도,050,45~49세,2018,142245,75738,66507,113.9,139239,74132,65107,113.9
36,전라남도,050001, 45세,2018,27222,14355,12867,111.6,26589,13993,12596,111.1
36,전라남도,050002, 46세,2018,27419,14707,12712,115.7,26789,14354,12435,115.4
36,전라남도,050003, 47세,2018,29701,15926,13775,115.6,29100,15615,13485,115.8
36,전라남도,050004, 48세,2018,28770,15297,13473,113.5,28167,14972,13195,113.5
36,전라남도,050005, 49세,2018,29133,15453,13680,113,28594,15198,13396,113.5
36,전라남도,055,50~54세,2018,145188,77326,67862,113.9,142792,76234,66558,114.5
36,전라남도,055001, 50세,2018,30669,16354,14315,114.2,30138,16091,14047,114.6
36,전라남도,055002, 51세,2018,28420,15035,13385,112.3,27932,14812,13120,112.9
36,전라남도,055003, 52세,2018,29312,16016,13296,120.5,28866,15811,13055,121.1
36,전라남도,055004, 53세,2018,29272,15532,13740,113,28771,15305,13466,113.7
36,전라남도,055005, 54세,2018,27515,14389,13126,109.6,27085,14215,12870,110.5
36,전라남도,060,55~59세,2018,155654,79688,75966,104.9,153942,78902,75040,105.1
36,전라남도,060001, 55세,2018,29986,15779,14207,111.1,29497,15565,13932,111.7
36,전라남도,060002, 56세,2018,29178,15297,13881,110.2,28818,15112,13706,110.3
36,전라남도,060003, 57세,2018,32059,16220,15839,102.4,31775,16094,15681,102.6
36,전라남도,060004, 58세,2018,33846,17045,16801,101.5,33505,16883,16622,101.6
36,전라남도,060005, 59세,2018,30585,15347,15238,100.7,30347,15248,15099,101
36,전라남도,065,60~64세,2018,129201,65233,63968,102,128169,64749,63420,102.1
36,전라남도,065001, 60세,2018,28281,14487,13794,105,28011,14361,13650,105.2
36,전라남도,065002, 61세,2018,27925,14239,13686,104,27693,14138,13555,104.3
36,전라남도,065003, 62세,2018,24526,12414,12112,102.5,24329,12319,12010,102.6
36,전라남도,065004, 63세,2018,26298,13138,13160,99.8,26103,13036,13067,99.8
36,전라남도,065005, 64세,2018,22171,10955,11216,97.7,22033,10895,11138,97.8
36,전라남도,070,65~69세,2018,103484,50480,53004,95.2,103036,50256,52780,95.2
36,전라남도,070001, 65세,2018,19309,9433,9876,95.5,19197,9371,9826,95.4
36,전라남도,070002, 66세,2018,22853,11114,11739,94.7,22754,11069,11685,94.7
36,전라남도,070003, 67세,2018,20053,9858,10195,96.7,19962,9819,10143,96.8
36,전라남도,070004, 68세,2018,20668,10043,10625,94.5,20584,10001,10583,94.5
36,전라남도,070005, 69세,2018,20601,10032,10569,94.9,20539,9996,10543,94.8
36,전라남도,075,70~74세,2018,90013,40914,49099,83.3,89854,40851,49003,83.4
36,전라남도,075001, 70세,2018,20108,9577,10531,90.9,20062,9557,10505,91
36,전라남도,075002, 71세,2018,21370,9971,11399,87.5,21331,9952,11379,87.5
36,전라남도,075003, 72세,2018,16209,7453,8756,85.1,16181,7444,8737,85.2
36,전라남도,075004, 73세,2018,16582,7203,9379,76.8,16554,7196,9358,76.9
36,전라남도,075005, 74세,2018,15744,6710,9034,74.3,15726,6702,9024,74.3
36,전라남도,080,75~79세,2018,93396,37152,56244,66.1,93301,37119,56182,66.1
36,전라남도,080001, 75세,2018,17811,7384,10427,70.8,17784,7373,10411,70.8
36,전라남도,080002, 76세,2018,22976,9418,13558,69.5,22962,9413,13549,69.5
36,전라남도,080003, 77세,2018,18545,7418,11127,66.7,18517,7410,11107,66.7
36,전라남도,080004, 78세,2018,17467,6659,10808,61.6,17456,6656,10800,61.6
36,전라남도,080005, 79세,2018,16597,6273,10324,60.8,16582,6267,10315,60.8
36,전라남도,085,80~84세,2018,62349,21002,41347,50.8,62311,20985,41326,50.8
36,전라남도,085001, 80세,2018,15302,5510,9792,56.3,15291,5506,9785,56.3
36,전라남도,085002, 81세,2018,13842,4887,8955,54.6,13828,4880,8948,54.5
36,전라남도,085003, 82세,2018,11889,3991,7898,50.5,11882,3987,7895,50.5
36,전라남도,085004, 83세,2018,11303,3583,7720,46.4,11298,3582,7716,46.4
36,전라남도,085005, 84세,2018,10013,3031,6982,43.4,10012,3030,6982,43.4
36,전라남도,090,85~89세,2018,30869,7962,22907,34.8,30850,7958,22892,34.8
36,전라남도,090001, 85세,2018,8268,2333,5935,39.3,8262,2331,5931,39.3
36,전라남도,090002, 86세,2018,7144,1933,5211,37.1,7140,1932,5208,37.1
36,전라남도,090003, 87세,2018,5677,1423,4254,33.5,5674,1423,4251,33.5
36,전라남도,090004, 88세,2018,5741,1261,4480,28.1,5739,1261,4478,28.2
36,전라남도,090005, 89세,2018,4039,1012,3027,33.4,4035,1011,3024,33.4
36,전라남도,095,90~94세,2018,8805,1923,6882,27.9,8801,1922,6879,27.9
36,전라남도,095001, 90세,2018,3030,685,2345,29.2,3028,684,2344,29.2
36,전라남도,095002, 91세,2018,2249,488,1761,27.7,2249,488,1761,27.7
36,전라남도,095003, 92세,2018,1522,319,1203,26.5,1522,319,1203,26.5
36,전라남도,095004, 93세,2018,1157,250,907,27.6,1155,250,905,27.6
36,전라남도,095005, 94세,2018,847,181,666,27.2,847,181,666,27.2
36,전라남도,100,95~99세,2018,2422,368,2054,17.9,2422,368,2054,17.9
36,전라남도,100001, 95세,2018,1032,148,884,16.7,1032,148,884,16.7
36,전라남도,100002, 96세,2018,631,116,515,22.5,631,116,515,22.5
36,전라남도,100003, 97세,2018,358,51,307,16.6,358,51,307,16.6
36,전라남도,100004, 98세,2018,259,32,227,14.1,259,32,227,14.1
36,전라남도,100005, 99세,2018,142,21,121,17.4,142,21,121,17.4
36,전라남도,101,100세이상,2018,256,28,228,12.3,256,28,228,12.3
36,전라남도,102,15세미만,2018,219431,112641,106790,105.5,219012,112435,106577,105.5
36,전라남도,103,15~64세,2018,1179327,627684,551643,113.8,1137989,602227,535762,112.4
36,전라남도,104,65세이상,2018,391594,159829,231765,69,390831,159487,231344,68.9
36,전라남도,086,85세이상,2018,42352,10281,32071,32.1,42329,10276,32053,32.1
36,전라남도,126,평균연령,2018,45.4,43.5,47.4,,45.7,43.7,47.6,
36,전라남도,127,중위연령,2018,47.5,45.5,49.6,,48,46.2,50,
36004, 읍부,000,합계,2018,431659,217200,214459,101.3,418948,209182,209766,99.7
36004, 읍부,005,0~4세,2018,17621,8932,8689,102.8,17538,8887,8651,102.7
36004, 읍부,005001, 0세,2018,3101,1575,1526,103.2,3081,1562,1519,102.8
36004, 읍부,005002, 1세,2018,3339,1662,1677,99.1,3321,1654,1667,99.2
36004, 읍부,005003, 2세,2018,3567,1832,1735,105.6,3547,1820,1727,105.4
36004, 읍부,005004, 3세,2018,3789,1912,1877,101.9,3773,1903,1870,101.8
36004, 읍부,005005, 4세,2018,3825,1951,1874,104.1,3816,1948,1868,104.3
36004, 읍부,010,5~9세,2018,20769,10671,10098,105.7,20713,10643,10070,105.7
36004, 읍부,010001, 5세,2018,4103,2132,1971,108.2,4092,2126,1966,108.1
36004, 읍부,010002, 6세,2018,4397,2229,2168,102.8,4381,2219,2162,102.6
36004, 읍부,010003, 7세,2018,4445,2266,2179,104,4435,2264,2171,104.3
36004, 읍부,010004, 8세,2018,3954,2051,1903,107.8,3944,2045,1899,107.7
36004, 읍부,010005, 9세,2018,3870,1993,1877,106.2,3861,1989,1872,106.3
36004, 읍부,015,10~14세,2018,20137,10437,9700,107.6,20086,10408,9678,107.5
36004, 읍부,015001, 10세,2018,4049,2063,1986,103.9,4038,2057,1981,103.8
36004, 읍부,015002, 11세,2018,4148,2129,2019,105.4,4138,2124,2014,105.5
36004, 읍부,015003, 12세,2018,3958,2071,1887,109.8,3949,2065,1884,109.6
36004, 읍부,015004, 13세,2018,3816,1982,1834,108.1,3805,1974,1831,107.8
36004, 읍부,015005, 14세,2018,4166,2192,1974,111,4156,2188,1968,111.2
36004, 읍부,020,15~19세,2018,26563,13931,12632,110.3,26422,13867,12555,110.5
36004, 읍부,020001, 15세,2018,4465,2307,2158,106.9,4454,2300,2154,106.8
36004, 읍부,020002, 16세,2018,5062,2581,2481,104,5044,2574,2470,104.2
36004, 읍부,020003, 17세,2018,6132,3120,3012,103.6,6119,3113,3006,103.6
36004, 읍부,020004, 18세,2018,6439,3342,3097,107.9,6404,3328,3076,108.2
36004, 읍부,020005, 19세,2018,4465,2581,1884,137,4401,2552,1849,138
36004, 읍부,025,20~24세,2018,23352,13719,9633,142.4,21941,12798,9143,140
36004, 읍부,025001, 20세,2018,4708,2892,1816,159.3,4577,2823,1754,160.9
36004, 읍부,025002, 21세,2018,4860,2877,1983,145.1,4672,2754,1918,143.6
36004, 읍부,025003, 22세,2018,4801,2881,1920,150.1,4494,2685,1809,148.4
36004, 읍부,025004, 23세,2018,4556,2577,1979,130.2,4188,2326,1862,124.9
36004, 읍부,025005, 24세,2018,4427,2492,1935,128.8,4010,2210,1800,122.8
36004, 읍부,030,25~29세,2018,20492,11094,9398,118,17779,9207,8572,107.4
36004, 읍부,030001, 25세,2018,4211,2315,1896,122.1,3702,1958,1744,112.3
36004, 읍부,030002, 26세,2018,4272,2287,1985,115.2,3744,1919,1825,105.2
36004, 읍부,030003, 27세,2018,4064,2194,1870,117.3,3480,1771,1709,103.6
36004, 읍부,030004, 28세,2018,4102,2235,1867,119.7,3526,1857,1669,111.3
36004, 읍부,030005, 29세,2018,3843,2063,1780,115.9,3327,1702,1625,104.7
36004, 읍부,035,30~34세,2018,21475,11044,10431,105.9,19119,9475,9644,98.2
36004, 읍부,035001, 30세,2018,3909,2038,1871,108.9,3395,1694,1701,99.6
36004, 읍부,035002, 31세,2018,4084,2068,2016,102.6,3578,1728,1850,93.4
36004, 읍부,035003, 32세,2018,4235,2209,2026,109,3756,1890,1866,101.3
36004, 읍부,035004, 33세,2018,4422,2260,2162,104.5,3970,1959,2011,97.4
36004, 읍부,035005, 34세,2018,4825,2469,2356,104.8,4420,2204,2216,99.5
36004, 읍부,040,35~39세,2018,29629,15446,14183,108.9,27984,14309,13675,104.6
36004, 읍부,040001, 35세,2018,5436,2849,2587,110.1,5039,2559,2480,103.2
36004, 읍부,040002, 36세,2018,6136,3225,2911,110.8,5783,2976,2807,106
36004, 읍부,040003, 37세,2018,5750,3070,2680,114.6,5389,2826,2563,110.3
36004, 읍부,040004, 38세,2018,6219,3161,3058,103.4,5940,2983,2957,100.9
36004, 읍부,040005, 39세,2018,6088,3141,2947,106.6,5833,2965,2868,103.4
36004, 읍부,045,40~44세,2018,30282,16023,14259,112.4,29108,15245,13863,110
36004, 읍부,045001, 40세,2018,5737,3005,2732,110,5497,2834,2663,106.4
36004, 읍부,045002, 41세,2018,5885,3070,2815,109.1,5652,2907,2745,105.9
36004, 읍부,045003, 42세,2018,5819,3124,2695,115.9,5559,2953,2606,113.3
36004, 읍부,045004, 43세,2018,6008,3172,2836,111.8,5776,3025,2751,110
36004, 읍부,045005, 44세,2018,6833,3652,3181,114.8,6624,3526,3098,113.8
36004, 읍부,050,45~49세,2018,35098,18937,16161,117.2,34112,18413,15699,117.3
36004, 읍부,050001, 45세,2018,6842,3615,3227,112,6647,3502,3145,111.4
36004, 읍부,050002, 46세,2018,6758,3615,3143,115,6559,3499,3060,114.3
36004, 읍부,050003, 47세,2018,7455,4112,3343,123,7255,4015,3240,123.9
36004, 읍부,050004, 48세,2018,7049,3821,3228,118.4,6833,3705,3128,118.4
36004, 읍부,050005, 49세,2018,6994,3774,3220,117.2,6818,3692,3126,118.1
36004, 읍부,055,50~54세,2018,33410,17997,15413,116.8,32565,17562,15003,117.1
36004, 읍부,055001, 50세,2018,7243,3957,3286,120.4,7040,3842,3198,120.1
36004, 읍부,055002, 51세,2018,6530,3489,3041,114.7,6368,3409,2959,115.2
36004, 읍부,055003, 52세,2018,6857,3798,3059,124.2,6701,3721,2980,124.9
36004, 읍부,055004, 53세,2018,6573,3488,3085,113.1,6411,3399,3012,112.8
36004, 읍부,055005, 54세,2018,6207,3265,2942,111,6045,3191,2854,111.8
36004, 읍부,060,55~59세,2018,35568,18373,17195,106.9,34961,18067,16894,106.9
36004, 읍부,060001, 55세,2018,6845,3576,3269,109.4,6665,3487,3178,109.7
36004, 읍부,060002, 56세,2018,6789,3553,3236,109.8,6655,3483,3172,109.8
36004, 읍부,060003, 57세,2018,7328,3738,3590,104.1,7247,3700,3547,104.3
36004, 읍부,060004, 58세,2018,7716,4009,3707,108.1,7585,3941,3644,108.2
36004, 읍부,060005, 59세,2018,6890,3497,3393,103.1,6809,3456,3353,103.1
36004, 읍부,065,60~64세,2018,29098,14670,14428,101.7,28720,14491,14229,101.8
36004, 읍부,065001, 60세,2018,6333,3267,3066,106.6,6230,3213,3017,106.5
36004, 읍부,065002, 61세,2018,6307,3216,3091,104,6223,3173,3050,104
36004, 읍부,065003, 62세,2018,5548,2864,2684,106.7,5478,2836,2642,107.3
36004, 읍부,065004, 63세,2018,5888,2905,2983,97.4,5827,2874,2953,97.3
36004, 읍부,065005, 64세,2018,5022,2418,2604,92.9,4962,2395,2567,93.3
36004, 읍부,070,65~69세,2018,23505,11314,12191,92.8,23351,11237,12114,92.8
36004, 읍부,070001, 65세,2018,4400,2085,2315,90.1,4369,2066,2303,89.7
36004, 읍부,070002, 66세,2018,5147,2492,2655,93.9,5106,2472,2634,93.8
36004, 읍부,070003, 67세,2018,4580,2219,2361,94,4548,2205,2343,94.1
36004, 읍부,070004, 68세,2018,4708,2248,2460,91.4,4678,2235,2443,91.5
36004, 읍부,070005, 69세,2018,4670,2270,2400,94.6,4650,2259,2391,94.5
36004, 읍부,075,70~74세,2018,20339,9384,10955,85.7,20289,9366,10923,85.7
36004, 읍부,075001, 70세,2018,4544,2175,2369,91.8,4530,2169,2361,91.9
36004, 읍부,075002, 71세,2018,4882,2344,2538,92.4,4871,2339,2532,92.4
36004, 읍부,075003, 72세,2018,3703,1696,2007,84.5,3695,1694,2001,84.7
36004, 읍부,075004, 73세,2018,3729,1661,2068,80.3,3721,1660,2061,80.5
36004, 읍부,075005, 74세,2018,3481,1508,1973,76.4,3472,1504,1968,76.4
36004, 읍부,080,75~79세,2018,20580,8186,12394,66,20545,8175,12370,66.1
36004, 읍부,080001, 75세,2018,3935,1634,2301,71,3923,1629,2294,71
36004, 읍부,080002, 76세,2018,5073,2089,2984,70,5068,2087,2981,70
36004, 읍부,080003, 77세,2018,4081,1632,2449,66.6,4070,1629,2441,66.7
36004, 읍부,080004, 78세,2018,3867,1464,2403,60.9,3864,1463,2401,60.9
36004, 읍부,080005, 79세,2018,3624,1367,2257,60.6,3620,1367,2253,60.7
36004, 읍부,085,80~84세,2018,13785,4734,9051,52.3,13768,4726,9042,52.3
36004, 읍부,085001, 80세,2018,3370,1239,2131,58.1,3363,1236,2127,58.1
36004, 읍부,085002, 81세,2018,3031,1057,1974,53.5,3023,1053,1970,53.5
36004, 읍부,085003, 82세,2018,2621,897,1724,52,2620,896,1724,52
36004, 읍부,085004, 83세,2018,2471,818,1653,49.5,2470,818,1652,49.5
36004, 읍부,085005, 84세,2018,2292,723,1569,46.1,2292,723,1569,46.1
36004, 읍부,090,85~89세,2018,7141,1758,5383,32.7,7134,1757,5377,32.7
36004, 읍부,090001, 85세,2018,1787,484,1303,37.1,1784,484,1300,37.2
36004, 읍부,090002, 86세,2018,1699,435,1264,34.4,1697,434,1263,34.4
36004, 읍부,090003, 87세,2018,1330,324,1006,32.2,1329,324,1005,32.2
36004, 읍부,090004, 88세,2018,1319,269,1050,25.6,1318,269,1049,25.6
36004, 읍부,090005, 89세,2018,1006,246,760,32.4,1006,246,760,32.4
36004, 읍부,095,90~94세,2018,2146,459,1687,27.2,2144,458,1686,27.2
36004, 읍부,095001, 90세,2018,752,160,592,27,751,159,592,26.9
36004, 읍부,095002, 91세,2018,555,118,437,27,555,118,437,27
36004, 읍부,095003, 92세,2018,333,64,269,23.8,333,64,269,23.8
36004, 읍부,095004, 93세,2018,290,74,216,34.3,289,74,215,34.4
36004, 읍부,095005, 94세,2018,216,43,173,24.9,216,43,173,24.9
36004, 읍부,100,95~99세,2018,602,82,520,15.8,602,82,520,15.8
36004, 읍부,100001, 95세,2018,258,31,227,13.7,258,31,227,13.7
36004, 읍부,100002, 96세,2018,164,28,136,20.6,164,28,136,20.6
36004, 읍부,100003, 97세,2018,86,15,71,21.1,86,15,71,21.1
36004, 읍부,100004, 98세,2018,62,5,57,8.8,62,5,57,8.8
36004, 읍부,100005, 99세,2018,32,X,29,10.3,32,X,29,10.3
36004, 읍부,101,100세이상,2018,67,9,58,15.5,67,9,58,15.5
36004, 읍부,102,15세미만,2018,58527,30040,28487,105.5,58337,29938,28399,105.4
36004, 읍부,103,15~64세,2018,284967,151234,133733,113.1,272711,143434,129277,111
36004, 읍부,104,65세이상,2018,88165,35926,52239,68.8,87900,35810,52090,68.7
36004, 읍부,086,85세이상,2018,9956,2308,7648,30.2,9947,2306,7641,30.2
36004, 읍부,126,평균연령,2018,44.2,42.3,46,,44.4,42.6,46.2,
36004, 읍부,127,중위연령,2018,45.8,44.3,47.5,,46.3,44.9,47.9,
36005, 면부,000,합계,2018,575168,286095,289073,99,557641,274800,282841,97.2
36005, 면부,005,0~4세,2018,15225,7719,7506,102.8,15211,7709,7502,102.8
36005, 면부,005001, 0세,2018,2725,1403,1322,106.1,2722,1402,1320,106.2
36005, 면부,005002, 1세,2018,2967,1556,1411,110.3,2963,1553,1410,110.1
36005, 면부,005003, 2세,2018,3137,1546,1591,97.2,3135,1544,1591,97
36005, 면부,005004, 3세,2018,3262,1638,1624,100.9,3259,1635,1624,100.7
36005, 면부,005005, 4세,2018,3134,1576,1558,101.2,3132,1575,1557,101.2
36005, 면부,010,5~9세,2018,15927,8212,7715,106.4,15910,8207,7703,106.5
36005, 면부,010001, 5세,2018,3269,1675,1594,105.1,3265,1673,1592,105.1
36005, 면부,010002, 6세,2018,3280,1666,1614,103.2,3279,1665,1614,103.2
36005, 면부,010003, 7세,2018,3260,1668,1592,104.8,3255,1668,1587,105.1
36005, 면부,010004, 8세,2018,3057,1599,1458,109.7,3054,1598,1456,109.8
36005, 면부,010005, 9세,2018,3061,1604,1457,110.1,3057,1603,1454,110.2
36005, 면부,015,10~14세,2018,16191,8417,7774,108.3,16169,8405,7764,108.3
36005, 면부,015001, 10세,2018,3163,1653,1510,109.5,3158,1651,1507,109.6
36005, 면부,015002, 11세,2018,3359,1712,1647,103.9,3356,1709,1647,103.8
36005, 면부,015003, 12세,2018,2963,1544,1419,108.8,2961,1543,1418,108.8
36005, 면부,015004, 13세,2018,3131,1640,1491,110,3128,1638,1490,109.9
36005, 면부,015005, 14세,2018,3575,1868,1707,109.4,3566,1864,1702,109.5
36005, 면부,020,15~19세,2018,20635,11375,9260,122.8,20457,11286,9171,123.1
36005, 면부,020001, 15세,2018,3504,1872,1632,114.7,3497,1870,1627,114.9
36005, 면부,020002, 16세,2018,3868,2063,1805,114.3,3861,2059,1802,114.3
36005, 면부,020003, 17세,2018,4488,2439,2049,119,4479,2435,2044,119.1
36005, 면부,020004, 18세,2018,4410,2449,1961,124.9,4375,2430,1945,124.9
36005, 면부,020005, 19세,2018,4365,2552,1813,140.8,4245,2492,1753,142.2
36005, 면부,025,20~24세,2018,25111,15430,9681,159.4,22317,13441,8876,151.4
36005, 면부,025001, 20세,2018,4816,2965,1851,160.2,4593,2828,1765,160.2
36005, 면부,025002, 21세,2018,5174,3171,2003,158.3,4761,2911,1850,157.4
36005, 면부,025003, 22세,2018,4982,3065,1917,159.9,4447,2689,1758,153
36005, 면부,025004, 23세,2018,5140,3164,1976,160.1,4365,2586,1779,145.4
36005, 면부,025005, 24세,2018,4999,3065,1934,158.5,4151,2427,1724,140.8
36005, 면부,030,25~29세,2018,23537,13656,9881,138.2,18855,10298,8557,120.3
36005, 면부,030001, 25세,2018,4960,2900,2060,140.8,3958,2190,1768,123.9
36005, 면부,030002, 26세,2018,5014,2889,2125,136,4021,2158,1863,115.8
36005, 면부,030003, 27세,2018,4639,2731,1908,143.1,3708,2050,1658,123.6
36005, 면부,030004, 28세,2018,4650,2676,1974,135.6,3724,2025,1699,119.2
36005, 면부,030005, 29세,2018,4274,2460,1814,135.6,3444,1875,1569,119.5
36005, 면부,035,30~34세,2018,22173,12373,9800,126.3,18784,10104,8680,116.4
36005, 면부,035001, 30세,2018,4227,2367,1860,127.3,3457,1847,1610,114.7
36005, 면부,035002, 31세,2018,4376,2453,1923,127.6,3633,1954,1679,116.4
36005, 면부,035003, 32세,2018,4434,2471,1963,125.9,3717,1984,1733,114.5
36005, 면부,035004, 33세,2018,4417,2487,1930,128.9,3807,2078,1729,120.2
36005, 면부,035005, 34세,2018,4719,2595,2124,122.2,4170,2241,1929,116.2
36005, 면부,040,35~39세,2018,26553,15075,11478,131.3,24342,13666,10676,128
36005, 면부,040001, 35세,2018,5121,2859,2262,126.4,4598,2508,2090,120
36005, 면부,040002, 36세,2018,5449,3146,2303,136.6,4968,2842,2126,133.7
36005, 면부,040003, 37세,2018,5149,2937,2212,132.8,4718,2660,2058,129.3
36005, 면부,040004, 38세,2018,5570,3134,2436,128.7,5188,2905,2283,127.2
36005, 면부,040005, 39세,2018,5264,2999,2265,132.4,4870,2751,2119,129.8
36005, 면부,045,40~44세,2018,27736,16245,11491,141.4,26418,15446,10972,140.8
36005, 면부,045001, 40세,2018,5050,2938,2112,139.1,4724,2732,1992,137.1
36005, 면부,045002, 41세,2018,5390,3073,2317,132.6,5096,2884,2212,130.4
36005, 면부,045003, 42세,2018,5389,3185,2204,144.5,5128,3041,2087,145.7
36005, 면부,045004, 43세,2018,5515,3239,2276,142.3,5285,3097,2188,141.5
36005, 면부,045005, 44세,2018,6392,3810,2582,147.6,6185,3692,2493,148.1
36005, 면부,050,45~49세,2018,36150,20882,15268,136.8,35179,20386,14793,137.8
36005, 면부,050001, 45세,2018,6663,3889,2774,140.2,6440,3769,2671,141.1
36005, 면부,050002, 46세,2018,6756,3974,2782,142.8,6556,3862,2694,143.4
36005, 면부,050003, 47세,2018,7472,4356,3116,139.8,7278,4260,3018,141.2
36005, 면부,050004, 48세,2018,7441,4272,3169,134.8,7270,4187,3083,135.8
36005, 면부,050005, 49세,2018,7818,4391,3427,128.1,7635,4308,3327,129.5
36005, 면부,055,50~54세,2018,43640,24283,19357,125.4,42832,23938,18894,126.7
36005, 면부,055001, 50세,2018,8567,4852,3715,130.6,8402,4779,3623,131.9
36005, 면부,055002, 51세,2018,8239,4541,3698,122.8,8078,4470,3608,123.9
36005, 면부,055003, 52세,2018,8791,4950,3841,128.9,8638,4876,3762,129.6
36005, 면부,055004, 53세,2018,9100,5026,4074,123.4,8907,4956,3951,125.4
36005, 면부,055005, 54세,2018,8943,4914,4029,122,8807,4857,3950,123
36005, 면부,060,55~59세,2018,54299,28449,25850,110.1,53739,28205,25534,110.5
36005, 면부,060001, 55세,2018,9768,5320,4448,119.6,9607,5253,4354,120.6
36005, 면부,060002, 56세,2018,9799,5257,4542,115.7,9686,5203,4483,116.1
36005, 면부,060003, 57세,2018,11197,5814,5383,108,11091,5765,5326,108.2
36005, 면부,060004, 58세,2018,12155,6219,5936,104.8,12055,6169,5886,104.8
36005, 면부,060005, 59세,2018,11380,5839,5541,105.4,11300,5815,5485,106
36005, 면부,065,60~64세,2018,50165,25509,24656,103.5,49841,25356,24485,103.6
36005, 면부,065001, 60세,2018,10751,5548,5203,106.6,10674,5516,5158,106.9
36005, 면부,065002, 61세,2018,10628,5482,5146,106.5,10549,5451,5098,106.9
36005, 면부,065003, 62세,2018,9550,4891,4659,105,9489,4856,4633,104.8
36005, 면부,065004, 63세,2018,10389,5215,5174,100.8,10321,5180,5141,100.8
36005, 면부,065005, 64세,2018,8847,4373,4474,97.7,8808,4353,4455,97.7
36005, 면부,070,65~69세,2018,44652,21719,22933,94.7,44509,21646,22863,94.7
36005, 면부,070001, 65세,2018,8008,3929,4079,96.3,7973,3914,4059,96.4
36005, 면부,070002, 66세,2018,9615,4660,4955,94,9587,4642,4945,93.9
36005, 면부,070003, 67세,2018,8558,4139,4419,93.7,8532,4127,4405,93.7
36005, 면부,070004, 68세,2018,9181,4418,4763,92.8,9151,4403,4748,92.7
36005, 면부,070005, 69세,2018,9290,4573,4717,96.9,9266,4560,4706,96.9
36005, 면부,075,70~74세,2018,43156,19127,24029,79.6,43100,19102,23998,79.6
36005, 면부,075001, 70세,2018,9330,4410,4920,89.6,9312,4403,4909,89.7
36005, 면부,075002, 71세,2018,9952,4567,5385,84.8,9937,4559,5378,84.8
36005, 면부,075003, 72세,2018,7645,3477,4168,83.4,7632,3470,4162,83.4
36005, 면부,075004, 73세,2018,8198,3382,4816,70.2,8189,3379,4810,70.2
36005, 면부,075005, 74세,2018,8031,3291,4740,69.4,8030,3291,4739,69.4
36005, 면부,080,75~79세,2018,50977,19905,31072,64.1,50952,19894,31058,64.1
36005, 면부,080001, 75세,2018,9217,3703,5514,67.2,9210,3700,5510,67.2
36005, 면부,080002, 76세,2018,12381,4982,7399,67.3,12376,4979,7397,67.3
36005, 면부,080003, 77세,2018,10274,4078,6196,65.8,10266,4075,6191,65.8
36005, 면부,080004, 78세,2018,9653,3603,6050,59.6,9651,3602,6049,59.5
36005, 면부,080005, 79세,2018,9452,3539,5913,59.9,9449,3538,5911,59.9
36005, 면부,085,80~84세,2018,35654,11832,23822,49.7,35645,11826,23819,49.6
36005, 면부,085001, 80세,2018,8617,3055,5562,54.9,8615,3054,5561,54.9
36005, 면부,085002, 81세,2018,7911,2766,5145,53.8,7908,2764,5144,53.7
36005, 면부,085003, 82세,2018,6856,2283,4573,49.9,6854,2281,4573,49.9
36005, 면부,085004, 83세,2018,6595,2026,4569,44.3,6594,2026,4568,44.4
36005, 면부,085005, 84세,2018,5675,1702,3973,42.8,5674,1701,3973,42.8
36005, 면부,090,85~89세,2018,17206,4571,12635,36.2,17202,4569,12633,36.2
36005, 면부,090001, 85세,2018,4772,1357,3415,39.7,4771,1356,3415,39.7
36005, 면부,090002, 86세,2018,3939,1110,2829,39.2,3939,1110,2829,39.2
36005, 면부,090003, 87세,2018,3113,792,2321,34.1,3111,792,2319,34.2
36005, 면부,090004, 88세,2018,3180,739,2441,30.3,3180,739,2441,30.3
36005, 면부,090005, 89세,2018,2202,573,1629,35.2,2201,572,1629,35.1
36005, 면부,095,90~94세,2018,4753,1090,3663,29.8,4751,1090,3661,29.8
36005, 면부,095001, 90세,2018,1663,398,1265,31.5,1662,398,1264,31.5
36005, 면부,095002, 91세,2018,1174,264,910,29,1174,264,910,29
36005, 면부,095003, 92세,2018,863,194,669,29,863,194,669,29
36005, 면부,095004, 93세,2018,599,128,471,27.2,598,128,470,27.2
36005, 면부,095005, 94세,2018,454,106,348,30.5,454,106,348,30.5
36005, 면부,100,95~99세,2018,1280,210,1070,19.6,1280,210,1070,19.6
36005, 면부,100001, 95세,2018,529,87,442,19.7,529,87,442,19.7
36005, 면부,100002, 96세,2018,334,62,272,22.8,334,62,272,22.8
36005, 면부,100003, 97세,2018,190,28,162,17.3,190,28,162,17.3
36005, 면부,100004, 98세,2018,136,19,117,16.2,136,19,117,16.2
36005, 면부,100005, 99세,2018,91,14,77,18.2,91,14,77,18.2
36005, 면부,101,100세이상,2018,148,16,132,12.1,148,16,132,12.1
36005, 면부,102,15세미만,2018,47343,24348,22995,105.9,47290,24321,22969,105.9
36005, 면부,103,15~64세,2018,329999,183277,146722,124.9,312764,172126,140638,122.4
36005, 면부,104,65세이상,2018,197826,78470,119356,65.7,197587,78353,119234,65.7
36005, 면부,086,85세이상,2018,23387,5887,17500,33.6,23381,5885,17496,33.6
36005, 면부,126,평균연령,2018,52.5,49.5,55.5,,53.1,50.1,55.9,
36005, 면부,127,중위연령,2018,56.5,52.9,59.9,,57.3,53.9,60.4,
36003, 동부,000,합계,2018,783525,396859,386666,102.6,771243,390167,381076,102.4
36003, 동부,005,0~4세,2018,32883,16980,15903,106.8,32793,16943,15850,106.9
36003, 동부,005001, 0세,2018,5503,2820,2683,105.1,5483,2811,2672,105.2
36003, 동부,005002, 1세,2018,5885,3081,2804,109.9,5861,3071,2790,110.1
36003, 동부,005003, 2세,2018,6914,3544,3370,105.2,6898,3538,3360,105.3
36003, 동부,005004, 3세,2018,7307,3819,3488,109.5,7296,3816,3480,109.7
36003, 동부,005005, 4세,2018,7274,3716,3558,104.4,7255,3707,3548,104.5
36003, 동부,010,5~9세,2018,40670,20676,19994,103.4,40623,20655,19968,103.4
36003, 동부,010001, 5세,2018,7670,3920,3750,104.5,7660,3917,3743,104.6
36003, 동부,010002, 6세,2018,8558,4283,4275,100.2,8545,4275,4270,100.1
36003, 동부,010003, 7세,2018,8637,4317,4320,99.9,8629,4313,4316,99.9
36003, 동부,010004, 8세,2018,8061,4223,3838,110,8053,4219,3834,110
36003, 동부,010005, 9세,2018,7744,3933,3811,103.2,7736,3931,3805,103.3
36003, 동부,015,10~14세,2018,40008,20597,19411,106.1,39969,20578,19391,106.1
36003, 동부,015001, 10세,2018,8105,4162,3943,105.6,8097,4157,3940,105.5
36003, 동부,015002, 11세,2018,8267,4278,3989,107.2,8257,4273,3984,107.3
36003, 동부,015003, 12세,2018,7774,3968,3806,104.3,7769,3967,3802,104.3
36003, 동부,015004, 13세,2018,7469,3817,3652,104.5,7462,3813,3649,104.5
36003, 동부,015005, 14세,2018,8393,4372,4021,108.7,8384,4368,4016,108.8
36003, 동부,020,15~19세,2018,48731,26107,22624,115.4,48210,25807,22403,115.2
36003, 동부,020001, 15세,2018,8639,4453,4186,106.4,8632,4453,4179,106.6
36003, 동부,020002, 16세,2018,9036,4693,4343,108.1,9027,4689,4338,108.1
36003, 동부,020003, 17세,2018,10460,5504,4956,111.1,10423,5483,4940,111
36003, 동부,020004, 18세,2018,11296,6015,5281,113.9,11128,5913,5215,113.4
36003, 동부,020005, 19세,2018,9300,5442,3858,141.1,9000,5269,3731,141.2
36003, 동부,025,20~24세,2018,51626,29710,21916,135.6,49896,28795,21101,136.5
36003, 동부,025001, 20세,2018,10212,6086,4126,147.5,9897,5903,3994,147.8
36003, 동부,025002, 21세,2018,10744,6360,4384,145.1,10440,6211,4229,146.9
36003, 동부,025003, 22세,2018,10581,6108,4473,136.6,10262,5925,4337,136.6
36003, 동부,025004, 23세,2018,10168,5724,4444,128.8,9786,5539,4247,130.4
36003, 동부,025005, 24세,2018,9921,5432,4489,121,9511,5217,4294,121.5
36003, 동부,030,25~29세,2018,45212,24302,20910,116.2,42893,23023,19870,115.9
36003, 동부,030001, 25세,2018,9666,5203,4463,116.6,9236,4970,4266,116.5
36003, 동부,030002, 26세,2018,9680,5101,4579,111.4,9185,4824,4361,110.6
36003, 동부,030003, 27세,2018,8847,4820,4027,119.7,8388,4580,3808,120.3
36003, 동부,030004, 28세,2018,8742,4704,4038,116.5,8250,4419,3831,115.3
36003, 동부,030005, 29세,2018,8277,4474,3803,117.6,7834,4230,3604,117.4
36003, 동부,035,30~34세,2018,44164,23032,21132,109,42236,21929,20307,108
36003, 동부,035001, 30세,2018,8043,4251,3792,112.1,7597,3996,3601,111
36003, 동부,035002, 31세,2018,8254,4279,3975,107.6,7873,4074,3799,107.2
36003, 동부,035003, 32세,2018,8758,4567,4191,109,8363,4352,4011,108.5
36003, 동부,035004, 33세,2018,9092,4738,4354,108.8,8738,4536,4202,107.9
36003, 동부,035005, 34세,2018,10017,5197,4820,107.8,9665,4971,4694,105.9
36003, 동부,040,35~39세,2018,60190,31056,29134,106.6,58668,30107,28561,105.4
36003, 동부,040001, 35세,2018,11169,5769,5400,106.8,10837,5565,5272,105.6
36003, 동부,040002, 36세,2018,12218,6334,5884,107.6,11899,6141,5758,106.7
36003, 동부,040003, 37세,2018,11971,6279,5692,110.3,11649,6071,5578,108.8
36003, 동부,040004, 38세,2018,12597,6445,6152,104.8,12322,6275,6047,103.8
36003, 동부,040005, 39세,2018,12235,6229,6006,103.7,11961,6055,5906,102.5
36003, 동부,045,40~44세,2018,59578,30081,29497,102,58418,29407,29011,101.4
36003, 동부,045001, 40세,2018,11192,5697,5495,103.7,10939,5549,5390,102.9
36003, 동부,045002, 41세,2018,11669,5839,5830,100.2,11450,5706,5744,99.3
36003, 동부,045003, 42세,2018,11539,5911,5628,105,11289,5770,5519,104.5
36003, 동부,045004, 43세,2018,12052,6067,5985,101.4,11822,5937,5885,100.9
36003, 동부,045005, 44세,2018,13126,6567,6559,100.1,12918,6445,6473,99.6
36003, 동부,050,45~49세,2018,70997,35919,35078,102.4,69948,35333,34615,102.1
36003, 동부,050001, 45세,2018,13717,6851,6866,99.8,13502,6722,6780,99.1
36003, 동부,050002, 46세,2018,13905,7118,6787,104.9,13674,6993,6681,104.7
36003, 동부,050003, 47세,2018,14774,7458,7316,101.9,14567,7340,7227,101.6
36003, 동부,050004, 48세,2018,14280,7204,7076,101.8,14064,7080,6984,101.4
36003, 동부,050005, 49세,2018,14321,7288,7033,103.6,14141,7198,6943,103.7
36003, 동부,055,50~54세,2018,68138,35046,33092,105.9,67395,34734,32661,106.3
36003, 동부,055001, 50세,2018,14859,7545,7314,103.2,14696,7470,7226,103.4
36003, 동부,055002, 51세,2018,13651,7005,6646,105.4,13486,6933,6553,105.8
36003, 동부,055003, 52세,2018,13664,7268,6396,113.6,13527,7214,6313,114.3
36003, 동부,055004, 53세,2018,13599,7018,6581,106.6,13453,6950,6503,106.9
36003, 동부,055005, 54세,2018,12365,6210,6155,100.9,12233,6167,6066,101.7
36003, 동부,060,55~59세,2018,65787,32866,32921,99.8,65242,32630,32612,100.1
36003, 동부,060001, 55세,2018,13373,6883,6490,106.1,13225,6825,6400,106.6
36003, 동부,060002, 56세,2018,12590,6487,6103,106.3,12477,6426,6051,106.2
36003, 동부,060003, 57세,2018,13534,6668,6866,97.1,13437,6629,6808,97.4
36003, 동부,060004, 58세,2018,13975,6817,7158,95.2,13865,6773,7092,95.5
36003, 동부,060005, 59세,2018,12315,6011,6304,95.4,12238,5977,6261,95.5
36003, 동부,065,60~64세,2018,49938,25054,24884,100.7,49608,24902,24706,100.8
36003, 동부,065001, 60세,2018,11197,5672,5525,102.7,11107,5632,5475,102.9
36003, 동부,065002, 61세,2018,10990,5541,5449,101.7,10921,5514,5407,102
36003, 동부,065003, 62세,2018,9428,4659,4769,97.7,9362,4627,4735,97.7
36003, 동부,065004, 63세,2018,10021,5018,5003,100.3,9955,4982,4973,100.2
36003, 동부,065005, 64세,2018,8302,4164,4138,100.6,8263,4147,4116,100.8
36003, 동부,070,65~69세,2018,35327,17447,17880,97.6,35176,17373,17803,97.6
36003, 동부,070001, 65세,2018,6901,3419,3482,98.2,6855,3391,3464,97.9
36003, 동부,070002, 66세,2018,8091,3962,4129,96,8061,3955,4106,96.3
36003, 동부,070003, 67세,2018,6915,3500,3415,102.5,6882,3487,3395,102.7
36003, 동부,070004, 68세,2018,6779,3377,3402,99.3,6755,3363,3392,99.1
36003, 동부,070005, 69세,2018,6641,3189,3452,92.4,6623,3177,3446,92.2
36003, 동부,075,70~74세,2018,26518,12403,14115,87.9,26465,12383,14082,87.9
36003, 동부,075001, 70세,2018,6234,2992,3242,92.3,6220,2985,3235,92.3
36003, 동부,075002, 71세,2018,6536,3060,3476,88,6523,3054,3469,88
36003, 동부,075003, 72세,2018,4861,2280,2581,88.3,4854,2280,2574,88.6
36003, 동부,075004, 73세,2018,4655,2160,2495,86.6,4644,2157,2487,86.7
36003, 동부,075005, 74세,2018,4232,1911,2321,82.3,4224,1907,2317,82.3
36003, 동부,080,75~79세,2018,21839,9061,12778,70.9,21804,9050,12754,71
36003, 동부,080001, 75세,2018,4659,2047,2612,78.4,4651,2044,2607,78.4
36003, 동부,080002, 76세,2018,5522,2347,3175,73.9,5518,2347,3171,74
36003, 동부,080003, 77세,2018,4190,1708,2482,68.8,4181,1706,2475,68.9
36003, 동부,080004, 78세,2018,3947,1592,2355,67.6,3941,1591,2350,67.7
36003, 동부,080005, 79세,2018,3521,1367,2154,63.5,3513,1362,2151,63.3
36003, 동부,085,80~84세,2018,12910,4436,8474,52.3,12898,4433,8465,52.4
36003, 동부,085001, 80세,2018,3315,1216,2099,57.9,3313,1216,2097,58
36003, 동부,085002, 81세,2018,2900,1064,1836,58,2897,1063,1834,58
36003, 동부,085003, 82세,2018,2412,811,1601,50.7,2408,810,1598,50.7
36003, 동부,085004, 83세,2018,2237,739,1498,49.3,2234,738,1496,49.3
36003, 동부,085005, 84세,2018,2046,606,1440,42.1,2046,606,1440,42.1
36003, 동부,090,85~89세,2018,6522,1633,4889,33.4,6514,1632,4882,33.4
36003, 동부,090001, 85세,2018,1709,492,1217,40.4,1707,491,1216,40.4
36003, 동부,090002, 86세,2018,1506,388,1118,34.7,1504,388,1116,34.8
36003, 동부,090003, 87세,2018,1234,307,927,33.1,1234,307,927,33.1
36003, 동부,090004, 88세,2018,1242,253,989,25.6,1241,253,988,25.6
36003, 동부,090005, 89세,2018,831,193,638,30.3,828,193,635,30.4
36003, 동부,095,90~94세,2018,1906,374,1532,24.4,1906,374,1532,24.4
36003, 동부,095001, 90세,2018,615,127,488,26,615,127,488,26
36003, 동부,095002, 91세,2018,520,106,414,25.6,520,106,414,25.6
36003, 동부,095003, 92세,2018,326,61,265,23,326,61,265,23
36003, 동부,095004, 93세,2018,268,48,220,21.8,268,48,220,21.8
36003, 동부,095005, 94세,2018,177,32,145,22.1,177,32,145,22.1
36003, 동부,100,95~99세,2018,540,76,464,16.4,540,76,464,16.4
36003, 동부,100001, 95세,2018,245,30,215,14,245,30,215,14
36003, 동부,100002, 96세,2018,133,26,107,24.3,133,26,107,24.3
36003, 동부,100003, 97세,2018,82,8,74,10.8,82,8,74,10.8
36003, 동부,100004, 98세,2018,61,8,53,15.1,61,8,53,15.1
36003, 동부,100005, 99세,2018,19,X,15,26.7,19,X,15,26.7
36003, 동부,101,100세이상,2018,41,X,38,7.9,41,X,38,7.9
36003, 동부,102,15세미만,2018,113561,58253,55308,105.3,113385,58176,55209,105.4
36003, 동부,103,15~64세,2018,564361,293173,271188,108.1,552514,286667,265847,107.8
36003, 동부,104,65세이상,2018,105603,45433,60170,75.5,105344,45324,60020,75.5
36003, 동부,086,85세이상,2018,9009,2086,6923,30.1,9001,2085,6916,30.1
36003, 동부,126,평균연령,2018,40.9,39.7,42.2,,41,39.8,42.3,
36003, 동부,127,중위연령,2018,42.5,41,43.9,,42.7,41.3,44.1,
36010, 목포시,000,합계,2018,231798,116258,115540,100.6,227791,114006,113785,100.2
36010, 목포시,005,0~4세,2018,8917,4656,4261,109.3,8887,4643,4244,109.4
36010, 목포시,005001, 0세,2018,1359,718,641,112,1356,717,639,112.2
36010, 목포시,005002, 1세,2018,1463,748,715,104.6,1456,744,712,104.5
36010, 목포시,005003, 2세,2018,1954,1021,933,109.4,1948,1020,928,109.9
36010, 목포시,005004, 3세,2018,2018,1070,948,112.9,2015,1069,946,113
36010, 목포시,005005, 4세,2018,2123,1099,1024,107.3,2112,1093,1019,107.3
36010, 목포시,010,5~9세,2018,12475,6325,6150,102.8,12451,6314,6137,102.9
36010, 목포시,010001, 5세,2018,2299,1166,1133,102.9,2293,1164,1129,103.1
36010, 목포시,010002, 6세,2018,2640,1332,1308,101.8,2633,1327,1306,101.6
36010, 목포시,010003, 7세,2018,2598,1285,1313,97.9,2593,1282,1311,97.8
36010, 목포시,010004, 8세,2018,2540,1325,1215,109.1,2538,1325,1213,109.2
36010, 목포시,010005, 9세,2018,2398,1217,1181,103,2394,1216,1178,103.2
36010, 목포시,015,10~14세,2018,11924,6093,5831,104.5,11910,6088,5822,104.6
36010, 목포시,015001, 10세,2018,2435,1255,1180,106.4,2431,1253,1178,106.4
36010, 목포시,015002, 11세,2018,2510,1306,1204,108.5,2505,1304,1201,108.6
36010, 목포시,015003, 12세,2018,2301,1152,1149,100.3,2300,1152,1148,100.3
36010, 목포시,015004, 13세,2018,2229,1134,1095,103.6,2229,1134,1095,103.6
36010, 목포시,015005, 14세,2018,2449,1246,1203,103.6,2445,1245,1200,103.8
36010, 목포시,020,15~19세,2018,13921,7480,6441,116.1,13760,7379,6381,115.6
36010, 목포시,020001, 15세,2018,2529,1307,1222,107,2527,1307,1220,107.1
36010, 목포시,020002, 16세,2018,2541,1318,1223,107.8,2537,1317,1220,108
36010, 목포시,020003, 17세,2018,2895,1501,1394,107.7,2887,1495,1392,107.4
36010, 목포시,020004, 18세,2018,3164,1683,1481,113.6,3091,1638,1453,112.7
36010, 목포시,020005, 19세,2018,2792,1671,1121,149.1,2718,1622,1096,148
36010, 목포시,025,20~24세,2018,15374,8790,6584,133.5,14894,8533,6361,134.1
36010, 목포시,025001, 20세,2018,3188,1945,1243,156.5,3098,1888,1210,156
36010, 목포시,025002, 21세,2018,3294,1936,1358,142.6,3206,1891,1315,143.8
36010, 목포시,025003, 22세,2018,3227,1888,1339,141,3150,1844,1306,141.2
36010, 목포시,025004, 23세,2018,2902,1570,1332,117.9,2802,1525,1277,119.4
36010, 목포시,025005, 24세,2018,2763,1451,1312,110.6,2638,1385,1253,110.5
36010, 목포시,030,25~29세,2018,11941,6223,5718,108.8,11195,5788,5407,107
36010, 목포시,030001, 25세,2018,2561,1339,1222,109.6,2424,1252,1172,106.8
36010, 목포시,030002, 26세,2018,2600,1331,1269,104.9,2436,1235,1201,102.8
36010, 목포시,030003, 27세,2018,2342,1252,1090,114.9,2193,1165,1028,113.3
36010, 목포시,030004, 28세,2018,2298,1193,1105,108,2137,1107,1030,107.5
36010, 목포시,030005, 29세,2018,2140,1108,1032,107.4,2005,1029,976,105.4
36010, 목포시,035,30~34세,2018,12429,6359,6070,104.8,11784,5964,5820,102.5
36010, 목포시,035001, 30세,2018,2110,1069,1041,102.7,1971,983,988,99.5
36010, 목포시,035002, 31세,2018,2285,1147,1138,100.8,2152,1068,1084,98.5
36010, 목포시,035003, 32세,2018,2392,1233,1159,106.4,2275,1164,1111,104.8
36010, 목포시,035004, 33세,2018,2667,1363,1304,104.5,2532,1285,1247,103
36010, 목포시,035005, 34세,2018,2975,1547,1428,108.3,2854,1464,1390,105.3
36010, 목포시,040,35~39세,2018,18353,9604,8749,109.8,17850,9277,8573,108.2
36010, 목포시,040001, 35세,2018,3350,1706,1644,103.8,3240,1640,1600,102.5
36010, 목포시,040002, 36세,2018,3700,1975,1725,114.5,3590,1899,1691,112.3
36010, 목포시,040003, 37세,2018,3606,1930,1676,115.2,3504,1862,1642,113.4
36010, 목포시,040004, 38세,2018,3888,2000,1888,105.9,3803,1950,1853,105.2
36010, 목포시,040005, 39세,2018,3809,1993,1816,109.7,3713,1926,1787,107.8
36010, 목포시,045,40~44세,2018,18283,9435,8848,106.6,17894,9210,8684,106.1
36010, 목포시,045001, 40세,2018,3485,1824,1661,109.8,3397,1772,1625,109
36010, 목포시,045002, 41세,2018,3563,1785,1778,100.4,3496,1743,1753,99.4
36010, 목포시,045003, 42세,2018,3546,1872,1674,111.8,3453,1815,1638,110.8
36010, 목포시,045004, 43세,2018,3739,1944,1795,108.3,3659,1898,1761,107.8
36010, 목포시,045005, 44세,2018,3950,2010,1940,103.6,3889,1982,1907,103.9
36010, 목포시,050,45~49세,2018,20525,10585,9940,106.5,20159,10375,9784,106
36010, 목포시,050001, 45세,2018,4105,2077,2028,102.4,4033,2029,2004,101.2
36010, 목포시,050002, 46세,2018,4135,2158,1977,109.2,4066,2117,1949,108.6
36010, 목포시,050003, 47세,2018,4269,2230,2039,109.4,4192,2185,2007,108.9
36010, 목포시,050004, 48세,2018,4064,2081,1983,104.9,3979,2033,1946,104.5
36010, 목포시,050005, 49세,2018,3952,2039,1913,106.6,3889,2011,1878,107.1
36010, 목포시,055,50~54세,2018,18378,9368,9010,104,18133,9268,8865,104.5
36010, 목포시,055001, 50세,2018,3821,1985,1836,108.1,3773,1962,1811,108.3
36010, 목포시,055002, 51세,2018,3615,1840,1775,103.7,3560,1814,1746,103.9
36010, 목포시,055003, 52세,2018,3728,1956,1772,110.4,3677,1939,1738,111.6
36010, 목포시,055004, 53세,2018,3780,1924,1856,103.7,3733,1904,1829,104.1
36010, 목포시,055005, 54세,2018,3434,1663,1771,93.9,3390,1649,1741,94.7
36010, 목포시,060,55~59세,2018,18877,9110,9767,93.3,18684,9024,9660,93.4
36010, 목포시,060001, 55세,2018,3656,1782,1874,95.1,3601,1761,1840,95.7
36010, 목포시,060002, 56세,2018,3541,1753,1788,98,3500,1731,1769,97.9
36010, 목포시,060003, 57세,2018,3951,1888,2063,91.5,3921,1872,2049,91.4
36010, 목포시,060004, 58세,2018,4027,1896,2131,89,3985,1883,2102,89.6
36010, 목포시,060005, 59세,2018,3702,1791,1911,93.7,3677,1777,1900,93.5
36010, 목포시,065,60~64세,2018,15080,7427,7653,97,14969,7378,7591,97.2
36010, 목포시,065001, 60세,2018,3406,1717,1689,101.7,3381,1708,1673,102.1
36010, 목포시,065002, 61세,2018,3342,1683,1659,101.4,3318,1677,1641,102.2
36010, 목포시,065003, 62세,2018,2935,1414,1521,93,2909,1400,1509,92.8
36010, 목포시,065004, 63세,2018,3056,1438,1618,88.9,3027,1421,1606,88.5
36010, 목포시,065005, 64세,2018,2341,1175,1166,100.8,2334,1172,1162,100.9
36010, 목포시,070,65~69세,2018,11267,5303,5964,88.9,11214,5280,5934,89
36010, 목포시,070001, 65세,2018,2197,1075,1122,95.8,2184,1066,1118,95.3
36010, 목포시,070002, 66세,2018,2548,1188,1360,87.4,2533,1183,1350,87.6
36010, 목포시,070003, 67세,2018,2259,1059,1200,88.3,2249,1055,1194,88.4
36010, 목포시,070004, 68세,2018,2102,1008,1094,92.1,2092,1005,1087,92.5
36010, 목포시,070005, 69세,2018,2161,973,1188,81.9,2156,971,1185,81.9
36010, 목포시,075,70~74세,2018,9200,4232,4968,85.2,9177,4224,4953,85.3
36010, 목포시,075001, 70세,2018,1982,939,1043,90,1974,935,1039,90
36010, 목포시,075002, 71세,2018,2152,996,1156,86.2,2146,993,1153,86.1
36010, 목포시,075003, 72세,2018,1828,834,994,83.9,1825,834,991,84.2
36010, 목포시,075004, 73세,2018,1744,809,935,86.5,1741,808,933,86.6
36010, 목포시,075005, 74세,2018,1494,654,840,77.9,1491,654,837,78.1
36010, 목포시,080,75~79세,2018,7520,3131,4389,71.3,7502,3124,4378,71.4
36010, 목포시,080001, 75세,2018,1494,664,830,80,1491,662,829,79.9
36010, 목포시,080002, 76세,2018,1977,847,1130,75,1977,847,1130,75
36010, 목포시,080003, 77세,2018,1488,607,881,68.9,1482,606,876,69.2
36010, 목포시,080004, 78세,2018,1391,552,839,65.8,1388,552,836,66
36010, 목포시,080005, 79세,2018,1170,461,709,65,1164,457,707,64.6
36010, 목포시,085,80~84세,2018,4383,1450,2933,49.4,4380,1450,2930,49.5
36010, 목포시,085001, 80세,2018,1208,418,790,52.9,1207,418,789,53
36010, 목포시,085002, 81세,2018,1002,359,643,55.8,1002,359,643,55.8
36010, 목포시,085003, 82세,2018,766,253,513,49.3,765,253,512,49.4
36010, 목포시,085004, 83세,2018,735,218,517,42.2,734,218,516,42.2
36010, 목포시,085005, 84세,2018,672,202,470,43,672,202,470,43
36010, 목포시,090,85~89세,2018,2106,517,1589,32.5,2103,517,1586,32.6
36010, 목포시,090001, 85세,2018,552,155,397,39,552,155,397,39
36010, 목포시,090002, 86세,2018,496,133,363,36.6,495,133,362,36.7
36010, 목포시,090003, 87세,2018,376,93,283,32.9,376,93,283,32.9
36010, 목포시,090004, 88세,2018,418,80,338,23.7,418,80,338,23.7
36010, 목포시,090005, 89세,2018,264,56,208,26.9,262,56,206,27.2
36010, 목포시,095,90~94세,2018,630,139,491,28.3,630,139,491,28.3
36010, 목포시,095001, 90세,2018,196,46,150,30.7,196,46,150,30.7
36010, 목포시,095002, 91세,2018,170,39,131,29.8,170,39,131,29.8
36010, 목포시,095003, 92세,2018,109,24,85,28.2,109,24,85,28.2
36010, 목포시,095004, 93세,2018,96,23,73,31.5,96,23,73,31.5
36010, 목포시,095005, 94세,2018,59,7,52,13.5,59,7,52,13.5
36010, 목포시,100,95~99세,2018,203,30,173,17.3,203,30,173,17.3
36010, 목포시,100001, 95세,2018,97,9,88,10.2,97,9,88,10.2
36010, 목포시,100002, 96세,2018,48,9,39,23.1,48,9,39,23.1
36010, 목포시,100003, 97세,2018,28,X,24,16.7,28,X,24,16.7
36010, 목포시,100004, 98세,2018,22,5,17,29.4,22,5,17,29.4
36010, 목포시,100005, 99세,2018,8,X,5,60,8,X,5,60
36010, 목포시,101,100세이상,2018,12,X,11,9.1,12,X,11,9.1
36010, 목포시,102,15세미만,2018,33316,17074,16242,105.1,33248,17045,16203,105.2
36010, 목포시,103,15~64세,2018,163161,84381,78780,107.1,159322,82196,77126,106.6
36010, 목포시,104,65세이상,2018,35321,14803,20518,72.1,35221,14765,20456,72.2
36010, 목포시,086,85세이상,2018,2951,687,2264,30.3,2948,687,2261,30.4
36010, 목포시,126,평균연령,2018,41.6,40.2,43.1,,41.7,40.3,43.2,
36010, 목포시,127,중위연령,2018,43,41.4,44.5,,43.2,41.7,44.7,
36020, 여수시,000,합계,2018,270947,139229,131718,105.7,265136,135138,129998,104
36020, 여수시,005,0~4세,2018,10565,5394,5171,104.3,10555,5389,5166,104.3
36020, 여수시,005001, 0세,2018,1744,862,882,97.7,1739,860,879,97.8
36020, 여수시,005002, 1세,2018,1962,1024,938,109.2,1961,1023,938,109.1
36020, 여수시,005003, 2세,2018,2256,1143,1113,102.7,2255,1142,1113,102.6
36020, 여수시,005004, 3세,2018,2339,1181,1158,102,2338,1180,1158,101.9
36020, 여수시,005005, 4세,2018,2264,1184,1080,109.6,2262,1184,1078,109.8
36020, 여수시,010,5~9세,2018,12126,6166,5960,103.5,12121,6165,5956,103.5
36020, 여수시,010001, 5세,2018,2373,1242,1131,109.8,2372,1242,1130,109.9
36020, 여수시,010002, 6세,2018,2529,1207,1322,91.3,2528,1206,1322,91.2
36020, 여수시,010003, 7세,2018,2663,1349,1314,102.7,2662,1349,1313,102.7
36020, 여수시,010004, 8세,2018,2302,1203,1099,109.5,2301,1203,1098,109.6
36020, 여수시,010005, 9세,2018,2259,1165,1094,106.5,2258,1165,1093,106.6
36020, 여수시,015,10~14세,2018,12280,6303,5977,105.5,12272,6298,5974,105.4
36020, 여수시,015001, 10세,2018,2433,1231,1202,102.4,2433,1231,1202,102.4
36020, 여수시,015002, 11세,2018,2531,1263,1268,99.6,2530,1263,1267,99.7
36020, 여수시,015003, 12세,2018,2312,1194,1118,106.8,2311,1194,1117,106.9
36020, 여수시,015004, 13세,2018,2328,1192,1136,104.9,2326,1191,1135,104.9
36020, 여수시,015005, 14세,2018,2676,1423,1253,113.6,2672,1419,1253,113.2
36020, 여수시,020,15~19세,2018,14510,8072,6438,125.4,14369,7970,6399,124.6
36020, 여수시,020001, 15세,2018,2615,1351,1264,106.9,2612,1350,1262,107
36020, 여수시,020002, 16세,2018,2758,1426,1332,107.1,2755,1425,1330,107.1
36020, 여수시,020003, 17세,2018,3219,1770,1449,122.2,3208,1767,1441,122.6
36020, 여수시,020004, 18세,2018,3297,1832,1465,125.1,3255,1802,1453,124
36020, 여수시,020005, 19세,2018,2621,1693,928,182.4,2539,1626,913,178.1
36020, 여수시,025,20~24세,2018,15096,9304,5792,160.6,14502,8886,5616,158.2
36020, 여수시,025001, 20세,2018,2785,1826,959,190.4,2712,1770,942,187.9
36020, 여수시,025002, 21세,2018,3014,1945,1069,181.9,2926,1891,1035,182.7
36020, 여수시,025003, 22세,2018,3112,1898,1214,156.3,3010,1822,1188,153.4
36020, 여수시,025004, 23세,2018,3096,1847,1249,147.9,2935,1736,1199,144.8
36020, 여수시,025005, 24세,2018,3089,1788,1301,137.4,2919,1667,1252,133.1
36020, 여수시,030,25~29세,2018,15164,8570,6594,130,13935,7652,6283,121.8
36020, 여수시,030001, 25세,2018,3190,1804,1386,130.2,2967,1641,1326,123.8
36020, 여수시,030002, 26세,2018,3292,1833,1459,125.6,3045,1648,1397,118
36020, 여수시,030003, 27세,2018,2913,1646,1267,129.9,2668,1462,1206,121.2
36020, 여수시,030004, 28세,2018,2973,1675,1298,129,2702,1472,1230,119.7
36020, 여수시,030005, 29세,2018,2796,1612,1184,136.1,2553,1429,1124,127.1
36020, 여수시,035,30~34세,2018,14740,8251,6489,127.2,13602,7399,6203,119.3
36020, 여수시,035001, 30세,2018,2767,1583,1184,133.7,2507,1390,1117,124.4
36020, 여수시,035002, 31세,2018,2793,1569,1224,128.2,2574,1409,1165,120.9
36020, 여수시,035003, 32세,2018,2992,1674,1318,127,2740,1488,1252,118.8
36020, 여수시,035004, 33세,2018,2971,1658,1313,126.3,2756,1491,1265,117.9
36020, 여수시,035005, 34세,2018,3217,1767,1450,121.9,3025,1621,1404,115.5
36020, 여수시,040,35~39세,2018,19443,10360,9083,114.1,18551,9690,8861,109.4
36020, 여수시,040001, 35세,2018,3680,1952,1728,113,3476,1803,1673,107.8
36020, 여수시,040002, 36세,2018,3989,2143,1846,116.1,3793,2005,1788,112.1
36020, 여수시,040003, 37세,2018,3885,2119,1766,120,3704,1977,1727,114.5
36020, 여수시,040004, 38세,2018,3953,2084,1869,111.5,3802,1960,1842,106.4
36020, 여수시,040005, 39세,2018,3936,2062,1874,110,3776,1945,1831,106.2
36020, 여수시,045,40~44세,2018,19244,10138,9106,111.3,18601,9649,8952,107.8
36020, 여수시,045001, 40세,2018,3639,1898,1741,109,3507,1797,1710,105.1
36020, 여수시,045002, 41세,2018,3710,1969,1741,113.1,3588,1872,1716,109.1
36020, 여수시,045003, 42세,2018,3751,2021,1730,116.8,3634,1940,1694,114.5
36020, 여수시,045004, 43세,2018,3815,2002,1813,110.4,3679,1900,1779,106.8
36020, 여수시,045005, 44세,2018,4329,2248,2081,108,4193,2140,2053,104.2
36020, 여수시,050,45~49세,2018,23106,12249,10857,112.8,22614,11925,10689,111.6
36020, 여수시,050001, 45세,2018,4485,2362,2123,111.3,4385,2294,2091,109.7
36020, 여수시,050002, 46세,2018,4505,2395,2110,113.5,4389,2312,2077,111.3
36020, 여수시,050003, 47세,2018,4893,2582,2311,111.7,4794,2516,2278,110.4
36020, 여수시,050004, 48세,2018,4608,2437,2171,112.3,4512,2374,2138,111
36020, 여수시,050005, 49세,2018,4615,2473,2142,115.5,4534,2429,2105,115.4
36020, 여수시,055,50~54세,2018,22696,11712,10984,106.6,22400,11563,10837,106.7
36020, 여수시,055001, 50세,2018,4849,2487,2362,105.3,4773,2445,2328,105
36020, 여수시,055002, 51세,2018,4471,2246,2225,100.9,4411,2212,2199,100.6
36020, 여수시,055003, 52세,2018,4564,2406,2158,111.5,4523,2384,2139,111.5
36020, 여수시,055004, 53세,2018,4522,2357,2165,108.9,4458,2328,2130,109.3
36020, 여수시,055005, 54세,2018,4290,2216,2074,106.8,4235,2194,2041,107.5
36020, 여수시,060,55~59세,2018,24306,12155,12151,100,24130,12081,12049,100.3
36020, 여수시,060001, 55세,2018,4900,2529,2371,106.7,4849,2505,2344,106.9
36020, 여수시,060002, 56세,2018,4558,2377,2181,109,4520,2360,2160,109.3
36020, 여수시,060003, 57세,2018,4934,2393,2541,94.2,4898,2379,2519,94.4
36020, 여수시,060004, 58세,2018,5230,2559,2671,95.8,5200,2545,2655,95.9
36020, 여수시,060005, 59세,2018,4684,2297,2387,96.2,4663,2292,2371,96.7
36020, 여수시,065,60~64세,2018,20005,9976,10029,99.5,19893,9925,9968,99.6
36020, 여수시,065001, 60세,2018,4286,2141,2145,99.8,4257,2127,2130,99.9
36020, 여수시,065002, 61세,2018,4291,2143,2148,99.8,4265,2129,2136,99.7
36020, 여수시,065003, 62세,2018,3707,1842,1865,98.8,3689,1839,1850,99.4
36020, 여수시,065004, 63세,2018,4164,2076,2088,99.4,4144,2065,2079,99.3
36020, 여수시,065005, 64세,2018,3557,1774,1783,99.5,3538,1765,1773,99.5
36020, 여수시,070,65~69세,2018,15372,7670,7702,99.6,15329,7649,7680,99.6
36020, 여수시,070001, 65세,2018,2803,1358,1445,94,2789,1351,1438,93.9
36020, 여수시,070002, 66세,2018,3540,1741,1799,96.8,3534,1740,1794,97
36020, 여수시,070003, 67세,2018,3075,1593,1482,107.5,3065,1590,1475,107.8
36020, 여수시,070004, 68세,2018,3054,1523,1531,99.5,3047,1518,1529,99.3
36020, 여수시,070005, 69세,2018,2900,1455,1445,100.7,2894,1450,1444,100.4
36020, 여수시,075,70~74세,2018,11824,5554,6270,88.6,11807,5548,6259,88.6
36020, 여수시,075001, 70세,2018,2819,1350,1469,91.9,2815,1349,1466,92
36020, 여수시,075002, 71세,2018,2989,1392,1597,87.2,2984,1389,1595,87.1
36020, 여수시,075003, 72세,2018,2118,1026,1092,94,2115,1026,1089,94.2
36020, 여수시,075004, 73세,2018,1981,895,1086,82.4,1979,895,1084,82.6
36020, 여수시,075005, 74세,2018,1917,891,1026,86.8,1914,889,1025,86.7
36020, 여수시,080,75~79세,2018,10198,4240,5958,71.2,10190,4237,5953,71.2
36020, 여수시,080001, 75세,2018,2196,957,1239,77.2,2194,956,1238,77.2
36020, 여수시,080002, 76세,2018,2481,1032,1449,71.2,2481,1032,1449,71.2
36020, 여수시,080003, 77세,2018,1969,816,1153,70.8,1967,815,1152,70.7
36020, 여수시,080004, 78세,2018,1879,762,1117,68.2,1877,761,1116,68.2
36020, 여수시,080005, 79세,2018,1673,673,1000,67.3,1671,673,998,67.4
36020, 여수시,085,80~84세,2018,5915,2105,3810,55.2,5909,2102,3807,55.2
36020, 여수시,085001, 80세,2018,1465,562,903,62.2,1465,562,903,62.2
36020, 여수시,085002, 81세,2018,1345,517,828,62.4,1344,517,827,62.5
36020, 여수시,085003, 82세,2018,1131,382,749,51,1126,379,747,50.7
36020, 여수시,085004, 83세,2018,1047,358,689,52,1047,358,689,52
36020, 여수시,085005, 84세,2018,927,286,641,44.6,927,286,641,44.6
36020, 여수시,090,85~89세,2018,3145,811,2334,34.7,3144,811,2333,34.8
36020, 여수시,090001, 85세,2018,814,248,566,43.8,814,248,566,43.8
36020, 여수시,090002, 86세,2018,745,193,552,35,745,193,552,35
36020, 여수시,090003, 87세,2018,622,151,471,32.1,621,151,470,32.1
36020, 여수시,090004, 88세,2018,585,134,451,29.7,585,134,451,29.7
36020, 여수시,090005, 89세,2018,379,85,294,28.9,379,85,294,28.9
36020, 여수시,095,90~94세,2018,924,167,757,22.1,924,167,757,22.1
36020, 여수시,095001, 90세,2018,314,59,255,23.1,314,59,255,23.1
36020, 여수시,095002, 91세,2018,238,45,193,23.3,238,45,193,23.3
36020, 여수시,095003, 92세,2018,160,20,140,14.3,160,20,140,14.3
36020, 여수시,095004, 93세,2018,126,23,103,22.3,126,23,103,22.3
36020, 여수시,095005, 94세,2018,86,20,66,30.3,86,20,66,30.3
36020, 여수시,100,95~99세,2018,262,31,231,13.4,262,31,231,13.4
36020, 여수시,100001, 95세,2018,126,14,112,12.5,126,14,112,12.5
36020, 여수시,100002, 96세,2018,72,9,63,14.3,72,9,63,14.3
36020, 여수시,100003, 97세,2018,30,X,28,7.1,30,X,28,7.1
36020, 여수시,100004, 98세,2018,22,X,18,22.2,22,X,18,22.2
36020, 여수시,100005, 99세,2018,12,X,10,20,12,X,10,20
36020, 여수시,101,100세이상,2018,26,X,25,4,26,X,25,4
36020, 여수시,102,15세미만,2018,34971,17863,17108,104.4,34948,17852,17096,104.4
36020, 여수시,103,15~64세,2018,188310,100787,87523,115.2,182597,96740,85857,112.7
36020, 여수시,104,65세이상,2018,47666,20579,27087,76,47591,20546,27045,76
36020, 여수시,086,85세이상,2018,4357,1010,3347,30.2,4356,1010,3346,30.2
36020, 여수시,126,평균연령,2018,43.6,42,45.2,,43.7,42.2,45.3,
36020, 여수시,127,중위연령,2018,45.5,43.7,47.4,,45.9,44.3,47.6,
36030, 순천시,000,합계,2018,268284,133555,134729,99.1,265788,132411,133377,99.3
36030, 순천시,005,0~4세,2018,10961,5664,5297,106.9,10940,5657,5283,107.1
36030, 순천시,005001, 0세,2018,1771,940,831,113.1,1765,938,827,113.4
36030, 순천시,005002, 1세,2018,2011,1072,939,114.2,2005,1070,935,114.4
36030, 순천시,005003, 2세,2018,2237,1111,1126,98.7,2234,1110,1124,98.8
36030, 순천시,005004, 3세,2018,2457,1296,1161,111.6,2453,1294,1159,111.6
36030, 순천시,005005, 4세,2018,2485,1245,1240,100.4,2483,1245,1238,100.6
36030, 순천시,010,5~9세,2018,13499,6925,6574,105.3,13494,6922,6572,105.3
36030, 순천시,010001, 5세,2018,2577,1297,1280,101.3,2576,1296,1280,101.3
36030, 순천시,010002, 6세,2018,2780,1409,1371,102.8,2778,1409,1369,102.9
36030, 순천시,010003, 7세,2018,2820,1446,1374,105.2,2820,1446,1374,105.2
36030, 순천시,010004, 8세,2018,2649,1425,1224,116.4,2647,1423,1224,116.3
36030, 순천시,010005, 9세,2018,2673,1348,1325,101.7,2673,1348,1325,101.7
36030, 순천시,015,10~14세,2018,13968,7214,6754,106.8,13960,7209,6751,106.8
36030, 순천시,015001, 10세,2018,2762,1441,1321,109.1,2760,1439,1321,108.9
36030, 순천시,015002, 11세,2018,2840,1476,1364,108.2,2838,1474,1364,108.1
36030, 순천시,015003, 12세,2018,2721,1380,1341,102.9,2719,1380,1339,103.1
36030, 순천시,015004, 13세,2018,2630,1378,1252,110.1,2629,1378,1251,110.2
36030, 순천시,015005, 14세,2018,3015,1539,1476,104.3,3014,1538,1476,104.2
36030, 순천시,020,15~19세,2018,17036,9129,7907,115.5,16938,9073,7865,115.4
36030, 순천시,020001, 15세,2018,3040,1593,1447,110.1,3037,1593,1444,110.3
36030, 순천시,020002, 16세,2018,3072,1650,1422,116,3070,1648,1422,115.9
36030, 순천시,020003, 17세,2018,3628,1996,1632,122.3,3619,1989,1630,122
36030, 순천시,020004, 18세,2018,3905,2079,1826,113.9,3875,2058,1817,113.3
36030, 순천시,020005, 19세,2018,3391,1811,1580,114.6,3337,1785,1552,115
36030, 순천시,025,20~24세,2018,18628,10379,8249,125.8,18266,10198,8068,126.4
36030, 순천시,025001, 20세,2018,3625,1999,1626,122.9,3570,1969,1601,123
36030, 순천시,025002, 21세,2018,3889,2185,1704,128.2,3829,2159,1670,129.3
36030, 순천시,025003, 22세,2018,3768,2091,1677,124.7,3698,2057,1641,125.4
36030, 순천시,025004, 23세,2018,3801,2121,1680,126.3,3722,2082,1640,127
36030, 순천시,025005, 24세,2018,3545,1983,1562,127,3447,1931,1516,127.4
36030, 순천시,030,25~29세,2018,15078,7960,7118,111.8,14565,7716,6849,112.7
36030, 순천시,030001, 25세,2018,3367,1793,1574,113.9,3269,1749,1520,115.1
36030, 순천시,030002, 26세,2018,3286,1706,1580,108,3193,1657,1536,107.9
36030, 순천시,030003, 27세,2018,2905,1561,1344,116.1,2802,1513,1289,117.4
36030, 순천시,030004, 28세,2018,2858,1515,1343,112.8,2738,1449,1289,112.4
36030, 순천시,030005, 29세,2018,2662,1385,1277,108.5,2563,1348,1215,110.9
36030, 순천시,035,30~34세,2018,14347,7167,7180,99.8,13978,6997,6981,100.2
36030, 순천시,035001, 30세,2018,2618,1335,1283,104.1,2540,1295,1245,104
36030, 순천시,035002, 31세,2018,2665,1325,1340,98.9,2583,1287,1296,99.3
36030, 순천시,035003, 32세,2018,2829,1396,1433,97.4,2744,1358,1386,98
36030, 순천시,035004, 33세,2018,2947,1510,1437,105.1,2884,1482,1402,105.7
36030, 순천시,035005, 34세,2018,3288,1601,1687,94.9,3227,1575,1652,95.3
36030, 순천시,040,35~39세,2018,18750,9316,9434,98.7,18481,9190,9291,98.9
36030, 순천시,040001, 35세,2018,3466,1741,1725,100.9,3406,1717,1689,101.7
36030, 순천시,040002, 36세,2018,3827,1908,1919,99.4,3771,1883,1888,99.7
36030, 순천시,040003, 37세,2018,3614,1778,1836,96.8,3565,1758,1807,97.3
36030, 순천시,040004, 38세,2018,4018,1990,2028,98.1,3969,1964,2005,98
36030, 순천시,040005, 39세,2018,3825,1899,1926,98.6,3770,1868,1902,98.2
36030, 순천시,045,40~44세,2018,19613,9471,10142,93.4,19402,9385,10017,93.7
36030, 순천시,045001, 40세,2018,3545,1726,1819,94.9,3498,1705,1793,95.1
36030, 순천시,045002, 41세,2018,3821,1808,2013,89.8,3786,1794,1992,90.1
36030, 순천시,045003, 42세,2018,3778,1806,1972,91.6,3730,1788,1942,92.1
36030, 순천시,045004, 43세,2018,3989,1905,2084,91.4,3943,1890,2053,92.1
36030, 순천시,045005, 44세,2018,4480,2226,2254,98.8,4445,2208,2237,98.7
36030, 순천시,050,45~49세,2018,23903,11723,12180,96.2,23698,11632,12066,96.4
36030, 순천시,050001, 45세,2018,4651,2236,2415,92.6,4603,2212,2391,92.5
36030, 순천시,050002, 46세,2018,4623,2290,2333,98.2,4568,2271,2297,98.9
36030, 순천시,050003, 47세,2018,4891,2435,2456,99.1,4852,2417,2435,99.3
36030, 순천시,050004, 48세,2018,4818,2386,2432,98.1,4790,2371,2419,98
36030, 순천시,050005, 49세,2018,4920,2376,2544,93.4,4885,2361,2524,93.5
36030, 순천시,055,50~54세,2018,23868,12000,11868,101.1,23705,11940,11765,101.5
36030, 순천시,055001, 50세,2018,5357,2644,2713,97.5,5325,2630,2695,97.6
36030, 순천시,055002, 51세,2018,4689,2345,2344,100,4655,2331,2324,100.3
36030, 순천시,055003, 52세,2018,4699,2413,2286,105.6,4671,2405,2266,106.1
36030, 순천시,055004, 53세,2018,4767,2367,2400,98.6,4728,2352,2376,99
36030, 순천시,055005, 54세,2018,4356,2231,2125,105,4326,2222,2104,105.6
36030, 순천시,060,55~59세,2018,23042,11706,11336,103.3,22901,11650,11251,103.5
36030, 순천시,060001, 55세,2018,4676,2426,2250,107.8,4647,2415,2232,108.2
36030, 순천시,060002, 56세,2018,4411,2310,2101,109.9,4380,2295,2085,110.1
36030, 순천시,060003, 57세,2018,4728,2373,2355,100.8,4701,2363,2338,101.1
36030, 순천시,060004, 58세,2018,4929,2490,2439,102.1,4898,2479,2419,102.5
36030, 순천시,060005, 59세,2018,4298,2107,2191,96.2,4275,2098,2177,96.4
36030, 순천시,065,60~64세,2018,16446,8357,8089,103.3,16386,8332,8054,103.5
36030, 순천시,065001, 60세,2018,3757,1964,1793,109.5,3737,1957,1780,109.9
36030, 순천시,065002, 61세,2018,3624,1808,1816,99.6,3611,1804,1807,99.8
36030, 순천시,065003, 62세,2018,3055,1542,1513,101.9,3046,1536,1510,101.7
36030, 순천시,065004, 63세,2018,3228,1681,1547,108.7,3214,1674,1540,108.7
36030, 순천시,065005, 64세,2018,2782,1362,1420,95.9,2778,1361,1417,96
36030, 순천시,070,65~69세,2018,11727,5888,5839,100.8,11685,5866,5819,100.8
36030, 순천시,070001, 65세,2018,2275,1164,1111,104.8,2264,1159,1105,104.9
36030, 순천시,070002, 66세,2018,2650,1308,1342,97.5,2643,1306,1337,97.7
36030, 순천시,070003, 67세,2018,2220,1131,1089,103.9,2215,1128,1087,103.8
36030, 순천시,070004, 68세,2018,2315,1164,1151,101.1,2305,1159,1146,101.1
36030, 순천시,070005, 69세,2018,2267,1121,1146,97.8,2258,1114,1144,97.4
36030, 순천시,075,70~74세,2018,8872,4159,4713,88.2,8857,4151,4706,88.2
36030, 순천시,075001, 70세,2018,2124,1028,1096,93.8,2119,1025,1094,93.7
36030, 순천시,075002, 71세,2018,2204,1030,1174,87.7,2202,1029,1173,87.7
36030, 순천시,075003, 72세,2018,1569,765,804,95.1,1567,763,804,94.9
36030, 순천시,075004, 73세,2018,1479,666,813,81.9,1475,666,809,82.3
36030, 순천시,075005, 74세,2018,1496,670,826,81.1,1494,668,826,80.9
36030, 순천시,080,75~79세,2018,8563,3464,5099,67.9,8554,3462,5092,68
36030, 순천시,080001, 75세,2018,1833,750,1083,69.3,1830,749,1081,69.3
36030, 순천시,080002, 76세,2018,2033,837,1196,70,2030,836,1194,70
36030, 순천시,080003, 77세,2018,1696,697,999,69.8,1694,697,997,69.9
36030, 순천시,080004, 78세,2018,1507,594,913,65.1,1506,594,912,65.1
36030, 순천시,080005, 79세,2018,1494,586,908,64.5,1494,586,908,64.5
36030, 순천시,085,80~84세,2018,5857,1983,3874,51.2,5855,1982,3873,51.2
36030, 순천시,085001, 80세,2018,1393,513,880,58.3,1392,513,879,58.4
36030, 순천시,085002, 81세,2018,1268,450,818,55,1267,449,818,54.9
36030, 순천시,085003, 82세,2018,1125,367,758,48.4,1125,367,758,48.4
36030, 순천시,085004, 83세,2018,1103,367,736,49.9,1103,367,736,49.9
36030, 순천시,085005, 84세,2018,968,286,682,41.9,968,286,682,41.9
36030, 순천시,090,85~89세,2018,3027,824,2203,37.4,3024,823,2201,37.4
36030, 순천시,090001, 85세,2018,813,234,579,40.4,811,233,578,40.3
36030, 순천시,090002, 86세,2018,676,194,482,40.2,675,194,481,40.3
36030, 순천시,090003, 87세,2018,546,153,393,38.9,546,153,393,38.9
36030, 순천시,090004, 88세,2018,563,131,432,30.3,563,131,432,30.3
36030, 순천시,090005, 89세,2018,429,112,317,35.3,429,112,317,35.3
36030, 순천시,095,90~94세,2018,848,189,659,28.7,848,189,659,28.7
36030, 순천시,095001, 90세,2018,273,71,202,35.1,273,71,202,35.1
36030, 순천시,095002, 91세,2018,230,49,181,27.1,230,49,181,27.1
36030, 순천시,095003, 92세,2018,140,28,112,25,140,28,112,25
36030, 순천시,095004, 93세,2018,126,25,101,24.8,126,25,101,24.8
36030, 순천시,095005, 94세,2018,79,16,63,25.4,79,16,63,25.4
36030, 순천시,100,95~99세,2018,228,36,192,18.8,228,36,192,18.8
36030, 순천시,100001, 95세,2018,83,17,66,25.8,83,17,66,25.8
36030, 순천시,100002, 96세,2018,72,11,61,18,72,11,61,18
36030, 순천시,100003, 97세,2018,34,X,32,6.3,34,X,32,6.3
36030, 순천시,100004, 98세,2018,28,X,26,7.7,28,X,26,7.7
36030, 순천시,100005, 99세,2018,11,X,7,57.1,11,X,7,57.1
36030, 순천시,101,100세이상,2018,23,X,22,4.5,23,X,22,4.5
36030, 순천시,102,15세미만,2018,38428,19803,18625,106.3,38394,19788,18606,106.4
36030, 순천시,103,15~64세,2018,190711,97208,93503,104,188320,96113,92207,104.2
36030, 순천시,104,65세이상,2018,39145,16544,22601,73.2,39074,16510,22564,73.2
36030, 순천시,086,85세이상,2018,4126,1050,3076,34.1,4123,1049,3074,34.1
36030, 순천시,126,평균연령,2018,41.5,40.1,42.8,,41.5,40.2,42.9,
36030, 순천시,127,중위연령,2018,43.2,41.7,44.4,,43.3,41.9,44.6,
36040, 나주시,000,합계,2018,109862,54658,55204,99,106246,52655,53591,98.3
36040, 나주시,005,0~4세,2018,5292,2735,2557,107,5263,2719,2544,106.9
36040, 나주시,005001, 0세,2018,954,504,450,112,948,499,449,111.1
36040, 나주시,005002, 1세,2018,993,505,488,103.5,985,502,483,103.9
36040, 나주시,005003, 2세,2018,1105,565,540,104.6,1097,560,537,104.3
36040, 나주시,005004, 3세,2018,1152,587,565,103.9,1149,587,562,104.4
36040, 나주시,005005, 4세,2018,1088,574,514,111.7,1084,571,513,111.3
36040, 나주시,010,5~9세,2018,5137,2617,2520,103.8,5125,2611,2514,103.9
36040, 나주시,010001, 5세,2018,1074,548,526,104.2,1073,548,525,104.4
36040, 나주시,010002, 6세,2018,1188,623,565,110.3,1185,621,564,110.1
36040, 나주시,010003, 7세,2018,1048,507,541,93.7,1047,506,541,93.5
36040, 나주시,010004, 8세,2018,931,481,450,106.9,928,479,449,106.7
36040, 나주시,010005, 9세,2018,896,458,438,104.6,892,457,435,105.1
36040, 나주시,015,10~14세,2018,4131,2163,1968,109.9,4123,2158,1965,109.8
36040, 나주시,015001, 10세,2018,935,474,461,102.8,933,472,461,102.4
36040, 나주시,015002, 11세,2018,898,464,434,106.9,898,464,434,106.9
36040, 나주시,015003, 12세,2018,808,441,367,120.2,807,440,367,119.9
36040, 나주시,015004, 13세,2018,713,382,331,115.4,710,380,330,115.2
36040, 나주시,015005, 14세,2018,777,402,375,107.2,775,402,373,107.8
36040, 나주시,020,15~19세,2018,5483,2791,2692,103.7,5333,2725,2608,104.5
36040, 나주시,020001, 15세,2018,864,425,439,96.8,863,425,438,97
36040, 나주시,020002, 16세,2018,994,493,501,98.4,992,491,501,98
36040, 나주시,020003, 17세,2018,1145,583,562,103.7,1137,578,559,103.4
36040, 나주시,020004, 18세,2018,1279,638,641,99.5,1251,627,624,100.5
36040, 나주시,020005, 19세,2018,1201,652,549,118.8,1090,604,486,124.3
36040, 나주시,025,20~24세,2018,6277,3397,2880,118,5427,2881,2546,113.2
36040, 나주시,025001, 20세,2018,1272,641,631,101.6,1134,569,565,100.7
36040, 나주시,025002, 21세,2018,1255,666,589,113.1,1097,580,517,112.2
36040, 나주시,025003, 22세,2018,1282,689,593,116.2,1114,588,526,111.8
36040, 나주시,025004, 23세,2018,1236,707,529,133.6,1030,575,455,126.4
36040, 나주시,025005, 24세,2018,1232,694,538,129,1052,569,483,117.8
36040, 나주시,030,25~29세,2018,6339,3296,3043,108.3,5579,2855,2724,104.8
36040, 나주시,030001, 25세,2018,1260,688,572,120.3,1083,574,509,112.8
36040, 나주시,030002, 26세,2018,1265,613,652,94,1090,514,576,89.2
36040, 나주시,030003, 27세,2018,1274,662,612,108.2,1122,579,543,106.6
36040, 나주시,030004, 28세,2018,1262,669,593,112.8,1128,593,535,110.8
36040, 나주시,030005, 29세,2018,1278,664,614,108.1,1156,595,561,106.1
36040, 나주시,035,30~34세,2018,6608,3347,3261,102.6,6040,3038,3002,101.2
36040, 나주시,035001, 30세,2018,1226,627,599,104.7,1085,549,536,102.4
36040, 나주시,035002, 31세,2018,1292,646,646,100,1167,584,583,100.2
36040, 나주시,035003, 32세,2018,1290,653,637,102.5,1198,605,593,102
36040, 나주시,035004, 33세,2018,1371,669,702,95.3,1254,608,646,94.1
36040, 나주시,035005, 34세,2018,1429,752,677,111.1,1336,692,644,107.5
36040, 나주시,040,35~39세,2018,8560,4513,4047,111.5,8180,4292,3888,110.4
36040, 나주시,040001, 35세,2018,1623,864,759,113.8,1538,802,736,109
36040, 나주시,040002, 36세,2018,1749,914,835,109.5,1669,874,795,109.9
36040, 나주시,040003, 37세,2018,1779,959,820,117,1693,911,782,116.5
36040, 나주시,040004, 38세,2018,1749,888,861,103.1,1684,851,833,102.2
36040, 나주시,040005, 39세,2018,1660,888,772,115,1596,854,742,115.1
36040, 나주시,045,40~44세,2018,7386,4073,3313,122.9,7142,3942,3200,123.2
36040, 나주시,045001, 40세,2018,1478,784,694,113,1410,753,657,114.6
36040, 나주시,045002, 41세,2018,1485,808,677,119.4,1439,778,661,117.7
36040, 나주시,045003, 42세,2018,1447,831,616,134.9,1387,795,592,134.3
36040, 나주시,045004, 43세,2018,1456,797,659,120.9,1422,781,641,121.8
36040, 나주시,045005, 44세,2018,1520,853,667,127.9,1484,835,649,128.7
36040, 나주시,050,45~49세,2018,7547,4202,3345,125.6,7336,4089,3247,125.9
36040, 나주시,050001, 45세,2018,1512,870,642,135.5,1469,849,620,136.9
36040, 나주시,050002, 46세,2018,1506,861,645,133.5,1467,840,627,134
36040, 나주시,050003, 47세,2018,1519,848,671,126.4,1483,826,657,125.7
36040, 나주시,050004, 48세,2018,1548,865,683,126.6,1500,844,656,128.7
36040, 나주시,050005, 49세,2018,1462,758,704,107.7,1417,730,687,106.3
36040, 나주시,055,50~54세,2018,7618,4063,3555,114.3,7432,3985,3447,115.6
36040, 나주시,055001, 50세,2018,1552,832,720,115.6,1516,816,700,116.6
36040, 나주시,055002, 51세,2018,1494,803,691,116.2,1460,792,668,118.6
36040, 나주시,055003, 52세,2018,1533,830,703,118.1,1496,814,682,119.4
36040, 나주시,055004, 53세,2018,1574,867,707,122.6,1535,846,689,122.8
36040, 나주시,055005, 54세,2018,1465,731,734,99.6,1425,717,708,101.3
36040, 나주시,060,55~59세,2018,8482,4386,4096,107.1,8377,4339,4038,107.5
36040, 나주시,060001, 55세,2018,1597,869,728,119.4,1569,857,712,120.4
36040, 나주시,060002, 56세,2018,1567,827,740,111.8,1545,814,731,111.4
36040, 나주시,060003, 57세,2018,1730,876,854,102.6,1716,871,845,103.1
36040, 나주시,060004, 58세,2018,1890,945,945,100,1866,933,933,100
36040, 나주시,060005, 59세,2018,1698,869,829,104.8,1681,864,817,105.8
36040, 나주시,065,60~64세,2018,7564,3796,3768,100.7,7495,3760,3735,100.7
36040, 나주시,065001, 60세,2018,1655,816,839,97.3,1637,808,829,97.5
36040, 나주시,065002, 61세,2018,1614,829,785,105.6,1601,824,777,106
36040, 나주시,065003, 62세,2018,1441,729,712,102.4,1427,719,708,101.6
36040, 나주시,065004, 63세,2018,1512,752,760,98.9,1500,746,754,98.9
36040, 나주시,065005, 64세,2018,1342,670,672,99.7,1330,663,667,99.4
36040, 나주시,070,65~69세,2018,5842,2836,3006,94.3,5814,2820,2994,94.2
36040, 나주시,070001, 65세,2018,1098,537,561,95.7,1088,531,557,95.3
36040, 나주시,070002, 66세,2018,1293,615,678,90.7,1287,612,675,90.7
36040, 나주시,070003, 67세,2018,1074,536,538,99.6,1069,534,535,99.8
36040, 나주시,070004, 68세,2018,1153,571,582,98.1,1150,568,582,97.6
36040, 나주시,070005, 69세,2018,1224,577,647,89.2,1220,575,645,89.1
36040, 나주시,075,70~74세,2018,5259,2349,2910,80.7,5254,2348,2906,80.8
36040, 나주시,075001, 70세,2018,1149,546,603,90.5,1148,546,602,90.7
36040, 나주시,075002, 71세,2018,1198,562,636,88.4,1196,561,635,88.3
36040, 나주시,075003, 72세,2018,878,383,495,77.4,877,383,494,77.5
36040, 나주시,075004, 73세,2018,1055,443,612,72.4,1055,443,612,72.4
36040, 나주시,075005, 74세,2018,979,415,564,73.6,978,415,563,73.7
36040, 나주시,080,75~79세,2018,5593,2157,3436,62.8,5588,2156,3432,62.8
36040, 나주시,080001, 75세,2018,1100,454,646,70.3,1099,454,645,70.4
36040, 나주시,080002, 76세,2018,1413,567,846,67,1412,567,845,67.1
36040, 나주시,080003, 77세,2018,1087,435,652,66.7,1085,435,650,66.9
36040, 나주시,080004, 78세,2018,1020,381,639,59.6,1020,381,639,59.6
36040, 나주시,080005, 79세,2018,973,320,653,49,972,319,653,48.9
36040, 나주시,085,80~84세,2018,3891,1276,2615,48.8,3888,1276,2612,48.9
36040, 나주시,085001, 80세,2018,924,323,601,53.7,924,323,601,53.7
36040, 나주시,085002, 81세,2018,879,285,594,48,877,285,592,48.1
36040, 나주시,085003, 82세,2018,724,247,477,51.8,724,247,477,51.8
36040, 나주시,085004, 83세,2018,708,231,477,48.4,707,231,476,48.5
36040, 나주시,085005, 84세,2018,656,190,466,40.8,656,190,466,40.8
36040, 나주시,090,85~89세,2018,2031,486,1545,31.5,2028,486,1542,31.5
36040, 나주시,090001, 85세,2018,552,151,401,37.7,551,151,400,37.8
36040, 나주시,090002, 86세,2018,447,119,328,36.3,447,119,328,36.3
36040, 나주시,090003, 87세,2018,376,85,291,29.2,376,85,291,29.2
36040, 나주시,090004, 88세,2018,388,68,320,21.3,387,68,319,21.3
36040, 나주시,090005, 89세,2018,268,63,205,30.7,267,63,204,30.9
36040, 나주시,095,90~94세,2018,620,137,483,28.4,620,137,483,28.4
36040, 나주시,095001, 90세,2018,226,54,172,31.4,226,54,172,31.4
36040, 나주시,095002, 91세,2018,152,32,120,26.7,152,32,120,26.7
36040, 나주시,095003, 92세,2018,123,20,103,19.4,123,20,103,19.4
36040, 나주시,095004, 93세,2018,75,20,55,36.4,75,20,55,36.4
36040, 나주시,095005, 94세,2018,44,11,33,33.3,44,11,33,33.3
36040, 나주시,100,95~99세,2018,181,35,146,24,181,35,146,24
36040, 나주시,100001, 95세,2018,74,11,63,17.5,74,11,63,17.5
36040, 나주시,100002, 96세,2018,40,14,26,53.8,40,14,26,53.8
36040, 나주시,100003, 97세,2018,32,X,29,10.3,32,X,29,10.3
36040, 나주시,100004, 98세,2018,24,X,20,20,24,X,20,20
36040, 나주시,100005, 99세,2018,11,X,8,37.5,11,X,8,37.5
36040, 나주시,101,100세이상,2018,21,X,18,16.7,21,X,18,16.7
36040, 나주시,102,15세미만,2018,14560,7515,7045,106.7,14511,7488,7023,106.6
36040, 나주시,103,15~64세,2018,71864,37864,34000,111.4,68341,35906,32435,110.7
36040, 나주시,104,65세이상,2018,23438,9279,14159,65.5,23394,9261,14133,65.5
36040, 나주시,086,85세이상,2018,2853,661,2192,30.2,2850,661,2189,30.2
36040, 나주시,126,평균연령,2018,44.3,42.3,46.2,,44.7,42.7,46.6,
36040, 나주시,127,중위연령,2018,44.8,43.1,47,,45.6,43.9,47.8,
36060, 광양시,000,합계,2018,144027,74530,69497,107.2,141986,73610,68376,107.7
36060, 광양시,005,0~4세,2018,6717,3449,3268,105.5,6703,3443,3260,105.6
36060, 광양시,005001, 0세,2018,1184,596,588,101.4,1180,595,585,101.7
36060, 광양시,005002, 1세,2018,1259,686,573,119.7,1255,685,570,120.2
36060, 광양시,005003, 2세,2018,1336,692,644,107.5,1335,691,644,107.3
36060, 광양시,005004, 3세,2018,1511,786,725,108.4,1509,785,724,108.4
36060, 광양시,005005, 4세,2018,1427,689,738,93.4,1424,687,737,93.2
36060, 광양시,010,5~9세,2018,7851,4044,3807,106.2,7843,4041,3802,106.3
36060, 광양시,010001, 5세,2018,1563,807,756,106.7,1561,806,755,106.8
36060, 광양시,010002, 6세,2018,1627,842,785,107.3,1626,841,785,107.1
36060, 광양시,010003, 7세,2018,1653,830,823,100.9,1651,830,821,101.1
36060, 광양시,010004, 8세,2018,1563,827,736,112.4,1560,826,734,112.5
36060, 광양시,010005, 9세,2018,1445,738,707,104.4,1445,738,707,104.4
36060, 광양시,015,10~14세,2018,7355,3799,3556,106.8,7346,3796,3550,106.9
36060, 광양시,015001, 10세,2018,1521,782,739,105.8,1520,782,738,106
36060, 광양시,015002, 11세,2018,1511,793,718,110.4,1506,791,715,110.6
36060, 광양시,015003, 12세,2018,1430,728,702,103.7,1430,728,702,103.7
36060, 광양시,015004, 13세,2018,1416,714,702,101.7,1415,713,702,101.6
36060, 광양시,015005, 14세,2018,1477,782,695,112.5,1475,782,693,112.8
36060, 광양시,020,15~19세,2018,8878,4680,4198,111.5,8849,4671,4178,111.8
36060, 광양시,020001, 15세,2018,1534,813,721,112.8,1531,813,718,113.2
36060, 광양시,020002, 16세,2018,1788,909,879,103.4,1785,907,878,103.3
36060, 광양시,020003, 17세,2018,2065,1039,1026,101.3,2061,1036,1025,101.1
36060, 광양시,020004, 18세,2018,2098,1098,1000,109.8,2095,1097,998,109.9
36060, 광양시,020005, 19세,2018,1393,821,572,143.5,1377,818,559,146.3
36060, 광양시,025,20~24세,2018,8570,5157,3413,151.1,8373,5072,3301,153.7
36060, 광양시,025001, 20세,2018,1663,1103,560,197,1646,1098,548,200.4
36060, 광양시,025002, 21세,2018,1883,1167,716,163,1854,1158,696,166.4
36060, 광양시,025003, 22세,2018,1622,986,636,155,1589,971,618,157.1
36060, 광양시,025004, 23세,2018,1704,951,753,126.3,1646,925,721,128.3
36060, 광양시,025005, 24세,2018,1698,950,748,127,1638,920,718,128.1
36060, 광양시,030,25~29세,2018,8314,4649,3665,126.8,7934,4469,3465,129
36060, 광양시,030001, 25세,2018,1709,933,776,120.2,1633,901,732,123.1
36060, 광양시,030002, 26세,2018,1683,938,745,125.9,1600,893,707,126.3
36060, 광양시,030003, 27세,2018,1700,981,719,136.4,1625,946,679,139.3
36060, 광양시,030004, 28세,2018,1643,901,742,121.4,1568,870,698,124.6
36060, 광양시,030005, 29세,2018,1579,896,683,131.2,1508,859,649,132.4
36060, 광양시,035,30~34세,2018,8418,4397,4021,109.4,8056,4239,3817,111.1
36060, 광양시,035001, 30세,2018,1537,814,723,112.6,1460,788,672,117.3
36060, 광양시,035002, 31세,2018,1556,812,744,109.1,1477,775,702,110.4
36060, 광양시,035003, 32세,2018,1712,901,811,111.1,1634,867,767,113
36060, 광양시,035004, 33세,2018,1749,914,835,109.5,1686,884,802,110.2
36060, 광양시,035005, 34세,2018,1864,956,908,105.3,1799,925,874,105.8
36060, 광양시,040,35~39세,2018,11143,5894,5249,112.3,10902,5780,5122,112.8
36060, 광양시,040001, 35세,2018,2130,1142,988,115.6,2075,1112,963,115.5
36060, 광양시,040002, 36세,2018,2310,1218,1092,111.5,2266,1200,1066,112.6
36060, 광양시,040003, 37세,2018,2135,1160,975,119,2078,1132,946,119.7
36060, 광양시,040004, 38세,2018,2326,1234,1092,113,2287,1215,1072,113.3
36060, 광양시,040005, 39세,2018,2242,1140,1102,103.4,2196,1121,1075,104.3
36060, 광양시,045,40~44세,2018,10622,5368,5254,102.2,10441,5274,5167,102.1
36060, 광양시,045001, 40세,2018,2067,1092,975,112,2028,1065,963,110.6
36060, 광양시,045002, 41세,2018,2108,1058,1050,100.8,2068,1036,1032,100.4
36060, 광양시,045003, 42세,2018,2027,994,1033,96.2,1981,974,1007,96.7
36060, 광양시,045004, 43세,2018,2105,1067,1038,102.8,2077,1052,1025,102.6
36060, 광양시,045005, 44세,2018,2315,1157,1158,99.9,2287,1147,1140,100.6
36060, 광양시,050,45~49세,2018,13873,6860,7013,97.8,13681,6775,6906,98.1
36060, 광양시,050001, 45세,2018,2486,1209,1277,94.7,2446,1191,1255,94.9
36060, 광양시,050002, 46세,2018,2529,1285,1244,103.3,2487,1266,1221,103.7
36060, 광양시,050003, 47세,2018,2927,1406,1521,92.4,2886,1386,1500,92.4
36060, 광양시,050004, 48세,2018,2866,1399,1467,95.4,2831,1381,1450,95.2
36060, 광양시,050005, 49세,2018,3065,1561,1504,103.8,3031,1551,1480,104.8
36060, 광양시,055,50~54세,2018,14488,8091,6397,126.5,14321,8018,6303,127.2
36060, 광양시,055001, 50세,2018,3326,1799,1527,117.8,3290,1786,1504,118.8
36060, 광양시,055002, 51세,2018,3109,1731,1378,125.6,3068,1711,1357,126.1
36060, 광양시,055003, 52세,2018,2953,1739,1214,143.2,2922,1726,1196,144.3
36060, 광양시,055004, 53세,2018,2780,1576,1204,130.9,2745,1559,1186,131.5
36060, 광양시,055005, 54세,2018,2320,1246,1074,116,2296,1236,1060,116.6
36060, 광양시,060,55~59세,2018,12107,6414,5693,112.7,11984,6363,5621,113.2
36060, 광양시,060001, 55세,2018,2565,1448,1117,129.6,2531,1435,1096,130.9
36060, 광양시,060002, 56세,2018,2328,1266,1062,119.2,2303,1250,1053,118.7
36060, 광양시,060003, 57세,2018,2545,1325,1220,108.6,2523,1319,1204,109.6
36060, 광양시,060004, 58세,2018,2539,1290,1249,103.3,2518,1282,1236,103.7
36060, 광양시,060005, 59세,2018,2130,1085,1045,103.8,2109,1077,1032,104.4
36060, 광양시,065,60~64세,2018,8370,4453,3917,113.7,8290,4419,3871,114.2
36060, 광양시,065001, 60세,2018,1961,1053,908,116,1936,1042,894,116.6
36060, 광양시,065002, 61세,2018,1812,1002,810,123.7,1793,996,797,125
36060, 광양시,065003, 62세,2018,1531,818,713,114.7,1517,811,706,114.9
36060, 광양시,065004, 63세,2018,1613,825,788,104.7,1601,820,781,105
36060, 광양시,065005, 64세,2018,1453,755,698,108.2,1443,750,693,108.2
36060, 광양시,070,65~69세,2018,5284,2779,2505,110.9,5246,2760,2486,111
36060, 광양시,070001, 65세,2018,1086,578,508,113.8,1073,570,503,113.3
36060, 광양시,070002, 66세,2018,1151,627,524,119.7,1146,625,521,120
36060, 광양시,070003, 67세,2018,1053,556,497,111.9,1043,552,491,112.4
36060, 광양시,070004, 68세,2018,1038,535,503,106.4,1031,530,501,105.8
36060, 광양시,070005, 69세,2018,956,483,473,102.1,953,483,470,102.8
36060, 광양시,075,70~74세,2018,3826,1759,2067,85.1,3815,1756,2059,85.3
36060, 광양시,075001, 70세,2018,987,480,507,94.7,987,480,507,94.7
36060, 광양시,075002, 71세,2018,984,479,505,94.9,980,478,502,95.2
36060, 광양시,075003, 72세,2018,608,293,315,93,605,293,312,93.9
36060, 광양시,075004, 73세,2018,615,267,348,76.7,611,265,346,76.6
36060, 광양시,075005, 74세,2018,632,240,392,61.2,632,240,392,61.2
36060, 광양시,080,75~79세,2018,3664,1402,2262,62,3657,1401,2256,62.1
36060, 광양시,080001, 75세,2018,731,296,435,68,728,296,432,68.5
36060, 광양시,080002, 76세,2018,850,335,515,65,848,335,513,65.3
36060, 광양시,080003, 77세,2018,715,260,455,57.1,714,259,455,56.9
36060, 광양시,080004, 78세,2018,679,248,431,57.5,678,248,430,57.7
36060, 광양시,080005, 79세,2018,689,263,426,61.7,689,263,426,61.7
36060, 광양시,085,80~84세,2018,2679,924,1755,52.6,2677,922,1755,52.5
36060, 광양시,085001, 80세,2018,632,226,406,55.7,632,226,406,55.7
36060, 광양시,085002, 81세,2018,580,208,372,55.9,579,207,372,55.6
36060, 광양시,085003, 82세,2018,571,208,363,57.3,571,208,363,57.3
36060, 광양시,085004, 83세,2018,489,157,332,47.3,488,156,332,47
36060, 광양시,085005, 84세,2018,407,125,282,44.3,407,125,282,44.3
36060, 광양시,090,85~89세,2018,1329,318,1011,31.5,1329,318,1011,31.5
36060, 광양시,090001, 85세,2018,343,93,250,37.2,343,93,250,37.2
36060, 광양시,090002, 86세,2018,323,80,243,32.9,323,80,243,32.9
36060, 광양시,090003, 87세,2018,279,61,218,28,279,61,218,28
36060, 광양시,090004, 88세,2018,216,42,174,24.1,216,42,174,24.1
36060, 광양시,090005, 89세,2018,168,42,126,33.3,168,42,126,33.3
36060, 광양시,095,90~94세,2018,429,80,349,22.9,429,80,349,22.9
36060, 광양시,095001, 90세,2018,160,37,123,30.1,160,37,123,30.1
36060, 광양시,095002, 91세,2018,99,15,84,17.9,99,15,84,17.9
36060, 광양시,095003, 92세,2018,73,15,58,25.9,73,15,58,25.9
36060, 광양시,095004, 93세,2018,50,7,43,16.3,50,7,43,16.3
36060, 광양시,095005, 94세,2018,47,6,41,14.6,47,6,41,14.6
36060, 광양시,100,95~99세,2018,103,12,91,13.2,103,12,91,13.2
36060, 광양시,100001, 95세,2018,45,X,41,9.8,45,X,41,9.8
36060, 광양시,100002, 96세,2018,29,6,23,26.1,29,6,23,26.1
36060, 광양시,100003, 97세,2018,20,X,19,5.3,20,X,19,5.3
36060, 광양시,100004, 98세,2018,7,X,6,16.7,7,X,6,16.7
36060, 광양시,100005, 99세,2018,X,X,X,0,X,X,X,0
36060, 광양시,101,100세이상,2018,7,X,6,16.7,7,X,6,16.7
36060, 광양시,102,15세미만,2018,21923,11292,10631,106.2,21892,11280,10612,106.3
36060, 광양시,103,15~64세,2018,104783,55963,48820,114.6,102831,55080,47751,115.3
36060, 광양시,104,65세이상,2018,17321,7275,10046,72.4,17263,7250,10013,72.4
36060, 광양시,086,85세이상,2018,1868,411,1457,28.2,1868,411,1457,28.2
36060, 광양시,126,평균연령,2018,40.5,39.4,41.6,,40.5,39.4,41.7,
36060, 광양시,127,중위연령,2018,42.3,41.1,43.5,,42.4,41.2,43.7,
36310, 담양군,000,합계,2018,43749,21648,22101,98,42347,20908,21439,97.5
36310, 담양군,005,0~4세,2018,1225,585,640,91.4,1222,584,638,91.5
36310, 담양군,005001, 0세,2018,246,115,131,87.8,246,115,131,87.8
36310, 담양군,005002, 1세,2018,239,115,124,92.7,239,115,124,92.7
36310, 담양군,005003, 2세,2018,235,119,116,102.6,235,119,116,102.6
36310, 담양군,005004, 3세,2018,255,104,151,68.9,252,103,149,69.1
36310, 담양군,005005, 4세,2018,250,132,118,111.9,250,132,118,111.9
36310, 담양군,010,5~9세,2018,1232,636,596,106.7,1231,635,596,106.5
36310, 담양군,010001, 5세,2018,235,118,117,100.9,234,117,117,100
36310, 담양군,010002, 6세,2018,251,122,129,94.6,251,122,129,94.6
36310, 담양군,010003, 7세,2018,246,147,99,148.5,246,147,99,148.5
36310, 담양군,010004, 8세,2018,253,118,135,87.4,253,118,135,87.4
36310, 담양군,010005, 9세,2018,247,131,116,112.9,247,131,116,112.9
36310, 담양군,015,10~14세,2018,1222,627,595,105.4,1218,624,594,105.1
36310, 담양군,015001, 10세,2018,239,131,108,121.3,239,131,108,121.3
36310, 담양군,015002, 11세,2018,224,113,111,101.8,223,112,111,100.9
36310, 담양군,015003, 12세,2018,242,121,121,100,241,121,120,100.8
36310, 담양군,015004, 13세,2018,260,132,128,103.1,260,132,128,103.1
36310, 담양군,015005, 14세,2018,257,130,127,102.4,255,128,127,100.8
36310, 담양군,020,15~19세,2018,2551,1375,1176,116.9,2543,1372,1171,117.2
36310, 담양군,020001, 15세,2018,302,153,149,102.7,302,153,149,102.7
36310, 담양군,020002, 16세,2018,456,250,206,121.4,456,250,206,121.4
36310, 담양군,020003, 17세,2018,667,358,309,115.9,666,358,308,116.2
36310, 담양군,020004, 18세,2018,612,325,287,113.2,610,324,286,113.3
36310, 담양군,020005, 19세,2018,514,289,225,128.4,509,287,222,129.3
36310, 담양군,025,20~24세,2018,2331,1389,942,147.5,2064,1224,840,145.7
36310, 담양군,025001, 20세,2018,437,231,206,112.1,415,218,197,110.7
36310, 담양군,025002, 21세,2018,436,274,162,169.1,396,249,147,169.4
36310, 담양군,025003, 22세,2018,540,355,185,191.9,478,315,163,193.3
36310, 담양군,025004, 23세,2018,474,278,196,141.8,405,234,171,136.8
36310, 담양군,025005, 24세,2018,444,251,193,130.1,370,208,162,128.4
36310, 담양군,030,25~29세,2018,2110,1104,1006,109.7,1730,902,828,108.9
36310, 담양군,030001, 25세,2018,413,220,193,114,326,175,151,115.9
36310, 담양군,030002, 26세,2018,488,270,218,123.9,389,217,172,126.2
36310, 담양군,030003, 27세,2018,429,220,209,105.3,356,183,173,105.8
36310, 담양군,030004, 28세,2018,409,208,201,103.5,354,175,179,97.8
36310, 담양군,030005, 29세,2018,371,186,185,100.5,305,152,153,99.3
36310, 담양군,035,30~34세,2018,1865,968,897,107.9,1594,828,766,108.1
36310, 담양군,035001, 30세,2018,364,192,172,111.6,295,155,140,110.7
36310, 담양군,035002, 31세,2018,381,197,184,107.1,325,163,162,100.6
36310, 담양군,035003, 32세,2018,365,195,170,114.7,314,170,144,118.1
36310, 담양군,035004, 33세,2018,355,177,178,99.4,312,159,153,103.9
36310, 담양군,035005, 34세,2018,400,207,193,107.3,348,181,167,108.4
36310, 담양군,040,35~39세,2018,2014,1078,936,115.2,1865,1006,859,117.1
36310, 담양군,040001, 35세,2018,399,218,181,120.4,366,203,163,124.5
36310, 담양군,040002, 36세,2018,400,218,182,119.8,377,202,175,115.4
36310, 담양군,040003, 37세,2018,404,198,206,96.1,381,191,190,100.5
36310, 담양군,040004, 38세,2018,430,235,195,120.5,396,220,176,125
36310, 담양군,040005, 39세,2018,381,209,172,121.5,345,190,155,122.6
36310, 담양군,045,40~44세,2018,2244,1285,959,134,2118,1220,898,135.9
36310, 담양군,045001, 40세,2018,403,229,174,131.6,379,216,163,132.5
36310, 담양군,045002, 41세,2018,400,220,180,122.2,379,210,169,124.3
36310, 담양군,045003, 42세,2018,398,238,160,148.8,372,224,148,151.4
36310, 담양군,045004, 43세,2018,476,264,212,124.5,452,251,201,124.9
36310, 담양군,045005, 44세,2018,567,334,233,143.3,536,319,217,147
36310, 담양군,050,45~49세,2018,2866,1587,1279,124.1,2804,1552,1252,124
36310, 담양군,050001, 45세,2018,498,264,234,112.8,476,253,223,113.5
36310, 담양군,050002, 46세,2018,539,327,212,154.2,530,321,209,153.6
36310, 담양군,050003, 47세,2018,623,365,258,141.5,609,358,251,142.6
36310, 담양군,050004, 48세,2018,590,320,270,118.5,581,315,266,118.4
36310, 담양군,050005, 49세,2018,616,311,305,102,608,305,303,100.7
36310, 담양군,055,50~54세,2018,3355,1775,1580,112.3,3298,1754,1544,113.6
36310, 담양군,055001, 50세,2018,679,367,312,117.6,666,360,306,117.6
36310, 담양군,055002, 51세,2018,607,325,282,115.2,595,320,275,116.4
36310, 담양군,055003, 52세,2018,654,365,289,126.3,643,361,282,128
36310, 담양군,055004, 53세,2018,716,348,368,94.6,700,345,355,97.2
36310, 담양군,055005, 54세,2018,699,370,329,112.5,694,368,326,112.9
36310, 담양군,060,55~59세,2018,4157,2171,1986,109.3,4116,2153,1963,109.7
36310, 담양군,060001, 55세,2018,746,408,338,120.7,736,403,333,121
36310, 담양군,060002, 56세,2018,758,415,343,121,750,411,339,121.2
36310, 담양군,060003, 57세,2018,879,434,445,97.5,869,429,440,97.5
36310, 담양군,060004, 58세,2018,920,470,450,104.4,913,468,445,105.2
36310, 담양군,060005, 59세,2018,854,444,410,108.3,848,442,406,108.9
36310, 담양군,065,60~64세,2018,3692,1842,1850,99.6,3679,1837,1842,99.7
36310, 담양군,065001, 60세,2018,763,385,378,101.9,761,384,377,101.9
36310, 담양군,065002, 61세,2018,817,427,390,109.5,816,427,389,109.8
36310, 담양군,065003, 62세,2018,671,343,328,104.6,668,342,326,104.9
36310, 담양군,065004, 63세,2018,741,355,386,92,738,354,384,92.2
36310, 담양군,065005, 64세,2018,700,332,368,90.2,696,330,366,90.2
36310, 담양군,070,65~69세,2018,3099,1505,1594,94.4,3089,1501,1588,94.5
36310, 담양군,070001, 65세,2018,598,292,306,95.4,597,291,306,95.1
36310, 담양군,070002, 66세,2018,715,362,353,102.5,715,362,353,102.5
36310, 담양군,070003, 67세,2018,555,261,294,88.8,553,260,293,88.7
36310, 담양군,070004, 68세,2018,629,309,320,96.6,627,309,318,97.2
36310, 담양군,070005, 69세,2018,602,281,321,87.5,597,279,318,87.7
36310, 담양군,075,70~74세,2018,2813,1272,1541,82.5,2807,1269,1538,82.5
36310, 담양군,075001, 70세,2018,641,318,323,98.5,639,317,322,98.4
36310, 담양군,075002, 71세,2018,705,335,370,90.5,703,334,369,90.5
36310, 담양군,075003, 72세,2018,494,235,259,90.7,492,234,258,90.7
36310, 담양군,075004, 73세,2018,488,220,268,82.1,488,220,268,82.1
36310, 담양군,075005, 74세,2018,485,164,321,51.1,485,164,321,51.1
36310, 담양군,080,75~79세,2018,3325,1342,1983,67.7,3324,1341,1983,67.6
36310, 담양군,080001, 75세,2018,609,258,351,73.5,609,258,351,73.5
36310, 담양군,080002, 76세,2018,865,349,516,67.6,865,349,516,67.6
36310, 담양군,080003, 77세,2018,636,264,372,71,635,263,372,70.7
36310, 담양군,080004, 78세,2018,580,216,364,59.3,580,216,364,59.3
36310, 담양군,080005, 79세,2018,635,255,380,67.1,635,255,380,67.1
36310, 담양군,085,80~84세,2018,2132,710,1422,49.9,2130,709,1421,49.9
36310, 담양군,085001, 80세,2018,524,189,335,56.4,523,189,334,56.6
36310, 담양군,085002, 81세,2018,458,150,308,48.7,457,149,308,48.4
36310, 담양군,085003, 82세,2018,425,142,283,50.2,425,142,283,50.2
36310, 담양군,085004, 83세,2018,387,121,266,45.5,387,121,266,45.5
36310, 담양군,085005, 84세,2018,338,108,230,47,338,108,230,47
36310, 담양군,090,85~89세,2018,1070,303,767,39.5,1070,303,767,39.5
36310, 담양군,090001, 85세,2018,304,86,218,39.4,304,86,218,39.4
36310, 담양군,090002, 86세,2018,250,72,178,40.4,250,72,178,40.4
36310, 담양군,090003, 87세,2018,181,52,129,40.3,181,52,129,40.3
36310, 담양군,090004, 88세,2018,196,54,142,38,196,54,142,38
36310, 담양군,090005, 89세,2018,139,39,100,39,139,39,100,39
36310, 담양군,095,90~94세,2018,333,69,264,26.1,332,69,263,26.2
36310, 담양군,095001, 90세,2018,116,25,91,27.5,116,25,91,27.5
36310, 담양군,095002, 91세,2018,80,16,64,25,80,16,64,25
36310, 담양군,095003, 92세,2018,63,12,51,23.5,63,12,51,23.5
36310, 담양군,095004, 93세,2018,42,9,33,27.3,41,9,32,28.1
36310, 담양군,095005, 94세,2018,32,7,25,28,32,7,25,28
36310, 담양군,100,95~99세,2018,99,22,77,28.6,99,22,77,28.6
36310, 담양군,100001, 95세,2018,30,5,25,20,30,5,25,20
36310, 담양군,100002, 96세,2018,25,9,16,56.3,25,9,16,56.3
36310, 담양군,100003, 97세,2018,20,6,14,42.9,20,6,14,42.9
36310, 담양군,100004, 98세,2018,11,X,11,0,11,X,11,0
36310, 담양군,100005, 99세,2018,13,X,11,18.2,13,X,11,18.2
36310, 담양군,101,100세이상,2018,14,X,11,27.3,14,X,11,27.3
36310, 담양군,102,15세미만,2018,3679,1848,1831,100.9,3671,1843,1828,100.8
36310, 담양군,103,15~64세,2018,27185,14574,12611,115.6,25811,13848,11963,115.8
36310, 담양군,104,65세이상,2018,12885,5226,7659,68.2,12865,5217,7648,68.2
36310, 담양군,086,85세이상,2018,1516,397,1119,35.5,1515,397,1118,35.5
36310, 담양군,126,평균연령,2018,49.8,47.4,52.1,,50.3,47.9,52.7,
36310, 담양군,127,중위연령,2018,53.4,50.5,56.3,,54.3,51.5,57.1,
36320, 곡성군,000,합계,2018,28116,13619,14497,93.9,27470,13262,14208,93.3
36320, 곡성군,005,0~4세,2018,620,298,322,92.5,620,298,322,92.5
36320, 곡성군,005001, 0세,2018,124,62,62,100,124,62,62,100
36320, 곡성군,005002, 1세,2018,106,51,55,92.7,106,51,55,92.7
36320, 곡성군,005003, 2세,2018,133,61,72,84.7,133,61,72,84.7
36320, 곡성군,005004, 3세,2018,131,56,75,74.7,131,56,75,74.7
36320, 곡성군,005005, 4세,2018,126,68,58,117.2,126,68,58,117.2
36320, 곡성군,010,5~9세,2018,726,386,340,113.5,726,386,340,113.5
36320, 곡성군,010001, 5세,2018,125,72,53,135.8,125,72,53,135.8
36320, 곡성군,010002, 6세,2018,141,81,60,135,141,81,60,135
36320, 곡성군,010003, 7세,2018,172,80,92,87,172,80,92,87
36320, 곡성군,010004, 8세,2018,144,71,73,97.3,144,71,73,97.3
36320, 곡성군,010005, 9세,2018,144,82,62,132.3,144,82,62,132.3
36320, 곡성군,015,10~14세,2018,825,444,381,116.5,823,443,380,116.6
36320, 곡성군,015001, 10세,2018,166,104,62,167.7,166,104,62,167.7
36320, 곡성군,015002, 11세,2018,157,75,82,91.5,157,75,82,91.5
36320, 곡성군,015003, 12세,2018,165,93,72,129.2,165,93,72,129.2
36320, 곡성군,015004, 13세,2018,163,82,81,101.2,162,82,80,102.5
36320, 곡성군,015005, 14세,2018,174,90,84,107.1,173,89,84,106
36320, 곡성군,020,15~19세,2018,1732,888,844,105.2,1705,870,835,104.2
36320, 곡성군,020001, 15세,2018,209,114,95,120,209,114,95,120
36320, 곡성군,020002, 16세,2018,261,115,146,78.8,261,115,146,78.8
36320, 곡성군,020003, 17세,2018,341,169,172,98.3,341,169,172,98.3
36320, 곡성군,020004, 18세,2018,426,198,228,86.8,419,194,225,86.2
36320, 곡성군,020005, 19세,2018,495,292,203,143.8,475,278,197,141.1
36320, 곡성군,025,20~24세,2018,1735,969,766,126.5,1588,871,717,121.5
36320, 곡성군,025001, 20세,2018,491,288,203,141.9,459,265,194,136.6
36320, 곡성군,025002, 21세,2018,389,191,198,96.5,354,168,186,90.3
36320, 곡성군,025003, 22세,2018,325,183,142,128.9,295,161,134,120.1
36320, 곡성군,025004, 23세,2018,294,174,120,145,266,156,110,141.8
36320, 곡성군,025005, 24세,2018,236,133,103,129.1,214,121,93,130.1
36320, 곡성군,030,25~29세,2018,1102,599,503,119.1,965,523,442,118.3
36320, 곡성군,030001, 25세,2018,269,147,122,120.5,233,129,104,124
36320, 곡성군,030002, 26세,2018,239,134,105,127.6,211,113,98,115.3
36320, 곡성군,030003, 27세,2018,215,114,101,112.9,193,102,91,112.1
36320, 곡성군,030004, 28세,2018,209,120,89,134.8,180,108,72,150
36320, 곡성군,030005, 29세,2018,170,84,86,97.7,148,71,77,92.2
36320, 곡성군,035,30~34세,2018,881,466,415,112.3,801,419,382,109.7
36320, 곡성군,035001, 30세,2018,188,104,84,123.8,162,88,74,118.9
36320, 곡성군,035002, 31세,2018,179,92,87,105.7,167,85,82,103.7
36320, 곡성군,035003, 32세,2018,151,75,76,98.7,136,67,69,97.1
36320, 곡성군,035004, 33세,2018,163,91,72,126.4,154,85,69,123.2
36320, 곡성군,035005, 34세,2018,200,104,96,108.3,182,94,88,106.8
36320, 곡성군,040,35~39세,2018,1106,596,510,116.9,1040,563,477,118
36320, 곡성군,040001, 35세,2018,208,121,87,139.1,191,110,81,135.8
36320, 곡성군,040002, 36세,2018,211,120,91,131.9,198,114,84,135.7
36320, 곡성군,040003, 37세,2018,215,112,103,108.7,204,109,95,114.7
36320, 곡성군,040004, 38세,2018,232,123,109,112.8,220,117,103,113.6
36320, 곡성군,040005, 39세,2018,240,120,120,100,227,113,114,99.1
36320, 곡성군,045,40~44세,2018,1363,738,625,118.1,1319,719,600,119.8
36320, 곡성군,045001, 40세,2018,230,134,96,139.6,225,132,93,141.9
36320, 곡성군,045002, 41세,2018,260,134,126,106.3,245,127,118,107.6
36320, 곡성군,045003, 42세,2018,260,148,112,132.1,247,142,105,135.2
36320, 곡성군,045004, 43세,2018,268,136,132,103,263,135,128,105.5
36320, 곡성군,045005, 44세,2018,345,186,159,117,339,183,156,117.3
36320, 곡성군,050,45~49세,2018,1813,1011,802,126.1,1770,994,776,128.1
36320, 곡성군,050001, 45세,2018,323,194,129,150.4,312,189,123,153.7
36320, 곡성군,050002, 46세,2018,356,201,155,129.7,348,198,150,132
36320, 곡성군,050003, 47세,2018,365,176,189,93.1,359,175,184,95.1
36320, 곡성군,050004, 48세,2018,377,211,166,127.1,365,207,158,131
36320, 곡성군,050005, 49세,2018,392,229,163,140.5,386,225,161,139.8
36320, 곡성군,055,50~54세,2018,2028,1117,911,122.6,1986,1098,888,123.6
36320, 곡성군,055001, 50세,2018,386,213,173,123.1,382,212,170,124.7
36320, 곡성군,055002, 51세,2018,382,217,165,131.5,373,215,158,136.1
36320, 곡성군,055003, 52세,2018,426,231,195,118.5,417,225,192,117.2
36320, 곡성군,055004, 53세,2018,433,247,186,132.8,423,241,182,132.4
36320, 곡성군,055005, 54세,2018,401,209,192,108.9,391,205,186,110.2
36320, 곡성군,060,55~59세,2018,2537,1299,1238,104.9,2513,1291,1222,105.6
36320, 곡성군,060001, 55세,2018,431,221,210,105.2,421,216,205,105.4
36320, 곡성군,060002, 56세,2018,464,240,224,107.1,460,240,220,109.1
36320, 곡성군,060003, 57세,2018,538,276,262,105.3,536,276,260,106.2
36320, 곡성군,060004, 58세,2018,560,293,267,109.7,556,291,265,109.8
36320, 곡성군,060005, 59세,2018,544,269,275,97.8,540,268,272,98.5
36320, 곡성군,065,60~64세,2018,2250,1167,1083,107.8,2230,1155,1075,107.4
36320, 곡성군,065001, 60세,2018,502,281,221,127.1,499,279,220,126.8
36320, 곡성군,065002, 61세,2018,494,266,228,116.7,493,265,228,116.2
36320, 곡성군,065003, 62세,2018,392,201,191,105.2,386,198,188,105.3
36320, 곡성군,065004, 63세,2018,467,227,240,94.6,462,222,240,92.5
36320, 곡성군,065005, 64세,2018,395,192,203,94.6,390,191,199,96
36320, 곡성군,070,65~69세,2018,2011,990,1021,97,2004,985,1019,96.7
36320, 곡성군,070001, 65세,2018,347,184,163,112.9,346,184,162,113.6
36320, 곡성군,070002, 66세,2018,441,220,221,99.5,438,218,220,99.1
36320, 곡성군,070003, 67세,2018,391,177,214,82.7,390,176,214,82.2
36320, 곡성군,070004, 68세,2018,409,201,208,96.6,408,200,208,96.2
36320, 곡성군,070005, 69세,2018,423,208,215,96.7,422,207,215,96.3
36320, 곡성군,075,70~74세,2018,1924,824,1100,74.9,1919,822,1097,74.9
36320, 곡성군,075001, 70세,2018,441,195,246,79.3,440,195,245,79.6
36320, 곡성군,075002, 71세,2018,446,205,241,85.1,444,204,240,85
36320, 곡성군,075003, 72세,2018,368,158,210,75.2,368,158,210,75.2
36320, 곡성군,075004, 73세,2018,327,126,201,62.7,325,125,200,62.5
36320, 곡성군,075005, 74세,2018,342,140,202,69.3,342,140,202,69.3
36320, 곡성군,080,75~79세,2018,2358,875,1483,59,2357,874,1483,58.9
36320, 곡성군,080001, 75세,2018,388,159,229,69.4,388,159,229,69.4
36320, 곡성군,080002, 76세,2018,588,217,371,58.5,588,217,371,58.5
36320, 곡성군,080003, 77세,2018,479,176,303,58.1,478,175,303,57.8
36320, 곡성군,080004, 78세,2018,451,158,293,53.9,451,158,293,53.9
36320, 곡성군,080005, 79세,2018,452,165,287,57.5,452,165,287,57.5
36320, 곡성군,085,80~84세,2018,1900,649,1251,51.9,1899,648,1251,51.8
36320, 곡성군,085001, 80세,2018,420,156,264,59.1,420,156,264,59.1
36320, 곡성군,085002, 81세,2018,433,158,275,57.5,432,157,275,57.1
36320, 곡성군,085003, 82세,2018,369,109,260,41.9,369,109,260,41.9
36320, 곡성군,085004, 83세,2018,374,111,263,42.2,374,111,263,42.2
36320, 곡성군,085005, 84세,2018,304,115,189,60.8,304,115,189,60.8
36320, 곡성군,090,85~89세,2018,851,228,623,36.6,851,228,623,36.6
36320, 곡성군,090001, 85세,2018,222,64,158,40.5,222,64,158,40.5
36320, 곡성군,090002, 86세,2018,207,60,147,40.8,207,60,147,40.8
36320, 곡성군,090003, 87세,2018,169,37,132,28,169,37,132,28
36320, 곡성군,090004, 88세,2018,146,37,109,33.9,146,37,109,33.9
36320, 곡성군,090005, 89세,2018,107,30,77,39,107,30,77,39
36320, 곡성군,095,90~94세,2018,286,68,218,31.2,286,68,218,31.2
36320, 곡성군,095001, 90세,2018,105,17,88,19.3,105,17,88,19.3
36320, 곡성군,095002, 91세,2018,63,22,41,53.7,63,22,41,53.7
36320, 곡성군,095003, 92세,2018,67,13,54,24.1,67,13,54,24.1
36320, 곡성군,095004, 93세,2018,30,8,22,36.4,30,8,22,36.4
36320, 곡성군,095005, 94세,2018,21,8,13,61.5,21,8,13,61.5
36320, 곡성군,100,95~99세,2018,60,6,54,11.1,60,6,54,11.1
36320, 곡성군,100001, 95세,2018,31,X,29,6.9,31,X,29,6.9
36320, 곡성군,100002, 96세,2018,14,X,12,16.7,14,X,12,16.7
36320, 곡성군,100003, 97세,2018,7,X,6,16.7,7,X,6,16.7
36320, 곡성군,100004, 98세,2018,5,X,X,25,5,X,X,25
36320, 곡성군,100005, 99세,2018,X,X,X,0,X,X,X,0
36320, 곡성군,101,100세이상,2018,8,X,7,14.3,8,X,7,14.3
36320, 곡성군,102,15세미만,2018,2171,1128,1043,108.1,2169,1127,1042,108.2
36320, 곡성군,103,15~64세,2018,16547,8850,7697,115,15917,8503,7414,114.7
36320, 곡성군,104,65세이상,2018,9398,3641,5757,63.2,9384,3632,5752,63.1
36320, 곡성군,086,85세이상,2018,1205,303,902,33.6,1205,303,902,33.6
36320, 곡성군,126,평균연령,2018,51.4,48.5,54.2,,51.8,48.9,54.5,
36320, 곡성군,127,중위연령,2018,55.3,51.9,58.5,,55.9,52.5,59,
36330, 구례군,000,합계,2018,24246,11669,12577,92.8,23924,11556,12368,93.4
36330, 구례군,005,0~4세,2018,541,276,265,104.2,541,276,265,104.2
36330, 구례군,005001, 0세,2018,81,37,44,84.1,81,37,44,84.1
36330, 구례군,005002, 1세,2018,111,56,55,101.8,111,56,55,101.8
36330, 구례군,005003, 2세,2018,115,57,58,98.3,115,57,58,98.3
36330, 구례군,005004, 3세,2018,124,61,63,96.8,124,61,63,96.8
36330, 구례군,005005, 4세,2018,110,65,45,144.4,110,65,45,144.4
36330, 구례군,010,5~9세,2018,748,374,374,100,748,374,374,100
36330, 구례군,010001, 5세,2018,156,75,81,92.6,156,75,81,92.6
36330, 구례군,010002, 6세,2018,145,64,81,79,145,64,81,79
36330, 구례군,010003, 7세,2018,169,83,86,96.5,169,83,86,96.5
36330, 구례군,010004, 8세,2018,136,73,63,115.9,136,73,63,115.9
36330, 구례군,010005, 9세,2018,142,79,63,125.4,142,79,63,125.4
36330, 구례군,015,10~14세,2018,809,423,386,109.6,809,423,386,109.6
36330, 구례군,015001, 10세,2018,157,88,69,127.5,157,88,69,127.5
36330, 구례군,015002, 11세,2018,173,83,90,92.2,173,83,90,92.2
36330, 구례군,015003, 12세,2018,148,75,73,102.7,148,75,73,102.7
36330, 구례군,015004, 13세,2018,169,89,80,111.3,169,89,80,111.3
36330, 구례군,015005, 14세,2018,162,88,74,118.9,162,88,74,118.9
36330, 구례군,020,15~19세,2018,829,426,403,105.7,822,423,399,106
36330, 구례군,020001, 15세,2018,164,84,80,105,164,84,80,105
36330, 구례군,020002, 16세,2018,156,80,76,105.3,156,80,76,105.3
36330, 구례군,020003, 17세,2018,195,94,101,93.1,195,94,101,93.1
36330, 구례군,020004, 18세,2018,186,92,94,97.9,186,92,94,97.9
36330, 구례군,020005, 19세,2018,128,76,52,146.2,121,73,48,152.1
36330, 구례군,025,20~24세,2018,922,545,377,144.6,883,524,359,146
36330, 구례군,025001, 20세,2018,177,109,68,160.3,172,108,64,168.8
36330, 구례군,025002, 21세,2018,183,120,63,190.5,179,117,62,188.7
36330, 구례군,025003, 22세,2018,180,108,72,150,172,104,68,152.9
36330, 구례군,025004, 23세,2018,195,105,90,116.7,180,96,84,114.3
36330, 구례군,025005, 24세,2018,187,103,84,122.6,180,99,81,122.2
36330, 구례군,030,25~29세,2018,814,403,411,98.1,759,383,376,101.9
36330, 구례군,030001, 25세,2018,188,96,92,104.3,171,92,79,116.5
36330, 구례군,030002, 26세,2018,154,78,76,102.6,149,73,76,96.1
36330, 구례군,030003, 27세,2018,171,74,97,76.3,160,71,89,79.8
36330, 구례군,030004, 28세,2018,148,75,73,102.7,138,72,66,109.1
36330, 구례군,030005, 29세,2018,153,80,73,109.6,141,75,66,113.6
36330, 구례군,035,30~34세,2018,771,397,374,106.1,724,384,340,112.9
36330, 구례군,035001, 30세,2018,140,70,70,100,134,69,65,106.2
36330, 구례군,035002, 31세,2018,147,90,57,157.9,140,86,54,159.3
36330, 구례군,035003, 32세,2018,156,67,89,75.3,144,63,81,77.8
36330, 구례군,035004, 33세,2018,162,85,77,110.4,151,83,68,122.1
36330, 구례군,035005, 34세,2018,166,85,81,104.9,155,83,72,115.3
36330, 구례군,040,35~39세,2018,1089,586,503,116.5,1055,579,476,121.6
36330, 구례군,040001, 35세,2018,207,106,101,105,197,104,93,111.8
36330, 구례군,040002, 36세,2018,230,125,105,119,221,124,97,127.8
36330, 구례군,040003, 37세,2018,212,128,84,152.4,209,127,82,154.9
36330, 구례군,040004, 38세,2018,223,118,105,112.4,216,116,100,116
36330, 구례군,040005, 39세,2018,217,109,108,100.9,212,108,104,103.8
36330, 구례군,045,40~44세,2018,1275,658,617,106.6,1247,653,594,109.9
36330, 구례군,045001, 40세,2018,223,117,106,110.4,220,117,103,113.6
36330, 구례군,045002, 41세,2018,238,121,117,103.4,231,118,113,104.4
36330, 구례군,045003, 42세,2018,262,123,139,88.5,257,123,134,91.8
36330, 구례군,045004, 43세,2018,241,121,120,100.8,236,121,115,105.2
36330, 구례군,045005, 44세,2018,311,176,135,130.4,303,174,129,134.9
36330, 구례군,050,45~49세,2018,1803,1018,785,129.7,1776,1007,769,130.9
36330, 구례군,050001, 45세,2018,337,182,155,117.4,332,180,152,118.4
36330, 구례군,050002, 46세,2018,300,165,135,122.2,295,163,132,123.5
36330, 구례군,050003, 47세,2018,367,222,145,153.1,361,220,141,156
36330, 구례군,050004, 48세,2018,370,209,161,129.8,366,206,160,128.8
36330, 구례군,050005, 49세,2018,429,240,189,127,422,238,184,129.3
36330, 구례군,055,50~54세,2018,1973,1083,890,121.7,1947,1075,872,123.3
36330, 구례군,055001, 50세,2018,390,221,169,130.8,383,220,163,135
36330, 구례군,055002, 51세,2018,386,214,172,124.4,383,214,169,126.6
36330, 구례군,055003, 52세,2018,397,222,175,126.9,390,220,170,129.4
36330, 구례군,055004, 53세,2018,414,218,196,111.2,409,216,193,111.9
36330, 구례군,055005, 54세,2018,386,208,178,116.9,382,205,177,115.8
36330, 구례군,060,55~59세,2018,2456,1282,1174,109.2,2426,1270,1156,109.9
36330, 구례군,060001, 55세,2018,393,210,183,114.8,386,207,179,115.6
36330, 구례군,060002, 56세,2018,476,251,225,111.6,466,249,217,114.7
36330, 구례군,060003, 57세,2018,516,269,247,108.9,514,269,245,109.8
36330, 구례군,060004, 58세,2018,568,302,266,113.5,563,298,265,112.5
36330, 구례군,060005, 59세,2018,503,250,253,98.8,497,247,250,98.8
36330, 구례군,065,60~64세,2018,2092,1030,1062,97,2073,1021,1052,97.1
36330, 구례군,065001, 60세,2018,455,221,234,94.4,451,220,231,95.2
36330, 구례군,065002, 61세,2018,418,216,202,106.9,412,213,199,107
36330, 구례군,065003, 62세,2018,382,182,200,91,377,179,198,90.4
36330, 구례군,065004, 63세,2018,430,225,205,109.8,429,225,204,110.3
36330, 구례군,065005, 64세,2018,407,186,221,84.2,404,184,220,83.6
36330, 구례군,070,65~69세,2018,1803,837,966,86.6,1799,837,962,87
36330, 구례군,070001, 65세,2018,324,141,183,77,324,141,183,77
36330, 구례군,070002, 66세,2018,395,196,199,98.5,395,196,199,98.5
36330, 구례군,070003, 67세,2018,361,165,196,84.2,360,165,195,84.6
36330, 구례군,070004, 68세,2018,361,175,186,94.1,359,175,184,95.1
36330, 구례군,070005, 69세,2018,362,160,202,79.2,361,160,201,79.6
36330, 구례군,075,70~74세,2018,1777,787,990,79.5,1774,784,990,79.2
36330, 구례군,075001, 70세,2018,347,167,180,92.8,345,165,180,91.7
36330, 구례군,075002, 71세,2018,415,180,235,76.6,414,179,235,76.2
36330, 구례군,075003, 72세,2018,351,162,189,85.7,351,162,189,85.7
36330, 구례군,075004, 73세,2018,314,131,183,71.6,314,131,183,71.6
36330, 구례군,075005, 74세,2018,350,147,203,72.4,350,147,203,72.4
36330, 구례군,080,75~79세,2018,2094,784,1310,59.8,2092,783,1309,59.8
36330, 구례군,080001, 75세,2018,357,133,224,59.4,356,133,223,59.6
36330, 구례군,080002, 76세,2018,527,194,333,58.3,527,194,333,58.3
36330, 구례군,080003, 77세,2018,434,175,259,67.6,433,174,259,67.2
36330, 구례군,080004, 78세,2018,371,127,244,52,371,127,244,52
36330, 구례군,080005, 79세,2018,405,155,250,62,405,155,250,62
36330, 구례군,085,80~84세,2018,1443,506,937,54,1443,506,937,54
36330, 구례군,085001, 80세,2018,325,130,195,66.7,325,130,195,66.7
36330, 구례군,085002, 81세,2018,332,114,218,52.3,332,114,218,52.3
36330, 구례군,085003, 82세,2018,288,103,185,55.7,288,103,185,55.7
36330, 구례군,085004, 83세,2018,267,90,177,50.8,267,90,177,50.8
36330, 구례군,085005, 84세,2018,231,69,162,42.6,231,69,162,42.6
36330, 구례군,090,85~89세,2018,732,199,533,37.3,731,199,532,37.4
36330, 구례군,090001, 85세,2018,169,45,124,36.3,168,45,123,36.6
36330, 구례군,090002, 86세,2018,172,55,117,47,172,55,117,47
36330, 구례군,090003, 87세,2018,118,39,79,49.4,118,39,79,49.4
36330, 구례군,090004, 88세,2018,174,40,134,29.9,174,40,134,29.9
36330, 구례군,090005, 89세,2018,99,20,79,25.3,99,20,79,25.3
36330, 구례군,095,90~94세,2018,225,47,178,26.4,225,47,178,26.4
36330, 구례군,095001, 90세,2018,86,17,69,24.6,86,17,69,24.6
36330, 구례군,095002, 91세,2018,57,12,45,26.7,57,12,45,26.7
36330, 구례군,095003, 92세,2018,34,X,30,13.3,34,X,30,13.3
36330, 구례군,095004, 93세,2018,31,9,22,40.9,31,9,22,40.9
36330, 구례군,095005, 94세,2018,17,5,12,41.7,17,5,12,41.7
36330, 구례군,100,95~99세,2018,47,7,40,17.5,47,7,40,17.5
36330, 구례군,100001, 95세,2018,14,X,13,7.7,14,X,13,7.7
36330, 구례군,100002, 96세,2018,14,X,12,16.7,14,X,12,16.7
36330, 구례군,100003, 97세,2018,8,X,5,60,8,X,5,60
36330, 구례군,100004, 98세,2018,10,X,9,11.1,10,X,9,11.1
36330, 구례군,100005, 99세,2018,X,X,X,0,X,X,X,0
36330, 구례군,101,100세이상,2018,X,X,X,50,X,X,X,50
36330, 구례군,102,15세미만,2018,2098,1073,1025,104.7,2098,1073,1025,104.7
36330, 구례군,103,15~64세,2018,14024,7428,6596,112.6,13712,7319,6393,114.5
36330, 구례군,104,65세이상,2018,8124,3168,4956,63.9,8114,3164,4950,63.9
36330, 구례군,086,85세이상,2018,1007,254,753,33.7,1006,254,752,33.8
36330, 구례군,126,평균연령,2018,52.7,50.1,55.1,,52.9,50.2,55.4,
36330, 구례군,127,중위연령,2018,56.3,53.3,58.9,,56.6,53.5,59.3,
36350, 고흥군,000,합계,2018,60664,29495,31169,94.6,59398,28675,30723,93.3
36350, 고흥군,005,0~4세,2018,1214,583,631,92.4,1214,583,631,92.4
36350, 고흥군,005001, 0세,2018,225,102,123,82.9,225,102,123,82.9
36350, 고흥군,005002, 1세,2018,231,112,119,94.1,231,112,119,94.1
36350, 고흥군,005003, 2세,2018,260,124,136,91.2,260,124,136,91.2
36350, 고흥군,005004, 3세,2018,245,120,125,96,245,120,125,96
36350, 고흥군,005005, 4세,2018,253,125,128,97.7,253,125,128,97.7
36350, 고흥군,010,5~9세,2018,1496,780,716,108.9,1495,779,716,108.8
36350, 고흥군,010001, 5세,2018,274,147,127,115.7,274,147,127,115.7
36350, 고흥군,010002, 6세,2018,317,162,155,104.5,316,161,155,103.9
36350, 고흥군,010003, 7세,2018,313,165,148,111.5,313,165,148,111.5
36350, 고흥군,010004, 8세,2018,301,153,148,103.4,301,153,148,103.4
36350, 고흥군,010005, 9세,2018,291,153,138,110.9,291,153,138,110.9
36350, 고흥군,015,10~14세,2018,1666,897,769,116.6,1664,895,769,116.4
36350, 고흥군,015001, 10세,2018,307,162,145,111.7,307,162,145,111.7
36350, 고흥군,015002, 11세,2018,340,183,157,116.6,340,183,157,116.6
36350, 고흥군,015003, 12세,2018,335,184,151,121.9,334,183,151,121.2
36350, 고흥군,015004, 13세,2018,349,183,166,110.2,348,182,166,109.6
36350, 고흥군,015005, 14세,2018,335,185,150,123.3,335,185,150,123.3
36350, 고흥군,020,15~19세,2018,1909,1056,853,123.8,1896,1052,844,124.6
36350, 고흥군,020001, 15세,2018,356,203,153,132.7,355,202,153,132
36350, 고흥군,020002, 16세,2018,396,204,192,106.3,394,204,190,107.4
36350, 고흥군,020003, 17세,2018,434,235,199,118.1,434,235,199,118.1
36350, 고흥군,020004, 18세,2018,405,219,186,117.7,403,219,184,119
36350, 고흥군,020005, 19세,2018,318,195,123,158.5,310,192,118,162.7
36350, 고흥군,025,20~24세,2018,2022,1292,730,177,1832,1156,676,171
36350, 고흥군,025001, 20세,2018,401,265,136,194.9,387,257,130,197.7
36350, 고흥군,025002, 21세,2018,400,276,124,222.6,379,262,117,223.9
36350, 고흥군,025003, 22세,2018,388,256,132,193.9,349,228,121,188.4
36350, 고흥군,025004, 23세,2018,403,244,159,153.5,354,207,147,140.8
36350, 고흥군,025005, 24세,2018,430,251,179,140.2,363,202,161,125.5
36350, 고흥군,030,25~29세,2018,1884,1075,809,132.9,1528,800,728,109.9
36350, 고흥군,030001, 25세,2018,422,231,191,120.9,334,166,168,98.8
36350, 고흥군,030002, 26세,2018,409,248,161,154,320,173,147,117.7
36350, 고흥군,030003, 27세,2018,352,203,149,136.2,277,146,131,111.5
36350, 고흥군,030004, 28세,2018,381,213,168,126.8,330,173,157,110.2
36350, 고흥군,030005, 29세,2018,320,180,140,128.6,267,142,125,113.6
36350, 고흥군,035,30~34세,2018,1845,1010,835,121,1599,851,748,113.8
36350, 고흥군,035001, 30세,2018,379,217,162,134,318,174,144,120.8
36350, 고흥군,035002, 31세,2018,364,185,179,103.4,309,152,157,96.8
36350, 고흥군,035003, 32세,2018,365,208,157,132.5,316,178,138,129
36350, 고흥군,035004, 33세,2018,329,178,151,117.9,283,148,135,109.6
36350, 고흥군,035005, 34세,2018,408,222,186,119.4,373,199,174,114.4
36350, 고흥군,040,35~39세,2018,2267,1216,1051,115.7,2146,1145,1001,114.4
36350, 고흥군,040001, 35세,2018,382,195,187,104.3,354,176,178,98.9
36350, 고흥군,040002, 36세,2018,477,277,200,138.5,451,261,190,137.4
36350, 고흥군,040003, 37세,2018,444,254,190,133.7,423,242,181,133.7
36350, 고흥군,040004, 38세,2018,485,235,250,94,456,221,235,94
36350, 고흥군,040005, 39세,2018,479,255,224,113.8,462,245,217,112.9
36350, 고흥군,045,40~44세,2018,2744,1568,1176,133.3,2651,1509,1142,132.1
36350, 고흥군,045001, 40세,2018,470,270,200,135,451,256,195,131.3
36350, 고흥군,045002, 41세,2018,512,282,230,122.6,494,273,221,123.5
36350, 고흥군,045003, 42세,2018,563,334,229,145.9,547,320,227,141
36350, 고흥군,045004, 43세,2018,532,298,234,127.4,506,284,222,127.9
36350, 고흥군,045005, 44세,2018,667,384,283,135.7,653,376,277,135.7
36350, 고흥군,050,45~49세,2018,3645,2156,1489,144.8,3580,2135,1445,147.8
36350, 고흥군,050001, 45세,2018,666,412,254,162.2,651,404,247,163.6
36350, 고흥군,050002, 46세,2018,682,400,282,141.8,669,395,274,144.2
36350, 고흥군,050003, 47세,2018,737,438,299,146.5,722,435,287,151.6
36350, 고흥군,050004, 48세,2018,778,438,340,128.8,773,437,336,130.1
36350, 고흥군,050005, 49세,2018,782,468,314,149,765,464,301,154.2
36350, 고흥군,055,50~54세,2018,4329,2375,1954,121.5,4268,2346,1922,122.1
36350, 고흥군,055001, 50세,2018,907,534,373,143.2,892,524,368,142.4
36350, 고흥군,055002, 51세,2018,778,427,351,121.7,762,420,342,122.8
36350, 고흥군,055003, 52세,2018,855,480,375,128,843,474,369,128.5
36350, 고흥군,055004, 53세,2018,908,471,437,107.8,900,469,431,108.8
36350, 고흥군,055005, 54세,2018,881,463,418,110.8,871,459,412,111.4
36350, 고흥군,060,55~59세,2018,5892,3052,2840,107.5,5843,3026,2817,107.4
36350, 고흥군,060001, 55세,2018,1022,570,452,126.1,1010,564,446,126.5
36350, 고흥군,060002, 56세,2018,1064,578,486,118.9,1050,570,480,118.8
36350, 고흥군,060003, 57세,2018,1212,608,604,100.7,1202,602,600,100.3
36350, 고흥군,060004, 58세,2018,1300,646,654,98.8,1292,642,650,98.8
36350, 고흥군,060005, 59세,2018,1294,650,644,100.9,1289,648,641,101.1
36350, 고흥군,065,60~64세,2018,5756,2833,2923,96.9,5714,2811,2903,96.8
36350, 고흥군,065001, 60세,2018,1180,580,600,96.7,1176,579,597,97
36350, 고흥군,065002, 61세,2018,1153,561,592,94.8,1144,555,589,94.2
36350, 고흥군,065003, 62세,2018,1045,518,527,98.3,1036,514,522,98.5
36350, 고흥군,065004, 63세,2018,1268,637,631,101,1257,630,627,100.5
36350, 고흥군,065005, 64세,2018,1110,537,573,93.7,1101,533,568,93.8
36350, 고흥군,070,65~69세,2018,5557,2647,2910,91,5542,2638,2904,90.8
36350, 고흥군,070001, 65세,2018,968,453,515,88,966,452,514,87.9
36350, 고흥군,070002, 66세,2018,1144,554,590,93.9,1139,551,588,93.7
36350, 고흥군,070003, 67세,2018,1143,558,585,95.4,1140,557,583,95.5
36350, 고흥군,070004, 68세,2018,1155,539,616,87.5,1151,536,615,87.2
36350, 고흥군,070005, 69세,2018,1147,543,604,89.9,1146,542,604,89.7
36350, 고흥군,075,70~74세,2018,5173,2314,2859,80.9,5167,2311,2856,80.9
36350, 고흥군,075001, 70세,2018,1116,542,574,94.4,1114,542,572,94.8
36350, 고흥군,075002, 71세,2018,1293,595,698,85.2,1292,594,698,85.1
36350, 고흥군,075003, 72세,2018,854,376,478,78.7,852,374,478,78.2
36350, 고흥군,075004, 73세,2018,983,394,589,66.9,982,394,588,67
36350, 고흥군,075005, 74세,2018,927,407,520,78.3,927,407,520,78.3
36350, 고흥군,080,75~79세,2018,5963,2399,3564,67.3,5960,2398,3562,67.3
36350, 고흥군,080001, 75세,2018,1096,465,631,73.7,1096,465,631,73.7
36350, 고흥군,080002, 76세,2018,1402,612,790,77.5,1399,611,788,77.5
36350, 고흥군,080003, 77세,2018,1217,498,719,69.3,1217,498,719,69.3
36350, 고흥군,080004, 78세,2018,1156,437,719,60.8,1156,437,719,60.8
36350, 고흥군,080005, 79세,2018,1092,387,705,54.9,1092,387,705,54.9
36350, 고흥군,085,80~84세,2018,4120,1417,2703,52.4,4117,1415,2702,52.4
36350, 고흥군,085001, 80세,2018,899,315,584,53.9,899,315,584,53.9
36350, 고흥군,085002, 81세,2018,977,351,626,56.1,975,350,625,56
36350, 고흥군,085003, 82세,2018,830,299,531,56.3,829,298,531,56.1
36350, 고흥군,085004, 83세,2018,727,254,473,53.7,727,254,473,53.7
36350, 고흥군,085005, 84세,2018,687,198,489,40.5,687,198,489,40.5
36350, 고흥군,090,85~89세,2018,2351,658,1693,38.9,2351,658,1693,38.9
36350, 고흥군,090001, 85세,2018,640,192,448,42.9,640,192,448,42.9
36350, 고흥군,090002, 86세,2018,559,157,402,39.1,559,157,402,39.1
36350, 고흥군,090003, 87세,2018,386,95,291,32.6,386,95,291,32.6
36350, 고흥군,090004, 88세,2018,416,111,305,36.4,416,111,305,36.4
36350, 고흥군,090005, 89세,2018,350,103,247,41.7,350,103,247,41.7
36350, 고흥군,095,90~94세,2018,606,138,468,29.5,606,138,468,29.5
36350, 고흥군,095001, 90세,2018,197,57,140,40.7,197,57,140,40.7
36350, 고흥군,095002, 91세,2018,144,29,115,25.2,144,29,115,25.2
36350, 고흥군,095003, 92세,2018,111,21,90,23.3,111,21,90,23.3
36350, 고흥군,095004, 93세,2018,91,19,72,26.4,91,19,72,26.4
36350, 고흥군,095005, 94세,2018,63,12,51,23.5,63,12,51,23.5
36350, 고흥군,100,95~99세,2018,203,26,177,14.7,203,26,177,14.7
36350, 고흥군,100001, 95세,2018,84,8,76,10.5,84,8,76,10.5
36350, 고흥군,100002, 96세,2018,53,13,40,32.5,53,13,40,32.5
36350, 고흥군,100003, 97세,2018,29,X,26,11.5,29,X,26,11.5
36350, 고흥군,100004, 98세,2018,23,X,22,4.5,23,X,22,4.5
36350, 고흥군,100005, 99세,2018,14,X,13,7.7,14,X,13,7.7
36350, 고흥군,101,100세이상,2018,22,X,19,15.8,22,X,19,15.8
36350, 고흥군,102,15세미만,2018,4376,2260,2116,106.8,4373,2257,2116,106.7
36350, 고흥군,103,15~64세,2018,32293,17633,14660,120.3,31057,16831,14226,118.3
36350, 고흥군,104,65세이상,2018,23995,9602,14393,66.7,23968,9587,14381,66.7
36350, 고흥군,086,85세이상,2018,3182,825,2357,35,3182,825,2357,35
36350, 고흥군,126,평균연령,2018,55.4,52.3,58.4,,55.8,52.8,58.7,
36350, 고흥군,127,중위연령,2018,59.6,56.3,63,,60,56.9,63.3,
36360, 보성군,000,합계,2018,39373,18873,20500,92.1,38755,18621,20134,92.5
36360, 보성군,005,0~4세,2018,1039,531,508,104.5,1037,531,506,104.9
36360, 보성군,005001, 0세,2018,166,86,80,107.5,166,86,80,107.5
36360, 보성군,005002, 1세,2018,220,114,106,107.5,220,114,106,107.5
36360, 보성군,005003, 2세,2018,228,104,124,83.9,227,104,123,84.6
36360, 보성군,005004, 3세,2018,217,115,102,112.7,216,115,101,113.9
36360, 보성군,005005, 4세,2018,208,112,96,116.7,208,112,96,116.7
36360, 보성군,010,5~9세,2018,1075,547,528,103.6,1074,546,528,103.4
36360, 보성군,010001, 5세,2018,217,114,103,110.7,217,114,103,110.7
36360, 보성군,010002, 6세,2018,205,117,88,133,204,116,88,131.8
36360, 보성군,010003, 7세,2018,245,126,119,105.9,245,126,119,105.9
36360, 보성군,010004, 8세,2018,208,98,110,89.1,208,98,110,89.1
36360, 보성군,010005, 9세,2018,200,92,108,85.2,200,92,108,85.2
36360, 보성군,015,10~14세,2018,1186,606,580,104.5,1186,606,580,104.5
36360, 보성군,015001, 10세,2018,205,94,111,84.7,205,94,111,84.7
36360, 보성군,015002, 11세,2018,254,133,121,109.9,254,133,121,109.9
36360, 보성군,015003, 12세,2018,220,114,106,107.5,220,114,106,107.5
36360, 보성군,015004, 13세,2018,232,120,112,107.1,232,120,112,107.1
36360, 보성군,015005, 14세,2018,275,145,130,111.5,275,145,130,111.5
36360, 보성군,020,15~19세,2018,1743,933,810,115.2,1720,932,788,118.3
36360, 보성군,020001, 15세,2018,309,171,138,123.9,309,171,138,123.9
36360, 보성군,020002, 16세,2018,390,205,185,110.8,386,205,181,113.3
36360, 보성군,020003, 17세,2018,428,215,213,100.9,425,215,210,102.4
36360, 보성군,020004, 18세,2018,398,211,187,112.8,394,211,183,115.3
36360, 보성군,020005, 19세,2018,218,131,87,150.6,206,130,76,171.1
36360, 보성군,025,20~24세,2018,1509,916,593,154.5,1418,873,545,160.2
36360, 보성군,025001, 20세,2018,302,197,105,187.6,294,195,99,197
36360, 보성군,025002, 21세,2018,313,185,128,144.5,299,178,121,147.1
36360, 보성군,025003, 22세,2018,309,193,116,166.4,295,186,109,170.6
36360, 보성군,025004, 23세,2018,291,173,118,146.6,263,158,105,150.5
36360, 보성군,025005, 24세,2018,294,168,126,133.3,267,156,111,140.5
36360, 보성군,030,25~29세,2018,1306,694,612,113.4,1146,617,529,116.6
36360, 보성군,030001, 25세,2018,255,143,112,127.7,222,126,96,131.3
36360, 보성군,030002, 26세,2018,292,146,146,100,252,129,123,104.9
36360, 보성군,030003, 27세,2018,261,140,121,115.7,237,127,110,115.5
36360, 보성군,030004, 28세,2018,266,140,126,111.1,233,123,110,111.8
36360, 보성군,030005, 29세,2018,232,125,107,116.8,202,112,90,124.4
36360, 보성군,035,30~34세,2018,1302,640,662,96.7,1194,600,594,101
36360, 보성군,035001, 30세,2018,227,108,119,90.8,205,102,103,99
36360, 보성군,035002, 31세,2018,288,148,140,105.7,257,133,124,107.3
36360, 보성군,035003, 32세,2018,294,151,143,105.6,268,142,126,112.7
36360, 보성군,035004, 33세,2018,231,103,128,80.5,216,97,119,81.5
36360, 보성군,035005, 34세,2018,262,130,132,98.5,248,126,122,103.3
36360, 보성군,040,35~39세,2018,1605,841,764,110.1,1525,809,716,113
36360, 보성군,040001, 35세,2018,305,158,147,107.5,279,145,134,108.2
36360, 보성군,040002, 36세,2018,349,173,176,98.3,329,165,164,100.6
36360, 보성군,040003, 37세,2018,310,170,140,121.4,293,164,129,127.1
36360, 보성군,040004, 38세,2018,328,171,157,108.9,315,167,148,112.8
36360, 보성군,040005, 39세,2018,313,169,144,117.4,309,168,141,119.1
36360, 보성군,045,40~44세,2018,1793,996,797,125,1745,978,767,127.5
36360, 보성군,045001, 40세,2018,331,180,151,119.2,320,177,143,123.8
36360, 보성군,045002, 41세,2018,385,208,177,117.5,375,203,172,118
36360, 보성군,045003, 42세,2018,348,190,158,120.3,339,187,152,123
36360, 보성군,045004, 43세,2018,295,170,125,136,288,167,121,138
36360, 보성군,045005, 44세,2018,434,248,186,133.3,423,244,179,136.3
36360, 보성군,050,45~49세,2018,2397,1368,1029,132.9,2368,1358,1010,134.5
36360, 보성군,050001, 45세,2018,423,264,159,166,419,263,156,168.6
36360, 보성군,050002, 46세,2018,455,251,204,123,449,250,199,125.6
36360, 보성군,050003, 47세,2018,505,280,225,124.4,499,279,220,126.8
36360, 보성군,050004, 48세,2018,503,288,215,134,498,286,212,134.9
36360, 보성군,050005, 49세,2018,511,285,226,126.1,503,280,223,125.6
36360, 보성군,055,50~54세,2018,2895,1604,1291,124.2,2860,1590,1270,125.2
36360, 보성군,055001, 50세,2018,608,343,265,129.4,601,341,260,131.2
36360, 보성군,055002, 51세,2018,546,296,250,118.4,536,292,244,119.7
36360, 보성군,055003, 52세,2018,555,328,227,144.5,550,324,226,143.4
36360, 보성군,055004, 53세,2018,580,301,279,107.9,574,300,274,109.5
36360, 보성군,055005, 54세,2018,606,336,270,124.4,599,333,266,125.2
36360, 보성군,060,55~59세,2018,3586,1837,1749,105,3567,1829,1738,105.2
36360, 보성군,060001, 55세,2018,641,326,315,103.5,633,323,310,104.2
36360, 보성군,060002, 56세,2018,681,359,322,111.5,681,359,322,111.5
36360, 보성군,060003, 57세,2018,681,350,331,105.7,678,348,330,105.5
36360, 보성군,060004, 58세,2018,767,385,382,100.8,761,383,378,101.3
36360, 보성군,060005, 59세,2018,816,417,399,104.5,814,416,398,104.5
36360, 보성군,065,60~64세,2018,3463,1730,1733,99.8,3449,1725,1724,100.1
36360, 보성군,065001, 60세,2018,717,355,362,98.1,715,354,361,98.1
36360, 보성군,065002, 61세,2018,746,381,365,104.4,741,378,363,104.1
36360, 보성군,065003, 62세,2018,654,335,319,105,652,335,317,105.7
36360, 보성군,065004, 63세,2018,722,362,360,100.6,718,361,357,101.1
36360, 보성군,065005, 64세,2018,624,297,327,90.8,623,297,326,91.1
36360, 보성군,070,65~69세,2018,3214,1497,1717,87.2,3209,1495,1714,87.2
36360, 보성군,070001, 65세,2018,571,257,314,81.8,569,257,312,82.4
36360, 보성군,070002, 66세,2018,687,327,360,90.8,685,325,360,90.3
36360, 보성군,070003, 67세,2018,642,305,337,90.5,641,305,336,90.8
36360, 보성군,070004, 68세,2018,652,302,350,86.3,652,302,350,86.3
36360, 보성군,070005, 69세,2018,662,306,356,86,662,306,356,86
36360, 보성군,075,70~74세,2018,2926,1340,1586,84.5,2925,1340,1585,84.5
36360, 보성군,075001, 70세,2018,660,325,335,97,660,325,335,97
36360, 보성군,075002, 71세,2018,709,329,380,86.6,708,329,379,86.8
36360, 보성군,075003, 72세,2018,504,243,261,93.1,504,243,261,93.1
36360, 보성군,075004, 73세,2018,539,225,314,71.7,539,225,314,71.7
36360, 보성군,075005, 74세,2018,514,218,296,73.6,514,218,296,73.6
36360, 보성군,080,75~79세,2018,3628,1405,2223,63.2,3627,1404,2223,63.2
36360, 보성군,080001, 75세,2018,687,261,426,61.3,686,260,426,61
36360, 보성군,080002, 76세,2018,852,339,513,66.1,852,339,513,66.1
36360, 보성군,080003, 77세,2018,725,282,443,63.7,725,282,443,63.7
36360, 보성군,080004, 78세,2018,669,255,414,61.6,669,255,414,61.6
36360, 보성군,080005, 79세,2018,695,268,427,62.8,695,268,427,62.8
36360, 보성군,085,80~84세,2018,2696,885,1811,48.9,2695,885,1810,48.9
36360, 보성군,085001, 80세,2018,644,229,415,55.2,643,229,414,55.3
36360, 보성군,085002, 81세,2018,602,207,395,52.4,602,207,395,52.4
36360, 보성군,085003, 82세,2018,515,174,341,51,515,174,341,51
36360, 보성군,085004, 83세,2018,480,150,330,45.5,480,150,330,45.5
36360, 보성군,085005, 84세,2018,455,125,330,37.9,455,125,330,37.9
36360, 보성군,090,85~89세,2018,1433,374,1059,35.3,1433,374,1059,35.3
36360, 보성군,090001, 85세,2018,360,116,244,47.5,360,116,244,47.5
36360, 보성군,090002, 86세,2018,368,94,274,34.3,368,94,274,34.3
36360, 보성군,090003, 87세,2018,272,69,203,34,272,69,203,34
36360, 보성군,090004, 88세,2018,266,59,207,28.5,266,59,207,28.5
36360, 보성군,090005, 89세,2018,167,36,131,27.5,167,36,131,27.5
36360, 보성군,095,90~94세,2018,450,104,346,30.1,450,104,346,30.1
36360, 보성군,095001, 90세,2018,167,37,130,28.5,167,37,130,28.5
36360, 보성군,095002, 91세,2018,118,30,88,34.1,118,30,88,34.1
36360, 보성군,095003, 92세,2018,74,18,56,32.1,74,18,56,32.1
36360, 보성군,095004, 93세,2018,45,8,37,21.6,45,8,37,21.6
36360, 보성군,095005, 94세,2018,46,11,35,31.4,46,11,35,31.4
36360, 보성군,100,95~99세,2018,99,20,79,25.3,99,20,79,25.3
36360, 보성군,100001, 95세,2018,44,9,35,25.7,44,9,35,25.7
36360, 보성군,100002, 96세,2018,33,6,27,22.2,33,6,27,22.2
36360, 보성군,100003, 97세,2018,9,X,5,80,9,X,5,80
36360, 보성군,100004, 98세,2018,9,X,8,12.5,9,X,8,12.5
36360, 보성군,100005, 99세,2018,X,X,X,0,X,X,X,0
36360, 보성군,101,100세이상,2018,28,5,23,21.7,28,5,23,21.7
36360, 보성군,102,15세미만,2018,3300,1684,1616,104.2,3297,1683,1614,104.3
36360, 보성군,103,15~64세,2018,21599,11559,10040,115.1,20992,11311,9681,116.8
36360, 보성군,104,65세이상,2018,14474,5630,8844,63.7,14466,5627,8839,63.7
36360, 보성군,086,85세이상,2018,2010,503,1507,33.4,2010,503,1507,33.4
36360, 보성군,126,평균연령,2018,53.4,50.4,56.2,,53.7,50.6,56.6,
36360, 보성군,127,중위연령,2018,57.8,54.3,60.9,,58.1,54.6,61.4,
36370, 화순군,000,합계,2018,60040,29062,30978,93.8,58834,28504,30330,94
36370, 화순군,005,0~4세,2018,1600,794,806,98.5,1593,790,803,98.4
36370, 화순군,005001, 0세,2018,260,125,135,92.6,259,124,135,91.9
36370, 화순군,005002, 1세,2018,316,162,154,105.2,313,160,153,104.6
36370, 화순군,005003, 2세,2018,301,152,149,102,300,152,148,102.7
36370, 화순군,005004, 3세,2018,358,178,180,98.9,357,177,180,98.3
36370, 화순군,005005, 4세,2018,365,177,188,94.1,364,177,187,94.7
36370, 화순군,010,5~9세,2018,2246,1166,1080,108,2243,1165,1078,108.1
36370, 화순군,010001, 5세,2018,411,225,186,121,411,225,186,121
36370, 화순군,010002, 6세,2018,445,220,225,97.8,445,220,225,97.8
36370, 화순군,010003, 7세,2018,470,240,230,104.3,468,240,228,105.3
36370, 화순군,010004, 8세,2018,449,233,216,107.9,448,232,216,107.4
36370, 화순군,010005, 9세,2018,471,248,223,111.2,471,248,223,111.2
36370, 화순군,015,10~14세,2018,2623,1384,1239,111.7,2620,1382,1238,111.6
36370, 화순군,015001, 10세,2018,470,246,224,109.8,469,245,224,109.4
36370, 화순군,015002, 11세,2018,548,281,267,105.2,548,281,267,105.2
36370, 화순군,015003, 12세,2018,501,269,232,115.9,499,268,231,116
36370, 화순군,015004, 13세,2018,497,263,234,112.4,497,263,234,112.4
36370, 화순군,015005, 14세,2018,607,325,282,115.2,607,325,282,115.2
36370, 화순군,020,15~19세,2018,3508,1809,1699,106.5,3500,1805,1695,106.5
36370, 화순군,020001, 15세,2018,595,318,277,114.8,595,318,277,114.8
36370, 화순군,020002, 16세,2018,675,325,350,92.9,673,323,350,92.3
36370, 화순군,020003, 17세,2018,809,384,425,90.4,808,384,424,90.6
36370, 화순군,020004, 18세,2018,850,468,382,122.5,848,468,380,123.2
36370, 화순군,020005, 19세,2018,579,314,265,118.5,576,312,264,118.2
36370, 화순군,025,20~24세,2018,3233,1789,1444,123.9,3043,1685,1358,124.1
36370, 화순군,025001, 20세,2018,596,368,228,161.4,589,366,223,164.1
36370, 화순군,025002, 21세,2018,691,409,282,145,664,393,271,145
36370, 화순군,025003, 22세,2018,660,358,302,118.5,617,334,283,118
36370, 화순군,025004, 23세,2018,646,324,322,100.6,590,289,301,96
36370, 화순군,025005, 24세,2018,640,330,310,106.5,583,303,280,108.2
36370, 화순군,030,25~29세,2018,2798,1464,1334,109.7,2508,1320,1188,111.1
36370, 화순군,030001, 25세,2018,651,325,326,99.7,576,287,289,99.3
36370, 화순군,030002, 26세,2018,597,316,281,112.5,541,288,253,113.8
36370, 화순군,030003, 27세,2018,538,269,269,100,485,243,242,100.4
36370, 화순군,030004, 28세,2018,538,293,245,119.6,477,265,212,125
36370, 화순군,030005, 29세,2018,474,261,213,122.5,429,237,192,123.4
36370, 화순군,035,30~34세,2018,2210,1138,1072,106.2,2005,1038,967,107.3
36370, 화순군,035001, 30세,2018,452,227,225,100.9,407,204,203,100.5
36370, 화순군,035002, 31세,2018,411,203,208,97.6,364,180,184,97.8
36370, 화순군,035003, 32세,2018,422,209,213,98.1,380,190,190,100
36370, 화순군,035004, 33세,2018,430,236,194,121.6,389,215,174,123.6
36370, 화순군,035005, 34세,2018,495,263,232,113.4,465,249,216,115.3
36370, 화순군,040,35~39세,2018,3110,1526,1584,96.3,2978,1469,1509,97.3
36370, 화순군,040001, 35세,2018,546,272,274,99.3,521,262,259,101.2
36370, 화순군,040002, 36세,2018,597,287,310,92.6,567,276,291,94.8
36370, 화순군,040003, 37세,2018,606,302,304,99.3,582,289,293,98.6
36370, 화순군,040004, 38세,2018,679,335,344,97.4,643,319,324,98.5
36370, 화순군,040005, 39세,2018,682,330,352,93.8,665,323,342,94.4
36370, 화순군,045,40~44세,2018,3674,1864,1810,103,3574,1824,1750,104.2
36370, 화순군,045001, 40세,2018,649,318,331,96.1,630,311,319,97.5
36370, 화순군,045002, 41세,2018,684,348,336,103.6,670,343,327,104.9
36370, 화순군,045003, 42세,2018,667,335,332,100.9,647,329,318,103.5
36370, 화순군,045004, 43세,2018,733,376,357,105.3,713,367,346,106.1
36370, 화순군,045005, 44세,2018,941,487,454,107.3,914,474,440,107.7
36370, 화순군,050,45~49세,2018,4990,2583,2407,107.3,4918,2547,2371,107.4
36370, 화순군,050001, 45세,2018,903,427,476,89.7,891,417,474,88
36370, 화순군,050002, 46세,2018,930,479,451,106.2,916,471,445,105.8
36370, 화순군,050003, 47세,2018,1031,556,475,117.1,1018,550,468,117.5
36370, 화순군,050004, 48세,2018,1090,581,509,114.1,1073,576,497,115.9
36370, 화순군,050005, 49세,2018,1036,540,496,108.9,1020,533,487,109.4
36370, 화순군,055,50~54세,2018,5072,2726,2346,116.2,4997,2707,2290,118.2
36370, 화순군,055001, 50세,2018,1064,579,485,119.4,1049,575,474,121.3
36370, 화순군,055002, 51세,2018,992,507,485,104.5,978,504,474,106.3
36370, 화순군,055003, 52세,2018,1046,575,471,122.1,1030,568,462,122.9
36370, 화순군,055004, 53세,2018,990,544,446,122,981,541,440,123
36370, 화순군,055005, 54세,2018,980,521,459,113.5,959,519,440,118
36370, 화순군,060,55~59세,2018,5350,2794,2556,109.3,5292,2772,2520,110
36370, 화순군,060001, 55세,2018,1050,552,498,110.8,1036,546,490,111.4
36370, 화순군,060002, 56세,2018,995,506,489,103.5,984,502,482,104.1
36370, 화순군,060003, 57세,2018,1117,594,523,113.6,1105,589,516,114.1
36370, 화순군,060004, 58세,2018,1123,581,542,107.2,1112,577,535,107.9
36370, 화순군,060005, 59세,2018,1065,561,504,111.3,1055,558,497,112.3
36370, 화순군,065,60~64세,2018,4283,2163,2120,102,4245,2150,2095,102.6
36370, 화순군,065001, 60세,2018,960,489,471,103.8,947,486,461,105.4
36370, 화순군,065002, 61세,2018,989,489,500,97.8,981,487,494,98.6
36370, 화순군,065003, 62세,2018,761,396,365,108.5,758,395,363,108.8
36370, 화순군,065004, 63세,2018,861,443,418,106,851,437,414,105.6
36370, 화순군,065005, 64세,2018,712,346,366,94.5,708,345,363,95
36370, 화순군,070,65~69세,2018,3521,1680,1841,91.3,3509,1675,1834,91.3
36370, 화순군,070001, 65세,2018,678,331,347,95.4,677,331,346,95.7
36370, 화순군,070002, 66세,2018,792,372,420,88.6,787,369,418,88.3
36370, 화순군,070003, 67세,2018,631,296,335,88.4,628,295,333,88.6
36370, 화순군,070004, 68세,2018,682,329,353,93.2,680,328,352,93.2
36370, 화순군,070005, 69세,2018,738,352,386,91.2,737,352,385,91.4
36370, 화순군,075,70~74세,2018,3374,1401,1973,71,3366,1396,1970,70.9
36370, 화순군,075001, 70세,2018,751,328,423,77.5,748,326,422,77.3
36370, 화순군,075002, 71세,2018,787,347,440,78.9,786,346,440,78.6
36370, 화순군,075003, 72세,2018,569,238,331,71.9,568,238,330,72.1
36370, 화순군,075004, 73세,2018,657,246,411,59.9,655,244,411,59.4
36370, 화순군,075005, 74세,2018,610,242,368,65.8,609,242,367,65.9
36370, 화순군,080,75~79세,2018,3931,1436,2495,57.6,3928,1436,2492,57.6
36370, 화순군,080001, 75세,2018,727,282,445,63.4,726,282,444,63.5
36370, 화순군,080002, 76세,2018,1003,380,623,61,1003,380,623,61
36370, 화순군,080003, 77세,2018,787,284,503,56.5,785,284,501,56.7
36370, 화순군,080004, 78세,2018,710,249,461,54,710,249,461,54
36370, 화순군,080005, 79세,2018,704,241,463,52.1,704,241,463,52.1
36370, 화순군,085,80~84세,2018,2730,879,1851,47.5,2728,877,1851,47.4
36370, 화순군,085001, 80세,2018,663,221,442,50,662,220,442,49.8
36370, 화순군,085002, 81세,2018,607,213,394,54.1,607,213,394,54.1
36370, 화순군,085003, 82세,2018,548,176,372,47.3,548,176,372,47.3
36370, 화순군,085004, 83세,2018,488,144,344,41.9,488,144,344,41.9
36370, 화순군,085005, 84세,2018,424,125,299,41.8,423,124,299,41.5
36370, 화순군,090,85~89세,2018,1280,341,939,36.3,1280,341,939,36.3
36370, 화순군,090001, 85세,2018,329,93,236,39.4,329,93,236,39.4
36370, 화순군,090002, 86세,2018,300,80,220,36.4,300,80,220,36.4
36370, 화순군,090003, 87세,2018,236,61,175,34.9,236,61,175,34.9
36370, 화순군,090004, 88세,2018,252,58,194,29.9,252,58,194,29.9
36370, 화순군,090005, 89세,2018,163,49,114,43,163,49,114,43
36370, 화순군,095,90~94세,2018,398,110,288,38.2,398,110,288,38.2
36370, 화순군,095001, 90세,2018,130,39,91,42.9,130,39,91,42.9
36370, 화순군,095002, 91세,2018,103,27,76,35.5,103,27,76,35.5
36370, 화순군,095003, 92세,2018,75,17,58,29.3,75,17,58,29.3
36370, 화순군,095004, 93세,2018,45,13,32,40.6,45,13,32,40.6
36370, 화순군,095005, 94세,2018,45,14,31,45.2,45,14,31,45.2
36370, 화순군,100,95~99세,2018,98,15,83,18.1,98,15,83,18.1
36370, 화순군,100001, 95세,2018,46,8,38,21.1,46,8,38,21.1
36370, 화순군,100002, 96세,2018,18,X,16,12.5,18,X,16,12.5
36370, 화순군,100003, 97세,2018,17,X,13,30.8,17,X,13,30.8
36370, 화순군,100004, 98세,2018,9,X,9,0,9,X,9,0
36370, 화순군,100005, 99세,2018,8,X,7,14.3,8,X,7,14.3
36370, 화순군,101,100세이상,2018,11,X,11,0,11,X,11,0
36370, 화순군,102,15세미만,2018,6469,3344,3125,107,6456,3337,3119,107
36370, 화순군,103,15~64세,2018,38228,19856,18372,108.1,37060,19317,17743,108.9
36370, 화순군,104,65세이상,2018,15343,5862,9481,61.8,15318,5850,9468,61.8
36370, 화순군,086,85세이상,2018,1787,466,1321,35.3,1787,466,1321,35.3
36370, 화순군,126,평균연령,2018,47.6,45.3,49.8,,47.9,45.5,50.1,
36370, 화순군,127,중위연령,2018,50,48.2,52.1,,50.4,48.6,52.6,
36380, 장흥군,000,합계,2018,35875,17450,18425,94.7,35123,17096,18027,94.8
36380, 장흥군,005,0~4세,2018,928,486,442,110,926,486,440,110.5
36380, 장흥군,005001, 0세,2018,163,90,73,123.3,163,90,73,123.3
36380, 장흥군,005002, 1세,2018,149,88,61,144.3,147,88,59,149.2
36380, 장흥군,005003, 2세,2018,192,103,89,115.7,192,103,89,115.7
36380, 장흥군,005004, 3세,2018,216,108,108,100,216,108,108,100
36380, 장흥군,005005, 4세,2018,208,97,111,87.4,208,97,111,87.4
36380, 장흥군,010,5~9세,2018,1138,584,554,105.4,1137,584,553,105.6
36380, 장흥군,010001, 5세,2018,252,125,127,98.4,251,125,126,99.2
36380, 장흥군,010002, 6세,2018,225,120,105,114.3,225,120,105,114.3
36380, 장흥군,010003, 7세,2018,235,130,105,123.8,235,130,105,123.8
36380, 장흥군,010004, 8세,2018,209,107,102,104.9,209,107,102,104.9
36380, 장흥군,010005, 9세,2018,217,102,115,88.7,217,102,115,88.7
36380, 장흥군,015,10~14세,2018,1201,647,554,116.8,1197,644,553,116.5
36380, 장흥군,015001, 10세,2018,226,105,121,86.8,225,105,120,87.5
36380, 장흥군,015002, 11세,2018,240,129,111,116.2,240,129,111,116.2
36380, 장흥군,015003, 12세,2018,234,133,101,131.7,234,133,101,131.7
36380, 장흥군,015004, 13세,2018,225,127,98,129.6,222,124,98,126.5
36380, 장흥군,015005, 14세,2018,276,153,123,124.4,276,153,123,124.4
36380, 장흥군,020,15~19세,2018,1490,791,699,113.2,1479,787,692,113.7
36380, 장흥군,020001, 15세,2018,285,139,146,95.2,284,139,145,95.9
36380, 장흥군,020002, 16세,2018,271,138,133,103.8,270,138,132,104.5
36380, 장흥군,020003, 17세,2018,336,168,168,100,335,167,168,99.4
36380, 장흥군,020004, 18세,2018,357,207,150,138,354,207,147,140.8
36380, 장흥군,020005, 19세,2018,241,139,102,136.3,236,136,100,136
36380, 장흥군,025,20~24세,2018,1536,932,604,154.3,1427,872,555,157.1
36380, 장흥군,025001, 20세,2018,317,200,117,170.9,304,194,110,176.4
36380, 장흥군,025002, 21세,2018,303,199,104,191.3,287,188,99,189.9
36380, 장흥군,025003, 22세,2018,311,190,121,157,289,177,112,158
36380, 장흥군,025004, 23세,2018,305,170,135,125.9,278,157,121,129.8
36380, 장흥군,025005, 24세,2018,300,173,127,136.2,269,156,113,138.1
36380, 장흥군,030,25~29세,2018,1329,705,624,113,1170,611,559,109.3
36380, 장흥군,030001, 25세,2018,274,148,126,117.5,241,126,115,109.6
36380, 장흥군,030002, 26세,2018,281,148,133,111.3,250,127,123,103.3
36380, 장흥군,030003, 27세,2018,267,147,120,122.5,236,124,112,110.7
36380, 장흥군,030004, 28세,2018,250,125,125,100,215,107,108,99.1
36380, 장흥군,030005, 29세,2018,257,137,120,114.2,228,127,101,125.7
36380, 장흥군,035,30~34세,2018,1293,650,643,101.1,1169,588,581,101.2
36380, 장흥군,035001, 30세,2018,265,137,128,107,232,123,109,112.8
36380, 장흥군,035002, 31세,2018,257,128,129,99.2,231,116,115,100.9
36380, 장흥군,035003, 32세,2018,254,136,118,115.3,228,118,110,107.3
36380, 장흥군,035004, 33세,2018,239,106,133,79.7,221,99,122,81.1
36380, 장흥군,035005, 34세,2018,278,143,135,105.9,257,132,125,105.6
36380, 장흥군,040,35~39세,2018,1742,946,796,118.8,1641,902,739,122.1
36380, 장흥군,040001, 35세,2018,316,174,142,122.5,289,165,124,133.1
36380, 장흥군,040002, 36세,2018,366,200,166,120.5,347,191,156,122.4
36380, 장흥군,040003, 37세,2018,340,183,157,116.6,318,169,149,113.4
36380, 장흥군,040004, 38세,2018,384,209,175,119.4,365,202,163,123.9
36380, 장흥군,040005, 39세,2018,336,180,156,115.4,322,175,147,119
36380, 장흥군,045,40~44세,2018,1745,960,785,122.3,1689,943,746,126.4
36380, 장흥군,045001, 40세,2018,290,144,146,98.6,278,139,139,100
36380, 장흥군,045002, 41세,2018,347,199,148,134.5,333,194,139,139.6
36380, 장흥군,045003, 42세,2018,344,197,147,134,339,194,145,133.8
36380, 장흥군,045004, 43세,2018,361,195,166,117.5,343,191,152,125.7
36380, 장흥군,045005, 44세,2018,403,225,178,126.4,396,225,171,131.6
36380, 장흥군,050,45~49세,2018,2472,1342,1130,118.8,2411,1319,1092,120.8
36380, 장흥군,050001, 45세,2018,438,229,209,109.6,428,223,205,108.8
36380, 장흥군,050002, 46세,2018,443,233,210,111,434,231,203,113.8
36380, 장흥군,050003, 47세,2018,544,299,245,122,527,293,234,125.2
36380, 장흥군,050004, 48세,2018,504,287,217,132.3,490,281,209,134.4
36380, 장흥군,050005, 49세,2018,543,294,249,118.1,532,291,241,120.7
36380, 장흥군,055,50~54세,2018,2780,1496,1284,116.5,2741,1485,1256,118.2
36380, 장흥군,055001, 50세,2018,533,290,243,119.3,524,287,237,121.1
36380, 장흥군,055002, 51세,2018,538,287,251,114.3,533,286,247,115.8
36380, 장흥군,055003, 52세,2018,570,312,258,120.9,564,311,253,122.9
36380, 장흥군,055004, 53세,2018,587,309,278,111.2,577,306,271,112.9
36380, 장흥군,055005, 54세,2018,552,298,254,117.3,543,295,248,119
36380, 장흥군,060,55~59세,2018,3421,1749,1672,104.6,3376,1732,1644,105.4
36380, 장흥군,060001, 55세,2018,626,326,300,108.7,612,322,290,111
36380, 장흥군,060002, 56세,2018,610,318,292,108.9,605,317,288,110.1
36380, 장흥군,060003, 57세,2018,701,347,354,98,691,342,349,98
36380, 장흥군,060004, 58세,2018,766,401,365,109.9,756,397,359,110.6
36380, 장흥군,060005, 59세,2018,718,357,361,98.9,712,354,358,98.9
36380, 장흥군,065,60~64세,2018,3134,1541,1593,96.7,3111,1530,1581,96.8
36380, 장흥군,065001, 60세,2018,683,339,344,98.5,674,336,338,99.4
36380, 장흥군,065002, 61세,2018,657,331,326,101.5,653,329,324,101.5
36380, 장흥군,065003, 62세,2018,617,306,311,98.4,614,305,309,98.7
36380, 장흥군,065004, 63세,2018,635,319,316,100.9,632,316,316,100
36380, 장흥군,065005, 64세,2018,542,246,296,83.1,538,244,294,83
36380, 장흥군,070,65~69세,2018,2610,1279,1331,96.1,2596,1272,1324,96.1
36380, 장흥군,070001, 65세,2018,488,233,255,91.4,482,231,251,92
36380, 장흥군,070002, 66세,2018,549,282,267,105.6,547,281,266,105.6
36380, 장흥군,070003, 67세,2018,510,272,238,114.3,505,268,237,113.1
36380, 장흥군,070004, 68세,2018,549,258,291,88.7,548,258,290,89
36380, 장흥군,070005, 69세,2018,514,234,280,83.6,514,234,280,83.6
36380, 장흥군,075,70~74세,2018,2514,1137,1377,82.6,2512,1136,1376,82.6
36380, 장흥군,075001, 70세,2018,565,261,304,85.9,564,260,304,85.5
36380, 장흥군,075002, 71세,2018,602,273,329,83,602,273,329,83
36380, 장흥군,075003, 72세,2018,446,188,258,72.9,446,188,258,72.9
36380, 장흥군,075004, 73세,2018,454,202,252,80.2,453,202,251,80.5
36380, 장흥군,075005, 74세,2018,447,213,234,91,447,213,234,91
36380, 장흥군,080,75~79세,2018,2885,1125,1760,63.9,2884,1125,1759,64
36380, 장흥군,080001, 75세,2018,495,193,302,63.9,495,193,302,63.9
36380, 장흥군,080002, 76세,2018,696,270,426,63.4,696,270,426,63.4
36380, 장흥군,080003, 77세,2018,568,243,325,74.8,568,243,325,74.8
36380, 장흥군,080004, 78세,2018,569,218,351,62.1,569,218,351,62.1
36380, 장흥군,080005, 79세,2018,557,201,356,56.5,556,201,355,56.6
36380, 장흥군,085,80~84세,2018,2167,723,1444,50.1,2167,723,1444,50.1
36380, 장흥군,085001, 80세,2018,510,194,316,61.4,510,194,316,61.4
36380, 장흥군,085002, 81세,2018,433,148,285,51.9,433,148,285,51.9
36380, 장흥군,085003, 82세,2018,435,143,292,49,435,143,292,49
36380, 장흥군,085004, 83세,2018,420,132,288,45.8,420,132,288,45.8
36380, 장흥군,085005, 84세,2018,369,106,263,40.3,369,106,263,40.3
36380, 장흥군,090,85~89세,2018,1130,280,850,32.9,1130,280,850,32.9
36380, 장흥군,090001, 85세,2018,283,78,205,38,283,78,205,38
36380, 장흥군,090002, 86세,2018,269,79,190,41.6,269,79,190,41.6
36380, 장흥군,090003, 87세,2018,206,43,163,26.4,206,43,163,26.4
36380, 장흥군,090004, 88세,2018,194,40,154,26,194,40,154,26
36380, 장흥군,090005, 89세,2018,178,40,138,29,178,40,138,29
36380, 장흥군,095,90~94세,2018,264,60,204,29.4,264,60,204,29.4
36380, 장흥군,095001, 90세,2018,98,18,80,22.5,98,18,80,22.5
36380, 장흥군,095002, 91세,2018,69,18,51,35.3,69,18,51,35.3
36380, 장흥군,095003, 92세,2018,43,11,32,34.4,43,11,32,34.4
36380, 장흥군,095004, 93세,2018,30,7,23,30.4,30,7,23,30.4
36380, 장흥군,095005, 94세,2018,24,6,18,33.3,24,6,18,33.3
36380, 장흥군,100,95~99세,2018,87,16,71,22.5,87,16,71,22.5
36380, 장흥군,100001, 95세,2018,41,8,33,24.2,41,8,33,24.2
36380, 장흥군,100002, 96세,2018,23,5,18,27.8,23,5,18,27.8
36380, 장흥군,100003, 97세,2018,11,X,9,22.2,11,X,9,22.2
36380, 장흥군,100004, 98세,2018,6,X,5,20,6,X,5,20
36380, 장흥군,100005, 99세,2018,6,X,6,0,6,X,6,0
36380, 장흥군,101,100세이상,2018,9,X,8,12.5,9,X,8,12.5
36380, 장흥군,102,15세미만,2018,3267,1717,1550,110.8,3260,1714,1546,110.9
36380, 장흥군,103,15~64세,2018,20942,11112,9830,113,20214,10769,9445,114
36380, 장흥군,104,65세이상,2018,11666,4621,7045,65.6,11649,4613,7036,65.6
36380, 장흥군,086,85세이상,2018,1490,357,1133,31.5,1490,357,1133,31.5
36380, 장흥군,126,평균연령,2018,51.7,48.8,54.4,,52,49.1,54.7,
36380, 장흥군,127,중위연령,2018,55.5,52.3,58.4,,55.9,52.8,58.9,
36390, 강진군,000,합계,2018,33298,15988,17310,92.4,32697,15713,16984,92.5
36390, 강진군,005,0~4세,2018,998,470,528,89,997,470,527,89.2
36390, 강진군,005001, 0세,2018,218,101,117,86.3,217,101,116,87.1
36390, 강진군,005002, 1세,2018,185,85,100,85,185,85,100,85
36390, 강진군,005003, 2세,2018,183,91,92,98.9,183,91,92,98.9
36390, 강진군,005004, 3세,2018,212,100,112,89.3,212,100,112,89.3
36390, 강진군,005005, 4세,2018,200,93,107,86.9,200,93,107,86.9
36390, 강진군,010,5~9세,2018,1028,545,483,112.8,1027,545,482,113.1
36390, 강진군,010001, 5세,2018,204,116,88,131.8,204,116,88,131.8
36390, 강진군,010002, 6세,2018,201,97,104,93.3,201,97,104,93.3
36390, 강진군,010003, 7세,2018,231,128,103,124.3,231,128,103,124.3
36390, 강진군,010004, 8세,2018,194,107,87,123,194,107,87,123
36390, 강진군,010005, 9세,2018,198,97,101,96,197,97,100,97
36390, 강진군,015,10~14세,2018,1149,593,556,106.7,1145,591,554,106.7
36390, 강진군,015001, 10세,2018,240,122,118,103.4,239,122,117,104.3
36390, 강진군,015002, 11세,2018,235,117,118,99.2,233,115,118,97.5
36390, 강진군,015003, 12세,2018,207,104,103,101,207,104,103,101
36390, 강진군,015004, 13세,2018,210,117,93,125.8,210,117,93,125.8
36390, 강진군,015005, 14세,2018,257,133,124,107.3,256,133,123,108.1
36390, 강진군,020,15~19세,2018,1502,817,685,119.3,1500,817,683,119.6
36390, 강진군,020001, 15세,2018,277,130,147,88.4,277,130,147,88.4
36390, 강진군,020002, 16세,2018,288,151,137,110.2,288,151,137,110.2
36390, 강진군,020003, 17세,2018,372,203,169,120.1,372,203,169,120.1
36390, 강진군,020004, 18세,2018,346,193,153,126.1,346,193,153,126.1
36390, 강진군,020005, 19세,2018,219,140,79,177.2,217,140,77,181.8
36390, 강진군,025,20~24세,2018,1371,812,559,145.3,1299,773,526,147
36390, 강진군,025001, 20세,2018,269,169,100,169,260,168,92,182.6
36390, 강진군,025002, 21세,2018,295,191,104,183.7,283,182,101,180.2
36390, 강진군,025003, 22세,2018,262,152,110,138.2,252,147,105,140
36390, 강진군,025004, 23세,2018,266,157,109,144,247,144,103,139.8
36390, 강진군,025005, 24세,2018,279,143,136,105.1,257,132,125,105.6
36390, 강진군,030,25~29세,2018,1261,666,595,111.9,1146,603,543,111
36390, 강진군,030001, 25세,2018,257,148,109,135.8,236,135,101,133.7
36390, 강진군,030002, 26세,2018,257,133,124,107.3,234,122,112,108.9
36390, 강진군,030003, 27세,2018,253,133,120,110.8,222,116,106,109.4
36390, 강진군,030004, 28세,2018,265,140,125,112,249,132,117,112.8
36390, 강진군,030005, 29세,2018,229,112,117,95.7,205,98,107,91.6
36390, 강진군,035,30~34세,2018,1203,595,608,97.9,1093,546,547,99.8
36390, 강진군,035001, 30세,2018,254,121,133,91,230,110,120,91.7
36390, 강진군,035002, 31세,2018,211,104,107,97.2,182,94,88,106.8
36390, 강진군,035003, 32세,2018,278,131,147,89.1,252,117,135,86.7
36390, 강진군,035004, 33세,2018,223,126,97,129.9,212,121,91,133
36390, 강진군,035005, 34세,2018,237,113,124,91.1,217,104,113,92
36390, 강진군,040,35~39세,2018,1496,761,735,103.5,1408,717,691,103.8
36390, 강진군,040001, 35세,2018,296,135,161,83.9,279,127,152,83.6
36390, 강진군,040002, 36세,2018,322,159,163,97.5,296,143,153,93.5
36390, 강진군,040003, 37세,2018,293,159,134,118.7,274,150,124,121
36390, 강진군,040004, 38세,2018,312,162,150,108,301,159,142,112
36390, 강진군,040005, 39세,2018,273,146,127,115,258,138,120,115
36390, 강진군,045,40~44세,2018,1585,857,728,117.7,1545,843,702,120.1
36390, 강진군,045001, 40세,2018,274,143,131,109.2,264,137,127,107.9
36390, 강진군,045002, 41세,2018,317,168,149,112.8,311,167,144,116
36390, 강진군,045003, 42세,2018,305,170,135,125.9,296,168,128,131.3
36390, 강진군,045004, 43세,2018,346,185,161,114.9,339,183,156,117.3
36390, 강진군,045005, 44세,2018,343,191,152,125.7,335,188,147,127.9
36390, 강진군,050,45~49세,2018,2210,1214,996,121.9,2159,1194,965,123.7
36390, 강진군,050001, 45세,2018,400,218,182,119.8,391,213,178,119.7
36390, 강진군,050002, 46세,2018,457,253,204,124,447,246,201,122.4
36390, 강진군,050003, 47세,2018,484,283,201,140.8,468,278,190,146.3
36390, 강진군,050004, 48세,2018,424,228,196,116.3,414,227,187,121.4
36390, 강진군,050005, 49세,2018,445,232,213,108.9,439,230,209,110
36390, 강진군,055,50~54세,2018,2482,1337,1145,116.8,2434,1324,1110,119.3
36390, 강진군,055001, 50세,2018,481,269,212,126.9,471,265,206,128.6
36390, 강진군,055002, 51세,2018,431,242,189,128,421,240,181,132.6
36390, 강진군,055003, 52세,2018,504,279,225,124,493,276,217,127.2
36390, 강진군,055004, 53세,2018,542,286,256,111.7,533,285,248,114.9
36390, 강진군,055005, 54세,2018,524,261,263,99.2,516,258,258,100
36390, 강진군,060,55~59세,2018,3177,1604,1573,102,3150,1593,1557,102.3
36390, 강진군,060001, 55세,2018,553,275,278,98.9,547,272,275,98.9
36390, 강진군,060002, 56세,2018,605,318,287,110.8,602,318,284,112
36390, 강진군,060003, 57세,2018,618,309,309,100,612,306,306,100
36390, 강진군,060004, 58세,2018,708,345,363,95,700,342,358,95.5
36390, 강진군,060005, 59세,2018,693,357,336,106.3,689,355,334,106.3
36390, 강진군,065,60~64세,2018,2828,1406,1422,98.9,2798,1391,1407,98.9
36390, 강진군,065001, 60세,2018,623,318,305,104.3,615,314,301,104.3
36390, 강진군,065002, 61세,2018,619,296,323,91.6,615,293,322,91
36390, 강진군,065003, 62세,2018,544,276,268,103,536,273,263,103.8
36390, 강진군,065004, 63세,2018,571,283,288,98.3,562,278,284,97.9
36390, 강진군,065005, 64세,2018,471,233,238,97.9,470,233,237,98.3
36390, 강진군,070,65~69세,2018,2539,1221,1318,92.6,2530,1217,1313,92.7
36390, 강진군,070001, 65세,2018,461,231,230,100.4,459,231,228,101.3
36390, 강진군,070002, 66세,2018,547,246,301,81.7,547,246,301,81.7
36390, 강진군,070003, 67세,2018,472,222,250,88.8,469,221,248,89.1
36390, 강진군,070004, 68세,2018,533,257,276,93.1,530,255,275,92.7
36390, 강진군,070005, 69세,2018,526,265,261,101.5,525,264,261,101.1
36390, 강진군,075,70~74세,2018,2448,1066,1382,77.1,2447,1066,1381,77.2
36390, 강진군,075001, 70세,2018,560,251,309,81.2,560,251,309,81.2
36390, 강진군,075002, 71세,2018,537,238,299,79.6,537,238,299,79.6
36390, 강진군,075003, 72세,2018,449,187,262,71.4,448,187,261,71.6
36390, 강진군,075004, 73세,2018,478,197,281,70.1,478,197,281,70.1
36390, 강진군,075005, 74세,2018,424,193,231,83.5,424,193,231,83.5
36390, 강진군,080,75~79세,2018,2723,1059,1664,63.6,2721,1058,1663,63.6
36390, 강진군,080001, 75세,2018,462,205,257,79.8,461,204,257,79.4
36390, 강진군,080002, 76세,2018,652,252,400,63,652,252,400,63
36390, 강진군,080003, 77세,2018,526,208,318,65.4,525,208,317,65.6
36390, 강진군,080004, 78세,2018,563,200,363,55.1,563,200,363,55.1
36390, 강진군,080005, 79세,2018,520,194,326,59.5,520,194,326,59.5
36390, 강진군,085,80~84세,2018,1957,662,1295,51.1,1957,662,1295,51.1
36390, 강진군,085001, 80세,2018,504,188,316,59.5,504,188,316,59.5
36390, 강진군,085002, 81세,2018,436,155,281,55.2,436,155,281,55.2
36390, 강진군,085003, 82세,2018,367,119,248,48,367,119,248,48
36390, 강진군,085004, 83세,2018,357,122,235,51.9,357,122,235,51.9
36390, 강진군,085005, 84세,2018,293,78,215,36.3,293,78,215,36.3
36390, 강진군,090,85~89세,2018,1009,231,778,29.7,1009,231,778,29.7
36390, 강진군,090001, 85세,2018,255,71,184,38.6,255,71,184,38.6
36390, 강진군,090002, 86세,2018,228,55,173,31.8,228,55,173,31.8
36390, 강진군,090003, 87세,2018,204,43,161,26.7,204,43,161,26.7
36390, 강진군,090004, 88세,2018,195,35,160,21.9,195,35,160,21.9
36390, 강진군,090005, 89세,2018,127,27,100,27,127,27,100,27
36390, 강진군,095,90~94세,2018,270,58,212,27.4,270,58,212,27.4
36390, 강진군,095001, 90세,2018,96,16,80,20,96,16,80,20
36390, 강진군,095002, 91세,2018,72,15,57,26.3,72,15,57,26.3
36390, 강진군,095003, 92세,2018,32,9,23,39.1,32,9,23,39.1
36390, 강진군,095004, 93세,2018,37,15,22,68.2,37,15,22,68.2
36390, 강진군,095005, 94세,2018,33,X,30,10,33,X,30,10
36390, 강진군,100,95~99세,2018,59,14,45,31.1,59,14,45,31.1
36390, 강진군,100001, 95세,2018,22,X,19,15.8,22,X,19,15.8
36390, 강진군,100002, 96세,2018,15,X,11,36.4,15,X,11,36.4
36390, 강진군,100003, 97세,2018,13,X,9,44.4,13,X,9,44.4
36390, 강진군,100004, 98세,2018,7,X,5,40,7,X,5,40
36390, 강진군,100005, 99세,2018,X,X,X,100,X,X,X,100
36390, 강진군,101,100세이상,2018,X,X,X,0,X,X,X,0
36390, 강진군,102,15세미만,2018,3175,1608,1567,102.6,3169,1606,1563,102.8
36390, 강진군,103,15~64세,2018,19115,10069,9046,111.3,18532,9801,8731,112.3
36390, 강진군,104,65세이상,2018,11008,4311,6697,64.4,10996,4306,6690,64.4
36390, 강진군,086,85세이상,2018,1341,303,1038,29.2,1341,303,1038,29.2
36390, 강진군,126,평균연령,2018,51.5,48.7,54,,51.7,48.9,54.3,
36390, 강진군,127,중위연령,2018,55.7,52.5,58.4,,56.1,52.9,58.8,
36400, 해남군,000,합계,2018,66209,32767,33442,98,64365,31635,32730,96.7
36400, 해남군,005,0~4세,2018,2453,1233,1220,101.1,2451,1232,1219,101.1
36400, 해남군,005001, 0세,2018,540,281,259,108.5,540,281,259,108.5
36400, 해남군,005002, 1세,2018,567,295,272,108.5,566,295,271,108.9
36400, 해남군,005003, 2세,2018,463,223,240,92.9,463,223,240,92.9
36400, 해남군,005004, 3세,2018,462,231,231,100,461,230,231,99.6
36400, 해남군,005005, 4세,2018,421,203,218,93.1,421,203,218,93.1
36400, 해남군,010,5~9세,2018,2195,1083,1112,97.4,2193,1082,1111,97.4
36400, 해남군,010001, 5세,2018,447,202,245,82.4,447,202,245,82.4
36400, 해남군,010002, 6세,2018,464,215,249,86.3,463,214,249,85.9
36400, 해남군,010003, 7세,2018,467,231,236,97.9,466,231,235,98.3
36400, 해남군,010004, 8세,2018,388,206,182,113.2,388,206,182,113.2
36400, 해남군,010005, 9세,2018,429,229,200,114.5,429,229,200,114.5
36400, 해남군,015,10~14세,2018,2291,1183,1108,106.8,2291,1183,1108,106.8
36400, 해남군,015001, 10세,2018,485,237,248,95.6,485,237,248,95.6
36400, 해남군,015002, 11세,2018,432,217,215,100.9,432,217,215,100.9
36400, 해남군,015003, 12세,2018,476,250,226,110.6,476,250,226,110.6
36400, 해남군,015004, 13세,2018,418,212,206,102.9,418,212,206,102.9
36400, 해남군,015005, 14세,2018,480,267,213,125.4,480,267,213,125.4
36400, 해남군,020,15~19세,2018,2536,1395,1141,122.3,2519,1391,1128,123.3
36400, 해남군,020001, 15세,2018,493,250,243,102.9,492,250,242,103.3
36400, 해남군,020002, 16세,2018,471,251,220,114.1,470,251,219,114.6
36400, 해남군,020003, 17세,2018,589,334,255,131,586,333,253,131.6
36400, 해남군,020004, 18세,2018,581,328,253,129.6,578,326,252,129.4
36400, 해남군,020005, 19세,2018,402,232,170,136.5,393,231,162,142.6
36400, 해남군,025,20~24세,2018,2568,1582,986,160.4,2354,1434,920,155.9
36400, 해남군,025001, 20세,2018,474,317,157,201.9,462,312,150,208
36400, 해남군,025002, 21세,2018,531,333,198,168.2,509,318,191,166.5
36400, 해남군,025003, 22세,2018,534,334,200,167,477,292,185,157.8
36400, 해남군,025004, 23세,2018,529,312,217,143.8,476,271,205,132.2
36400, 해남군,025005, 24세,2018,500,286,214,133.6,430,241,189,127.5
36400, 해남군,030,25~29세,2018,2533,1371,1162,118,2107,1078,1029,104.8
36400, 해남군,030001, 25세,2018,513,269,244,110.2,442,221,221,100
36400, 해남군,030002, 26세,2018,514,275,239,115.1,431,217,214,101.4
36400, 해남군,030003, 27세,2018,512,293,219,133.8,419,229,190,120.5
36400, 해남군,030004, 28세,2018,514,280,234,119.7,413,214,199,107.5
36400, 해남군,030005, 29세,2018,480,254,226,112.4,402,197,205,96.1
36400, 해남군,035,30~34세,2018,2740,1418,1322,107.3,2345,1151,1194,96.4
36400, 해남군,035001, 30세,2018,480,244,236,103.4,389,184,205,89.8
36400, 해남군,035002, 31세,2018,566,288,278,103.6,481,230,251,91.6
36400, 해남군,035003, 32세,2018,550,286,264,108.3,468,233,235,99.1
36400, 해남군,035004, 33세,2018,529,291,238,122.3,447,230,217,106
36400, 해남군,035005, 34세,2018,615,309,306,101,560,274,286,95.8
36400, 해남군,040,35~39세,2018,3372,1729,1643,105.2,3107,1572,1535,102.4
36400, 해남군,040001, 35세,2018,613,321,292,109.9,549,279,270,103.3
36400, 해남군,040002, 36세,2018,719,365,354,103.1,655,322,333,96.7
36400, 해남군,040003, 37세,2018,671,334,337,99.1,621,306,315,97.1
36400, 해남군,040004, 38세,2018,687,350,337,103.9,647,333,314,106.1
36400, 해남군,040005, 39세,2018,682,359,323,111.1,635,332,303,109.6
36400, 해남군,045,40~44세,2018,3583,2012,1571,128.1,3451,1933,1518,127.3
36400, 해남군,045001, 40세,2018,662,366,296,123.6,620,339,281,120.6
36400, 해남군,045002, 41세,2018,695,373,322,115.8,665,351,314,111.8
36400, 해남군,045003, 42세,2018,751,434,317,136.9,726,419,307,136.5
36400, 해남군,045004, 43세,2018,714,404,310,130.3,697,396,301,131.6
36400, 해남군,045005, 44세,2018,761,435,326,133.4,743,428,315,135.9
36400, 해남군,050,45~49세,2018,4533,2551,1982,128.7,4417,2501,1916,130.5
36400, 해남군,050001, 45세,2018,867,467,400,116.8,854,461,393,117.3
36400, 해남군,050002, 46세,2018,849,491,358,137.2,827,477,350,136.3
36400, 해남군,050003, 47세,2018,967,569,398,143,940,560,380,147.4
36400, 해남군,050004, 48세,2018,906,512,394,129.9,880,502,378,132.8
36400, 해남군,050005, 49세,2018,944,512,432,118.5,916,501,415,120.7
36400, 해남군,055,50~54세,2018,5229,2877,2352,122.3,5118,2825,2293,123.2
36400, 해남군,055001, 50세,2018,1011,552,459,120.3,988,540,448,120.5
36400, 해남군,055002, 51세,2018,1023,564,459,122.9,1003,556,447,124.4
36400, 해남군,055003, 52세,2018,1065,590,475,124.2,1046,580,466,124.5
36400, 해남군,055004, 53세,2018,1067,612,455,134.5,1035,597,438,136.3
36400, 해남군,055005, 54세,2018,1063,559,504,110.9,1046,552,494,111.7
36400, 해남군,060,55~59세,2018,6153,3225,2928,110.1,6075,3180,2895,109.8
36400, 해남군,060001, 55세,2018,1112,614,498,123.3,1085,600,485,123.7
36400, 해남군,060002, 56세,2018,1093,574,519,110.6,1077,565,512,110.4
36400, 해남군,060003, 57세,2018,1247,632,615,102.8,1234,626,608,103
36400, 해남군,060004, 58세,2018,1365,750,615,122,1356,744,612,121.6
36400, 해남군,060005, 59세,2018,1336,655,681,96.2,1323,645,678,95.1
36400, 해남군,065,60~64세,2018,5680,2874,2806,102.4,5634,2855,2779,102.7
36400, 해남군,065001, 60세,2018,1246,650,596,109.1,1229,641,588,109
36400, 해남군,065002, 61세,2018,1227,627,600,104.5,1218,626,592,105.7
36400, 해남군,065003, 62세,2018,1153,582,571,101.9,1138,576,562,102.5
36400, 해남군,065004, 63세,2018,1096,550,546,100.7,1091,547,544,100.6
36400, 해남군,065005, 64세,2018,958,465,493,94.3,958,465,493,94.3
36400, 해남군,070,65~69세,2018,5057,2452,2605,94.1,5035,2441,2594,94.1
36400, 해남군,070001, 65세,2018,925,431,494,87.2,921,430,491,87.6
36400, 해남군,070002, 66세,2018,1084,539,545,98.9,1081,537,544,98.7
36400, 해남군,070003, 67세,2018,967,446,521,85.6,959,443,516,85.9
36400, 해남군,070004, 68세,2018,1008,495,513,96.5,1005,493,512,96.3
36400, 해남군,070005, 69세,2018,1073,541,532,101.7,1069,538,531,101.3
36400, 해남군,075,70~74세,2018,4592,2089,2503,83.5,4583,2085,2498,83.5
36400, 해남군,075001, 70세,2018,992,485,507,95.7,989,484,505,95.8
36400, 해남군,075002, 71세,2018,1054,490,564,86.9,1052,490,562,87.2
36400, 해남군,075003, 72세,2018,821,385,436,88.3,820,384,436,88.1
36400, 해남군,075004, 73세,2018,913,396,517,76.6,911,395,516,76.6
36400, 해남군,075005, 74세,2018,812,333,479,69.5,811,332,479,69.3
36400, 해남군,080,75~79세,2018,5114,2062,3052,67.6,5108,2062,3046,67.7
36400, 해남군,080001, 75세,2018,988,412,576,71.5,988,412,576,71.5
36400, 해남군,080002, 76세,2018,1215,489,726,67.4,1215,489,726,67.4
36400, 해남군,080003, 77세,2018,982,389,593,65.6,980,389,591,65.8
36400, 해남군,080004, 78세,2018,993,394,599,65.8,991,394,597,66
36400, 해남군,080005, 79세,2018,936,378,558,67.7,934,378,556,68
36400, 해남군,085,80~84세,2018,3354,1115,2239,49.8,3352,1114,2238,49.8
36400, 해남군,085001, 80세,2018,816,300,516,58.1,815,299,516,57.9
36400, 해남군,085002, 81세,2018,791,285,506,56.3,790,285,505,56.4
36400, 해남군,085003, 82세,2018,634,195,439,44.4,634,195,439,44.4
36400, 해남군,085004, 83세,2018,580,171,409,41.8,580,171,409,41.8
36400, 해남군,085005, 84세,2018,533,164,369,44.4,533,164,369,44.4
36400, 해남군,090,85~89세,2018,1669,409,1260,32.5,1669,409,1260,32.5
36400, 해남군,090001, 85세,2018,454,119,335,35.5,454,119,335,35.5
36400, 해남군,090002, 86세,2018,366,98,268,36.6,366,98,268,36.6
36400, 해남군,090003, 87세,2018,317,68,249,27.3,317,68,249,27.3
36400, 해남군,090004, 88세,2018,321,66,255,25.9,321,66,255,25.9
36400, 해남군,090005, 89세,2018,211,58,153,37.9,211,58,153,37.9
36400, 해남군,095,90~94세,2018,423,90,333,27,422,90,332,27.1
36400, 해남군,095001, 90세,2018,142,30,112,26.8,142,30,112,26.8
36400, 해남군,095002, 91세,2018,111,20,91,22,111,20,91,22
36400, 해남군,095003, 92세,2018,77,22,55,40,77,22,55,40
36400, 해남군,095004, 93세,2018,35,8,27,29.6,34,8,26,30.8
36400, 해남군,095005, 94세,2018,58,10,48,20.8,58,10,48,20.8
36400, 해남군,100,95~99세,2018,124,16,108,14.8,124,16,108,14.8
36400, 해남군,100001, 95세,2018,50,7,43,16.3,50,7,43,16.3
36400, 해남군,100002, 96세,2018,29,6,23,26.1,29,6,23,26.1
36400, 해남군,100003, 97세,2018,17,X,16,6.3,17,X,16,6.3
36400, 해남군,100004, 98세,2018,19,X,17,11.8,19,X,17,11.8
36400, 해남군,100005, 99세,2018,9,X,9,0,9,X,9,0
36400, 해남군,101,100세이상,2018,10,X,9,11.1,10,X,9,11.1
36400, 해남군,102,15세미만,2018,6939,3499,3440,101.7,6935,3497,3438,101.7
36400, 해남군,103,15~64세,2018,38927,21034,17893,117.6,37127,19920,17207,115.8
36400, 해남군,104,65세이상,2018,20343,8234,12109,68,20303,8218,12085,68
36400, 해남군,086,85세이상,2018,2226,516,1710,30.2,2225,516,1709,30.2
36400, 해남군,126,평균연령,2018,50.3,47.9,52.7,,50.7,48.4,53,
36400, 해남군,127,중위연령,2018,54.1,51.5,57.2,,54.8,52.3,57.7,
36410, 영암군,000,합계,2018,57175,30312,26863,112.8,52092,26646,25446,104.7
36410, 영암군,005,0~4세,2018,2069,1063,1006,105.7,2016,1034,982,105.3
36410, 영암군,005001, 0세,2018,401,212,189,112.2,387,203,184,110.3
36410, 영암군,005002, 1세,2018,404,199,205,97.1,393,194,199,97.5
36410, 영암군,005003, 2세,2018,424,220,204,107.8,410,211,199,106
36410, 영암군,005004, 3세,2018,430,225,205,109.8,422,221,201,110
36410, 영암군,005005, 4세,2018,410,207,203,102,404,205,199,103
36410, 영암군,010,5~9세,2018,2154,1112,1042,106.7,2110,1092,1018,107.3
36410, 영암군,010001, 5세,2018,450,234,216,108.3,441,230,211,109
36410, 영암군,010002, 6세,2018,428,225,203,110.8,417,218,199,109.5
36410, 영암군,010003, 7세,2018,442,208,234,88.9,434,206,228,90.4
36410, 영암군,010004, 8세,2018,417,217,200,108.5,411,214,197,108.6
36410, 영암군,010005, 9세,2018,417,228,189,120.6,407,224,183,122.4
36410, 영암군,015,10~14세,2018,2047,1091,956,114.1,2013,1072,941,113.9
36410, 영암군,015001, 10세,2018,394,210,184,114.1,385,206,179,115.1
36410, 영암군,015002, 11세,2018,439,231,208,111.1,432,227,205,110.7
36410, 영암군,015003, 12세,2018,386,207,179,115.6,379,202,177,114.1
36410, 영암군,015004, 13세,2018,398,212,186,114,393,208,185,112.4
36410, 영암군,015005, 14세,2018,430,231,199,116.1,424,229,195,117.4
36410, 영암군,020,15~19세,2018,2942,1499,1443,103.9,2903,1478,1425,103.7
36410, 영암군,020001, 15세,2018,472,255,217,117.5,465,250,215,116.3
36410, 영암군,020002, 16세,2018,516,250,266,94,509,248,261,95
36410, 영암군,020003, 17세,2018,540,281,259,108.5,539,281,258,108.9
36410, 영암군,020004, 18세,2018,706,336,370,90.8,693,329,364,90.4
36410, 영암군,020005, 19세,2018,708,377,331,113.9,697,370,327,113.1
36410, 영암군,025,20~24세,2018,3431,2014,1417,142.1,3041,1718,1323,129.9
36410, 영암군,025001, 20세,2018,718,401,317,126.5,691,383,308,124.4
36410, 영암군,025002, 21세,2018,760,415,345,120.3,709,378,331,114.2
36410, 영암군,025003, 22세,2018,736,437,299,146.2,650,376,274,137.2
36410, 영암군,025004, 23세,2018,615,380,235,161.7,501,292,209,139.7
36410, 영암군,025005, 24세,2018,602,381,221,172.4,490,289,201,143.8
36410, 영암군,030,25~29세,2018,2950,1812,1138,159.2,1960,1027,933,110.1
36410, 영암군,030001, 25세,2018,599,373,226,165,425,231,194,119.1
36410, 영암군,030002, 26세,2018,605,371,234,158.5,436,238,198,120.2
36410, 영암군,030003, 27세,2018,542,341,201,169.7,348,178,170,104.7
36410, 영암군,030004, 28세,2018,637,373,264,141.3,403,204,199,102.5
36410, 영암군,030005, 29세,2018,567,354,213,166.2,348,176,172,102.3
36410, 영암군,035,30~34세,2018,3192,1950,1242,157,2181,1159,1022,113.4
36410, 영암군,035001, 30세,2018,583,362,221,163.8,366,192,174,110.3
36410, 영암군,035002, 31세,2018,639,389,250,155.6,423,220,203,108.4
36410, 영암군,035003, 32세,2018,614,377,237,159.1,413,219,194,112.9
36410, 영암군,035004, 33세,2018,688,415,273,152,488,260,228,114
36410, 영암군,035005, 34세,2018,668,407,261,155.9,491,268,223,120.2
36410, 영암군,040,35~39세,2018,3962,2476,1486,166.6,3236,1900,1336,142.2
36410, 영암군,040001, 35세,2018,761,496,265,187.2,590,348,242,143.8
36410, 영암군,040002, 36세,2018,854,529,325,162.8,690,397,293,135.5
36410, 영암군,040003, 37세,2018,799,521,278,187.4,627,391,236,165.7
36410, 영암군,040004, 38세,2018,766,467,299,156.2,661,389,272,143
36410, 영암군,040005, 39세,2018,782,463,319,145.1,668,375,293,128
36410, 영암군,045,40~44세,2018,3771,2314,1457,158.8,3253,1928,1325,145.5
36410, 영암군,045001, 40세,2018,713,463,250,185.2,606,373,233,160.1
36410, 영암군,045002, 41세,2018,745,445,300,148.3,624,356,268,132.8
36410, 영암군,045003, 42세,2018,749,462,287,161,626,373,253,147.4
36410, 영암군,045004, 43세,2018,743,457,286,159.8,654,386,268,144
36410, 영암군,045005, 44세,2018,821,487,334,145.8,743,440,303,145.2
36410, 영암군,050,45~49세,2018,4469,2615,1854,141,4048,2363,1685,140.2
36410, 영암군,050001, 45세,2018,887,542,345,157.1,789,481,308,156.2
36410, 영암군,050002, 46세,2018,890,532,358,148.6,808,486,322,150.9
36410, 영암군,050003, 47세,2018,902,499,403,123.8,823,456,367,124.3
36410, 영암군,050004, 48세,2018,888,529,359,147.4,794,467,327,142.8
36410, 영암군,050005, 49세,2018,902,513,389,131.9,834,473,361,131
36410, 영암군,055,50~54세,2018,4533,2647,1886,140.3,4165,2415,1750,138
36410, 영암군,055001, 50세,2018,951,564,387,145.7,858,500,358,139.7
36410, 영암군,055002, 51세,2018,868,506,362,139.8,797,462,335,137.9
36410, 영암군,055003, 52세,2018,935,547,388,141,862,503,359,140.1
36410, 영암군,055004, 53세,2018,889,517,372,139,825,474,351,135
36410, 영암군,055005, 54세,2018,890,513,377,136.1,823,476,347,137.2
36410, 영암군,060,55~59세,2018,4766,2600,2166,120,4522,2458,2064,119.1
36410, 영암군,060001, 55세,2018,957,532,425,125.2,873,491,382,128.5
36410, 영암군,060002, 56세,2018,928,488,440,110.9,872,454,418,108.6
36410, 영암군,060003, 57세,2018,1012,578,434,133.2,983,560,423,132.4
36410, 영암군,060004, 58세,2018,945,506,439,115.3,900,473,427,110.8
36410, 영암군,060005, 59세,2018,924,496,428,115.9,894,480,414,115.9
36410, 영암군,065,60~64세,2018,3835,1961,1874,104.6,3690,1885,1805,104.4
36410, 영암군,065001, 60세,2018,828,454,374,121.4,786,428,358,119.6
36410, 영암군,065002, 61세,2018,836,438,398,110.1,803,421,382,110.2
36410, 영암군,065003, 62세,2018,775,380,395,96.2,748,368,380,96.8
36410, 영암군,065004, 63세,2018,742,370,372,99.5,722,358,364,98.4
36410, 영암군,065005, 64세,2018,654,319,335,95.2,631,310,321,96.6
36410, 영암군,070,65~69세,2018,3105,1483,1622,91.4,3055,1459,1596,91.4
36410, 영암군,070001, 65세,2018,585,274,311,88.1,576,269,307,87.6
36410, 영암군,070002, 66세,2018,674,328,346,94.8,654,318,336,94.6
36410, 영암군,070003, 67세,2018,567,259,308,84.1,560,255,305,83.6
36410, 영암군,070004, 68세,2018,640,295,345,85.5,631,292,339,86.1
36410, 영암군,070005, 69세,2018,639,327,312,104.8,634,325,309,105.2
36410, 영암군,075,70~74세,2018,2901,1255,1646,76.2,2878,1247,1631,76.5
36410, 영암군,075001, 70세,2018,592,285,307,92.8,586,283,303,93.4
36410, 영암군,075002, 71세,2018,624,277,347,79.8,619,273,346,78.9
36410, 영암군,075003, 72세,2018,532,215,317,67.8,529,215,314,68.5
36410, 영암군,075004, 73세,2018,581,254,327,77.7,577,254,323,78.6
36410, 영암군,075005, 74세,2018,572,224,348,64.4,567,222,345,64.3
36410, 영암군,080,75~79세,2018,3289,1287,2002,64.3,3271,1280,1991,64.3
36410, 영암군,080001, 75세,2018,582,223,359,62.1,575,221,354,62.4
36410, 영암군,080002, 76세,2018,790,351,439,80,787,349,438,79.7
36410, 영암군,080003, 77세,2018,661,242,419,57.8,654,240,414,58
36410, 영암군,080004, 78세,2018,639,233,406,57.4,639,233,406,57.4
36410, 영암군,080005, 79세,2018,617,238,379,62.8,616,237,379,62.5
36410, 영암군,085,80~84세,2018,2275,753,1522,49.5,2270,752,1518,49.5
36410, 영암군,085001, 80세,2018,547,186,361,51.5,545,186,359,51.8
36410, 영암군,085002, 81세,2018,478,177,301,58.8,476,176,300,58.7
36410, 영암군,085003, 82세,2018,436,142,294,48.3,436,142,294,48.3
36410, 영암군,085004, 83세,2018,427,128,299,42.8,426,128,298,43
36410, 영암군,085005, 84세,2018,387,120,267,44.9,387,120,267,44.9
36410, 영암군,090,85~89세,2018,1130,299,831,36,1127,299,828,36.1
36410, 영암군,090001, 85세,2018,315,100,215,46.5,315,100,215,46.5
36410, 영암군,090002, 86세,2018,249,69,180,38.3,248,69,179,38.5
36410, 영암군,090003, 87세,2018,219,55,164,33.5,218,55,163,33.7
36410, 영암군,090004, 88세,2018,195,47,148,31.8,194,47,147,32
36410, 영암군,090005, 89세,2018,152,28,124,22.6,152,28,124,22.6
36410, 영암군,095,90~94세,2018,282,66,216,30.6,281,65,216,30.1
36410, 영암군,095001, 90세,2018,85,20,65,30.8,84,19,65,29.2
36410, 영암군,095002, 91세,2018,75,15,60,25,75,15,60,25
36410, 영암군,095003, 92세,2018,49,15,34,44.1,49,15,34,44.1
36410, 영암군,095004, 93세,2018,38,8,30,26.7,38,8,30,26.7
36410, 영암군,095005, 94세,2018,35,8,27,29.6,35,8,27,29.6
36410, 영암군,100,95~99세,2018,68,14,54,25.9,68,14,54,25.9
36410, 영암군,100001, 95세,2018,32,9,23,39.1,32,9,23,39.1
36410, 영암군,100002, 96세,2018,15,X,13,15.4,15,X,13,15.4
36410, 영암군,100003, 97세,2018,9,X,7,28.6,9,X,7,28.6
36410, 영암군,100004, 98세,2018,9,X,8,12.5,9,X,8,12.5
36410, 영암군,100005, 99세,2018,X,X,X,0,X,X,X,0
36410, 영암군,101,100세이상,2018,X,X,X,33.3,X,X,X,33.3
36410, 영암군,102,15세미만,2018,6270,3266,3004,108.7,6139,3198,2941,108.7
36410, 영암군,103,15~64세,2018,37851,21888,15963,137.1,32999,18331,14668,125
36410, 영암군,104,65세이상,2018,13054,5158,7896,65.3,12954,5117,7837,65.3
36410, 영암군,086,85세이상,2018,1484,380,1104,34.4,1480,379,1101,34.4
36410, 영암군,126,평균연령,2018,45.9,43.6,48.6,,46.8,44.6,49.1,
36410, 영암군,127,중위연령,2018,47.3,44.6,51,,49.1,46.9,52.1,
36420, 무안군,000,합계,2018,81324,41131,40193,102.3,79188,39955,39233,101.8
36420, 무안군,005,0~4세,2018,3153,1629,1524,106.9,3148,1627,1521,107
36420, 무안군,005001, 0세,2018,471,246,225,109.3,468,244,224,108.9
36420, 무안군,005002, 1세,2018,532,264,268,98.5,532,264,268,98.5
36420, 무안군,005003, 2세,2018,657,343,314,109.2,656,343,313,109.6
36420, 무안군,005004, 3세,2018,751,401,350,114.6,751,401,350,114.6
36420, 무안군,005005, 4세,2018,742,375,367,102.2,741,375,366,102.5
36420, 무안군,010,5~9세,2018,4422,2247,2175,103.3,4418,2245,2173,103.3
36420, 무안군,010001, 5세,2018,839,435,404,107.7,838,434,404,107.4
36420, 무안군,010002, 6세,2018,955,485,470,103.2,954,485,469,103.4
36420, 무안군,010003, 7세,2018,890,437,453,96.5,890,437,453,96.5
36420, 무안군,010004, 8세,2018,897,442,455,97.1,896,442,454,97.4
36420, 무안군,010005, 9세,2018,841,448,393,114,840,447,393,113.7
36420, 무안군,015,10~14세,2018,4080,2071,2009,103.1,4074,2067,2007,103
36420, 무안군,015001, 10세,2018,837,418,419,99.8,835,416,419,99.3
36420, 무안군,015002, 11세,2018,868,463,405,114.3,868,463,405,114.3
36420, 무안군,015003, 12세,2018,774,394,380,103.7,774,394,380,103.7
36420, 무안군,015004, 13세,2018,742,350,392,89.3,740,348,392,88.8
36420, 무안군,015005, 14세,2018,859,446,413,108,857,446,411,108.5
36420, 무안군,020,15~19세,2018,5457,2941,2516,116.9,5411,2920,2491,117.2
36420, 무안군,020001, 15세,2018,853,448,405,110.6,852,447,405,110.4
36420, 무안군,020002, 16세,2018,873,466,407,114.5,873,466,407,114.5
36420, 무안군,020003, 17세,2018,969,483,486,99.4,965,480,485,99
36420, 무안군,020004, 18세,2018,1176,638,538,118.6,1166,634,532,119.2
36420, 무안군,020005, 19세,2018,1586,906,680,133.2,1555,893,662,134.9
36420, 무안군,025,20~24세,2018,6405,3690,2715,135.9,5932,3425,2507,136.6
36420, 무안군,025001, 20세,2018,1435,753,682,110.4,1371,724,647,111.9
36420, 무안군,025002, 21세,2018,1366,704,662,106.3,1272,654,618,105.8
36420, 무안군,025003, 22세,2018,1345,784,561,139.8,1239,721,518,139.2
36420, 무안군,025004, 23세,2018,1195,778,417,186.6,1090,716,374,191.4
36420, 무안군,025005, 24세,2018,1064,671,393,170.7,960,610,350,174.3
36420, 무안군,030,25~29세,2018,3858,2119,1739,121.9,3388,1834,1554,118
36420, 무안군,030001, 25세,2018,858,508,350,145.1,748,442,306,144.4
36420, 무안군,030002, 26세,2018,813,438,375,116.8,723,387,336,115.2
36420, 무안군,030003, 27세,2018,769,418,351,119.1,674,359,315,114
36420, 무안군,030004, 28세,2018,720,384,336,114.3,619,314,305,103
36420, 무안군,030005, 29세,2018,698,371,327,113.5,624,332,292,113.7
36420, 무안군,035,30~34세,2018,4054,2054,2000,102.7,3701,1863,1838,101.4
36420, 무안군,035001, 30세,2018,678,362,316,114.6,603,319,284,112.3
36420, 무안군,035002, 31세,2018,741,371,370,100.3,672,329,343,95.9
36420, 무안군,035003, 32세,2018,785,416,369,112.7,701,372,329,113.1
36420, 무안군,035004, 33세,2018,892,448,444,100.9,834,416,418,99.5
36420, 무안군,035005, 34세,2018,958,457,501,91.2,891,427,464,92
36420, 무안군,040,35~39세,2018,6054,3090,2964,104.3,5829,2967,2862,103.7
36420, 무안군,040001, 35세,2018,1081,529,552,95.8,1035,507,528,96
36420, 무안군,040002, 36세,2018,1235,643,592,108.6,1196,622,574,108.4
36420, 무안군,040003, 37세,2018,1208,615,593,103.7,1162,591,571,103.5
36420, 무안군,040004, 38세,2018,1320,663,657,100.9,1274,639,635,100.6
36420, 무안군,040005, 39세,2018,1210,640,570,112.3,1162,608,554,109.7
36420, 무안군,045,40~44세,2018,5896,3069,2827,108.6,5737,2975,2762,107.7
36420, 무안군,045001, 40세,2018,1158,587,571,102.8,1123,564,559,100.9
36420, 무안군,045002, 41세,2018,1208,592,616,96.1,1176,576,600,96
36420, 무안군,045003, 42세,2018,1144,617,527,117.1,1111,599,512,117
36420, 무안군,045004, 43세,2018,1138,600,538,111.5,1099,576,523,110.1
36420, 무안군,045005, 44세,2018,1248,673,575,117,1228,660,568,116.2
36420, 무안군,050,45~49세,2018,6125,3369,2756,122.2,5986,3296,2690,122.5
36420, 무안군,050001, 45세,2018,1218,647,571,113.3,1185,633,552,114.7
36420, 무안군,050002, 46세,2018,1172,632,540,117,1151,619,532,116.4
36420, 무안군,050003, 47세,2018,1325,755,570,132.5,1302,744,558,133.3
36420, 무안군,050004, 48세,2018,1222,669,553,121,1184,646,538,120.1
36420, 무안군,050005, 49세,2018,1188,666,522,127.6,1164,654,510,128.2
36420, 무안군,055,50~54세,2018,5633,3034,2599,116.7,5521,2987,2534,117.9
36420, 무안군,055001, 50세,2018,1236,653,583,112,1210,637,573,111.2
36420, 무안군,055002, 51세,2018,1134,597,537,111.2,1115,593,522,113.6
36420, 무안군,055003, 52세,2018,1139,613,526,116.5,1118,605,513,117.9
36420, 무안군,055004, 53세,2018,1084,588,496,118.5,1056,576,480,120
36420, 무안군,055005, 54세,2018,1040,583,457,127.6,1022,576,446,129.1
36420, 무안군,060,55~59세,2018,5801,3007,2794,107.6,5723,2973,2750,108.1
36420, 무안군,060001, 55세,2018,1122,570,552,103.3,1101,561,540,103.9
36420, 무안군,060002, 56세,2018,1134,616,518,118.9,1120,610,510,119.6
36420, 무안군,060003, 57세,2018,1183,623,560,111.3,1170,619,551,112.3
36420, 무안군,060004, 58세,2018,1257,650,607,107.1,1237,641,596,107.6
36420, 무안군,060005, 59세,2018,1105,548,557,98.4,1095,542,553,98
36420, 무안군,065,60~64세,2018,4975,2440,2535,96.3,4935,2420,2515,96.2
36420, 무안군,065001, 60세,2018,1090,557,533,104.5,1082,551,531,103.8
36420, 무안군,065002, 61세,2018,1055,508,547,92.9,1045,503,542,92.8
36420, 무안군,065003, 62세,2018,936,462,474,97.5,930,459,471,97.5
36420, 무안군,065004, 63세,2018,1013,488,525,93,1006,485,521,93.1
36420, 무안군,065005, 64세,2018,881,425,456,93.2,872,422,450,93.8
36420, 무안군,070,65~69세,2018,4177,2063,2114,97.6,4159,2052,2107,97.4
36420, 무안군,070001, 65세,2018,772,402,370,108.6,768,398,370,107.6
36420, 무안군,070002, 66세,2018,918,441,477,92.5,916,441,475,92.8
36420, 무안군,070003, 67세,2018,816,400,416,96.2,813,398,415,95.9
36420, 무안군,070004, 68세,2018,817,394,423,93.1,814,392,422,92.9
36420, 무안군,070005, 69세,2018,854,426,428,99.5,848,423,425,99.5
36420, 무안군,075,70~74세,2018,3688,1715,1973,86.9,3683,1712,1971,86.9
36420, 무안군,075001, 70세,2018,854,429,425,100.9,853,428,425,100.7
36420, 무안군,075002, 71세,2018,816,391,425,92,815,391,424,92.2
36420, 무안군,075003, 72세,2018,686,317,369,85.9,685,316,369,85.6
36420, 무안군,075004, 73세,2018,696,310,386,80.3,695,310,385,80.5
36420, 무안군,075005, 74세,2018,636,268,368,72.8,635,267,368,72.6
36420, 무안군,080,75~79세,2018,3680,1462,2218,65.9,3679,1461,2218,65.9
36420, 무안군,080001, 75세,2018,643,283,360,78.6,643,283,360,78.6
36420, 무안군,080002, 76세,2018,966,394,572,68.9,966,394,572,68.9
36420, 무안군,080003, 77세,2018,749,293,456,64.3,749,293,456,64.3
36420, 무안군,080004, 78세,2018,697,259,438,59.1,696,258,438,58.9
36420, 무안군,080005, 79세,2018,625,233,392,59.4,625,233,392,59.4
36420, 무안군,085,80~84세,2018,2342,789,1553,50.8,2341,789,1552,50.8
36420, 무안군,085001, 80세,2018,612,230,382,60.2,612,230,382,60.2
36420, 무안군,085002, 81세,2018,505,176,329,53.5,505,176,329,53.5
36420, 무안군,085003, 82세,2018,410,133,277,48,410,133,277,48
36420, 무안군,085004, 83세,2018,436,132,304,43.4,435,132,303,43.6
36420, 무안군,085005, 84세,2018,379,118,261,45.2,379,118,261,45.2
36420, 무안군,090,85~89세,2018,1115,268,847,31.6,1115,268,847,31.6
36420, 무안군,090001, 85세,2018,318,80,238,33.6,318,80,238,33.6
36420, 무안군,090002, 86세,2018,244,61,183,33.3,244,61,183,33.3
36420, 무안군,090003, 87세,2018,182,51,131,38.9,182,51,131,38.9
36420, 무안군,090004, 88세,2018,215,34,181,18.8,215,34,181,18.8
36420, 무안군,090005, 89세,2018,156,42,114,36.8,156,42,114,36.8
36420, 무안군,095,90~94세,2018,312,63,249,25.3,311,63,248,25.4
36420, 무안군,095001, 90세,2018,113,24,89,27,112,24,88,27.3
36420, 무안군,095002, 91세,2018,70,15,55,27.3,70,15,55,27.3
36420, 무안군,095003, 92세,2018,52,13,39,33.3,52,13,39,33.3
36420, 무안군,095004, 93세,2018,50,8,42,19,50,8,42,19
36420, 무안군,095005, 94세,2018,27,X,24,12.5,27,X,24,12.5
36420, 무안군,100,95~99세,2018,88,11,77,14.3,88,11,77,14.3
36420, 무안군,100001, 95세,2018,41,X,37,10.8,41,X,37,10.8
36420, 무안군,100002, 96세,2018,20,X,16,25,20,X,16,25
36420, 무안군,100003, 97세,2018,12,X,11,9.1,12,X,11,9.1
36420, 무안군,100004, 98세,2018,6,X,X,50,6,X,X,50
36420, 무안군,100005, 99세,2018,9,X,9,0,9,X,9,0
36420, 무안군,101,100세이상,2018,9,X,9,0,9,X,9,0
36420, 무안군,102,15세미만,2018,11655,5947,5708,104.2,11640,5939,5701,104.2
36420, 무안군,103,15~64세,2018,54258,28813,25445,113.2,52163,27660,24503,112.9
36420, 무안군,104,65세이상,2018,15411,6371,9040,70.5,15385,6356,9029,70.4
36420, 무안군,086,85세이상,2018,1524,342,1182,28.9,1523,342,1181,29
36420, 무안군,126,평균연령,2018,42.3,40.6,44.1,,42.5,40.8,44.3,
36420, 무안군,127,중위연령,2018,42.7,41.2,44.4,,43.3,41.8,44.8,
36430, 함평군,000,합계,2018,30600,15180,15420,98.4,29728,14685,15043,97.6
36430, 함평군,005,0~4세,2018,740,381,359,106.1,739,380,359,105.8
36430, 함평군,005001, 0세,2018,136,72,64,112.5,136,72,64,112.5
36430, 함평군,005002, 1세,2018,134,77,57,135.1,133,76,57,133.3
36430, 함평군,005003, 2세,2018,154,88,66,133.3,154,88,66,133.3
36430, 함평군,005004, 3세,2018,152,69,83,83.1,152,69,83,83.1
36430, 함평군,005005, 4세,2018,164,75,89,84.3,164,75,89,84.3
36430, 함평군,010,5~9세,2018,844,466,378,123.3,843,465,378,123
36430, 함평군,010001, 5세,2018,174,96,78,123.1,174,96,78,123.1
36430, 함평군,010002, 6세,2018,182,100,82,122,182,100,82,122
36430, 함평군,010003, 7세,2018,186,101,85,118.8,186,101,85,118.8
36430, 함평군,010004, 8세,2018,147,79,68,116.2,146,78,68,114.7
36430, 함평군,010005, 9세,2018,155,90,65,138.5,155,90,65,138.5
36430, 함평군,015,10~14세,2018,909,471,438,107.5,908,471,437,107.8
36430, 함평군,015001, 10세,2018,172,84,88,95.5,172,84,88,95.5
36430, 함평군,015002, 11세,2018,170,86,84,102.4,170,86,84,102.4
36430, 함평군,015003, 12세,2018,164,85,79,107.6,164,85,79,107.6
36430, 함평군,015004, 13세,2018,185,98,87,112.6,185,98,87,112.6
36430, 함평군,015005, 14세,2018,218,118,100,118,217,118,99,119.2
36430, 함평군,020,15~19세,2018,1540,777,763,101.8,1533,771,762,101.2
36430, 함평군,020001, 15세,2018,240,132,108,122.2,240,132,108,122.2
36430, 함평군,020002, 16세,2018,317,166,151,109.9,317,166,151,109.9
36430, 함평군,020003, 17세,2018,415,194,221,87.8,414,193,221,87.3
36430, 함평군,020004, 18세,2018,386,175,211,82.9,384,173,211,82
36430, 함평군,020005, 19세,2018,182,110,72,152.8,178,107,71,150.7
36430, 함평군,025,20~24세,2018,1246,777,469,165.7,1094,677,417,162.4
36430, 함평군,025001, 20세,2018,224,141,83,169.9,211,131,80,163.8
36430, 함평군,025002, 21세,2018,239,151,88,171.6,223,143,80,178.8
36430, 함평군,025003, 22세,2018,251,158,93,169.9,221,136,85,160
36430, 함평군,025004, 23세,2018,278,171,107,159.8,237,142,95,149.5
36430, 함평군,025005, 24세,2018,254,156,98,159.2,202,125,77,162.3
36430, 함평군,030,25~29세,2018,1143,654,489,133.7,910,512,398,128.6
36430, 함평군,030001, 25세,2018,235,142,93,152.7,188,107,81,132.1
36430, 함평군,030002, 26세,2018,246,146,100,146,187,107,80,133.8
36430, 함평군,030003, 27세,2018,242,137,105,130.5,190,112,78,143.6
36430, 함평군,030004, 28세,2018,217,119,98,121.4,172,94,78,120.5
36430, 함평군,030005, 29세,2018,203,110,93,118.3,173,92,81,113.6
36430, 함평군,035,30~34세,2018,1068,576,492,117.1,924,496,428,115.9
36430, 함평군,035001, 30세,2018,224,109,115,94.8,193,97,96,101
36430, 함평군,035002, 31세,2018,210,120,90,133.3,176,100,76,131.6
36430, 함평군,035003, 32세,2018,219,126,93,135.5,182,105,77,136.4
36430, 함평군,035004, 33세,2018,221,120,101,118.8,198,106,92,115.2
36430, 함평군,035005, 34세,2018,194,101,93,108.6,175,88,87,101.1
36430, 함평군,040,35~39세,2018,1290,719,571,125.9,1202,672,530,126.8
36430, 함평군,040001, 35세,2018,247,138,109,126.6,222,126,96,131.3
36430, 함평군,040002, 36세,2018,254,133,121,109.9,239,125,114,109.6
36430, 함평군,040003, 37세,2018,273,155,118,131.4,259,147,112,131.3
36430, 함평군,040004, 38세,2018,260,154,106,145.3,248,150,98,153.1
36430, 함평군,040005, 39세,2018,256,139,117,118.8,234,124,110,112.7
36430, 함평군,045,40~44세,2018,1514,859,655,131.1,1434,810,624,129.8
36430, 함평군,045001, 40세,2018,262,145,117,123.9,244,138,106,130.2
36430, 함평군,045002, 41세,2018,282,154,128,120.3,264,140,124,112.9
36430, 함평군,045003, 42세,2018,292,165,127,129.9,276,156,120,130
36430, 함평군,045004, 43세,2018,339,189,150,126,318,174,144,120.8
36430, 함평군,045005, 44세,2018,339,206,133,154.9,332,202,130,155.4
36430, 함평군,050,45~49세,2018,1936,1117,819,136.4,1882,1092,790,138.2
36430, 함평군,050001, 45세,2018,368,213,155,137.4,358,207,151,137.1
36430, 함평군,050002, 46세,2018,376,222,154,144.2,359,212,147,144.2
36430, 함평군,050003, 47세,2018,397,237,160,148.1,389,234,155,151
36430, 함평군,050004, 48세,2018,381,218,163,133.7,372,214,158,135.4
36430, 함평군,050005, 49세,2018,414,227,187,121.4,404,225,179,125.7
36430, 함평군,055,50~54세,2018,2315,1348,967,139.4,2280,1335,945,141.3
36430, 함평군,055001, 50세,2018,453,271,182,148.9,445,270,175,154.3
36430, 함평군,055002, 51세,2018,477,279,198,140.9,467,274,193,142
36430, 함평군,055003, 52세,2018,468,289,179,161.5,464,286,178,160.7
36430, 함평군,055004, 53세,2018,472,264,208,126.9,461,260,201,129.4
36430, 함평군,055005, 54세,2018,445,245,200,122.5,443,245,198,123.7
36430, 함평군,060,55~59세,2018,2817,1535,1282,119.7,2783,1525,1258,121.2
36430, 함평군,060001, 55세,2018,526,289,237,121.9,517,286,231,123.8
36430, 함평군,060002, 56세,2018,517,286,231,123.8,511,285,226,126.1
36430, 함평군,060003, 57세,2018,581,305,276,110.5,573,304,269,113
36430, 함평군,060004, 58세,2018,640,349,291,119.9,635,346,289,119.7
36430, 함평군,060005, 59세,2018,553,306,247,123.9,547,304,243,125.1
36430, 함평군,065,60~64세,2018,2672,1375,1297,106,2642,1361,1281,106.2
36430, 함평군,065001, 60세,2018,544,281,263,106.8,538,278,260,106.9
36430, 함평군,065002, 61세,2018,595,314,281,111.7,587,309,278,111.2
36430, 함평군,065003, 62세,2018,518,276,242,114,513,275,238,115.5
36430, 함평군,065004, 63세,2018,563,266,297,89.6,557,265,292,90.8
36430, 함평군,065005, 64세,2018,452,238,214,111.2,447,234,213,109.9
36430, 함평군,070,65~69세,2018,2354,1112,1242,89.5,2345,1105,1240,89.1
36430, 함평군,070001, 65세,2018,458,213,245,86.9,456,211,245,86.1
36430, 함평군,070002, 66세,2018,506,231,275,84,502,227,275,82.5
36430, 함평군,070003, 67세,2018,422,203,219,92.7,422,203,219,92.7
36430, 함평군,070004, 68세,2018,490,224,266,84.2,488,224,264,84.8
36430, 함평군,070005, 69세,2018,478,241,237,101.7,477,240,237,101.3
36430, 함평군,075,70~74세,2018,2325,989,1336,74,2322,989,1333,74.2
36430, 함평군,075001, 70세,2018,479,209,270,77.4,478,209,269,77.7
36430, 함평군,075002, 71세,2018,502,241,261,92.3,501,241,260,92.7
36430, 함평군,075003, 72세,2018,477,206,271,76,477,206,271,76
36430, 함평군,075004, 73세,2018,432,167,265,63,431,167,264,63.3
36430, 함평군,075005, 74세,2018,435,166,269,61.7,435,166,269,61.7
36430, 함평군,080,75~79세,2018,2747,1079,1668,64.7,2747,1079,1668,64.7
36430, 함평군,080001, 75세,2018,473,194,279,69.5,473,194,279,69.5
36430, 함평군,080002, 76세,2018,697,288,409,70.4,697,288,409,70.4
36430, 함평군,080003, 77세,2018,549,215,334,64.4,549,215,334,64.4
36430, 함평군,080004, 78세,2018,550,212,338,62.7,550,212,338,62.7
36430, 함평군,080005, 79세,2018,478,170,308,55.2,478,170,308,55.2
36430, 함평군,085,80~84세,2018,1940,631,1309,48.2,1940,631,1309,48.2
36430, 함평군,085001, 80세,2018,501,167,334,50,501,167,334,50
36430, 함평군,085002, 81세,2018,415,136,279,48.7,415,136,279,48.7
36430, 함평군,085003, 82세,2018,355,126,229,55,355,126,229,55
36430, 함평군,085004, 83세,2018,363,102,261,39.1,363,102,261,39.1
36430, 함평군,085005, 84세,2018,306,100,206,48.5,306,100,206,48.5
36430, 함평군,090,85~89세,2018,865,247,618,40,865,247,618,40
36430, 함평군,090001, 85세,2018,233,65,168,38.7,233,65,168,38.7
36430, 함평군,090002, 86세,2018,187,50,137,36.5,187,50,137,36.5
36430, 함평군,090003, 87세,2018,168,51,117,43.6,168,51,117,43.6
36430, 함평군,090004, 88세,2018,158,47,111,42.3,158,47,111,42.3
36430, 함평군,090005, 89세,2018,119,34,85,40,119,34,85,40
36430, 함평군,095,90~94세,2018,250,58,192,30.2,250,58,192,30.2
36430, 함평군,095001, 90세,2018,85,19,66,28.8,85,19,66,28.8
36430, 함평군,095002, 91세,2018,68,19,49,38.8,68,19,49,38.8
36430, 함평군,095003, 92세,2018,43,9,34,26.5,43,9,34,26.5
36430, 함평군,095004, 93세,2018,35,5,30,16.7,35,5,30,16.7
36430, 함평군,095005, 94세,2018,19,6,13,46.2,19,6,13,46.2
36430, 함평군,100,95~99세,2018,77,9,68,13.2,77,9,68,13.2
36430, 함평군,100001, 95세,2018,35,6,29,20.7,35,6,29,20.7
36430, 함평군,100002, 96세,2018,17,X,16,6.3,17,X,16,6.3
36430, 함평군,100003, 97세,2018,11,X,10,10,11,X,10,10
36430, 함평군,100004, 98세,2018,10,X,9,11.1,10,X,9,11.1
36430, 함평군,100005, 99세,2018,X,X,X,0,X,X,X,0
36430, 함평군,101,100세이상,2018,8,X,8,0,8,X,8,0
36430, 함평군,102,15세미만,2018,2493,1318,1175,112.2,2490,1316,1174,112.1
36430, 함평군,103,15~64세,2018,17541,9737,7804,124.8,16684,9251,7433,124.5
36430, 함평군,104,65세이상,2018,10566,4125,6441,64,10554,4118,6436,64
36430, 함평군,086,85세이상,2018,1200,314,886,35.4,1200,314,886,35.4
36430, 함평군,126,평균연령,2018,52.4,49.4,55.3,,52.9,49.9,55.8,
36430, 함평군,127,중위연령,2018,56.4,52.8,60.1,,57.2,53.6,60.8,
36440, 영광군,000,합계,2018,49570,24724,24846,99.5,48375,24027,24348,98.7
36440, 영광군,005,0~4세,2018,1798,904,894,101.1,1796,902,894,100.9
36440, 영광군,005001, 0세,2018,383,185,198,93.4,383,185,198,93.4
36440, 영광군,005002, 1세,2018,357,176,181,97.2,357,176,181,97.2
36440, 영광군,005003, 2세,2018,377,196,181,108.3,376,195,181,107.7
36440, 영광군,005004, 3세,2018,335,166,169,98.2,334,165,169,97.6
36440, 영광군,005005, 4세,2018,346,181,165,109.7,346,181,165,109.7
36440, 영광군,010,5~9세,2018,1814,927,887,104.5,1812,927,885,104.7
36440, 영광군,010001, 5세,2018,334,178,156,114.1,333,178,155,114.8
36440, 영광군,010002, 6세,2018,416,205,211,97.2,416,205,211,97.2
36440, 영광군,010003, 7세,2018,378,190,188,101.1,377,190,187,101.6
36440, 영광군,010004, 8세,2018,357,195,162,120.4,357,195,162,120.4
36440, 영광군,010005, 9세,2018,329,159,170,93.5,329,159,170,93.5
36440, 영광군,015,10~14세,2018,1856,949,907,104.6,1854,948,906,104.6
36440, 영광군,015001, 10세,2018,386,193,193,100,386,193,193,100
36440, 영광군,015002, 11세,2018,379,191,188,101.6,379,191,188,101.6
36440, 영광군,015003, 12세,2018,351,182,169,107.7,351,182,169,107.7
36440, 영광군,015004, 13세,2018,337,180,157,114.6,336,180,156,115.4
36440, 영광군,015005, 14세,2018,403,203,200,101.5,402,202,200,101
36440, 영광군,020,15~19세,2018,2454,1326,1128,117.6,2451,1324,1127,117.5
36440, 영광군,020001, 15세,2018,434,223,211,105.7,434,223,211,105.7
36440, 영광군,020002, 16세,2018,514,278,236,117.8,514,278,236,117.8
36440, 영광군,020003, 17세,2018,614,310,304,102,613,309,304,101.6
36440, 영광군,020004, 18세,2018,547,304,243,125.1,546,304,242,125.6
36440, 영광군,020005, 19세,2018,345,211,134,157.5,344,210,134,156.7
36440, 영광군,025,20~24세,2018,2157,1330,827,160.8,1995,1210,785,154.1
36440, 영광군,025001, 20세,2018,401,280,121,231.4,384,268,116,231
36440, 영광군,025002, 21세,2018,430,277,153,181,403,255,148,172.3
36440, 영광군,025003, 22세,2018,430,275,155,177.4,398,249,149,167.1
36440, 영광군,025004, 23세,2018,422,241,181,133.1,386,218,168,129.8
36440, 영광군,025005, 24세,2018,474,257,217,118.4,424,220,204,107.8
36440, 영광군,030,25~29세,2018,2171,1227,944,130,1873,1031,842,122.4
36440, 영광군,030001, 25세,2018,445,254,191,133,380,209,171,122.2
36440, 영광군,030002, 26세,2018,437,231,206,112.1,376,188,188,100
36440, 영광군,030003, 27세,2018,416,245,171,143.3,353,203,150,135.3
36440, 영광군,030004, 28세,2018,464,260,204,127.5,404,226,178,127
36440, 영광군,030005, 29세,2018,409,237,172,137.8,360,205,155,132.3
36440, 영광군,035,30~34세,2018,2203,1145,1058,108.2,2004,1044,960,108.8
36440, 영광군,035001, 30세,2018,414,221,193,114.5,368,198,170,116.5
36440, 영광군,035002, 31세,2018,456,230,226,101.8,414,213,201,106
36440, 영광군,035003, 32세,2018,415,228,187,121.9,382,209,173,120.8
36440, 영광군,035004, 33세,2018,437,212,225,94.2,397,191,206,92.7
36440, 영광군,035005, 34세,2018,481,254,227,111.9,443,233,210,111
36440, 영광군,040,35~39세,2018,2673,1410,1263,111.6,2539,1327,1212,109.5
36440, 영광군,040001, 35세,2018,476,245,231,106.1,452,229,223,102.7
36440, 영광군,040002, 36세,2018,533,296,237,124.9,503,278,225,123.6
36440, 영광군,040003, 37세,2018,517,255,262,97.3,478,231,247,93.5
36440, 영광군,040004, 38세,2018,541,286,255,112.2,513,273,240,113.8
36440, 영광군,040005, 39세,2018,606,328,278,118,593,316,277,114.1
36440, 영광군,045,40~44세,2018,2820,1573,1247,126.1,2736,1528,1208,126.5
36440, 영광군,045001, 40세,2018,533,280,253,110.7,513,269,244,110.2
36440, 영광군,045002, 41세,2018,504,291,213,136.6,483,279,204,136.8
36440, 영광군,045003, 42세,2018,519,303,216,140.3,503,295,208,141.8
36440, 영광군,045004, 43세,2018,581,318,263,120.9,565,309,256,120.7
36440, 영광군,045005, 44세,2018,683,381,302,126.2,672,376,296,127
36440, 영광군,050,45~49세,2018,3554,1997,1557,128.3,3448,1946,1502,129.6
36440, 영광군,050001, 45세,2018,672,378,294,128.6,655,369,286,129
36440, 영광군,050002, 46세,2018,661,371,290,127.9,637,357,280,127.5
36440, 영광군,050003, 47세,2018,784,435,349,124.6,764,427,337,126.7
36440, 영광군,050004, 48세,2018,723,408,315,129.5,699,397,302,131.5
36440, 영광군,050005, 49세,2018,714,405,309,131.1,693,396,297,133.3
36440, 영광군,055,50~54세,2018,3820,2074,1746,118.8,3745,2044,1701,120.2
36440, 영광군,055001, 50세,2018,771,427,344,124.1,754,423,331,127.8
36440, 영광군,055002, 51세,2018,755,418,337,124,739,412,327,126
36440, 영광군,055003, 52세,2018,744,401,343,116.9,730,395,335,117.9
36440, 영광군,055004, 53세,2018,776,407,369,110.3,762,398,364,109.3
36440, 영광군,055005, 54세,2018,774,421,353,119.3,760,416,344,120.9
36440, 영광군,060,55~59세,2018,4273,2206,2067,106.7,4219,2179,2040,106.8
36440, 영광군,060001, 55세,2018,796,408,388,105.2,775,401,374,107.2
36440, 영광군,060002, 56세,2018,782,410,372,110.2,771,402,369,108.9
36440, 영광군,060003, 57세,2018,891,462,429,107.7,885,459,426,107.7
36440, 영광군,060004, 58세,2018,956,499,457,109.2,945,493,452,109.1
36440, 영광군,060005, 59세,2018,848,427,421,101.4,843,424,419,101.2
36440, 영광군,065,60~64세,2018,4027,2046,1981,103.3,3980,2021,1959,103.2
36440, 영광군,065001, 60세,2018,906,477,429,111.2,897,471,426,110.6
36440, 영광군,065002, 61세,2018,835,431,404,106.7,825,426,399,106.8
36440, 영광군,065003, 62세,2018,768,393,375,104.8,760,388,372,104.3
36440, 영광군,065004, 63세,2018,835,406,429,94.6,823,401,422,95
36440, 영광군,065005, 64세,2018,683,339,344,98.5,675,335,340,98.5
36440, 영광군,070,65~69세,2018,3441,1591,1850,86,3423,1581,1842,85.8
36440, 영광군,070001, 65세,2018,636,279,357,78.2,631,278,353,78.8
36440, 영광군,070002, 66세,2018,720,344,376,91.5,716,341,375,90.9
36440, 영광군,070003, 67세,2018,641,293,348,84.2,637,291,346,84.1
36440, 영광군,070004, 68세,2018,727,338,389,86.9,724,336,388,86.6
36440, 영광군,070005, 69세,2018,717,337,380,88.7,715,335,380,88.2
36440, 영광군,075,70~74세,2018,3278,1470,1808,81.3,3273,1467,1806,81.2
36440, 영광군,075001, 70세,2018,677,325,352,92.3,675,324,351,92.3
36440, 영광군,075002, 71세,2018,779,361,418,86.4,778,360,418,86.1
36440, 영광군,075003, 72세,2018,614,273,341,80.1,613,272,341,79.8
36440, 영광군,075004, 73세,2018,600,262,338,77.5,600,262,338,77.5
36440, 영광군,075005, 74세,2018,608,249,359,69.4,607,249,358,69.6
36440, 영광군,080,75~79세,2018,3614,1433,2181,65.7,3614,1433,2181,65.7
36440, 영광군,080001, 75세,2018,667,274,393,69.7,667,274,393,69.7
36440, 영광군,080002, 76세,2018,917,388,529,73.3,917,388,529,73.3
36440, 영광군,080003, 77세,2018,720,287,433,66.3,720,287,433,66.3
36440, 영광군,080004, 78세,2018,667,243,424,57.3,667,243,424,57.3
36440, 영광군,080005, 79세,2018,643,241,402,60,643,241,402,60
36440, 영광군,085,80~84세,2018,2324,799,1525,52.4,2323,799,1524,52.4
36440, 영광군,085001, 80세,2018,601,223,378,59,600,223,377,59.2
36440, 영광군,085002, 81세,2018,498,163,335,48.7,498,163,335,48.7
36440, 영광군,085003, 82세,2018,423,155,268,57.8,423,155,268,57.8
36440, 영광군,085004, 83세,2018,461,139,322,43.2,461,139,322,43.2
36440, 영광군,085005, 84세,2018,341,119,222,53.6,341,119,222,53.6
36440, 영광군,090,85~89세,2018,931,253,678,37.3,928,252,676,37.3
36440, 영광군,090001, 85세,2018,265,65,200,32.5,264,65,199,32.7
36440, 영광군,090002, 86세,2018,199,61,138,44.2,198,60,138,43.5
36440, 영광군,090003, 87세,2018,158,53,105,50.5,157,53,104,51
36440, 영광군,090004, 88세,2018,179,31,148,20.9,179,31,148,20.9
36440, 영광군,090005, 89세,2018,130,43,87,49.4,130,43,87,49.4
36440, 영광군,095,90~94세,2018,267,51,216,23.6,267,51,216,23.6
36440, 영광군,095001, 90세,2018,93,19,74,25.7,93,19,74,25.7
36440, 영광군,095002, 91세,2018,78,17,61,27.9,78,17,61,27.9
36440, 영광군,095003, 92세,2018,31,5,26,19.2,31,5,26,19.2
36440, 영광군,095004, 93세,2018,38,X,34,11.8,38,X,34,11.8
36440, 영광군,095005, 94세,2018,27,6,21,28.6,27,6,21,28.6
36440, 영광군,100,95~99세,2018,84,13,71,18.3,84,13,71,18.3
36440, 영광군,100001, 95세,2018,41,8,33,24.2,41,8,33,24.2
36440, 영광군,100002, 96세,2018,20,X,19,5.3,20,X,19,5.3
36440, 영광군,100003, 97세,2018,12,X,12,0,12,X,12,0
36440, 영광군,100004, 98세,2018,5,X,X,25,5,X,X,25
36440, 영광군,100005, 99세,2018,6,X,X,100,6,X,X,100
36440, 영광군,101,100세이상,2018,11,X,11,0,11,X,11,0
36440, 영광군,102,15세미만,2018,5468,2780,2688,103.4,5462,2777,2685,103.4
36440, 영광군,103,15~64세,2018,30152,16334,13818,118.2,28990,15654,13336,117.4
36440, 영광군,104,65세이상,2018,13950,5610,8340,67.3,13923,5596,8327,67.2
36440, 영광군,086,85세이상,2018,1293,317,976,32.5,1290,316,974,32.4
36440, 영광군,126,평균연령,2018,48.6,46.2,50.9,,48.9,46.5,51.2,
36440, 영광군,127,중위연령,2018,51.7,48.9,54.9,,52.3,49.6,55.4,
36450, 장성군,000,합계,2018,41850,20976,20874,100.5,40395,20072,20323,98.8
36450, 장성군,005,0~4세,2018,1531,760,771,98.6,1530,759,771,98.4
36450, 장성군,005001, 0세,2018,286,141,145,97.2,286,141,145,97.2
36450, 장성군,005002, 1세,2018,299,152,147,103.4,298,151,147,102.7
36450, 장성군,005003, 2세,2018,319,149,170,87.6,319,149,170,87.6
36450, 장성군,005004, 3세,2018,320,154,166,92.8,320,154,166,92.8
36450, 장성군,005005, 4세,2018,307,164,143,114.7,307,164,143,114.7
36450, 장성군,010,5~9세,2018,1505,773,732,105.6,1504,772,732,105.5
36450, 장성군,010001, 5세,2018,293,149,144,103.5,293,149,144,103.5
36450, 장성군,010002, 6세,2018,304,149,155,96.1,304,149,155,96.1
36450, 장성군,010003, 7세,2018,327,167,160,104.4,327,167,160,104.4
36450, 장성군,010004, 8세,2018,312,172,140,122.9,311,171,140,122.1
36450, 장성군,010005, 9세,2018,269,136,133,102.3,269,136,133,102.3
36450, 장성군,015,10~14세,2018,1472,778,694,112.1,1469,778,691,112.6
36450, 장성군,015001, 10세,2018,294,159,135,117.8,293,159,134,118.7
36450, 장성군,015002, 11세,2018,304,153,151,101.3,304,153,151,101.3
36450, 장성군,015003, 12세,2018,263,141,122,115.6,263,141,122,115.6
36450, 장성군,015004, 13세,2018,298,156,142,109.9,297,156,141,110.6
36450, 장성군,015005, 14세,2018,313,169,144,117.4,312,169,143,118.2
36450, 장성군,020,15~19세,2018,2223,1168,1055,110.7,2206,1157,1049,110.3
36450, 장성군,020001, 15세,2018,356,167,189,88.4,356,167,189,88.4
36450, 장성군,020002, 16세,2018,439,228,211,108.1,438,227,211,107.6
36450, 장성군,020003, 17세,2018,500,260,240,108.3,499,260,239,108.8
36450, 장성군,020004, 18세,2018,613,325,288,112.8,610,322,288,111.8
36450, 장성군,020005, 19세,2018,315,188,127,148,303,181,122,148.4
36450, 장성군,025,20~24세,2018,1764,1064,700,152,1579,935,644,145.2
36450, 장성군,025001, 20세,2018,307,206,101,204,293,195,98,199
36450, 장성군,025002, 21세,2018,374,243,131,185.5,352,227,125,181.6
36450, 장성군,025003, 22세,2018,343,209,134,156,304,181,123,147.2
36450, 장성군,025004, 23세,2018,371,210,161,130.4,316,175,141,124.1
36450, 장성군,025005, 24세,2018,369,196,173,113.3,314,157,157,100
36450, 장성군,030,25~29세,2018,1977,1099,878,125.2,1630,879,751,117
36450, 장성군,030001, 25세,2018,403,230,173,132.9,332,189,143,132.2
36450, 장성군,030002, 26세,2018,428,238,190,125.3,361,196,165,118.8
36450, 장성군,030003, 27세,2018,408,227,181,125.4,339,179,160,111.9
36450, 장성군,030004, 28세,2018,403,231,172,134.3,325,181,144,125.7
36450, 장성군,030005, 29세,2018,335,173,162,106.8,273,134,139,96.4
36450, 장성군,035,30~34세,2018,1763,960,803,119.6,1490,788,702,112.3
36450, 장성군,035001, 30세,2018,334,181,153,118.3,278,142,136,104.4
36450, 장성군,035002, 31세,2018,314,175,139,125.9,263,142,121,117.4
36450, 장성군,035003, 32세,2018,379,195,184,106,319,156,163,95.7
36450, 장성군,035004, 33세,2018,333,185,148,125,289,153,136,112.5
36450, 장성군,035005, 34세,2018,403,224,179,125.1,341,195,146,133.6
36450, 장성군,040,35~39세,2018,2360,1281,1079,118.7,2163,1148,1015,113.1
36450, 장성군,040001, 35세,2018,484,256,228,112.3,422,211,211,100
36450, 장성군,040002, 36세,2018,493,275,218,126.1,450,248,202,122.8
36450, 장성군,040003, 37세,2018,434,237,197,120.3,402,215,187,115
36450, 장성군,040004, 38세,2018,505,265,240,110.4,473,245,228,107.5
36450, 장성군,040005, 39세,2018,444,248,196,126.5,416,229,187,122.5
36450, 장성군,045,40~44세,2018,2344,1329,1015,130.9,2209,1240,969,128
36450, 장성군,045001, 40세,2018,434,249,185,134.6,405,231,174,132.8
36450, 장성군,045002, 41세,2018,477,271,206,131.6,441,245,196,125
36450, 장성군,045003, 42세,2018,441,258,183,141,419,247,172,143.6
36450, 장성군,045004, 43세,2018,474,262,212,123.6,451,245,206,118.9
36450, 장성군,045005, 44세,2018,518,289,229,126.2,493,272,221,123.1
36450, 장성군,050,45~49세,2018,2944,1668,1276,130.7,2846,1616,1230,131.4
36450, 장성군,050001, 45세,2018,564,323,241,134,530,305,225,135.6
36450, 장성군,050002, 46세,2018,543,299,244,122.5,526,291,235,123.8
36450, 장성군,050003, 47세,2018,640,365,275,132.7,626,356,270,131.9
36450, 장성군,050004, 48세,2018,602,340,262,129.8,585,330,255,129.4
36450, 장성군,050005, 49세,2018,595,341,254,134.3,579,334,245,136.3
36450, 장성군,055,50~54세,2018,3134,1725,1409,122.4,3058,1692,1366,123.9
36450, 장성군,055001, 50세,2018,630,350,280,125,615,342,273,125.3
36450, 장성군,055002, 51세,2018,578,323,255,126.7,565,316,249,126.9
36450, 장성군,055003, 52세,2018,638,357,281,127,627,353,274,128.8
36450, 장성군,055004, 53세,2018,653,359,294,122.1,632,351,281,124.9
36450, 장성군,055005, 54세,2018,635,336,299,112.4,619,330,289,114.2
36450, 장성군,060,55~59세,2018,3683,1914,1769,108.2,3622,1884,1738,108.4
36450, 장성군,060001, 55세,2018,730,387,343,112.8,714,379,335,113.1
36450, 장성군,060002, 56세,2018,643,324,319,101.6,631,319,312,102.2
36450, 장성군,060003, 57세,2018,780,424,356,119.1,766,416,350,118.9
36450, 장성군,060004, 58세,2018,850,434,416,104.3,839,427,412,103.6
36450, 장성군,060005, 59세,2018,680,345,335,103,672,343,329,104.3
36450, 장성군,065,60~64세,2018,3173,1639,1534,106.8,3139,1620,1519,106.6
36450, 장성군,065001, 60세,2018,668,338,330,102.4,659,333,326,102.1
36450, 장성군,065002, 61세,2018,698,379,319,118.8,686,371,315,117.8
36450, 장성군,065003, 62세,2018,608,320,288,111.1,603,317,286,110.8
36450, 장성군,065004, 63세,2018,718,365,353,103.4,711,362,349,103.7
36450, 장성군,065005, 64세,2018,481,237,244,97.1,480,237,243,97.5
36450, 장성군,070,65~69세,2018,2852,1345,1507,89.3,2835,1338,1497,89.4
36450, 장성군,070001, 65세,2018,544,269,275,97.8,540,266,274,97.1
36450, 장성군,070002, 66세,2018,626,293,333,88,623,292,331,88.2
36450, 장성군,070003, 67세,2018,502,239,263,90.9,498,238,260,91.5
36450, 장성군,070004, 68세,2018,578,255,323,78.9,573,253,320,79.1
36450, 장성군,070005, 69세,2018,602,289,313,92.3,601,289,312,92.6
36450, 장성군,075,70~74세,2018,2625,1165,1460,79.8,2622,1164,1458,79.8
36450, 장성군,075001, 70세,2018,602,261,341,76.5,602,261,341,76.5
36450, 장성군,075002, 71세,2018,582,277,305,90.8,581,277,304,91.1
36450, 장성군,075003, 72세,2018,503,232,271,85.6,502,231,271,85.2
36450, 장성군,075004, 73세,2018,449,195,254,76.8,448,195,253,77.1
36450, 장성군,075005, 74세,2018,489,200,289,69.2,489,200,289,69.2
36450, 장성군,080,75~79세,2018,3049,1221,1828,66.8,3046,1219,1827,66.7
36450, 장성군,080001, 75세,2018,570,224,346,64.7,569,223,346,64.5
36450, 장성군,080002, 76세,2018,754,319,435,73.3,753,318,435,73.1
36450, 장성군,080003, 77세,2018,640,282,358,78.8,640,282,358,78.8
36450, 장성군,080004, 78세,2018,563,206,357,57.7,563,206,357,57.7
36450, 장성군,080005, 79세,2018,522,190,332,57.2,521,190,331,57.4
36450, 장성군,085,80~84세,2018,2181,751,1430,52.5,2179,749,1430,52.4
36450, 장성군,085001, 80세,2018,516,189,327,57.8,515,188,327,57.5
36450, 장성군,085002, 81세,2018,467,166,301,55.1,466,165,301,54.8
36450, 장성군,085003, 82세,2018,394,142,252,56.3,394,142,252,56.3
36450, 장성군,085004, 83세,2018,438,139,299,46.5,438,139,299,46.5
36450, 장성군,085005, 84세,2018,366,115,251,45.8,366,115,251,45.8
36450, 장성군,090,85~89세,2018,906,254,652,39,904,252,652,38.7
36450, 장성군,090001, 85세,2018,273,83,190,43.7,272,82,190,43.2
36450, 장성군,090002, 86세,2018,193,55,138,39.9,193,55,138,39.9
36450, 장성군,090003, 87세,2018,161,39,122,32,161,39,122,32
36450, 장성군,090004, 88세,2018,158,45,113,39.8,158,45,113,39.8
36450, 장성군,090005, 89세,2018,121,32,89,36,120,31,89,34.8
36450, 장성군,095,90~94세,2018,291,73,218,33.5,291,73,218,33.5
36450, 장성군,095001, 90세,2018,96,24,72,33.3,96,24,72,33.3
36450, 장성군,095002, 91세,2018,73,14,59,23.7,73,14,59,23.7
36450, 장성군,095003, 92세,2018,49,11,38,28.9,49,11,38,28.9
36450, 장성군,095004, 93세,2018,42,12,30,40,42,12,30,40
36450, 장성군,095005, 94세,2018,31,12,19,63.2,31,12,19,63.2
36450, 장성군,100,95~99세,2018,62,8,54,14.8,62,8,54,14.8
36450, 장성군,100001, 95세,2018,24,X,20,20,24,X,20,20
36450, 장성군,100002, 96세,2018,17,X,16,6.3,17,X,16,6.3
36450, 장성군,100003, 97세,2018,12,X,10,20,12,X,10,20
36450, 장성군,100004, 98세,2018,X,X,X,33.3,X,X,X,33.3
36450, 장성군,100005, 99세,2018,5,X,5,0,5,X,5,0
36450, 장성군,101,100세이상,2018,11,X,10,10,11,X,10,10
36450, 장성군,102,15세미만,2018,4508,2311,2197,105.2,4503,2309,2194,105.2
36450, 장성군,103,15~64세,2018,25365,13847,11518,120.2,23942,12959,10983,118
36450, 장성군,104,65세이상,2018,11977,4818,7159,67.3,11950,4804,7146,67.2
36450, 장성군,086,85세이상,2018,1270,336,934,36,1268,334,934,35.8
36450, 장성군,126,평균연령,2018,48.7,46.3,51.1,,49.1,46.8,51.5,
36450, 장성군,127,중위연령,2018,51.7,48.8,55.1,,52.6,49.9,55.7,
36460, 완도군,000,합계,2018,48340,25092,23248,107.9,45916,23156,22760,101.7
36460, 완도군,005,0~4세,2018,1642,852,790,107.8,1639,849,790,107.5
36460, 완도군,005001, 0세,2018,292,138,154,89.6,292,138,154,89.6
36460, 완도군,005002, 1세,2018,314,173,141,122.7,313,172,141,122
36460, 완도군,005003, 2세,2018,344,184,160,115,343,183,160,114.4
36460, 완도군,005004, 3세,2018,310,166,144,115.3,309,165,144,114.6
36460, 완도군,005005, 4세,2018,382,191,191,100,382,191,191,100
36460, 완도군,010,5~9세,2018,1755,895,860,104.1,1754,895,859,104.2
36460, 완도군,010001, 5세,2018,355,180,175,102.9,355,180,175,102.9
36460, 완도군,010002, 6세,2018,397,200,197,101.5,396,200,196,102
36460, 완도군,010003, 7세,2018,350,188,162,116,350,188,162,116
36460, 완도군,010004, 8세,2018,359,177,182,97.3,359,177,182,97.3
36460, 완도군,010005, 9세,2018,294,150,144,104.2,294,150,144,104.2
36460, 완도군,015,10~14세,2018,1676,871,805,108.2,1676,871,805,108.2
36460, 완도군,015001, 10세,2018,309,173,136,127.2,309,173,136,127.2
36460, 완도군,015002, 11세,2018,344,165,179,92.2,344,165,179,92.2
36460, 완도군,015003, 12세,2018,344,179,165,108.5,344,179,165,108.5
36460, 완도군,015004, 13세,2018,318,164,154,106.5,318,164,154,106.5
36460, 완도군,015005, 14세,2018,361,190,171,111.1,361,190,171,111.1
36460, 완도군,020,15~19세,2018,1638,921,717,128.5,1619,913,706,129.3
36460, 완도군,020001, 15세,2018,297,160,137,116.8,296,160,136,117.6
36460, 완도군,020002, 16세,2018,325,168,157,107,324,167,157,106.4
36460, 완도군,020003, 17세,2018,418,230,188,122.3,416,229,187,122.5
36460, 완도군,020004, 18세,2018,380,217,163,133.1,372,214,158,135.4
36460, 완도군,020005, 19세,2018,218,146,72,202.8,211,143,68,210.3
36460, 완도군,025,20~24세,2018,1645,1145,500,229,1296,854,442,193.2
36460, 완도군,025001, 20세,2018,271,206,65,316.9,258,198,60,330
36460, 완도군,025002, 21세,2018,307,225,82,274.4,266,196,70,280
36460, 완도군,025003, 22세,2018,310,217,93,233.3,248,171,77,222.1
36460, 완도군,025004, 23세,2018,342,229,113,202.7,245,141,104,135.6
36460, 완도군,025005, 24세,2018,415,268,147,182.3,279,148,131,113
36460, 완도군,030,25~29세,2018,2162,1415,747,189.4,1394,755,639,118.2
36460, 완도군,030001, 25세,2018,409,270,139,194.2,280,157,123,127.6
36460, 완도군,030002, 26세,2018,452,288,164,175.6,282,145,137,105.8
36460, 완도군,030003, 27세,2018,438,288,150,192,263,140,123,113.8
36460, 완도군,030004, 28세,2018,426,289,137,210.9,279,162,117,138.5
36460, 완도군,030005, 29세,2018,437,280,157,178.3,290,151,139,108.6
36460, 완도군,035,30~34세,2018,2198,1309,889,147.2,1721,899,822,109.4
36460, 완도군,035001, 30세,2018,388,223,165,135.2,286,138,148,93.2
36460, 완도군,035002, 31세,2018,410,260,150,173.3,305,169,136,124.3
36460, 완도군,035003, 32세,2018,449,266,183,145.4,349,177,172,102.9
36460, 완도군,035004, 33세,2018,473,275,198,138.9,385,202,183,110.4
36460, 완도군,035005, 34세,2018,478,285,193,147.7,396,213,183,116.4
36460, 완도군,040,35~39세,2018,2870,1699,1171,145.1,2531,1416,1115,127
36460, 완도군,040001, 35세,2018,544,328,216,151.9,466,257,209,123
36460, 완도군,040002, 36세,2018,562,340,222,153.2,500,289,211,137
36460, 완도군,040003, 37세,2018,558,347,211,164.5,482,281,201,139.8
36460, 완도군,040004, 38세,2018,619,359,260,138.1,553,304,249,122.1
36460, 완도군,040005, 39세,2018,587,325,262,124,530,285,245,116.3
36460, 완도군,045,40~44세,2018,2784,1687,1097,153.8,2618,1558,1060,147
36460, 완도군,045001, 40세,2018,518,307,211,145.5,482,277,205,135.1
36460, 완도군,045002, 41세,2018,571,356,215,165.6,525,320,205,156.1
36460, 완도군,045003, 42세,2018,545,332,213,155.9,504,303,201,150.7
36460, 완도군,045004, 43세,2018,526,318,208,152.9,510,307,203,151.2
36460, 완도군,045005, 44세,2018,624,374,250,149.6,597,351,246,142.7
36460, 완도군,050,45~49세,2018,3308,1905,1403,135.8,3215,1855,1360,136.4
36460, 완도군,050001, 45세,2018,615,352,263,133.8,601,343,258,132.9
36460, 완도군,050002, 46세,2018,656,365,291,125.4,636,352,284,123.9
36460, 완도군,050003, 47세,2018,683,409,274,149.3,663,396,267,148.3
36460, 완도군,050004, 48세,2018,668,383,285,134.4,651,375,276,135.9
36460, 완도군,050005, 49세,2018,686,396,290,136.6,664,389,275,141.5
36460, 완도군,055,50~54세,2018,3543,1993,1550,128.6,3458,1948,1510,129
36460, 완도군,055001, 50세,2018,717,426,291,146.4,695,417,278,150
36460, 완도군,055002, 51세,2018,693,383,310,123.5,678,372,306,121.6
36460, 완도군,055003, 52세,2018,713,427,286,149.3,698,419,279,150.2
36460, 완도군,055004, 53세,2018,696,375,321,116.8,677,366,311,117.7
36460, 완도군,055005, 54세,2018,724,382,342,111.7,710,374,336,111.3
36460, 완도군,060,55~59세,2018,4508,2274,2234,101.8,4436,2240,2196,102
36460, 완도군,060001, 55세,2018,819,439,380,115.5,800,427,373,114.5
36460, 완도군,060002, 56세,2018,861,441,420,105,841,430,411,104.6
36460, 완도군,060003, 57세,2018,872,437,435,100.5,866,435,431,100.9
36460, 완도군,060004, 58세,2018,1059,519,540,96.1,1040,511,529,96.6
36460, 완도군,060005, 59세,2018,897,438,459,95.4,889,437,452,96.7
36460, 완도군,065,60~64세,2018,4054,2044,2010,101.7,4029,2030,1999,101.6
36460, 완도군,065001, 60세,2018,809,396,413,95.9,805,394,411,95.9
36460, 완도군,065002, 61세,2018,858,430,428,100.5,848,426,422,100.9
36460, 완도군,065003, 62세,2018,843,455,388,117.3,835,448,387,115.8
36460, 완도군,065004, 63세,2018,876,430,446,96.4,875,430,445,96.6
36460, 완도군,065005, 64세,2018,668,333,335,99.4,666,332,334,99.4
36460, 완도군,070,65~69세,2018,3520,1725,1795,96.1,3505,1720,1785,96.4
36460, 완도군,070001, 65세,2018,573,277,296,93.6,571,276,295,93.6
36460, 완도군,070002, 66세,2018,738,357,381,93.7,735,357,378,94.4
36460, 완도군,070003, 67세,2018,760,384,376,102.1,756,383,373,102.7
36460, 완도군,070004, 68세,2018,724,336,388,86.6,719,334,385,86.8
36460, 완도군,070005, 69세,2018,725,371,354,104.8,724,370,354,104.5
36460, 완도군,075,70~74세,2018,3518,1625,1893,85.8,3513,1625,1888,86.1
36460, 완도군,075001, 70세,2018,715,338,377,89.7,714,338,376,89.9
36460, 완도군,075002, 71세,2018,800,370,430,86,799,370,429,86.2
36460, 완도군,075003, 72세,2018,590,286,304,94.1,587,286,301,95
36460, 완도군,075004, 73세,2018,733,328,405,81,733,328,405,81
36460, 완도군,075005, 74세,2018,680,303,377,80.4,680,303,377,80.4
36460, 완도군,080,75~79세,2018,3695,1548,2147,72.1,3690,1545,2145,72
36460, 완도군,080001, 75세,2018,665,277,388,71.4,663,275,388,70.9
36460, 완도군,080002, 76세,2018,885,408,477,85.5,884,408,476,85.7
36460, 완도군,080003, 77세,2018,739,308,431,71.5,739,308,431,71.5
36460, 완도군,080004, 78세,2018,719,291,428,68,718,290,428,67.8
36460, 완도군,080005, 79세,2018,687,264,423,62.4,686,264,422,62.6
36460, 완도군,085,80~84세,2018,2357,830,1527,54.4,2355,829,1526,54.3
36460, 완도군,085001, 80세,2018,621,233,388,60.1,620,232,388,59.8
36460, 완도군,085002, 81세,2018,522,195,327,59.6,521,195,326,59.8
36460, 완도군,085003, 82세,2018,451,159,292,54.5,451,159,292,54.5
36460, 완도군,085004, 83세,2018,382,133,249,53.4,382,133,249,53.4
36460, 완도군,085005, 84세,2018,381,110,271,40.6,381,110,271,40.6
36460, 완도군,090,85~89세,2018,1109,300,809,37.1,1109,300,809,37.1
36460, 완도군,090001, 85세,2018,300,90,210,42.9,300,90,210,42.9
36460, 완도군,090002, 86세,2018,287,86,201,42.8,287,86,201,42.8
36460, 완도군,090003, 87세,2018,203,53,150,35.3,203,53,150,35.3
36460, 완도군,090004, 88세,2018,191,39,152,25.7,191,39,152,25.7
36460, 완도군,090005, 89세,2018,128,32,96,33.3,128,32,96,33.3
36460, 완도군,095,90~94세,2018,265,45,220,20.5,265,45,220,20.5
36460, 완도군,095001, 90세,2018,95,19,76,25,95,19,76,25
36460, 완도군,095002, 91세,2018,65,8,57,14,65,8,57,14
36460, 완도군,095003, 92세,2018,47,10,37,27,47,10,37,27
36460, 완도군,095004, 93세,2018,31,X,28,10.7,31,X,28,10.7
36460, 완도군,095005, 94세,2018,27,5,22,22.7,27,5,22,22.7
36460, 완도군,100,95~99세,2018,87,9,78,11.5,87,9,78,11.5
36460, 완도군,100001, 95세,2018,31,X,28,10.7,31,X,28,10.7
36460, 완도군,100002, 96세,2018,22,X,20,10,22,X,20,10
36460, 완도군,100003, 97세,2018,17,X,14,21.4,17,X,14,21.4
36460, 완도군,100004, 98세,2018,11,X,10,10,11,X,10,10
36460, 완도군,100005, 99세,2018,6,X,6,0,6,X,6,0
36460, 완도군,101,100세이상,2018,6,X,6,0,6,X,6,0
36460, 완도군,102,15세미만,2018,5073,2618,2455,106.6,5069,2615,2454,106.6
36460, 완도군,103,15~64세,2018,28710,16392,12318,133.1,26317,14468,11849,122.1
36460, 완도군,104,65세이상,2018,14557,6082,8475,71.8,14530,6073,8457,71.8
36460, 완도군,086,85세이상,2018,1467,354,1113,31.8,1467,354,1113,31.8
36460, 완도군,126,평균연령,2018,50.1,47.3,53.1,,50.9,48.5,53.4,
36460, 완도군,127,중위연령,2018,53.5,49.6,57.7,,55,51.8,58.1,
36470, 진도군,000,합계,2018,29366,15065,14301,105.3,27650,13644,14006,97.4
36470, 진도군,005,0~4세,2018,847,410,437,93.8,847,410,437,93.8
36470, 진도군,005001, 0세,2018,130,73,57,128.1,130,73,57,128.1
36470, 진도군,005002, 1세,2018,176,60,116,51.7,176,60,116,51.7
36470, 진도군,005003, 2세,2018,167,82,85,96.5,167,82,85,96.5
36470, 진도군,005004, 3세,2018,196,100,96,104.2,196,100,96,104.2
36470, 진도군,005005, 4세,2018,178,95,83,114.5,178,95,83,114.5
36470, 진도군,010,5~9세,2018,981,501,480,104.4,980,501,479,104.6
36470, 진도군,010001, 5세,2018,185,93,92,101.1,185,93,92,101.1
36470, 진도군,010002, 6세,2018,203,108,95,113.7,203,108,95,113.7
36470, 진도군,010003, 7세,2018,229,103,126,81.7,228,103,125,82.4
36470, 진도군,010004, 8세,2018,167,94,73,128.8,167,94,73,128.8
36470, 진도군,010005, 9세,2018,197,103,94,109.6,197,103,94,109.6
36470, 진도군,015,10~14세,2018,942,479,463,103.5,942,479,463,103.5
36470, 진도군,015001, 10세,2018,175,89,86,103.5,175,89,86,103.5
36470, 진도군,015002, 11세,2018,233,121,112,108,233,121,112,108
36470, 진도군,015003, 12세,2018,183,94,89,105.6,183,94,89,105.6
36470, 진도군,015004, 13세,2018,172,90,82,109.8,172,90,82,109.8
36470, 진도군,015005, 14세,2018,179,85,94,90.4,179,85,94,90.4
36470, 진도군,020,15~19세,2018,1045,564,481,117.3,1039,559,480,116.5
36470, 진도군,020001, 15세,2018,215,104,111,93.7,214,103,111,92.8
36470, 진도군,020002, 16세,2018,241,132,109,121.1,241,132,109,121.1
36470, 진도군,020003, 17세,2018,258,127,131,96.9,258,127,131,96.9
36470, 진도군,020004, 18세,2018,198,107,91,117.6,198,107,91,117.6
36470, 진도군,020005, 19세,2018,133,94,39,241,128,90,38,236.8
36470, 진도군,025,20~24세,2018,1114,778,336,231.5,831,537,294,182.7
36470, 진도군,025001, 20세,2018,176,128,48,266.7,160,116,44,263.6
36470, 진도군,025002, 21세,2018,191,138,53,260.4,169,125,44,284.1
36470, 진도군,025003, 22세,2018,221,149,72,206.9,172,110,62,177.4
36470, 진도군,025004, 23세,2018,261,176,85,207.1,168,93,75,124
36470, 진도군,025005, 24세,2018,265,187,78,239.7,162,93,69,134.8
36470, 진도군,030,25~29세,2018,1517,1045,472,221.4,898,492,406,121.2
36470, 진도군,030001, 25세,2018,291,205,86,238.4,168,95,73,130.1
36470, 진도군,030002, 26세,2018,346,229,117,195.7,211,109,102,106.9
36470, 진도군,030003, 27세,2018,292,201,91,220.9,168,88,80,110
36470, 진도군,030004, 28세,2018,301,215,86,250,175,101,74,136.5
36470, 진도군,030005, 29세,2018,287,195,92,212,176,99,77,128.6
36470, 진도군,035,30~34세,2018,1262,769,493,156,925,483,442,109.3
36470, 진도군,035001, 30세,2018,241,159,82,193.9,162,85,77,110.4
36470, 진도군,035002, 31세,2018,259,150,109,137.6,179,86,93,92.5
36470, 진도군,035003, 32세,2018,255,154,101,152.5,176,87,89,97.8
36470, 진도군,035004, 33세,2018,238,142,96,147.9,185,102,83,122.9
36470, 진도군,035005, 34세,2018,269,164,105,156.2,223,123,100,123
36470, 진도군,040,35~39세,2018,1464,886,578,153.3,1252,711,541,131.4
36470, 진도군,040001, 35세,2018,268,170,98,173.5,217,126,91,138.5
36470, 진도군,040002, 36세,2018,291,183,108,169.4,238,140,98,142.9
36470, 진도군,040003, 37세,2018,284,187,97,192.8,242,152,90,168.9
36470, 진도군,040004, 38세,2018,339,192,147,130.6,300,163,137,119
36470, 진도군,040005, 39세,2018,282,154,128,120.3,255,130,125,104
36470, 진도군,045,40~44세,2018,1582,926,656,141.2,1490,855,635,134.6
36470, 진도군,045001, 40세,2018,274,160,114,140.4,247,137,110,124.5
36470, 진도군,045002, 41세,2018,309,176,133,132.3,294,165,129,127.9
36470, 진도군,045003, 42세,2018,292,167,125,133.6,278,156,122,127.9
36470, 진도군,045004, 43세,2018,350,226,124,182.3,329,210,119,176.5
36470, 진도군,045005, 44세,2018,357,197,160,123.1,342,187,155,120.6
36470, 진도군,050,45~49세,2018,1907,1119,788,142,1849,1083,766,141.4
36470, 진도군,050001, 45세,2018,359,210,149,140.9,347,203,144,141
36470, 진도군,050002, 46세,2018,380,217,163,133.1,361,206,155,132.9
36470, 진도군,050003, 47세,2018,399,245,154,159.1,383,234,149,157
36470, 진도군,050004, 48세,2018,364,202,162,124.7,360,199,161,123.6
36470, 진도군,050005, 49세,2018,405,245,160,153.1,398,241,157,153.5
36470, 진도군,055,50~54세,2018,2255,1243,1012,122.8,2204,1215,989,122.9
36470, 진도군,055001, 50세,2018,433,231,202,114.4,421,224,197,113.7
36470, 진도군,055002, 51세,2018,378,202,176,114.8,367,197,170,115.9
36470, 진도군,055003, 52세,2018,522,310,212,146.2,510,302,208,145.2
36470, 진도군,055004, 53세,2018,453,246,207,118.8,446,244,202,120.8
36470, 진도군,055005, 54세,2018,469,254,215,118.1,460,248,212,117
36470, 진도군,060,55~59세,2018,2659,1361,1298,104.9,2630,1346,1284,104.8
36470, 진도군,060001, 55세,2018,430,232,198,117.2,421,230,191,120.4
36470, 진도군,060002, 56세,2018,510,278,232,119.8,504,273,231,118.2
36470, 진도군,060003, 57세,2018,577,293,284,103.2,571,289,282,102.5
36470, 진도군,060004, 58세,2018,634,304,330,92.1,629,301,328,91.8
36470, 진도군,060005, 59세,2018,508,254,254,100,505,253,252,100.4
36470, 진도군,065,60~64세,2018,2415,1273,1142,111.5,2399,1270,1129,112.5
36470, 진도군,065001, 60세,2018,521,270,251,107.6,515,269,246,109.3
36470, 진도군,065002, 61세,2018,516,278,238,116.8,511,278,233,119.3
36470, 진도군,065003, 62세,2018,536,294,242,121.5,535,293,242,121.1
36470, 진도군,065004, 63세,2018,478,249,229,108.7,476,249,227,109.7
36470, 진도군,065005, 64세,2018,364,182,182,100,362,181,181,100
36470, 진도군,070,65~69세,2018,2174,1073,1101,97.5,2164,1066,1098,97.1
36470, 진도군,070001, 65세,2018,380,175,205,85.4,376,171,205,83.4
36470, 진도군,070002, 66세,2018,458,224,234,95.7,457,224,233,96.1
36470, 진도군,070003, 67세,2018,416,195,221,88.2,415,194,221,87.8
36470, 진도군,070004, 68세,2018,477,240,237,101.3,476,240,236,101.7
36470, 진도군,070005, 69세,2018,443,239,204,117.2,440,237,203,116.7
36470, 진도군,075,70~74세,2018,2211,1012,1199,84.4,2209,1011,1198,84.4
36470, 진도군,075001, 70세,2018,460,214,246,87,458,213,245,86.9
36470, 진도군,075002, 71세,2018,492,244,248,98.4,492,244,248,98.4
36470, 진도군,075003, 72세,2018,374,171,203,84.2,374,171,203,84.2
36470, 진도군,075004, 73세,2018,490,206,284,72.5,490,206,284,72.5
36470, 진도군,075005, 74세,2018,395,177,218,81.2,395,177,218,81.2
36470, 진도군,080,75~79세,2018,2496,955,1541,62,2496,955,1541,62
36470, 진도군,080001, 75세,2018,408,154,254,60.6,408,154,254,60.6
36470, 진도군,080002, 76세,2018,616,224,392,57.1,616,224,392,57.1
36470, 진도군,080003, 77세,2018,529,193,336,57.4,529,193,336,57.4
36470, 진도군,080004, 78세,2018,504,204,300,68,504,204,300,68
36470, 진도군,080005, 79세,2018,439,180,259,69.5,439,180,259,69.5
36470, 진도군,085,80~84세,2018,1538,462,1076,42.9,1538,462,1076,42.9
36470, 진도군,085001, 80세,2018,435,121,314,38.5,435,121,314,38.5
36470, 진도군,085002, 81세,2018,304,105,199,52.8,304,105,199,52.8
36470, 진도군,085003, 82세,2018,284,91,193,47.2,284,91,193,47.2
36470, 진도군,085004, 83세,2018,275,85,190,44.7,275,85,190,44.7
36470, 진도군,085005, 84세,2018,240,60,180,33.3,240,60,180,33.3
36470, 진도군,090,85~89세,2018,714,154,560,27.5,714,154,560,27.5
36470, 진도군,090001, 85세,2018,198,39,159,24.5,198,39,159,24.5
36470, 진도군,090002, 86세,2018,167,35,132,26.5,167,35,132,26.5
36470, 진도군,090003, 87세,2018,125,33,92,35.9,125,33,92,35.9
36470, 진도군,090004, 88세,2018,139,27,112,24.1,139,27,112,24.1
36470, 진도군,090005, 89세,2018,85,20,65,30.8,85,20,65,30.8
36470, 진도군,095,90~94세,2018,196,45,151,29.8,196,45,151,29.8
36470, 진도군,095001, 90세,2018,75,20,55,36.4,75,20,55,36.4
36470, 진도군,095002, 91세,2018,49,13,36,36.1,49,13,36,36.1
36470, 진도군,095003, 92세,2018,32,6,26,23.1,32,6,26,23.1
36470, 진도군,095004, 93세,2018,30,5,25,20,30,5,25,20
36470, 진도군,095005, 94세,2018,10,X,9,11.1,10,X,9,11.1
36470, 진도군,100,95~99세,2018,44,10,34,29.4,44,10,34,29.4
36470, 진도군,100001, 95세,2018,20,5,15,33.3,20,5,15,33.3
36470, 진도군,100002, 96세,2018,12,X,9,33.3,12,X,9,33.3
36470, 진도군,100003, 97세,2018,X,X,X,33.3,X,X,X,33.3
36470, 진도군,100004, 98세,2018,5,X,5,0,5,X,5,0
36470, 진도군,100005, 99세,2018,X,X,X,50,X,X,X,50
36470, 진도군,101,100세이상,2018,X,X,X,0,X,X,X,0
36470, 진도군,102,15세미만,2018,2770,1390,1380,100.7,2769,1390,1379,100.8
36470, 진도군,103,15~64세,2018,17220,9964,7256,137.3,15517,8551,6966,122.8
36470, 진도군,104,65세이상,2018,9376,3711,5665,65.5,9364,3703,5661,65.4
36470, 진도군,086,85세이상,2018,957,209,748,27.9,957,209,748,27.9
36470, 진도군,126,평균연령,2018,50.9,47.6,54.3,,52.1,49.3,54.7,
36470, 진도군,127,중위연령,2018,54.5,50.2,58.7,,56.3,53,59.2,
36480, 신안군,000,합계,2018,35639,18873,16766,112.6,34628,18174,16454,110.5
36480, 신안군,005,0~4세,2018,879,478,401,119.2,878,477,401,119
36480, 신안군,005001, 0세,2018,195,112,83,134.9,195,112,83,134.9
36480, 신안군,005002, 1세,2018,163,85,78,109,163,85,78,109
36480, 신안군,005003, 2세,2018,178,94,84,111.9,178,94,84,111.9
36480, 신안군,005004, 3세,2018,167,95,72,131.9,166,94,72,130.6
36480, 신안군,005005, 4세,2018,176,92,84,109.5,176,92,84,109.5
36480, 신안군,010,5~9세,2018,919,460,459,100.2,917,459,458,100.2
36480, 신안군,010001, 5세,2018,205,108,97,111.3,204,107,97,110.3
36480, 신안군,010002, 6세,2018,192,95,97,97.9,192,95,97,97.9
36480, 신안군,010003, 7세,2018,210,110,100,110,209,110,99,111.1
36480, 신안군,010004, 8세,2018,149,70,79,88.6,149,70,79,88.6
36480, 신안군,010005, 9세,2018,163,77,86,89.5,163,77,86,89.5
36480, 신안군,015,10~14세,2018,724,365,359,101.7,724,365,359,101.7
36480, 신안군,015001, 10세,2018,169,80,89,89.9,169,80,89,89.9
36480, 신안군,015002, 11세,2018,144,76,68,111.8,144,76,68,111.8
36480, 신안군,015003, 12세,2018,130,63,67,94,130,63,67,94
36480, 신안군,015004, 13세,2018,127,64,63,101.6,127,64,63,101.6
36480, 신안군,015005, 14세,2018,154,82,72,113.9,154,82,72,113.9
36480, 신안군,020,15~19세,2018,1002,575,427,134.7,994,571,423,135
36480, 신안군,020001, 15세,2018,169,92,77,119.5,169,92,77,119.5
36480, 신안군,020002, 16세,2018,224,134,90,148.9,223,133,90,147.8
36480, 신안군,020003, 17세,2018,243,129,114,113.2,243,129,114,113.2
36480, 신안군,020004, 18세,2018,235,133,102,130.4,233,132,101,130.7
36480, 신안군,020005, 19세,2018,131,87,44,197.7,126,85,41,207.3
36480, 신안군,025,20~24세,2018,1155,808,347,232.9,1016,696,320,217.5
36480, 신안군,025001, 20세,2018,207,170,37,459.5,197,162,35,462.9
36480, 신안군,025002, 21세,2018,235,178,57,312.3,217,164,53,309.4
36480, 신안군,025003, 22세,2018,208,144,64,225,186,129,57,226.3
36480, 신안군,025004, 23세,2018,238,147,91,161.5,202,119,83,143.4
36480, 신안군,025005, 24세,2018,267,169,98,172.4,214,122,92,132.6
36480, 신안군,030,25~29세,2018,1490,902,588,153.4,1207,681,526,129.5
36480, 신안군,030001, 25세,2018,268,152,116,131,218,114,104,109.6
36480, 신안군,030002, 26세,2018,282,167,115,145.2,233,125,108,115.7
36480, 신안군,030003, 27세,2018,311,193,118,163.6,246,136,110,123.6
36480, 신안군,030004, 28세,2018,312,197,115,171.3,261,159,102,155.9
36480, 신안군,030005, 29세,2018,317,193,124,155.6,249,147,102,144.1
36480, 신안군,035,30~34세,2018,1420,883,537,164.4,1209,734,475,154.5
36480, 신안군,035001, 30세,2018,310,191,119,160.5,258,152,106,143.4
36480, 신안군,035002, 31세,2018,290,171,119,143.7,243,135,108,125
36480, 신안군,035003, 32세,2018,261,170,91,186.8,217,141,76,185.5
36480, 신안군,035004, 33세,2018,283,181,102,177.5,242,156,86,181.4
36480, 신안군,035005, 34세,2018,276,170,106,160.4,249,150,99,151.5
36480, 신안군,040,35~39세,2018,1649,1050,599,175.3,1513,950,563,168.7
36480, 신안군,040001, 35세,2018,344,210,134,156.7,310,183,127,144.1
36480, 신안군,040002, 36세,2018,335,224,111,201.8,304,201,103,195.1
36480, 신안군,040003, 37세,2018,283,183,100,183,255,162,93,174.2
36480, 신안군,040004, 38세,2018,342,220,122,180.3,324,206,118,174.6
36480, 신안군,040005, 39세,2018,345,213,132,161.4,320,198,122,162.3
36480, 신안군,045,40~44세,2018,1731,1169,562,208,1648,1122,526,213.3
36480, 신안군,045001, 40세,2018,341,224,117,191.5,313,210,103,203.9
36480, 신안군,045002, 41세,2018,323,216,107,201.9,311,207,104,199
36480, 신안군,045003, 42세,2018,318,223,95,234.7,304,217,87,249.4
36480, 신안군,045004, 43세,2018,354,244,110,221.8,340,236,104,226.9
36480, 신안군,045005, 44세,2018,395,262,133,197,380,252,128,196.9
36480, 신안군,050,45~49세,2018,2319,1499,820,182.8,2274,1478,796,185.7
36480, 신안군,050001, 45세,2018,445,279,166,168.1,434,274,160,171.3
36480, 신안군,050002, 46세,2018,432,280,152,184.2,419,273,146,187
36480, 신안군,050003, 47세,2018,449,292,157,186,440,290,150,193.3
36480, 신안군,050004, 48세,2018,476,306,170,180,470,304,166,183.1
36480, 신안군,050005, 49세,2018,517,342,175,195.4,511,337,174,193.7
36480, 신안군,055,50~54세,2018,2764,1638,1126,145.5,2721,1620,1101,147.1
36480, 신안군,055001, 50세,2018,514,317,197,160.9,507,315,192,164.1
36480, 신안군,055002, 51세,2018,476,283,193,146.6,466,279,187,149.2
36480, 신안군,055003, 52세,2018,604,346,258,134.1,592,341,251,135.9
36480, 신안군,055004, 53세,2018,589,349,240,145.4,581,347,234,148.3
36480, 신안군,055005, 54세,2018,581,343,238,144.1,575,338,237,142.6
36480, 신안군,060,55~59세,2018,3604,2007,1597,125.7,3573,1994,1579,126.3
36480, 신안군,060001, 55세,2018,638,366,272,134.6,633,364,269,135.3
36480, 신안군,060002, 56세,2018,652,362,290,124.8,645,358,287,124.7
36480, 신안군,060003, 57세,2018,766,424,342,124,761,421,340,123.8
36480, 신안군,060004, 58세,2018,813,431,382,112.8,804,427,377,113.3
36480, 신안군,060005, 59세,2018,735,424,311,136.3,730,424,306,138.6
36480, 신안군,065,60~64세,2018,3407,1860,1547,120.2,3389,1853,1536,120.6
36480, 신안군,065001, 60세,2018,721,405,316,128.2,714,402,312,128.8
36480, 신안군,065002, 61세,2018,729,402,327,122.9,727,401,326,123
36480, 신안군,065003, 62세,2018,654,350,304,115.1,652,349,303,115.2
36480, 신안군,065004, 63세,2018,709,391,318,123,707,390,317,123
36480, 신안군,065005, 64세,2018,594,312,282,110.6,589,311,278,111.9
36480, 신안군,070,65~69세,2018,2958,1504,1454,103.4,2949,1499,1450,103.4
36480, 신안군,070001, 65세,2018,542,279,263,106.1,540,277,263,105.3
36480, 신안군,070002, 66세,2018,677,319,358,89.1,674,318,356,89.3
36480, 신안군,070003, 67세,2018,576,308,268,114.9,575,308,267,115.4
36480, 신안군,070004, 68세,2018,575,295,280,105.4,574,294,280,105
36480, 신안군,070005, 69세,2018,588,303,285,106.3,586,302,284,106.3
36480, 신안군,075,70~74세,2018,2945,1400,1545,90.6,2944,1400,1544,90.7
36480, 신안군,075001, 70세,2018,595,301,294,102.4,594,301,293,102.7
36480, 신안군,075002, 71세,2018,700,359,341,105.3,700,359,341,105.3
36480, 신안군,075003, 72세,2018,576,280,296,94.6,576,280,296,94.6
36480, 신안군,075004, 73세,2018,574,264,310,85.2,574,264,310,85.2
36480, 신안군,075005, 74세,2018,500,196,304,64.5,500,196,304,64.5
36480, 신안군,080,75~79세,2018,3267,1286,1981,64.9,3266,1286,1980,64.9
36480, 신안군,080001, 75세,2018,640,266,374,71.1,639,266,373,71.3
36480, 신안군,080002, 76세,2018,797,326,471,69.2,797,326,471,69.2
36480, 신안군,080003, 77세,2018,649,264,385,68.6,649,264,385,68.6
36480, 신안군,080004, 78세,2018,590,220,370,59.5,590,220,370,59.5
36480, 신안군,080005, 79세,2018,591,210,381,55.1,591,210,381,55.1
36480, 신안군,085,80~84세,2018,2168,703,1465,48,2168,703,1465,48
36480, 신안군,085001, 80세,2018,542,197,345,57.1,542,197,345,57.1
36480, 신안군,085002, 81세,2018,510,169,341,49.6,510,169,341,49.6
36480, 신안군,085003, 82세,2018,408,126,282,44.7,408,126,282,44.7
36480, 신안군,085004, 83세,2018,359,99,260,38.1,359,99,260,38.1
36480, 신안군,085005, 84세,2018,349,112,237,47.3,349,112,237,47.3
36480, 신안군,090,85~89세,2018,936,208,728,28.6,936,208,728,28.6
36480, 신안군,090001, 85세,2018,276,66,210,31.4,276,66,210,31.4
36480, 신안군,090002, 86세,2018,212,47,165,28.5,212,47,165,28.5
36480, 신안군,090003, 87세,2018,173,38,135,28.1,173,38,135,28.1
36480, 신안군,090004, 88세,2018,176,36,140,25.7,176,36,140,25.7
36480, 신안군,090005, 89세,2018,99,21,78,26.9,99,21,78,26.9
36480, 신안군,095,90~94세,2018,236,66,170,38.8,236,66,170,38.8
36480, 신안군,095001, 90세,2018,82,17,65,26.2,82,17,65,26.2
36480, 신안군,095002, 91세,2018,65,18,47,38.3,65,18,47,38.3
36480, 신안군,095003, 92세,2018,38,16,22,72.7,38,16,22,72.7
36480, 신안군,095004, 93세,2018,34,11,23,47.8,34,11,23,47.8
36480, 신안군,095005, 94세,2018,17,X,13,30.8,17,X,13,30.8
36480, 신안군,100,95~99세,2018,59,8,51,15.7,59,8,51,15.7
36480, 신안군,100001, 95세,2018,21,X,18,16.7,21,X,18,16.7
36480, 신안군,100002, 96세,2018,23,X,19,21.1,23,X,19,21.1
36480, 신안군,100003, 97세,2018,6,X,5,20,6,X,5,20
36480, 신안군,100004, 98세,2018,7,X,7,0,7,X,7,0
36480, 신안군,100005, 99세,2018,X,X,X,0,X,X,X,0
36480, 신안군,101,100세이상,2018,7,X,X,133.3,7,X,X,133.3
36480, 신안군,102,15세미만,2018,2522,1303,1219,106.9,2519,1301,1218,106.8
36480, 신안군,103,15~64세,2018,20541,12391,8150,152,19544,11699,7845,149.1
36480, 신안군,104,65세이상,2018,12576,5179,7397,70,12565,5174,7391,70
36480, 신안군,086,85세이상,2018,1238,286,952,30,1238,286,952,30
36480, 신안군,126,평균연령,2018,53.7,50.6,57.2,,54.3,51.3,57.6,
36480, 신안군,127,중위연령,2018,57.6,53.9,61.7,,58.2,54.8,62.2,
37,경상북도,000,합계,2018,2672902,1352869,1320033,102.5,2598831,1306914,1291917,101.2
37,경상북도,005,0~4세,2018,97377,50210,47167,106.5,96629,49841,46788,106.5
37,경상북도,005001, 0세,2018,16304,8485,7819,108.5,16158,8413,7745,108.6
37,경상북도,005002, 1세,2018,17976,9244,8732,105.9,17805,9150,8655,105.7
37,경상북도,005003, 2세,2018,20523,10503,10020,104.8,20345,10424,9921,105.1
37,경상북도,005004, 3세,2018,21625,11106,10519,105.6,21486,11035,10451,105.6
37,경상북도,005005, 4세,2018,20949,10872,10077,107.9,20835,10819,10016,108
37,경상북도,010,5~9세,2018,109324,56731,52593,107.9,108857,56476,52381,107.8
37,경상북도,010001, 5세,2018,21555,11087,10468,105.9,21423,11011,10412,105.8
37,경상북도,010002, 6세,2018,23129,12024,11105,108.3,23025,11967,11058,108.2
37,경상북도,010003, 7세,2018,22601,11783,10818,108.9,22523,11743,10780,108.9
37,경상북도,010004, 8세,2018,21293,10971,10322,106.3,21214,10928,10286,106.2
37,경상북도,010005, 9세,2018,20746,10866,9880,110,20672,10827,9845,110
37,경상북도,015,10~14세,2018,106938,55985,50953,109.9,106623,55825,50798,109.9
37,경상북도,015001, 10세,2018,21890,11426,10464,109.2,21813,11388,10425,109.2
37,경상북도,015002, 11세,2018,22196,11468,10728,106.9,22134,11435,10699,106.9
37,경상북도,015003, 12세,2018,20580,10849,9731,111.5,20507,10814,9693,111.6
37,경상북도,015004, 13세,2018,20360,10617,9743,109,20300,10586,9714,109
37,경상북도,015005, 14세,2018,21912,11625,10287,113,21869,11602,10267,113
37,경상북도,020,15~19세,2018,141480,76179,65301,116.7,138941,75002,63939,117.3
37,경상북도,020001, 15세,2018,22747,11997,10750,111.6,22698,11974,10724,111.7
37,경상북도,020002, 16세,2018,24432,13096,11336,115.5,24371,13067,11304,115.6
37,경상북도,020003, 17세,2018,28443,15154,13289,114,28275,15088,13187,114.4
37,경상북도,020004, 18세,2018,32747,17745,15002,118.3,32135,17445,14690,118.8
37,경상북도,020005, 19세,2018,33111,18187,14924,121.9,31462,17428,14034,124.2
37,경상북도,025,20~24세,2018,169986,96945,73041,132.7,157817,89677,68140,131.6
37,경상북도,025001, 20세,2018,33666,18394,15272,120.4,31517,17281,14236,121.4
37,경상북도,025002, 21세,2018,34546,19108,15438,123.8,32303,17881,14422,124
37,경상북도,025003, 22세,2018,34643,19715,14928,132.1,32296,18288,14008,130.6
37,경상북도,025004, 23세,2018,34189,20194,13995,144.3,31573,18560,13013,142.6
37,경상북도,025005, 24세,2018,32942,19534,13408,145.7,30128,17667,12461,141.8
37,경상북도,030,25~29세,2018,149950,86382,63568,135.9,134703,76221,58482,130.3
37,경상북도,030001, 25세,2018,31627,18472,13155,140.4,28643,16467,12176,135.2
37,경상북도,030002, 26세,2018,31436,17955,13481,133.2,28310,15834,12476,126.9
37,경상북도,030003, 27세,2018,29415,16803,12612,133.2,26409,14776,11633,127
37,경상북도,030004, 28세,2018,29200,16827,12373,136,26084,14784,11300,130.8
37,경상북도,030005, 29세,2018,28272,16325,11947,136.6,25257,14360,10897,131.8
37,경상북도,035,30~34세,2018,147935,81434,66501,122.5,134411,72448,61963,116.9
37,경상북도,035001, 30세,2018,28401,16088,12313,130.7,25438,14152,11286,125.4
37,경상북도,035002, 31세,2018,29273,16100,13173,122.2,26345,14154,12191,116.1
37,경상북도,035003, 32세,2018,29439,16218,13221,122.7,26828,14467,12361,117
37,경상북도,035004, 33세,2018,29685,16296,13389,121.7,27060,14550,12510,116.3
37,경상북도,035005, 34세,2018,31137,16732,14405,116.2,28740,15125,13615,111.1
37,경상북도,040,35~39세,2018,185527,98199,87328,112.4,175787,91608,84179,108.8
37,경상북도,040001, 35세,2018,34625,18373,16252,113.1,32383,16841,15542,108.4
37,경상북도,040002, 36세,2018,38009,20005,18004,111.1,35830,18524,17306,107
37,경상북도,040003, 37세,2018,37947,20198,17749,113.8,36058,18931,17127,110.5
37,경상북도,040004, 38세,2018,38743,20464,18279,112,36937,19272,17665,109.1
37,경상북도,040005, 39세,2018,36203,19159,17044,112.4,34579,18040,16539,109.1
37,경상북도,045,40~44세,2018,181216,94755,86461,109.6,175113,90863,84250,107.8
37,경상북도,045001, 40세,2018,33575,17857,15718,113.6,32183,16934,15249,111
37,경상북도,045002, 41세,2018,34989,18258,16731,109.1,33707,17440,16267,107.2
37,경상북도,045003, 42세,2018,34802,18270,16532,110.5,33543,17462,16081,108.6
37,경상북도,045004, 43세,2018,37344,19350,17994,107.5,36229,18652,17577,106.1
37,경상북도,045005, 44세,2018,40506,21020,19486,107.9,39451,20375,19076,106.8
37,경상북도,050,45~49세,2018,213609,111118,102491,108.4,208895,108321,100574,107.7
37,경상북도,050001, 45세,2018,41065,21114,19951,105.8,40044,20475,19569,104.6
37,경상북도,050002, 46세,2018,41189,21665,19524,111,40189,21052,19137,110
37,경상북도,050003, 47세,2018,43560,22913,20647,111,42625,22357,20268,110.3
37,경상북도,050004, 48세,2018,43555,22477,21078,106.6,42629,21951,20678,106.2
37,경상북도,050005, 49세,2018,44240,22949,21291,107.8,43408,22486,20922,107.5
37,경상북도,055,50~54세,2018,215833,110928,104905,105.7,212375,109119,103256,105.7
37,경상북도,055001, 50세,2018,46135,23701,22434,105.6,45377,23295,22082,105.5
37,경상북도,055002, 51세,2018,42082,21340,20742,102.9,41369,20959,20410,102.7
37,경상북도,055003, 52세,2018,42740,22453,20287,110.7,42095,22128,19967,110.8
37,경상북도,055004, 53세,2018,43201,21938,21263,103.2,42534,21587,20947,103.1
37,경상북도,055005, 54세,2018,41675,21496,20179,106.5,41000,21150,19850,106.5
37,경상북도,060,55~59세,2018,238106,120370,117736,102.2,235724,119168,116556,102.2
37,경상북도,060001, 55세,2018,44242,22715,21527,105.5,43612,22383,21229,105.4
37,경상북도,060002, 56세,2018,46607,23962,22645,105.8,46106,23708,22398,105.8
37,경상북도,060003, 57세,2018,50829,25839,24990,103.4,50431,25644,24787,103.5
37,경상북도,060004, 58세,2018,50753,25172,25581,98.4,50280,24940,25340,98.4
37,경상북도,060005, 59세,2018,45675,22682,22993,98.6,45295,22493,22802,98.6
37,경상북도,065,60~64세,2018,201152,100428,100724,99.7,199670,99666,100004,99.7
37,경상북도,065001, 60세,2018,42080,21293,20787,102.4,41689,21079,20610,102.3
37,경상북도,065002, 61세,2018,42791,21691,21100,102.8,42466,21535,20931,102.9
37,경상북도,065003, 62세,2018,40868,20443,20425,100.1,40591,20294,20297,100
37,경상북도,065004, 63세,2018,39828,19427,20401,95.2,39561,19291,20270,95.2
37,경상북도,065005, 64세,2018,35585,17574,18011,97.6,35363,17467,17896,97.6
37,경상북도,070,65~69세,2018,153733,74438,79295,93.9,153057,74114,78943,93.9
37,경상북도,070001, 65세,2018,33512,16294,17218,94.6,33337,16210,17127,94.6
37,경상북도,070002, 66세,2018,35334,16927,18407,92,35167,16850,18317,92
37,경상북도,070003, 67세,2018,27317,13156,14161,92.9,27194,13094,14100,92.9
37,경상북도,070004, 68세,2018,27849,13492,14357,94,27724,13428,14296,93.9
37,경상북도,070005, 69세,2018,29721,14569,15152,96.2,29635,14532,15103,96.2
37,경상북도,075,70~74세,2018,112399,51720,60679,85.2,112122,51598,60524,85.3
37,경상북도,075001, 70세,2018,28120,13603,14517,93.7,28047,13563,14484,93.6
37,경상북도,075002, 71세,2018,26354,12469,13885,89.8,26291,12444,13847,89.9
37,경상북도,075003, 72세,2018,17318,8180,9138,89.5,17250,8151,9099,89.6
37,경상북도,075004, 73세,2018,18834,8312,10522,79,18800,8298,10502,79
37,경상북도,075005, 74세,2018,21773,9156,12617,72.6,21734,9142,12592,72.6
37,경상북도,080,75~79세,2018,116467,46470,69997,66.4,116341,46424,69917,66.4
37,경상북도,080001, 75세,2018,24458,10184,14274,71.3,24426,10168,14258,71.3
37,경상북도,080002, 76세,2018,27539,11389,16150,70.5,27514,11382,16132,70.6
37,경상북도,080003, 77세,2018,21809,8640,13169,65.6,21787,8632,13155,65.6
37,경상북도,080004, 78세,2018,20924,8083,12841,62.9,20902,8075,12827,63
37,경상북도,080005, 79세,2018,21737,8174,13563,60.3,21712,8167,13545,60.3
37,경상북도,085,80~84세,2018,79482,27324,52158,52.4,79406,27298,52108,52.4
37,경상북도,085001, 80세,2018,18732,6764,11968,56.5,18710,6753,11957,56.5
37,경상북도,085002, 81세,2018,17024,6020,11004,54.7,17008,6014,10994,54.7
37,경상북도,085003, 82세,2018,16029,5577,10452,53.4,16014,5573,10441,53.4
37,경상북도,085004, 83세,2018,15052,4913,10139,48.5,15039,4911,10128,48.5
37,경상북도,085005, 84세,2018,12645,4050,8595,47.1,12635,4047,8588,47.1
37,경상북도,090,85~89세,2018,37215,10182,27033,37.7,37196,10174,27022,37.7
37,경상북도,090001, 85세,2018,10310,3089,7221,42.8,10307,3088,7219,42.8
37,경상북도,090002, 86세,2018,9112,2594,6518,39.8,9108,2593,6515,39.8
37,경상북도,090003, 87세,2018,6947,1856,5091,36.5,6943,1853,5090,36.4
37,경상북도,090004, 88세,2018,6014,1480,4534,32.6,6012,1480,4532,32.7
37,경상북도,090005, 89세,2018,4832,1163,3669,31.7,4826,1160,3666,31.6
37,경상북도,095,90~94세,2018,12151,2591,9560,27.1,12143,2591,9552,27.1
37,경상북도,095001, 90세,2018,4012,871,3141,27.7,4010,871,3139,27.7
37,경상북도,095002, 91세,2018,3168,700,2468,28.4,3165,700,2465,28.4
37,경상북도,095003, 92세,2018,2042,419,1623,25.8,2041,419,1622,25.8
37,경상북도,095004, 93세,2018,1794,369,1425,25.9,1792,369,1423,25.9
37,경상북도,095005, 94세,2018,1135,232,903,25.7,1135,232,903,25.7
37,경상북도,100,95~99세,2018,2712,439,2273,19.3,2711,439,2272,19.3
37,경상북도,100001, 95세,2018,991,185,806,23,991,185,806,23
37,경상북도,100002, 96세,2018,759,121,638,19,759,121,638,19
37,경상북도,100003, 97세,2018,471,67,404,16.6,471,67,404,16.6
37,경상북도,100004, 98세,2018,314,42,272,15.4,313,42,271,15.5
37,경상북도,100005, 99세,2018,177,24,153,15.7,177,24,153,15.7
37,경상북도,101,100세이상,2018,310,41,269,15.2,310,41,269,15.2
37,경상북도,102,15세미만,2018,313639,162926,150713,108.1,312109,162142,149967,108.1
37,경상북도,103,15~64세,2018,1844794,976738,868056,112.5,1773436,932093,841343,110.8
37,경상북도,104,65세이상,2018,514469,213205,301264,70.8,513286,212679,300607,70.7
37,경상북도,086,85세이상,2018,52388,13253,39135,33.9,52360,13245,39115,33.9
37,경상북도,126,평균연령,2018,44.4,42.6,46.4,,44.7,42.9,46.6,
37,경상북도,127,중위연령,2018,46.1,44,48.3,,46.8,44.8,48.8,
37004, 읍부,000,합계,2018,605788,309749,296039,104.6,582780,294764,288016,102.3
37004, 읍부,005,0~4세,2018,22038,11413,10625,107.4,21804,11295,10509,107.5
37004, 읍부,005001, 0세,2018,3636,1887,1749,107.9,3598,1869,1729,108.1
37004, 읍부,005002, 1세,2018,4100,2146,1954,109.8,4038,2112,1926,109.7
37004, 읍부,005003, 2세,2018,4623,2363,2260,104.6,4571,2340,2231,104.9
37004, 읍부,005004, 3세,2018,4882,2561,2321,110.3,4842,2537,2305,110.1
37004, 읍부,005005, 4세,2018,4797,2456,2341,104.9,4755,2437,2318,105.1
37004, 읍부,010,5~9세,2018,25388,13240,12148,109,25243,13160,12083,108.9
37004, 읍부,010001, 5세,2018,4965,2535,2430,104.3,4922,2510,2412,104.1
37004, 읍부,010002, 6세,2018,5245,2798,2447,114.3,5222,2785,2437,114.3
37004, 읍부,010003, 7세,2018,5299,2760,2539,108.7,5272,2749,2523,109
37004, 읍부,010004, 8세,2018,4949,2575,2374,108.5,4925,2560,2365,108.2
37004, 읍부,010005, 9세,2018,4930,2572,2358,109.1,4902,2556,2346,109
37004, 읍부,015,10~14세,2018,25437,13313,12124,109.8,25335,13259,12076,109.8
37004, 읍부,015001, 10세,2018,5122,2652,2470,107.4,5096,2637,2459,107.2
37004, 읍부,015002, 11세,2018,5306,2695,2611,103.2,5286,2682,2604,103
37004, 읍부,015003, 12세,2018,4984,2651,2333,113.6,4963,2643,2320,113.9
37004, 읍부,015004, 13세,2018,4861,2552,2309,110.5,4839,2540,2299,110.5
37004, 읍부,015005, 14세,2018,5164,2763,2401,115.1,5151,2757,2394,115.2
37004, 읍부,020,15~19세,2018,35763,18413,17350,106.1,34759,17979,16780,107.1
37004, 읍부,020001, 15세,2018,5420,2796,2624,106.6,5405,2790,2615,106.7
37004, 읍부,020002, 16세,2018,5856,3025,2831,106.9,5834,3014,2820,106.9
37004, 읍부,020003, 17세,2018,6740,3456,3284,105.2,6666,3421,3245,105.4
37004, 읍부,020004, 18세,2018,8181,4165,4016,103.7,7898,4037,3861,104.6
37004, 읍부,020005, 19세,2018,9566,4971,4595,108.2,8956,4717,4239,111.3
37004, 읍부,025,20~24세,2018,42764,23999,18765,127.9,39264,21894,17370,126
37004, 읍부,025001, 20세,2018,9193,4635,4558,101.7,8510,4304,4206,102.3
37004, 읍부,025002, 21세,2018,8874,4693,4181,112.2,8251,4353,3898,111.7
37004, 읍부,025003, 22세,2018,8663,4941,3722,132.8,8022,4542,3480,130.5
37004, 읍부,025004, 23세,2018,8204,4969,3235,153.6,7458,4487,2971,151
37004, 읍부,025005, 24세,2018,7830,4761,3069,155.1,7023,4208,2815,149.5
37004, 읍부,030,25~29세,2018,33976,20053,13923,144,29367,16764,12603,133
37004, 읍부,030001, 25세,2018,7351,4418,2933,150.6,6441,3760,2681,140.2
37004, 읍부,030002, 26세,2018,7066,4099,2967,138.2,6146,3444,2702,127.5
37004, 읍부,030003, 27세,2018,6558,3861,2697,143.2,5696,3235,2461,131.5
37004, 읍부,030004, 28세,2018,6557,3831,2726,140.5,5597,3153,2444,129
37004, 읍부,030005, 29세,2018,6444,3844,2600,147.8,5487,3172,2315,137
37004, 읍부,035,30~34세,2018,33704,19087,14617,130.6,29407,16060,13347,120.3
37004, 읍부,035001, 30세,2018,6420,3795,2625,144.6,5483,3134,2349,133.4
37004, 읍부,035002, 31세,2018,6691,3776,2915,129.5,5773,3143,2630,119.5
37004, 읍부,035003, 32세,2018,6689,3750,2939,127.6,5861,3161,2700,117.1
37004, 읍부,035004, 33세,2018,6797,3883,2914,133.3,5962,3307,2655,124.6
37004, 읍부,035005, 34세,2018,7107,3883,3224,120.4,6328,3315,3013,110
37004, 읍부,040,35~39세,2018,42799,22769,20030,113.7,39681,20534,19147,107.2
37004, 읍부,040001, 35세,2018,7794,4166,3628,114.8,7100,3666,3434,106.8
37004, 읍부,040002, 36세,2018,8672,4589,4083,112.4,7955,4073,3882,104.9
37004, 읍부,040003, 37세,2018,8773,4733,4040,117.2,8171,4297,3874,110.9
37004, 읍부,040004, 38세,2018,9063,4812,4251,113.2,8480,4398,4082,107.7
37004, 읍부,040005, 39세,2018,8497,4469,4028,110.9,7975,4100,3875,105.8
37004, 읍부,045,40~44세,2018,42747,22786,19961,114.2,40773,21442,19331,110.9
37004, 읍부,045001, 40세,2018,7869,4225,3644,115.9,7414,3904,3510,111.2
37004, 읍부,045002, 41세,2018,8368,4419,3949,111.9,7920,4105,3815,107.6
37004, 읍부,045003, 42세,2018,8063,4332,3731,116.1,7681,4067,3614,112.5
37004, 읍부,045004, 43세,2018,8689,4572,4117,111.1,8347,4354,3993,109
37004, 읍부,045005, 44세,2018,9758,5238,4520,115.9,9411,5012,4399,113.9
37004, 읍부,050,45~49세,2018,50401,26756,23645,113.2,48924,25846,23078,112
37004, 읍부,050001, 45세,2018,9805,5184,4621,112.2,9498,4976,4522,110
37004, 읍부,050002, 46세,2018,9809,5237,4572,114.5,9498,5029,4469,112.5
37004, 읍부,050003, 47세,2018,10377,5521,4856,113.7,10064,5340,4724,113
37004, 읍부,050004, 48세,2018,10156,5323,4833,110.1,9873,5154,4719,109.2
37004, 읍부,050005, 49세,2018,10254,5491,4763,115.3,9991,5347,4644,115.1
37004, 읍부,055,50~54세,2018,49041,25767,23274,110.7,47987,25165,22822,110.3
37004, 읍부,055001, 50세,2018,10589,5585,5004,111.6,10337,5436,4901,110.9
37004, 읍부,055002, 51세,2018,9607,4993,4614,108.2,9400,4866,4534,107.3
37004, 읍부,055003, 52세,2018,9772,5234,4538,115.3,9576,5126,4450,115.2
37004, 읍부,055004, 53세,2018,9696,5032,4664,107.9,9490,4917,4573,107.5
37004, 읍부,055005, 54세,2018,9377,4923,4454,110.5,9184,4820,4364,110.4
37004, 읍부,060,55~59세,2018,51651,26812,24839,107.9,50929,26424,24505,107.8
37004, 읍부,060001, 55세,2018,9913,5184,4729,109.6,9716,5077,4639,109.4
37004, 읍부,060002, 56세,2018,10251,5446,4805,113.3,10091,5358,4733,113.2
37004, 읍부,060003, 57세,2018,10977,5768,5209,110.7,10862,5702,5160,110.5
37004, 읍부,060004, 58세,2018,10839,5474,5365,102,10698,5400,5298,101.9
37004, 읍부,060005, 59세,2018,9671,4940,4731,104.4,9562,4887,4675,104.5
37004, 읍부,065,60~64세,2018,42193,21150,21043,100.5,41739,20898,20841,100.3
37004, 읍부,065001, 60세,2018,9092,4649,4443,104.6,8969,4581,4388,104.4
37004, 읍부,065002, 61세,2018,9037,4572,4465,102.4,8934,4511,4423,102
37004, 읍부,065003, 62세,2018,8367,4256,4111,103.5,8284,4203,4081,103
37004, 읍부,065004, 63세,2018,8329,4097,4232,96.8,8251,4058,4193,96.8
37004, 읍부,065005, 64세,2018,7368,3576,3792,94.3,7301,3545,3756,94.4
37004, 읍부,070,65~69세,2018,31827,15411,16416,93.9,31637,15315,16322,93.8
37004, 읍부,070001, 65세,2018,6922,3438,3484,98.7,6874,3414,3460,98.7
37004, 읍부,070002, 66세,2018,7206,3521,3685,95.5,7165,3501,3664,95.6
37004, 읍부,070003, 67세,2018,5680,2696,2984,90.3,5639,2674,2965,90.2
37004, 읍부,070004, 68세,2018,5790,2765,3025,91.4,5753,2743,3010,91.1
37004, 읍부,070005, 69세,2018,6229,2991,3238,92.4,6206,2983,3223,92.6
37004, 읍부,075,70~74세,2018,23779,10814,12965,83.4,23701,10776,12925,83.4
37004, 읍부,075001, 70세,2018,5861,2815,3046,92.4,5838,2799,3039,92.1
37004, 읍부,075002, 71세,2018,5604,2636,2968,88.8,5589,2631,2958,88.9
37004, 읍부,075003, 72세,2018,3706,1726,1980,87.2,3688,1718,1970,87.2
37004, 읍부,075004, 73세,2018,4003,1714,2289,74.9,3992,1710,2282,74.9
37004, 읍부,075005, 74세,2018,4605,1923,2682,71.7,4594,1918,2676,71.7
37004, 읍부,080,75~79세,2018,24406,9497,14909,63.7,24376,9489,14887,63.7
37004, 읍부,080001, 75세,2018,5107,2063,3044,67.8,5098,2059,3039,67.8
37004, 읍부,080002, 76세,2018,5681,2315,3366,68.8,5675,2314,3361,68.8
37004, 읍부,080003, 77세,2018,4530,1724,2806,61.4,4524,1722,2802,61.5
37004, 읍부,080004, 78세,2018,4362,1698,2664,63.7,4357,1698,2659,63.9
37004, 읍부,080005, 79세,2018,4726,1697,3029,56,4722,1696,3026,56
37004, 읍부,085,80~84세,2018,16651,5685,10966,51.8,16635,5681,10954,51.9
37004, 읍부,085001, 80세,2018,3926,1414,2512,56.3,3922,1411,2511,56.2
37004, 읍부,085002, 81세,2018,3580,1244,2336,53.3,3577,1243,2334,53.3
37004, 읍부,085003, 82세,2018,3465,1219,2246,54.3,3461,1219,2242,54.4
37004, 읍부,085004, 83세,2018,3112,1000,2112,47.3,3109,1000,2109,47.4
37004, 읍부,085005, 84세,2018,2568,808,1760,45.9,2566,808,1758,46
37004, 읍부,090,85~89세,2018,7857,2104,5753,36.6,7855,2103,5752,36.6
37004, 읍부,090001, 85세,2018,2161,632,1529,41.3,2160,632,1528,41.4
37004, 읍부,090002, 86세,2018,1986,552,1434,38.5,1986,552,1434,38.5
37004, 읍부,090003, 87세,2018,1470,391,1079,36.2,1469,390,1079,36.1
37004, 읍부,090004, 88세,2018,1215,286,929,30.8,1215,286,929,30.8
37004, 읍부,090005, 89세,2018,1025,243,782,31.1,1025,243,782,31.1
37004, 읍부,095,90~94세,2018,2721,570,2151,26.5,2719,570,2149,26.5
37004, 읍부,095001, 90세,2018,883,191,692,27.6,882,191,691,27.6
37004, 읍부,095002, 91세,2018,708,153,555,27.6,708,153,555,27.6
37004, 읍부,095003, 92세,2018,474,86,388,22.2,474,86,388,22.2
37004, 읍부,095004, 93세,2018,409,76,333,22.8,408,76,332,22.9
37004, 읍부,095005, 94세,2018,247,64,183,35,247,64,183,35
37004, 읍부,100,95~99세,2018,585,105,480,21.9,585,105,480,21.9
37004, 읍부,100001, 95세,2018,208,43,165,26.1,208,43,165,26.1
37004, 읍부,100002, 96세,2018,165,29,136,21.3,165,29,136,21.3
37004, 읍부,100003, 97세,2018,97,14,83,16.9,97,14,83,16.9
37004, 읍부,100004, 98세,2018,68,8,60,13.3,68,8,60,13.3
37004, 읍부,100005, 99세,2018,47,11,36,30.6,47,11,36,30.6
37004, 읍부,101,100세이상,2018,60,5,55,9.1,60,5,55,9.1
37004, 읍부,102,15세미만,2018,72863,37966,34897,108.8,72382,37714,34668,108.8
37004, 읍부,103,15~64세,2018,425039,227592,197447,115.3,402830,213006,189824,112.2
37004, 읍부,104,65세이상,2018,107886,44191,63695,69.4,107568,44044,63524,69.3
37004, 읍부,086,85세이상,2018,11223,2784,8439,33,11219,2783,8436,33
37004, 읍부,126,평균연령,2018,43.4,41.7,45.3,,43.8,42.1,45.6,
37004, 읍부,127,중위연령,2018,44.8,42.9,46.8,,45.6,44,47.4,
37005, 면부,000,합계,2018,645300,325343,319957,101.7,622549,309433,313116,98.8
37005, 면부,005,0~4세,2018,15455,7942,7513,105.7,15416,7925,7491,105.8
37005, 면부,005001, 0세,2018,2868,1442,1426,101.1,2855,1437,1418,101.3
37005, 면부,005002, 1세,2018,2918,1499,1419,105.6,2912,1497,1415,105.8
37005, 면부,005003, 2세,2018,3257,1647,1610,102.3,3248,1643,1605,102.4
37005, 면부,005004, 3세,2018,3302,1733,1569,110.5,3294,1729,1565,110.5
37005, 면부,005005, 4세,2018,3110,1621,1489,108.9,3107,1619,1488,108.8
37005, 면부,010,5~9세,2018,15155,7871,7284,108.1,15125,7861,7264,108.2
37005, 면부,010001, 5세,2018,3236,1695,1541,110,3231,1694,1537,110.2
37005, 면부,010002, 6세,2018,3189,1647,1542,106.8,3182,1644,1538,106.9
37005, 면부,010003, 7세,2018,3087,1562,1525,102.4,3085,1562,1523,102.6
37005, 면부,010004, 8세,2018,2861,1505,1356,111,2854,1502,1352,111.1
37005, 면부,010005, 9세,2018,2782,1462,1320,110.8,2773,1459,1314,111
37005, 면부,015,10~14세,2018,14421,7644,6777,112.8,14398,7633,6765,112.8
37005, 면부,015001, 10세,2018,3074,1654,1420,116.5,3069,1652,1417,116.6
37005, 면부,015002, 11세,2018,2962,1509,1453,103.9,2955,1506,1449,103.9
37005, 면부,015003, 12세,2018,2707,1451,1256,115.5,2703,1450,1253,115.7
37005, 면부,015004, 13세,2018,2762,1488,1274,116.8,2758,1486,1272,116.8
37005, 면부,015005, 14세,2018,2916,1542,1374,112.2,2913,1539,1374,112
37005, 면부,020,15~19세,2018,19196,10595,8601,123.2,18914,10427,8487,122.9
37005, 면부,020001, 15세,2018,2887,1585,1302,121.7,2882,1583,1299,121.9
37005, 면부,020002, 16세,2018,3261,1778,1483,119.9,3248,1771,1477,119.9
37005, 면부,020003, 17세,2018,3759,1982,1777,111.5,3744,1971,1773,111.2
37005, 면부,020004, 18세,2018,4458,2492,1966,126.8,4381,2442,1939,125.9
37005, 면부,020005, 19세,2018,4831,2758,2073,133,4659,2660,1999,133.1
37005, 면부,025,20~24세,2018,27427,16608,10819,153.5,24110,14298,9812,145.7
37005, 면부,025001, 20세,2018,5141,2999,2142,140,4758,2761,1997,138.3
37005, 면부,025002, 21세,2018,5517,3219,2298,140.1,5016,2900,2116,137.1
37005, 면부,025003, 22세,2018,5544,3366,2178,154.5,4896,2900,1996,145.3
37005, 면부,025004, 23세,2018,5661,3520,2141,164.4,4844,2943,1901,154.8
37005, 면부,025005, 24세,2018,5564,3504,2060,170.1,4596,2794,1802,155
37005, 면부,030,25~29세,2018,28226,17367,10859,159.9,22595,13243,9352,141.6
37005, 면부,030001, 25세,2018,5574,3469,2105,164.8,4503,2683,1820,147.4
37005, 면부,030002, 26세,2018,5839,3569,2270,157.2,4633,2679,1954,137.1
37005, 면부,030003, 27세,2018,5619,3398,2221,153,4458,2525,1933,130.6
37005, 면부,030004, 28세,2018,5687,3492,2195,159.1,4548,2676,1872,142.9
37005, 면부,030005, 29세,2018,5507,3439,2068,166.3,4453,2680,1773,151.2
37005, 면부,035,30~34세,2018,27739,16538,11201,147.6,22985,13052,9933,131.4
37005, 면부,035001, 30세,2018,5547,3365,2182,154.2,4520,2625,1895,138.5
37005, 면부,035002, 31세,2018,5764,3394,2370,143.2,4718,2626,2092,125.5
37005, 면부,035003, 32세,2018,5415,3252,2163,150.3,4515,2577,1938,133
37005, 면부,035004, 33세,2018,5445,3253,2192,148.4,4524,2573,1951,131.9
37005, 면부,035005, 34세,2018,5568,3274,2294,142.7,4708,2651,2057,128.9
37005, 면부,040,35~39세,2018,30846,18145,12701,142.9,27533,15651,11882,131.7
37005, 면부,040001, 35세,2018,6140,3582,2558,140,5335,2970,2365,125.6
37005, 면부,040002, 36세,2018,6451,3711,2740,135.4,5711,3152,2559,123.2
37005, 면부,040003, 37세,2018,6159,3613,2546,141.9,5530,3164,2366,133.7
37005, 면부,040004, 38세,2018,6208,3678,2530,145.4,5597,3223,2374,135.8
37005, 면부,040005, 39세,2018,5888,3561,2327,153,5360,3142,2218,141.7
37005, 면부,045,40~44세,2018,29229,17544,11685,150.1,27361,16214,11147,145.5
37005, 면부,045001, 40세,2018,5402,3251,2151,151.1,4944,2905,2039,142.5
37005, 면부,045002, 41세,2018,5555,3284,2271,144.6,5173,3019,2154,140.2
37005, 면부,045003, 42세,2018,5685,3513,2172,161.7,5278,3227,2051,157.3
37005, 면부,045004, 43세,2018,5977,3590,2387,150.4,5649,3348,2301,145.5
37005, 면부,045005, 44세,2018,6610,3906,2704,144.5,6317,3715,2602,142.8
37005, 면부,050,45~49세,2018,38178,22024,16154,136.3,36835,21149,15686,134.8
37005, 면부,050001, 45세,2018,6874,4047,2827,143.2,6590,3852,2738,140.7
37005, 면부,050002, 46세,2018,6955,4063,2892,140.5,6676,3887,2789,139.4
37005, 면부,050003, 47세,2018,7886,4624,3262,141.8,7622,4444,3178,139.8
37005, 면부,050004, 48세,2018,7833,4443,3390,131.1,7561,4279,3282,130.4
37005, 면부,050005, 49세,2018,8630,4847,3783,128.1,8386,4687,3699,126.7
37005, 면부,055,50~54세,2018,48556,26048,22508,115.7,47647,25578,22069,115.9
37005, 면부,055001, 50세,2018,9274,5023,4251,118.2,9093,4929,4164,118.4
37005, 면부,055002, 51세,2018,9081,4829,4252,113.6,8896,4729,4167,113.5
37005, 면부,055003, 52세,2018,9700,5358,4342,123.4,9515,5271,4244,124.2
37005, 면부,055004, 53세,2018,10218,5421,4797,113,10053,5333,4720,113
37005, 면부,055005, 54세,2018,10283,5417,4866,111.3,10090,5316,4774,111.4
37005, 면부,060,55~59세,2018,66151,33713,32438,103.9,65549,33426,32123,104.1
37005, 면부,060001, 55세,2018,11033,5739,5294,108.4,10881,5660,5221,108.4
37005, 면부,060002, 56세,2018,12604,6656,5948,111.9,12483,6594,5889,112
37005, 면부,060003, 57세,2018,14169,7285,6884,105.8,14067,7249,6818,106.3
37005, 면부,060004, 58세,2018,14706,7265,7441,97.6,14586,7212,7374,97.8
37005, 면부,060005, 59세,2018,13639,6768,6871,98.5,13532,6711,6821,98.4
37005, 면부,065,60~64세,2018,65207,33169,32038,103.5,64854,32985,31869,103.5
37005, 면부,065001, 60세,2018,12781,6693,6088,109.9,12676,6634,6042,109.8
37005, 면부,065002, 61세,2018,13395,6968,6427,108.4,13323,6941,6382,108.8
37005, 면부,065003, 62세,2018,13440,6833,6607,103.4,13376,6797,6579,103.3
37005, 면부,065004, 63세,2018,13286,6530,6756,96.7,13220,6494,6726,96.6
37005, 면부,065005, 64세,2018,12305,6145,6160,99.8,12259,6119,6140,99.7
37005, 면부,070,65~69세,2018,56544,27701,28843,96,56381,27617,28764,96
37005, 면부,070001, 65세,2018,11853,5898,5955,99,11816,5878,5938,99
37005, 면부,070002, 66세,2018,12706,6119,6587,92.9,12663,6096,6567,92.8
37005, 면부,070003, 67세,2018,10040,4912,5128,95.8,10019,4899,5120,95.7
37005, 면부,070004, 68세,2018,10503,5091,5412,94.1,10467,5074,5393,94.1
37005, 면부,070005, 69세,2018,11442,5681,5761,98.6,11416,5670,5746,98.7
37005, 면부,075,70~74세,2018,44932,20771,24161,86,44860,20735,24125,85.9
37005, 면부,075001, 70세,2018,10892,5399,5493,98.3,10873,5388,5485,98.2
37005, 면부,075002, 71세,2018,10416,5016,5400,92.9,10399,5007,5392,92.9
37005, 면부,075003, 72세,2018,6748,3214,3534,90.9,6731,3207,3524,91
37005, 면부,075004, 73세,2018,7758,3407,4351,78.3,7749,3404,4345,78.3
37005, 면부,075005, 74세,2018,9118,3735,5383,69.4,9108,3729,5379,69.3
37005, 면부,080,75~79세,2018,53492,21326,32166,66.3,53462,21313,32149,66.3
37005, 면부,080001, 75세,2018,10675,4411,6264,70.4,10667,4406,6261,70.4
37005, 면부,080002, 76세,2018,12558,5193,7365,70.5,12552,5191,7361,70.5
37005, 면부,080003, 77세,2018,10050,4032,6018,67,10046,4030,6016,67
37005, 면부,080004, 78세,2018,9813,3757,6056,62,9810,3755,6055,62
37005, 면부,080005, 79세,2018,10396,3933,6463,60.9,10387,3931,6456,60.9
37005, 면부,085,80~84세,2018,39201,13597,25604,53.1,39187,13590,25597,53.1
37005, 면부,085001, 80세,2018,9003,3271,5732,57.1,8998,3269,5729,57.1
37005, 면부,085002, 81세,2018,8353,2962,5391,54.9,8351,2960,5391,54.9
37005, 면부,085003, 82세,2018,7823,2732,5091,53.7,7820,2731,5089,53.7
37005, 면부,085004, 83세,2018,7634,2515,5119,49.1,7632,2514,5118,49.1
37005, 면부,085005, 84세,2018,6388,2117,4271,49.6,6386,2116,4270,49.6
37005, 면부,090,85~89세,2018,18214,5206,13008,40,18207,5202,13005,40
37005, 면부,090001, 85세,2018,5110,1595,3515,45.4,5108,1594,3514,45.4
37005, 면부,090002, 86세,2018,4380,1306,3074,42.5,4378,1305,3073,42.5
37005, 면부,090003, 87세,2018,3387,924,2463,37.5,3386,923,2463,37.5
37005, 면부,090004, 88세,2018,2982,775,2207,35.1,2981,775,2206,35.1
37005, 면부,090005, 89세,2018,2355,606,1749,34.6,2354,605,1749,34.6
37005, 면부,095,90~94세,2018,5716,1285,4431,29,5715,1285,4430,29
37005, 면부,095001, 90세,2018,1875,425,1450,29.3,1875,425,1450,29.3
37005, 면부,095002, 91세,2018,1476,359,1117,32.1,1475,359,1116,32.2
37005, 면부,095003, 92세,2018,969,211,758,27.8,969,211,758,27.8
37005, 면부,095004, 93세,2018,846,190,656,29,846,190,656,29
37005, 면부,095005, 94세,2018,550,100,450,22.2,550,100,450,22.2
37005, 면부,100,95~99세,2018,1254,223,1031,21.6,1254,223,1031,21.6
37005, 면부,100001, 95세,2018,449,95,354,26.8,449,95,354,26.8
37005, 면부,100002, 96세,2018,350,60,290,20.7,350,60,290,20.7
37005, 면부,100003, 97세,2018,213,38,175,21.7,213,38,175,21.7
37005, 면부,100004, 98세,2018,161,22,139,15.8,161,22,139,15.8
37005, 면부,100005, 99세,2018,81,8,73,11,81,8,73,11
37005, 면부,101,100세이상,2018,161,26,135,19.3,161,26,135,19.3
37005, 면부,102,15세미만,2018,45031,23457,21574,108.7,44939,23419,21520,108.8
37005, 면부,103,15~64세,2018,380755,211751,169004,125.3,358383,196023,162360,120.7
37005, 면부,104,65세이상,2018,219514,90135,129379,69.7,219227,89991,129236,69.6
37005, 면부,086,85세이상,2018,25345,6740,18605,36.2,25337,6736,18601,36.2
37005, 면부,126,평균연령,2018,53.2,50.2,56.2,,53.9,51.1,56.6,
37005, 면부,127,중위연령,2018,57.3,54,60.2,,58.1,55.3,60.8,
37003, 동부,000,합계,2018,1421814,717777,704037,102,1393502,702717,690785,101.7
37003, 동부,005,0~4세,2018,59884,30855,29029,106.3,59409,30621,28788,106.4
37003, 동부,005001, 0세,2018,9800,5156,4644,111,9705,5107,4598,111.1
37003, 동부,005002, 1세,2018,10958,5599,5359,104.5,10855,5541,5314,104.3
37003, 동부,005003, 2세,2018,12643,6493,6150,105.6,12526,6441,6085,105.9
37003, 동부,005004, 3세,2018,13441,6812,6629,102.8,13350,6769,6581,102.9
37003, 동부,005005, 4세,2018,13042,6795,6247,108.8,12973,6763,6210,108.9
37003, 동부,010,5~9세,2018,68781,35620,33161,107.4,68489,35455,33034,107.3
37003, 동부,010001, 5세,2018,13354,6857,6497,105.5,13270,6807,6463,105.3
37003, 동부,010002, 6세,2018,14695,7579,7116,106.5,14621,7538,7083,106.4
37003, 동부,010003, 7세,2018,14215,7461,6754,110.5,14166,7432,6734,110.4
37003, 동부,010004, 8세,2018,13483,6891,6592,104.5,13435,6866,6569,104.5
37003, 동부,010005, 9세,2018,13034,6832,6202,110.2,12997,6812,6185,110.1
37003, 동부,015,10~14세,2018,67080,35028,32052,109.3,66890,34933,31957,109.3
37003, 동부,015001, 10세,2018,13694,7120,6574,108.3,13648,7099,6549,108.4
37003, 동부,015002, 11세,2018,13928,7264,6664,109,13893,7247,6646,109
37003, 동부,015003, 12세,2018,12889,6747,6142,109.9,12841,6721,6120,109.8
37003, 동부,015004, 13세,2018,12737,6577,6160,106.8,12703,6560,6143,106.8
37003, 동부,015005, 14세,2018,13832,7320,6512,112.4,13805,7306,6499,112.4
37003, 동부,020,15~19세,2018,86521,47171,39350,119.9,85268,46596,38672,120.5
37003, 동부,020001, 15세,2018,14440,7616,6824,111.6,14411,7601,6810,111.6
37003, 동부,020002, 16세,2018,15315,8293,7022,118.1,15289,8282,7007,118.2
37003, 동부,020003, 17세,2018,17944,9716,8228,118.1,17865,9696,8169,118.7
37003, 동부,020004, 18세,2018,20108,11088,9020,122.9,19856,10966,8890,123.4
37003, 동부,020005, 19세,2018,18714,10458,8256,126.7,17847,10051,7796,128.9
37003, 동부,025,20~24세,2018,99795,56338,43457,129.6,94443,53485,40958,130.6
37003, 동부,025001, 20세,2018,19332,10760,8572,125.5,18249,10216,8033,127.2
37003, 동부,025002, 21세,2018,20155,11196,8959,125,19036,10628,8408,126.4
37003, 동부,025003, 22세,2018,20436,11408,9028,126.4,19378,10846,8532,127.1
37003, 동부,025004, 23세,2018,20324,11705,8619,135.8,19271,11130,8141,136.7
37003, 동부,025005, 24세,2018,19548,11269,8279,136.1,18509,10665,7844,136
37003, 동부,030,25~29세,2018,87748,48962,38786,126.2,82741,46214,36527,126.5
37003, 동부,030001, 25세,2018,18702,10585,8117,130.4,17699,10024,7675,130.6
37003, 동부,030002, 26세,2018,18531,10287,8244,124.8,17531,9711,7820,124.2
37003, 동부,030003, 27세,2018,17238,9544,7694,124,16255,9016,7239,124.5
37003, 동부,030004, 28세,2018,16956,9504,7452,127.5,15939,8955,6984,128.2
37003, 동부,030005, 29세,2018,16321,9042,7279,124.2,15317,8508,6809,125
37003, 동부,035,30~34세,2018,86492,45809,40683,112.6,82019,43336,38683,112
37003, 동부,035001, 30세,2018,16434,8928,7506,118.9,15435,8393,7042,119.2
37003, 동부,035002, 31세,2018,16818,8930,7888,113.2,15854,8385,7469,112.3
37003, 동부,035003, 32세,2018,17335,9216,8119,113.5,16452,8729,7723,113
37003, 동부,035004, 33세,2018,17443,9160,8283,110.6,16574,8670,7904,109.7
37003, 동부,035005, 34세,2018,18462,9575,8887,107.7,17704,9159,8545,107.2
37003, 동부,040,35~39세,2018,111882,57285,54597,104.9,108573,55423,53150,104.3
37003, 동부,040001, 35세,2018,20691,10625,10066,105.6,19948,10205,9743,104.7
37003, 동부,040002, 36세,2018,22886,11705,11181,104.7,22164,11299,10865,104
37003, 동부,040003, 37세,2018,23015,11852,11163,106.2,22357,11470,10887,105.4
37003, 동부,040004, 38세,2018,23472,11974,11498,104.1,22860,11651,11209,103.9
37003, 동부,040005, 39세,2018,21818,11129,10689,104.1,21244,10798,10446,103.4
37003, 동부,045,40~44세,2018,109240,54425,54815,99.3,106979,53207,53772,98.9
37003, 동부,045001, 40세,2018,20304,10381,9923,104.6,19825,10125,9700,104.4
37003, 동부,045002, 41세,2018,21066,10555,10511,100.4,20614,10316,10298,100.2
37003, 동부,045003, 42세,2018,21054,10425,10629,98.1,20584,10168,10416,97.6
37003, 동부,045004, 43세,2018,22678,11188,11490,97.4,22233,10950,11283,97
37003, 동부,045005, 44세,2018,24138,11876,12262,96.9,23723,11648,12075,96.5
37003, 동부,050,45~49세,2018,125030,62338,62692,99.4,123136,61326,61810,99.2
37003, 동부,050001, 45세,2018,24386,11883,12503,95,23956,11647,12309,94.6
37003, 동부,050002, 46세,2018,24425,12365,12060,102.5,24015,12136,11879,102.2
37003, 동부,050003, 47세,2018,25297,12768,12529,101.9,24939,12573,12366,101.7
37003, 동부,050004, 48세,2018,25566,12711,12855,98.9,25195,12518,12677,98.7
37003, 동부,050005, 49세,2018,25356,12611,12745,98.9,25031,12452,12579,99
37003, 동부,055,50~54세,2018,118236,59113,59123,100,116741,58376,58365,100
37003, 동부,055001, 50세,2018,26272,13093,13179,99.3,25947,12930,13017,99.3
37003, 동부,055002, 51세,2018,23394,11518,11876,97,23073,11364,11709,97.1
37003, 동부,055003, 52세,2018,23268,11861,11407,104,23004,11731,11273,104.1
37003, 동부,055004, 53세,2018,23287,11485,11802,97.3,22991,11337,11654,97.3
37003, 동부,055005, 54세,2018,22015,11156,10859,102.7,21726,11014,10712,102.8
37003, 동부,060,55~59세,2018,120304,59845,60459,99,119246,59318,59928,99
37003, 동부,060001, 55세,2018,23296,11792,11504,102.5,23015,11646,11369,102.4
37003, 동부,060002, 56세,2018,23752,11860,11892,99.7,23532,11756,11776,99.8
37003, 동부,060003, 57세,2018,25683,12786,12897,99.1,25502,12693,12809,99.1
37003, 동부,060004, 58세,2018,25208,12433,12775,97.3,24996,12328,12668,97.3
37003, 동부,060005, 59세,2018,22365,10974,11391,96.3,22201,10895,11306,96.4
37003, 동부,065,60~64세,2018,93752,46109,47643,96.8,93077,45783,47294,96.8
37003, 동부,065001, 60세,2018,20207,9951,10256,97,20044,9864,10180,96.9
37003, 동부,065002, 61세,2018,20359,10151,10208,99.4,20209,10083,10126,99.6
37003, 동부,065003, 62세,2018,19061,9354,9707,96.4,18931,9294,9637,96.4
37003, 동부,065004, 63세,2018,18213,8800,9413,93.5,18090,8739,9351,93.5
37003, 동부,065005, 64세,2018,15912,7853,8059,97.4,15803,7803,8000,97.5
37003, 동부,070,65~69세,2018,65362,31326,34036,92,65039,31182,33857,92.1
37003, 동부,070001, 65세,2018,14737,6958,7779,89.4,14647,6918,7729,89.5
37003, 동부,070002, 66세,2018,15422,7287,8135,89.6,15339,7253,8086,89.7
37003, 동부,070003, 67세,2018,11597,5548,6049,91.7,11536,5521,6015,91.8
37003, 동부,070004, 68세,2018,11556,5636,5920,95.2,11504,5611,5893,95.2
37003, 동부,070005, 69세,2018,12050,5897,6153,95.8,12013,5879,6134,95.8
37003, 동부,075,70~74세,2018,43688,20135,23553,85.5,43561,20087,23474,85.6
37003, 동부,075001, 70세,2018,11367,5389,5978,90.1,11336,5376,5960,90.2
37003, 동부,075002, 71세,2018,10334,4817,5517,87.3,10303,4806,5497,87.4
37003, 동부,075003, 72세,2018,6864,3240,3624,89.4,6831,3226,3605,89.5
37003, 동부,075004, 73세,2018,7073,3191,3882,82.2,7059,3184,3875,82.2
37003, 동부,075005, 74세,2018,8050,3498,4552,76.8,8032,3495,4537,77
37003, 동부,080,75~79세,2018,38569,15647,22922,68.3,38503,15622,22881,68.3
37003, 동부,080001, 75세,2018,8676,3710,4966,74.7,8661,3703,4958,74.7
37003, 동부,080002, 76세,2018,9300,3881,5419,71.6,9287,3877,5410,71.7
37003, 동부,080003, 77세,2018,7229,2884,4345,66.4,7217,2880,4337,66.4
37003, 동부,080004, 78세,2018,6749,2628,4121,63.8,6735,2622,4113,63.7
37003, 동부,080005, 79세,2018,6615,2544,4071,62.5,6603,2540,4063,62.5
37003, 동부,085,80~84세,2018,23630,8042,15588,51.6,23584,8027,15557,51.6
37003, 동부,085001, 80세,2018,5803,2079,3724,55.8,5790,2073,3717,55.8
37003, 동부,085002, 81세,2018,5091,1814,3277,55.4,5080,1811,3269,55.4
37003, 동부,085003, 82세,2018,4741,1626,3115,52.2,4733,1623,3110,52.2
37003, 동부,085004, 83세,2018,4306,1398,2908,48.1,4298,1397,2901,48.2
37003, 동부,085005, 84세,2018,3689,1125,2564,43.9,3683,1123,2560,43.9
37003, 동부,090,85~89세,2018,11144,2872,8272,34.7,11134,2869,8265,34.7
37003, 동부,090001, 85세,2018,3039,862,2177,39.6,3039,862,2177,39.6
37003, 동부,090002, 86세,2018,2746,736,2010,36.6,2744,736,2008,36.7
37003, 동부,090003, 87세,2018,2090,541,1549,34.9,2088,540,1548,34.9
37003, 동부,090004, 88세,2018,1817,419,1398,30,1816,419,1397,30
37003, 동부,090005, 89세,2018,1452,314,1138,27.6,1447,312,1135,27.5
37003, 동부,095,90~94세,2018,3714,736,2978,24.7,3709,736,2973,24.8
37003, 동부,095001, 90세,2018,1254,255,999,25.5,1253,255,998,25.6
37003, 동부,095002, 91세,2018,984,188,796,23.6,982,188,794,23.7
37003, 동부,095003, 92세,2018,599,122,477,25.6,598,122,476,25.6
37003, 동부,095004, 93세,2018,539,103,436,23.6,538,103,435,23.7
37003, 동부,095005, 94세,2018,338,68,270,25.2,338,68,270,25.2
37003, 동부,100,95~99세,2018,873,111,762,14.6,872,111,761,14.6
37003, 동부,100001, 95세,2018,334,47,287,16.4,334,47,287,16.4
37003, 동부,100002, 96세,2018,244,32,212,15.1,244,32,212,15.1
37003, 동부,100003, 97세,2018,161,15,146,10.3,161,15,146,10.3
37003, 동부,100004, 98세,2018,85,12,73,16.4,84,12,72,16.7
37003, 동부,100005, 99세,2018,49,5,44,11.4,49,5,44,11.4
37003, 동부,101,100세이상,2018,89,10,79,12.7,89,10,79,12.7
37003, 동부,102,15세미만,2018,195745,101503,94242,107.7,194788,101009,93779,107.7
37003, 동부,103,15~64세,2018,1039000,537395,501605,107.1,1012223,523064,489159,106.9
37003, 동부,104,65세이상,2018,187069,78879,108190,72.9,186491,78644,107847,72.9
37003, 동부,086,85세이상,2018,15820,3729,12091,30.8,15804,3726,12078,30.8
37003, 동부,126,평균연령,2018,40.9,39.5,42.4,,41,39.6,42.5,
37003, 동부,127,중위연령,2018,42.1,40.2,43.9,,42.4,40.5,44.2,
37010, 포항시,000,합계,2018,504382,255904,248478,103,496719,251280,245439,102.4
37010, 포항시,005,0~4세,2018,19887,10379,9508,109.2,19780,10325,9455,109.2
37010, 포항시,005001, 0세,2018,3134,1669,1465,113.9,3112,1658,1454,114
37010, 포항시,005002, 1세,2018,3527,1862,1665,111.8,3503,1851,1652,112
37010, 포항시,005003, 2세,2018,4247,2211,2036,108.6,4216,2195,2021,108.6
37010, 포항시,005004, 3세,2018,4556,2363,2193,107.8,4535,2352,2183,107.7
37010, 포항시,005005, 4세,2018,4423,2274,2149,105.8,4414,2269,2145,105.8
37010, 포항시,010,5~9세,2018,23373,12199,11174,109.2,23303,12159,11144,109.1
37010, 포항시,010001, 5세,2018,4559,2322,2237,103.8,4538,2312,2226,103.9
37010, 포항시,010002, 6세,2018,4941,2641,2300,114.8,4926,2633,2293,114.8
37010, 포항시,010003, 7세,2018,4869,2545,2324,109.5,4856,2539,2317,109.6
37010, 포항시,010004, 8세,2018,4590,2378,2212,107.5,4583,2372,2211,107.3
37010, 포항시,010005, 9세,2018,4414,2313,2101,110.1,4400,2303,2097,109.8
37010, 포항시,015,10~14세,2018,22348,11679,10669,109.5,22316,11664,10652,109.5
37010, 포항시,015001, 10세,2018,4527,2329,2198,106,4521,2326,2195,106
37010, 포항시,015002, 11세,2018,4587,2368,2219,106.7,4580,2364,2216,106.7
37010, 포항시,015003, 12세,2018,4316,2258,2058,109.7,4307,2256,2051,110
37010, 포항시,015004, 13세,2018,4303,2307,1996,115.6,4299,2304,1995,115.5
37010, 포항시,015005, 14세,2018,4615,2417,2198,110,4609,2414,2195,110
37010, 포항시,020,15~19세,2018,26092,14199,11893,119.4,25807,14064,11743,119.8
37010, 포항시,020001, 15세,2018,4668,2466,2202,112,4663,2465,2198,112.1
37010, 포항시,020002, 16세,2018,4805,2602,2203,118.1,4800,2599,2201,118.1
37010, 포항시,020003, 17세,2018,5711,3055,2656,115,5693,3045,2648,115
37010, 포항시,020004, 18세,2018,6140,3337,2803,119.1,6052,3295,2757,119.5
37010, 포항시,020005, 19세,2018,4768,2739,2029,135,4599,2660,1939,137.2
37010, 포항시,025,20~24세,2018,29404,16952,12452,136.1,28117,16221,11896,136.4
37010, 포항시,025001, 20세,2018,5708,3400,2308,147.3,5470,3273,2197,149
37010, 포항시,025002, 21세,2018,5963,3564,2399,148.6,5690,3423,2267,151
37010, 포항시,025003, 22세,2018,5936,3329,2607,127.7,5686,3191,2495,127.9
37010, 포항시,025004, 23세,2018,5916,3270,2646,123.6,5655,3112,2543,122.4
37010, 포항시,025005, 24세,2018,5881,3389,2492,136,5616,3222,2394,134.6
37010, 포항시,030,25~29세,2018,28261,16317,11944,136.6,26783,15355,11428,134.4
37010, 포항시,030001, 25세,2018,5871,3394,2477,137,5585,3205,2380,134.7
37010, 포항시,030002, 26세,2018,5975,3493,2482,140.7,5681,3296,2385,138.2
37010, 포항시,030003, 27세,2018,5537,3214,2323,138.4,5239,3008,2231,134.8
37010, 포항시,030004, 28세,2018,5525,3167,2358,134.3,5230,2980,2250,132.4
37010, 포항시,030005, 29세,2018,5353,3049,2304,132.3,5048,2866,2182,131.3
37010, 포항시,035,30~34세,2018,28052,14962,13090,114.3,26696,14112,12584,112.1
37010, 포항시,035001, 30세,2018,5249,2900,2349,123.5,4932,2704,2228,121.4
37010, 포항시,035002, 31세,2018,5327,2851,2476,115.1,5049,2667,2382,112
37010, 포항시,035003, 32세,2018,5561,3013,2548,118.2,5305,2853,2452,116.4
37010, 포항시,035004, 33세,2018,5661,2954,2707,109.1,5400,2796,2604,107.4
37010, 포항시,035005, 34세,2018,6254,3244,3010,107.8,6010,3092,2918,106
37010, 포항시,040,35~39세,2018,37600,19439,18161,107,36658,18831,17827,105.6
37010, 포항시,040001, 35세,2018,6968,3715,3253,114.2,6752,3564,3188,111.8
37010, 포항시,040002, 36세,2018,7672,3944,3728,105.8,7490,3829,3661,104.6
37010, 포항시,040003, 37세,2018,7896,4112,3784,108.7,7686,3983,3703,107.6
37010, 포항시,040004, 38세,2018,7725,3956,3769,105,7553,3851,3702,104
37010, 포항시,040005, 39세,2018,7339,3712,3627,102.3,7177,3604,3573,100.9
37010, 포항시,045,40~44세,2018,36307,18477,17830,103.6,35648,18045,17603,102.5
37010, 포항시,045001, 40세,2018,6754,3497,3257,107.4,6600,3396,3204,106
37010, 포항시,045002, 41세,2018,7180,3666,3514,104.3,7045,3575,3470,103
37010, 포항시,045003, 42세,2018,6667,3382,3285,103,6535,3294,3241,101.6
37010, 포항시,045004, 43세,2018,7506,3829,3677,104.1,7375,3748,3627,103.3
37010, 포항시,045005, 44세,2018,8200,4103,4097,100.1,8093,4032,4061,99.3
37010, 포항시,050,45~49세,2018,43652,21979,21673,101.4,43103,21632,21471,100.7
37010, 포항시,050001, 45세,2018,8435,4222,4213,100.2,8299,4125,4174,98.8
37010, 포항시,050002, 46세,2018,8330,4211,4119,102.2,8218,4137,4081,101.4
37010, 포항시,050003, 47세,2018,8858,4450,4408,101,8743,4386,4357,100.7
37010, 포항시,050004, 48세,2018,9055,4506,4549,99.1,8960,4449,4511,98.6
37010, 포항시,050005, 49세,2018,8974,4590,4384,104.7,8883,4535,4348,104.3
37010, 포항시,055,50~54세,2018,43693,21834,21859,99.9,43362,21660,21702,99.8
37010, 포항시,055001, 50세,2018,9495,4839,4656,103.9,9420,4797,4623,103.8
37010, 포항시,055002, 51세,2018,8429,4200,4229,99.3,8359,4161,4198,99.1
37010, 포항시,055003, 52세,2018,8649,4403,4246,103.7,8589,4379,4210,104
37010, 포항시,055004, 53세,2018,8909,4332,4577,94.6,8852,4298,4554,94.4
37010, 포항시,055005, 54세,2018,8211,4060,4151,97.8,8142,4025,4117,97.8
37010, 포항시,060,55~59세,2018,48291,23789,24502,97.1,48027,23668,24359,97.2
37010, 포항시,060001, 55세,2018,9046,4498,4548,98.9,8965,4461,4504,99
37010, 포항시,060002, 56세,2018,9283,4724,4559,103.6,9232,4697,4535,103.6
37010, 포항시,060003, 57세,2018,10245,5079,5166,98.3,10210,5065,5145,98.4
37010, 포항시,060004, 58세,2018,10211,4948,5263,94,10153,4919,5234,94
37010, 포항시,060005, 59세,2018,9506,4540,4966,91.4,9467,4526,4941,91.6
37010, 포항시,065,60~64세,2018,40932,20280,20652,98.2,40767,20183,20584,98.1
37010, 포항시,065001, 60세,2018,8654,4171,4483,93,8618,4148,4470,92.8
37010, 포항시,065002, 61세,2018,8772,4421,4351,101.6,8735,4399,4336,101.5
37010, 포항시,065003, 62세,2018,8175,3992,4183,95.4,8143,3974,4169,95.3
37010, 포항시,065004, 63세,2018,8244,4039,4205,96.1,8217,4022,4195,95.9
37010, 포항시,065005, 64세,2018,7087,3657,3430,106.6,7054,3640,3414,106.6
37010, 포항시,070,65~69세,2018,27809,13970,13839,100.9,27734,13936,13798,101
37010, 포항시,070001, 65세,2018,6326,3174,3152,100.7,6310,3166,3144,100.7
37010, 포항시,070002, 66세,2018,6605,3308,3297,100.3,6588,3302,3286,100.5
37010, 포항시,070003, 67세,2018,5008,2514,2494,100.8,4990,2506,2484,100.9
37010, 포항시,070004, 68세,2018,4857,2477,2380,104.1,4839,2467,2372,104
37010, 포항시,070005, 69세,2018,5013,2497,2516,99.2,5007,2495,2512,99.3
37010, 포항시,075,70~74세,2018,18172,8755,9417,93,18137,8741,9396,93
37010, 포항시,075001, 70세,2018,4669,2334,2335,100,4659,2328,2331,99.9
37010, 포항시,075002, 71세,2018,4342,2128,2214,96.1,4335,2127,2208,96.3
37010, 포항시,075003, 72세,2018,2894,1424,1470,96.9,2887,1420,1467,96.8
37010, 포항시,075004, 73세,2018,2984,1374,1610,85.3,2977,1372,1605,85.5
37010, 포항시,075005, 74세,2018,3283,1495,1788,83.6,3279,1494,1785,83.7
37010, 포항시,080,75~79세,2018,15190,6339,8851,71.6,15175,6333,8842,71.6
37010, 포항시,080001, 75세,2018,3360,1467,1893,77.5,3357,1466,1891,77.5
37010, 포항시,080002, 76세,2018,3661,1575,2086,75.5,3659,1574,2085,75.5
37010, 포항시,080003, 77세,2018,2916,1217,1699,71.6,2914,1216,1698,71.6
37010, 포항시,080004, 78세,2018,2629,1053,1576,66.8,2625,1051,1574,66.8
37010, 포항시,080005, 79세,2018,2624,1027,1597,64.3,2620,1026,1594,64.4
37010, 포항시,085,80~84세,2018,9007,2972,6035,49.2,8995,2969,6026,49.3
37010, 포항시,085001, 80세,2018,2163,755,1408,53.6,2161,755,1406,53.7
37010, 포항시,085002, 81세,2018,1980,713,1267,56.3,1974,713,1261,56.5
37010, 포항시,085003, 82세,2018,1841,600,1241,48.3,1840,599,1241,48.3
37010, 포항시,085004, 83세,2018,1590,463,1127,41.1,1588,462,1126,41
37010, 포항시,085005, 84세,2018,1433,441,992,44.5,1432,440,992,44.4
37010, 포항시,090,85~89세,2018,4405,1062,3343,31.8,4404,1061,3343,31.7
37010, 포항시,090001, 85세,2018,1180,323,857,37.7,1180,323,857,37.7
37010, 포항시,090002, 86세,2018,1066,266,800,33.3,1066,266,800,33.3
37010, 포항시,090003, 87세,2018,851,196,655,29.9,851,196,655,29.9
37010, 포항시,090004, 88세,2018,714,156,558,28,714,156,558,28
37010, 포항시,090005, 89세,2018,594,121,473,25.6,593,120,473,25.4
37010, 포항시,095,90~94세,2018,1532,257,1275,20.2,1532,257,1275,20.2
37010, 포항시,095001, 90세,2018,512,86,426,20.2,512,86,426,20.2
37010, 포항시,095002, 91세,2018,420,65,355,18.3,420,65,355,18.3
37010, 포항시,095003, 92세,2018,236,36,200,18,236,36,200,18
37010, 포항시,095004, 93세,2018,210,37,173,21.4,210,37,173,21.4
37010, 포항시,095005, 94세,2018,154,33,121,27.3,154,33,121,27.3
37010, 포항시,100,95~99세,2018,334,58,276,21,334,58,276,21
37010, 포항시,100001, 95세,2018,128,32,96,33.3,128,32,96,33.3
37010, 포항시,100002, 96세,2018,92,12,80,15,92,12,80,15
37010, 포항시,100003, 97세,2018,49,6,43,14,49,6,43,14
37010, 포항시,100004, 98세,2018,46,X,42,9.5,46,X,42,9.5
37010, 포항시,100005, 99세,2018,19,X,15,26.7,19,X,15,26.7
37010, 포항시,101,100세이상,2018,41,6,35,17.1,41,6,35,17.1
37010, 포항시,102,15세미만,2018,65608,34257,31351,109.3,65399,34148,31251,109.3
37010, 포항시,103,15~64세,2018,362284,188228,174056,108.1,354968,183771,171197,107.3
37010, 포항시,104,65세이상,2018,76490,33419,43071,77.6,76352,33361,42991,77.6
37010, 포항시,086,85세이상,2018,6312,1383,4929,28.1,6311,1382,4929,28
37010, 포항시,126,평균연령,2018,42.9,41.4,44.4,,43,41.6,44.5,
37010, 포항시,127,중위연령,2018,45.1,43.3,46.8,,45.4,43.7,47,
37011, 남구,000,합계,2018,236268,123019,113249,108.6,232212,120317,111895,107.5
37011, 남구,005,0~4세,2018,9195,4811,4384,109.7,9148,4790,4358,109.9
37011, 남구,005001, 0세,2018,1440,772,668,115.6,1433,769,664,115.8
37011, 남구,005002, 1세,2018,1643,872,771,113.1,1632,867,765,113.3
37011, 남구,005003, 2세,2018,1968,1034,934,110.7,1951,1026,925,110.9
37011, 남구,005004, 3세,2018,2091,1065,1026,103.8,2082,1061,1021,103.9
37011, 남구,005005, 4세,2018,2053,1068,985,108.4,2050,1067,983,108.5
37011, 남구,010,5~9세,2018,10974,5718,5256,108.8,10944,5703,5241,108.8
37011, 남구,010001, 5세,2018,2094,1068,1026,104.1,2084,1063,1021,104.1
37011, 남구,010002, 6세,2018,2348,1244,1104,112.7,2344,1242,1102,112.7
37011, 남구,010003, 7세,2018,2294,1190,1104,107.8,2287,1188,1099,108.1
37011, 남구,010004, 8세,2018,2150,1109,1041,106.5,2148,1107,1041,106.3
37011, 남구,010005, 9세,2018,2088,1107,981,112.8,2081,1103,978,112.8
37011, 남구,015,10~14세,2018,10403,5406,4997,108.2,10395,5400,4995,108.1
37011, 남구,015001, 10세,2018,2152,1100,1052,104.6,2150,1099,1051,104.6
37011, 남구,015002, 11세,2018,2133,1094,1039,105.3,2131,1092,1039,105.1
37011, 남구,015003, 12세,2018,1971,1021,950,107.5,1969,1020,949,107.5
37011, 남구,015004, 13세,2018,2032,1095,937,116.9,2032,1095,937,116.9
37011, 남구,015005, 14세,2018,2115,1096,1019,107.6,2113,1094,1019,107.4
37011, 남구,020,15~19세,2018,11751,6650,5101,130.4,11713,6630,5083,130.4
37011, 남구,020001, 15세,2018,2104,1132,972,116.5,2104,1132,972,116.5
37011, 남구,020002, 16세,2018,2178,1203,975,123.4,2176,1201,975,123.2
37011, 남구,020003, 17세,2018,2775,1531,1244,123.1,2772,1530,1242,123.2
37011, 남구,020004, 18세,2018,2747,1575,1172,134.4,2743,1573,1170,134.4
37011, 남구,020005, 19세,2018,1947,1209,738,163.8,1918,1194,724,164.9
37011, 남구,025,20~24세,2018,12977,7924,5053,156.8,12526,7632,4894,155.9
37011, 남구,025001, 20세,2018,2353,1544,809,190.9,2311,1513,798,189.6
37011, 남구,025002, 21세,2018,2588,1673,915,182.8,2517,1637,880,186
37011, 남구,025003, 22세,2018,2649,1564,1085,144.1,2548,1506,1042,144.5
37011, 남구,025004, 23세,2018,2598,1483,1115,133,2494,1413,1081,130.7
37011, 남구,025005, 24세,2018,2789,1660,1129,147,2656,1563,1093,143
37011, 남구,030,25~29세,2018,14233,8508,5725,148.6,13366,7917,5449,145.3
37011, 남구,030001, 25세,2018,2920,1721,1199,143.5,2773,1621,1152,140.7
37011, 남구,030002, 26세,2018,3043,1825,1218,149.8,2864,1699,1165,145.8
37011, 남구,030003, 27세,2018,2827,1725,1102,156.5,2645,1590,1055,150.7
37011, 남구,030004, 28세,2018,2786,1661,1125,147.6,2610,1546,1064,145.3
37011, 남구,030005, 29세,2018,2657,1576,1081,145.8,2474,1461,1013,144.2
37011, 남구,035,30~34세,2018,13719,7622,6097,125,12858,7024,5834,120.4
37011, 남구,035001, 30세,2018,2602,1511,1091,138.5,2406,1372,1034,132.7
37011, 남구,035002, 31세,2018,2688,1483,1205,123.1,2498,1347,1151,117
37011, 남구,035003, 32세,2018,2720,1521,1199,126.9,2561,1414,1147,123.3
37011, 남구,035004, 33세,2018,2763,1515,1248,121.4,2593,1403,1190,117.9
37011, 남구,035005, 34세,2018,2946,1592,1354,117.6,2800,1488,1312,113.4
37011, 남구,040,35~39세,2018,17985,9507,8478,112.1,17421,9094,8327,109.2
37011, 남구,040001, 35세,2018,3369,1835,1534,119.6,3248,1738,1510,115.1
37011, 남구,040002, 36세,2018,3620,1904,1716,111,3504,1818,1686,107.8
37011, 남구,040003, 37세,2018,3781,2004,1777,112.8,3650,1919,1731,110.9
37011, 남구,040004, 38세,2018,3723,1932,1791,107.9,3623,1862,1761,105.7
37011, 남구,040005, 39세,2018,3492,1832,1660,110.4,3396,1757,1639,107.2
37011, 남구,045,40~44세,2018,17264,9040,8224,109.9,16865,8761,8104,108.1
37011, 남구,045001, 40세,2018,3243,1730,1513,114.3,3135,1652,1483,111.4
37011, 남구,045002, 41세,2018,3410,1832,1578,116.1,3339,1777,1562,113.8
37011, 남구,045003, 42세,2018,3119,1637,1482,110.5,3030,1579,1451,108.8
37011, 남구,045004, 43세,2018,3585,1831,1754,104.4,3517,1783,1734,102.8
37011, 남구,045005, 44세,2018,3907,2010,1897,106,3844,1970,1874,105.1
37011, 남구,050,45~49세,2018,20580,10748,9832,109.3,20264,10523,9741,108
37011, 남구,050001, 45세,2018,4018,2106,1912,110.1,3934,2039,1895,107.6
37011, 남구,050002, 46세,2018,3887,2012,1875,107.3,3818,1960,1858,105.5
37011, 남구,050003, 47세,2018,4157,2151,2006,107.2,4095,2112,1983,106.5
37011, 남구,050004, 48세,2018,4269,2233,2036,109.7,4212,2193,2019,108.6
37011, 남구,050005, 49세,2018,4249,2246,2003,112.1,4205,2219,1986,111.7
37011, 남구,055,50~54세,2018,20563,10607,9956,106.5,20382,10511,9871,106.5
37011, 남구,055001, 50세,2018,4560,2409,2151,112,4515,2382,2133,111.7
37011, 남구,055002, 51세,2018,4094,2129,1965,108.3,4054,2107,1947,108.2
37011, 남구,055003, 52세,2018,4040,2114,1926,109.8,4007,2100,1907,110.1
37011, 남구,055004, 53세,2018,4116,2056,2060,99.8,4081,2036,2045,99.6
37011, 남구,055005, 54세,2018,3753,1899,1854,102.4,3725,1886,1839,102.6
37011, 남구,060,55~59세,2018,22362,11236,11126,101,22231,11173,11058,101
37011, 남구,060001, 55세,2018,4135,2105,2030,103.7,4100,2091,2009,104.1
37011, 남구,060002, 56세,2018,4285,2205,2080,106,4258,2190,2068,105.9
37011, 남구,060003, 57세,2018,4717,2398,2319,103.4,4701,2392,2309,103.6
37011, 남구,060004, 58세,2018,4769,2388,2381,100.3,4736,2369,2367,100.1
37011, 남구,060005, 59세,2018,4456,2140,2316,92.4,4436,2131,2305,92.5
37011, 남구,065,60~64세,2018,19392,9600,9792,98,19297,9547,9750,97.9
37011, 남구,065001, 60세,2018,4066,1912,2154,88.8,4048,1900,2148,88.5
37011, 남구,065002, 61세,2018,4167,2087,2080,100.3,4144,2075,2069,100.3
37011, 남구,065003, 62세,2018,3880,1888,1992,94.8,3862,1879,1983,94.8
37011, 남구,065004, 63세,2018,3908,1963,1945,100.9,3893,1953,1940,100.7
37011, 남구,065005, 64세,2018,3371,1750,1621,108,3350,1740,1610,108.1
37011, 남구,070,65~69세,2018,13317,6734,6583,102.3,13272,6713,6559,102.3
37011, 남구,070001, 65세,2018,3010,1523,1487,102.4,3000,1518,1482,102.4
37011, 남구,070002, 66세,2018,3222,1616,1606,100.6,3210,1612,1598,100.9
37011, 남구,070003, 67세,2018,2388,1207,1181,102.2,2380,1202,1178,102
37011, 남구,070004, 68세,2018,2282,1198,1084,110.5,2272,1192,1080,110.4
37011, 남구,070005, 69세,2018,2415,1190,1225,97.1,2410,1189,1221,97.4
37011, 남구,075,70~74세,2018,8500,4166,4334,96.1,8484,4159,4325,96.2
37011, 남구,075001, 70세,2018,2201,1131,1070,105.7,2195,1128,1067,105.7
37011, 남구,075002, 71세,2018,2057,1014,1043,97.2,2055,1013,1042,97.2
37011, 남구,075003, 72세,2018,1329,657,672,97.8,1327,656,671,97.8
37011, 남구,075004, 73세,2018,1409,661,748,88.4,1406,660,746,88.5
37011, 남구,075005, 74세,2018,1504,703,801,87.8,1501,702,799,87.9
37011, 남구,080,75~79세,2018,6812,2938,3874,75.8,6810,2937,3873,75.8
37011, 남구,080001, 75세,2018,1550,727,823,88.3,1549,727,822,88.4
37011, 남구,080002, 76세,2018,1668,753,915,82.3,1668,753,915,82.3
37011, 남구,080003, 77세,2018,1312,557,755,73.8,1312,557,755,73.8
37011, 남구,080004, 78세,2018,1161,462,699,66.1,1161,462,699,66.1
37011, 남구,080005, 79세,2018,1121,439,682,64.4,1120,438,682,64.2
37011, 남구,085,80~84세,2018,3866,1279,2587,49.4,3861,1278,2583,49.5
37011, 남구,085001, 80세,2018,921,340,581,58.5,921,340,581,58.5
37011, 남구,085002, 81세,2018,899,318,581,54.7,896,318,578,55
37011, 남구,085003, 82세,2018,808,251,557,45.1,808,251,557,45.1
37011, 남구,085004, 83세,2018,653,186,467,39.8,652,186,466,39.9
37011, 남구,085005, 84세,2018,585,184,401,45.9,584,183,401,45.6
37011, 남구,090,85~89세,2018,1672,401,1271,31.5,1672,401,1271,31.5
37011, 남구,090001, 85세,2018,483,128,355,36.1,483,128,355,36.1
37011, 남구,090002, 86세,2018,403,96,307,31.3,403,96,307,31.3
37011, 남구,090003, 87세,2018,311,83,228,36.4,311,83,228,36.4
37011, 남구,090004, 88세,2018,265,52,213,24.4,265,52,213,24.4
37011, 남구,090005, 89세,2018,210,42,168,25,210,42,168,25
37011, 남구,095,90~94세,2018,574,98,476,20.6,574,98,476,20.6
37011, 남구,095001, 90세,2018,183,39,144,27.1,183,39,144,27.1
37011, 남구,095002, 91세,2018,156,22,134,16.4,156,22,134,16.4
37011, 남구,095003, 92세,2018,98,13,85,15.3,98,13,85,15.3
37011, 남구,095004, 93세,2018,80,13,67,19.4,80,13,67,19.4
37011, 남구,095005, 94세,2018,57,11,46,23.9,57,11,46,23.9
37011, 남구,100,95~99세,2018,113,22,91,24.2,113,22,91,24.2
37011, 남구,100001, 95세,2018,49,10,39,25.6,49,10,39,25.6
37011, 남구,100002, 96세,2018,25,6,19,31.6,25,6,19,31.6
37011, 남구,100003, 97세,2018,19,X,17,11.8,19,X,17,11.8
37011, 남구,100004, 98세,2018,14,X,11,27.3,14,X,11,27.3
37011, 남구,100005, 99세,2018,6,X,5,20,6,X,5,20
37011, 남구,101,100세이상,2018,16,X,12,33.3,16,X,12,33.3
37011, 남구,102,15세미만,2018,30572,15935,14637,108.9,30487,15893,14594,108.9
37011, 남구,103,15~64세,2018,170826,91442,79384,115.2,166923,88812,78111,113.7
37011, 남구,104,65세이상,2018,34870,15642,19228,81.4,34802,15612,19190,81.4
37011, 남구,086,85세이상,2018,2375,525,1850,28.4,2375,525,1850,28.4
37011, 남구,126,평균연령,2018,42.8,41.3,44.3,,42.9,41.5,44.4,
37011, 남구,127,중위연령,2018,44.9,43.1,46.7,,45.2,43.5,47,
37012, 북구,000,합계,2018,268114,132885,135229,98.3,264507,130963,133544,98.1
37012, 북구,005,0~4세,2018,10692,5568,5124,108.7,10632,5535,5097,108.6
37012, 북구,005001, 0세,2018,1694,897,797,112.5,1679,889,790,112.5
37012, 북구,005002, 1세,2018,1884,990,894,110.7,1871,984,887,110.9
37012, 북구,005003, 2세,2018,2279,1177,1102,106.8,2265,1169,1096,106.7
37012, 북구,005004, 3세,2018,2465,1298,1167,111.2,2453,1291,1162,111.1
37012, 북구,005005, 4세,2018,2370,1206,1164,103.6,2364,1202,1162,103.4
37012, 북구,010,5~9세,2018,12399,6481,5918,109.5,12359,6456,5903,109.4
37012, 북구,010001, 5세,2018,2465,1254,1211,103.6,2454,1249,1205,103.7
37012, 북구,010002, 6세,2018,2593,1397,1196,116.8,2582,1391,1191,116.8
37012, 북구,010003, 7세,2018,2575,1355,1220,111.1,2569,1351,1218,110.9
37012, 북구,010004, 8세,2018,2440,1269,1171,108.4,2435,1265,1170,108.1
37012, 북구,010005, 9세,2018,2326,1206,1120,107.7,2319,1200,1119,107.2
37012, 북구,015,10~14세,2018,11945,6273,5672,110.6,11921,6264,5657,110.7
37012, 북구,015001, 10세,2018,2375,1229,1146,107.2,2371,1227,1144,107.3
37012, 북구,015002, 11세,2018,2454,1274,1180,108,2449,1272,1177,108.1
37012, 북구,015003, 12세,2018,2345,1237,1108,111.6,2338,1236,1102,112.2
37012, 북구,015004, 13세,2018,2271,1212,1059,114.4,2267,1209,1058,114.3
37012, 북구,015005, 14세,2018,2500,1321,1179,112,2496,1320,1176,112.2
37012, 북구,020,15~19세,2018,14341,7549,6792,111.1,14094,7434,6660,111.6
37012, 북구,020001, 15세,2018,2564,1334,1230,108.5,2559,1333,1226,108.7
37012, 북구,020002, 16세,2018,2627,1399,1228,113.9,2624,1398,1226,114
37012, 북구,020003, 17세,2018,2936,1524,1412,107.9,2921,1515,1406,107.8
37012, 북구,020004, 18세,2018,3393,1762,1631,108,3309,1722,1587,108.5
37012, 북구,020005, 19세,2018,2821,1530,1291,118.5,2681,1466,1215,120.7
37012, 북구,025,20~24세,2018,16427,9028,7399,122,15591,8589,7002,122.7
37012, 북구,025001, 20세,2018,3355,1856,1499,123.8,3159,1760,1399,125.8
37012, 북구,025002, 21세,2018,3375,1891,1484,127.4,3173,1786,1387,128.8
37012, 북구,025003, 22세,2018,3287,1765,1522,116,3138,1685,1453,116
37012, 북구,025004, 23세,2018,3318,1787,1531,116.7,3161,1699,1462,116.2
37012, 북구,025005, 24세,2018,3092,1729,1363,126.9,2960,1659,1301,127.5
37012, 북구,030,25~29세,2018,14028,7809,6219,125.6,13417,7438,5979,124.4
37012, 북구,030001, 25세,2018,2951,1673,1278,130.9,2812,1584,1228,129
37012, 북구,030002, 26세,2018,2932,1668,1264,132,2817,1597,1220,130.9
37012, 북구,030003, 27세,2018,2710,1489,1221,121.9,2594,1418,1176,120.6
37012, 북구,030004, 28세,2018,2739,1506,1233,122.1,2620,1434,1186,120.9
37012, 북구,030005, 29세,2018,2696,1473,1223,120.4,2574,1405,1169,120.2
37012, 북구,035,30~34세,2018,14333,7340,6993,105,13838,7088,6750,105
37012, 북구,035001, 30세,2018,2647,1389,1258,110.4,2526,1332,1194,111.6
37012, 북구,035002, 31세,2018,2639,1368,1271,107.6,2551,1320,1231,107.2
37012, 북구,035003, 32세,2018,2841,1492,1349,110.6,2744,1439,1305,110.3
37012, 북구,035004, 33세,2018,2898,1439,1459,98.6,2807,1393,1414,98.5
37012, 북구,035005, 34세,2018,3308,1652,1656,99.8,3210,1604,1606,99.9
37012, 북구,040,35~39세,2018,19615,9932,9683,102.6,19237,9737,9500,102.5
37012, 북구,040001, 35세,2018,3599,1880,1719,109.4,3504,1826,1678,108.8
37012, 북구,040002, 36세,2018,4052,2040,2012,101.4,3986,2011,1975,101.8
37012, 북구,040003, 37세,2018,4115,2108,2007,105,4036,2064,1972,104.7
37012, 북구,040004, 38세,2018,4002,2024,1978,102.3,3930,1989,1941,102.5
37012, 북구,040005, 39세,2018,3847,1880,1967,95.6,3781,1847,1934,95.5
37012, 북구,045,40~44세,2018,19043,9437,9606,98.2,18783,9284,9499,97.7
37012, 북구,045001, 40세,2018,3511,1767,1744,101.3,3465,1744,1721,101.3
37012, 북구,045002, 41세,2018,3770,1834,1936,94.7,3706,1798,1908,94.2
37012, 북구,045003, 42세,2018,3548,1745,1803,96.8,3505,1715,1790,95.8
37012, 북구,045004, 43세,2018,3921,1998,1923,103.9,3858,1965,1893,103.8
37012, 북구,045005, 44세,2018,4293,2093,2200,95.1,4249,2062,2187,94.3
37012, 북구,050,45~49세,2018,23072,11231,11841,94.8,22839,11109,11730,94.7
37012, 북구,050001, 45세,2018,4417,2116,2301,92,4365,2086,2279,91.5
37012, 북구,050002, 46세,2018,4443,2199,2244,98,4400,2177,2223,97.9
37012, 북구,050003, 47세,2018,4701,2299,2402,95.7,4648,2274,2374,95.8
37012, 북구,050004, 48세,2018,4786,2273,2513,90.4,4748,2256,2492,90.5
37012, 북구,050005, 49세,2018,4725,2344,2381,98.4,4678,2316,2362,98.1
37012, 북구,055,50~54세,2018,23130,11227,11903,94.3,22980,11149,11831,94.2
37012, 북구,055001, 50세,2018,4935,2430,2505,97,4905,2415,2490,97
37012, 북구,055002, 51세,2018,4335,2071,2264,91.5,4305,2054,2251,91.2
37012, 북구,055003, 52세,2018,4609,2289,2320,98.7,4582,2279,2303,99
37012, 북구,055004, 53세,2018,4793,2276,2517,90.4,4771,2262,2509,90.2
37012, 북구,055005, 54세,2018,4458,2161,2297,94.1,4417,2139,2278,93.9
37012, 북구,060,55~59세,2018,25929,12553,13376,93.8,25796,12495,13301,93.9
37012, 북구,060001, 55세,2018,4911,2393,2518,95,4865,2370,2495,95
37012, 북구,060002, 56세,2018,4998,2519,2479,101.6,4974,2507,2467,101.6
37012, 북구,060003, 57세,2018,5528,2681,2847,94.2,5509,2673,2836,94.3
37012, 북구,060004, 58세,2018,5442,2560,2882,88.8,5417,2550,2867,88.9
37012, 북구,060005, 59세,2018,5050,2400,2650,90.6,5031,2395,2636,90.9
37012, 북구,065,60~64세,2018,21540,10680,10860,98.3,21470,10636,10834,98.2
37012, 북구,065001, 60세,2018,4588,2259,2329,97,4570,2248,2322,96.8
37012, 북구,065002, 61세,2018,4605,2334,2271,102.8,4591,2324,2267,102.5
37012, 북구,065003, 62세,2018,4295,2104,2191,96,4281,2095,2186,95.8
37012, 북구,065004, 63세,2018,4336,2076,2260,91.9,4324,2069,2255,91.8
37012, 북구,065005, 64세,2018,3716,1907,1809,105.4,3704,1900,1804,105.3
37012, 북구,070,65~69세,2018,14492,7236,7256,99.7,14462,7223,7239,99.8
37012, 북구,070001, 65세,2018,3316,1651,1665,99.2,3310,1648,1662,99.2
37012, 북구,070002, 66세,2018,3383,1692,1691,100.1,3378,1690,1688,100.1
37012, 북구,070003, 67세,2018,2620,1307,1313,99.5,2610,1304,1306,99.8
37012, 북구,070004, 68세,2018,2575,1279,1296,98.7,2567,1275,1292,98.7
37012, 북구,070005, 69세,2018,2598,1307,1291,101.2,2597,1306,1291,101.2
37012, 북구,075,70~74세,2018,9672,4589,5083,90.3,9653,4582,5071,90.4
37012, 북구,075001, 70세,2018,2468,1203,1265,95.1,2464,1200,1264,94.9
37012, 북구,075002, 71세,2018,2285,1114,1171,95.1,2280,1114,1166,95.5
37012, 북구,075003, 72세,2018,1565,767,798,96.1,1560,764,796,96
37012, 북구,075004, 73세,2018,1575,713,862,82.7,1571,712,859,82.9
37012, 북구,075005, 74세,2018,1779,792,987,80.2,1778,792,986,80.3
37012, 북구,080,75~79세,2018,8378,3401,4977,68.3,8365,3396,4969,68.3
37012, 북구,080001, 75세,2018,1810,740,1070,69.2,1808,739,1069,69.1
37012, 북구,080002, 76세,2018,1993,822,1171,70.2,1991,821,1170,70.2
37012, 북구,080003, 77세,2018,1604,660,944,69.9,1602,659,943,69.9
37012, 북구,080004, 78세,2018,1468,591,877,67.4,1464,589,875,67.3
37012, 북구,080005, 79세,2018,1503,588,915,64.3,1500,588,912,64.5
37012, 북구,085,80~84세,2018,5141,1693,3448,49.1,5134,1691,3443,49.1
37012, 북구,085001, 80세,2018,1242,415,827,50.2,1240,415,825,50.3
37012, 북구,085002, 81세,2018,1081,395,686,57.6,1078,395,683,57.8
37012, 북구,085003, 82세,2018,1033,349,684,51,1032,348,684,50.9
37012, 북구,085004, 83세,2018,937,277,660,42,936,276,660,41.8
37012, 북구,085005, 84세,2018,848,257,591,43.5,848,257,591,43.5
37012, 북구,090,85~89세,2018,2733,661,2072,31.9,2732,660,2072,31.9
37012, 북구,090001, 85세,2018,697,195,502,38.8,697,195,502,38.8
37012, 북구,090002, 86세,2018,663,170,493,34.5,663,170,493,34.5
37012, 북구,090003, 87세,2018,540,113,427,26.5,540,113,427,26.5
37012, 북구,090004, 88세,2018,449,104,345,30.1,449,104,345,30.1
37012, 북구,090005, 89세,2018,384,79,305,25.9,383,78,305,25.6
37012, 북구,095,90~94세,2018,958,159,799,19.9,958,159,799,19.9
37012, 북구,095001, 90세,2018,329,47,282,16.7,329,47,282,16.7
37012, 북구,095002, 91세,2018,264,43,221,19.5,264,43,221,19.5
37012, 북구,095003, 92세,2018,138,23,115,20,138,23,115,20
37012, 북구,095004, 93세,2018,130,24,106,22.6,130,24,106,22.6
37012, 북구,095005, 94세,2018,97,22,75,29.3,97,22,75,29.3
37012, 북구,100,95~99세,2018,221,36,185,19.5,221,36,185,19.5
37012, 북구,100001, 95세,2018,79,22,57,38.6,79,22,57,38.6
37012, 북구,100002, 96세,2018,67,6,61,9.8,67,6,61,9.8
37012, 북구,100003, 97세,2018,30,X,26,15.4,30,X,26,15.4
37012, 북구,100004, 98세,2018,32,X,31,3.2,32,X,31,3.2
37012, 북구,100005, 99세,2018,13,X,10,30,13,X,10,30
37012, 북구,101,100세이상,2018,25,X,23,8.7,25,X,23,8.7
37012, 북구,102,15세미만,2018,35036,18322,16714,109.6,34912,18255,16657,109.6
37012, 북구,103,15~64세,2018,191458,96786,94672,102.2,188045,94959,93086,102
37012, 북구,104,65세이상,2018,41620,17777,23843,74.6,41550,17749,23801,74.6
37012, 북구,086,85세이상,2018,3937,858,3079,27.9,3936,857,3079,27.8
37012, 북구,126,평균연령,2018,43,41.5,44.5,,43.2,41.6,44.7,
37012, 북구,127,중위연령,2018,45.3,43.6,46.8,,45.5,43.9,47.1,
37020, 경주시,000,합계,2018,264282,134464,129818,103.6,248654,124551,124103,100.4
37020, 경주시,005,0~4세,2018,8158,4157,4001,103.9,7918,4029,3889,103.6
37020, 경주시,005001, 0세,2018,1323,672,651,103.2,1278,646,632,102.2
37020, 경주시,005002, 1세,2018,1515,808,707,114.3,1461,775,686,113
37020, 경주시,005003, 2세,2018,1749,866,883,98.1,1692,842,850,99.1
37020, 경주시,005004, 3세,2018,1788,880,908,96.9,1745,854,891,95.8
37020, 경주시,005005, 4세,2018,1783,931,852,109.3,1742,912,830,109.9
37020, 경주시,010,5~9세,2018,9624,4969,4655,106.7,9444,4870,4574,106.5
37020, 경주시,010001, 5세,2018,1802,949,853,111.3,1752,918,834,110.1
37020, 경주시,010002, 6세,2018,2006,1011,995,101.6,1970,990,980,101
37020, 경주시,010003, 7세,2018,2029,1050,979,107.3,1994,1032,962,107.3
37020, 경주시,010004, 8세,2018,1902,980,922,106.3,1865,962,903,106.5
37020, 경주시,010005, 9세,2018,1885,979,906,108.1,1863,968,895,108.2
37020, 경주시,015,10~14세,2018,9981,5224,4757,109.8,9820,5142,4678,109.9
37020, 경주시,015001, 10세,2018,2026,1040,986,105.5,1982,1021,961,106.2
37020, 경주시,015002, 11세,2018,2003,1030,973,105.9,1975,1014,961,105.5
37020, 경주시,015003, 12세,2018,2009,1048,961,109.1,1970,1027,943,108.9
37020, 경주시,015004, 13세,2018,1894,1005,889,113,1864,990,874,113.3
37020, 경주시,015005, 14세,2018,2049,1101,948,116.1,2029,1090,939,116.1
37020, 경주시,020,15~19세,2018,13782,7450,6332,117.7,13198,7179,6019,119.3
37020, 경주시,020001, 15세,2018,2146,1104,1042,106,2128,1094,1034,105.8
37020, 경주시,020002, 16세,2018,2318,1253,1065,117.7,2291,1238,1053,117.6
37020, 경주시,020003, 17세,2018,2616,1404,1212,115.8,2586,1395,1191,117.1
37020, 경주시,020004, 18세,2018,3159,1698,1461,116.2,3069,1649,1420,116.1
37020, 경주시,020005, 19세,2018,3543,1991,1552,128.3,3124,1803,1321,136.5
37020, 경주시,025,20~24세,2018,18461,10577,7884,134.2,16028,9153,6875,133.1
37020, 경주시,025001, 20세,2018,3783,2088,1695,123.2,3316,1846,1470,125.6
37020, 경주시,025002, 21세,2018,3826,2076,1750,118.6,3323,1792,1531,117
37020, 경주시,025003, 22세,2018,3748,2078,1670,124.4,3274,1805,1469,122.9
37020, 경주시,025004, 23세,2018,3672,2202,1470,149.8,3190,1916,1274,150.4
37020, 경주시,025005, 24세,2018,3432,2133,1299,164.2,2925,1794,1131,158.6
37020, 경주시,030,25~29세,2018,15509,9288,6221,149.3,12765,7366,5399,136.4
37020, 경주시,030001, 25세,2018,3358,2073,1285,161.3,2808,1701,1107,153.7
37020, 경주시,030002, 26세,2018,3150,1856,1294,143.4,2625,1471,1154,127.5
37020, 경주시,030003, 27세,2018,3064,1794,1270,141.3,2520,1417,1103,128.5
37020, 경주시,030004, 28세,2018,3011,1809,1202,150.5,2447,1422,1025,138.7
37020, 경주시,030005, 29세,2018,2926,1756,1170,150.1,2365,1355,1010,134.2
37020, 경주시,035,30~34세,2018,13877,7854,6023,130.4,11065,5891,5174,113.9
37020, 경주시,035001, 30세,2018,2734,1561,1173,133.1,2149,1168,981,119.1
37020, 경주시,035002, 31세,2018,2799,1596,1203,132.7,2228,1205,1023,117.8
37020, 경주시,035003, 32세,2018,2674,1536,1138,135,2111,1146,965,118.8
37020, 경주시,035004, 33세,2018,2754,1558,1196,130.3,2191,1147,1044,109.9
37020, 경주시,035005, 34세,2018,2916,1603,1313,122.1,2386,1225,1161,105.5
37020, 경주시,040,35~39세,2018,17440,9544,7896,120.9,15380,8101,7279,111.3
37020, 경주시,040001, 35세,2018,3279,1789,1490,120.1,2820,1465,1355,108.1
37020, 경주시,040002, 36세,2018,3520,1952,1568,124.5,3039,1618,1421,113.9
37020, 경주시,040003, 37세,2018,3591,1969,1622,121.4,3214,1697,1517,111.9
37020, 경주시,040004, 38세,2018,3632,1948,1684,115.7,3261,1693,1568,108
37020, 경주시,040005, 39세,2018,3418,1886,1532,123.1,3046,1628,1418,114.8
37020, 경주시,045,40~44세,2018,17740,9363,8377,111.8,16296,8473,7823,108.3
37020, 경주시,045001, 40세,2018,3252,1741,1511,115.2,2908,1520,1388,109.5
37020, 경주시,045002, 41세,2018,3273,1762,1511,116.6,2978,1572,1406,111.8
37020, 경주시,045003, 42세,2018,3381,1783,1598,111.6,3072,1588,1484,107
37020, 경주시,045004, 43세,2018,3664,1940,1724,112.5,3419,1798,1621,110.9
37020, 경주시,045005, 44세,2018,4170,2137,2033,105.1,3919,1995,1924,103.7
37020, 경주시,050,45~49세,2018,21998,11433,10565,108.2,20882,10753,10129,106.2
37020, 경주시,050001, 45세,2018,4194,2137,2057,103.9,3965,1992,1973,101
37020, 경주시,050002, 46세,2018,4364,2313,2051,112.8,4110,2156,1954,110.3
37020, 경주시,050003, 47세,2018,4492,2333,2159,108.1,4268,2195,2073,105.9
37020, 경주시,050004, 48세,2018,4487,2340,2147,109,4261,2203,2058,107
37020, 경주시,050005, 49세,2018,4461,2310,2151,107.4,4278,2207,2071,106.6
37020, 경주시,055,50~54세,2018,22323,11482,10841,105.9,21493,11004,10489,104.9
37020, 경주시,055001, 50세,2018,4811,2480,2331,106.4,4600,2362,2238,105.5
37020, 경주시,055002, 51세,2018,4362,2206,2156,102.3,4196,2103,2093,100.5
37020, 경주시,055003, 52세,2018,4425,2336,2089,111.8,4274,2250,2024,111.2
37020, 경주시,055004, 53세,2018,4407,2265,2142,105.7,4243,2170,2073,104.7
37020, 경주시,055005, 54세,2018,4318,2195,2123,103.4,4180,2119,2061,102.8
37020, 경주시,060,55~59세,2018,24041,12308,11733,104.9,23506,12014,11492,104.5
37020, 경주시,060001, 55세,2018,4708,2443,2265,107.9,4567,2364,2203,107.3
37020, 경주시,060002, 56세,2018,4815,2483,2332,106.5,4697,2422,2275,106.5
37020, 경주시,060003, 57세,2018,4976,2533,2443,103.7,4880,2474,2406,102.8
37020, 경주시,060004, 58세,2018,4897,2506,2391,104.8,4794,2449,2345,104.4
37020, 경주시,060005, 59세,2018,4645,2343,2302,101.8,4568,2305,2263,101.9
37020, 경주시,065,60~64세,2018,20337,9991,10346,96.6,20042,9838,10204,96.4
37020, 경주시,065001, 60세,2018,4336,2194,2142,102.4,4249,2142,2107,101.7
37020, 경주시,065002, 61세,2018,4255,2108,2147,98.2,4184,2076,2108,98.5
37020, 경주시,065003, 62세,2018,4211,2080,2131,97.6,4165,2054,2111,97.3
37020, 경주시,065004, 63세,2018,4018,1922,2096,91.7,3962,1895,2067,91.7
37020, 경주시,065005, 64세,2018,3517,1687,1830,92.2,3482,1671,1811,92.3
37020, 경주시,070,65~69세,2018,15640,7384,8256,89.4,15525,7325,8200,89.3
37020, 경주시,070001, 65세,2018,3374,1632,1742,93.7,3345,1617,1728,93.6
37020, 경주시,070002, 66세,2018,3386,1553,1833,84.7,3356,1536,1820,84.4
37020, 경주시,070003, 67세,2018,2911,1379,1532,90,2891,1369,1522,89.9
37020, 경주시,070004, 68세,2018,2877,1330,1547,86,2858,1321,1537,85.9
37020, 경주시,070005, 69세,2018,3092,1490,1602,93,3075,1482,1593,93
37020, 경주시,075,70~74세,2018,11403,5223,6180,84.5,11361,5207,6154,84.6
37020, 경주시,075001, 70세,2018,2785,1333,1452,91.8,2780,1329,1451,91.6
37020, 경주시,075002, 71세,2018,2656,1240,1416,87.6,2647,1237,1410,87.7
37020, 경주시,075003, 72세,2018,1791,847,944,89.7,1777,842,935,90.1
37020, 경주시,075004, 73세,2018,2041,898,1143,78.6,2035,896,1139,78.7
37020, 경주시,075005, 74세,2018,2130,905,1225,73.9,2122,903,1219,74.1
37020, 경주시,080,75~79세,2018,11383,4472,6911,64.7,11366,4467,6899,64.7
37020, 경주시,080001, 75세,2018,2397,1008,1389,72.6,2394,1006,1388,72.5
37020, 경주시,080002, 76세,2018,2842,1197,1645,72.8,2838,1195,1643,72.7
37020, 경주시,080003, 77세,2018,2058,786,1272,61.8,2054,785,1269,61.9
37020, 경주시,080004, 78세,2018,1990,736,1254,58.7,1987,736,1251,58.8
37020, 경주시,080005, 79세,2018,2096,745,1351,55.1,2093,745,1348,55.3
37020, 경주시,085,80~84세,2018,7553,2504,5049,49.6,7540,2498,5042,49.5
37020, 경주시,085001, 80세,2018,1792,619,1173,52.8,1786,614,1172,52.4
37020, 경주시,085002, 81세,2018,1699,604,1095,55.2,1697,603,1094,55.1
37020, 경주시,085003, 82세,2018,1515,489,1026,47.7,1514,489,1025,47.7
37020, 경주시,085004, 83세,2018,1366,417,949,43.9,1364,417,947,44
37020, 경주시,085005, 84세,2018,1181,375,806,46.5,1179,375,804,46.6
37020, 경주시,090,85~89세,2018,3680,979,2701,36.2,3678,979,2699,36.3
37020, 경주시,090001, 85세,2018,1104,312,792,39.4,1104,312,792,39.4
37020, 경주시,090002, 86세,2018,908,275,633,43.4,907,275,632,43.5
37020, 경주시,090003, 87세,2018,662,159,503,31.6,662,159,503,31.6
37020, 경주시,090004, 88세,2018,538,126,412,30.6,538,126,412,30.6
37020, 경주시,090005, 89세,2018,468,107,361,29.6,467,107,360,29.7
37020, 경주시,095,90~94세,2018,1035,216,819,26.4,1031,216,815,26.5
37020, 경주시,095001, 90세,2018,350,69,281,24.6,348,69,279,24.7
37020, 경주시,095002, 91세,2018,293,56,237,23.6,293,56,237,23.6
37020, 경주시,095003, 92세,2018,148,30,118,25.4,148,30,118,25.4
37020, 경주시,095004, 93세,2018,146,33,113,29.2,144,33,111,29.7
37020, 경주시,095005, 94세,2018,98,28,70,40,98,28,70,40
37020, 경주시,100,95~99세,2018,287,41,246,16.7,286,41,245,16.7
37020, 경주시,100001, 95세,2018,130,19,111,17.1,130,19,111,17.1
37020, 경주시,100002, 96세,2018,75,12,63,19,75,12,63,19
37020, 경주시,100003, 97세,2018,44,7,37,18.9,44,7,37,18.9
37020, 경주시,100004, 98세,2018,25,X,22,13.6,24,X,21,14.3
37020, 경주시,100005, 99세,2018,13,X,13,0,13,X,13,0
37020, 경주시,101,100세이상,2018,30,5,25,20,30,5,25,20
37020, 경주시,102,15세미만,2018,27763,14350,13413,107,27182,14041,13141,106.8
37020, 경주시,103,15~64세,2018,185508,99290,86218,115.2,170655,89772,80883,111
37020, 경주시,104,65세이상,2018,51011,20824,30187,69,50817,20738,30079,68.9
37020, 경주시,086,85세이상,2018,5032,1241,3791,32.7,5025,1241,3784,32.8
37020, 경주시,126,평균연령,2018,44.9,42.9,47,,45.6,43.6,47.5,
37020, 경주시,127,중위연령,2018,46.8,44.4,49.2,,48,46,50.1,
37030, 김천시,000,합계,2018,139894,69916,69978,99.9,136830,68138,68692,99.2
37030, 김천시,005,0~4세,2018,5356,2724,2632,103.5,5338,2717,2621,103.7
37030, 김천시,005001, 0세,2018,968,513,455,112.7,962,511,451,113.3
37030, 김천시,005002, 1세,2018,1005,509,496,102.6,1003,509,494,103
37030, 김천시,005003, 2세,2018,1153,589,564,104.4,1149,587,562,104.4
37030, 김천시,005004, 3세,2018,1118,540,578,93.4,1113,538,575,93.6
37030, 김천시,005005, 4세,2018,1112,573,539,106.3,1111,572,539,106.1
37030, 김천시,010,5~9세,2018,5640,2931,2709,108.2,5628,2924,2704,108.1
37030, 김천시,010001, 5세,2018,1143,608,535,113.6,1139,605,534,113.3
37030, 김천시,010002, 6세,2018,1201,618,583,106,1197,616,581,106
37030, 김천시,010003, 7세,2018,1142,596,546,109.2,1141,596,545,109.4
37030, 김천시,010004, 8세,2018,1102,553,549,100.7,1100,552,548,100.7
37030, 김천시,010005, 9세,2018,1052,556,496,112.1,1051,555,496,111.9
37030, 김천시,015,10~14세,2018,5381,2820,2561,110.1,5377,2819,2558,110.2
37030, 김천시,015001, 10세,2018,1143,620,523,118.5,1143,620,523,118.5
37030, 김천시,015002, 11세,2018,1097,564,533,105.8,1095,564,531,106.2
37030, 김천시,015003, 12세,2018,998,551,447,123.3,998,551,447,123.3
37030, 김천시,015004, 13세,2018,1010,490,520,94.2,1009,489,520,94
37030, 김천시,015005, 14세,2018,1133,595,538,110.6,1132,595,537,110.8
37030, 김천시,020,15~19세,2018,7369,3968,3401,116.7,7176,3895,3281,118.7
37030, 김천시,020001, 15세,2018,1113,603,510,118.2,1111,602,509,118.3
37030, 김천시,020002, 16세,2018,1292,717,575,124.7,1291,716,575,124.5
37030, 김천시,020003, 17세,2018,1568,872,696,125.3,1550,867,683,126.9
37030, 김천시,020004, 18세,2018,1719,939,780,120.4,1680,924,756,122.2
37030, 김천시,020005, 19세,2018,1677,837,840,99.6,1544,786,758,103.7
37030, 김천시,025,20~24세,2018,8694,4698,3996,117.6,8072,4355,3717,117.2
37030, 김천시,025001, 20세,2018,1643,846,797,106.1,1541,790,751,105.2
37030, 김천시,025002, 21세,2018,1854,919,935,98.3,1734,848,886,95.7
37030, 김천시,025003, 22세,2018,1892,956,936,102.1,1764,902,862,104.6
37030, 김천시,025004, 23세,2018,1673,966,707,136.6,1555,900,655,137.4
37030, 김천시,025005, 24세,2018,1632,1011,621,162.8,1478,915,563,162.5
37030, 김천시,030,25~29세,2018,7561,4243,3318,127.9,6911,3829,3082,124.2
37030, 김천시,030001, 25세,2018,1534,881,653,134.9,1409,799,610,131
37030, 김천시,030002, 26세,2018,1618,891,727,122.6,1470,798,672,118.8
37030, 김천시,030003, 27세,2018,1514,841,673,125,1392,761,631,120.6
37030, 김천시,030004, 28세,2018,1484,817,667,122.5,1347,731,616,118.7
37030, 김천시,030005, 29세,2018,1411,813,598,136,1293,740,553,133.8
37030, 김천시,035,30~34세,2018,7354,4008,3346,119.8,6836,3675,3161,116.3
37030, 김천시,035001, 30세,2018,1396,784,612,128.1,1287,710,577,123.1
37030, 김천시,035002, 31세,2018,1415,803,612,131.2,1307,727,580,125.3
37030, 김천시,035003, 32세,2018,1468,797,671,118.8,1358,727,631,115.2
37030, 김천시,035004, 33세,2018,1526,797,729,109.3,1426,736,690,106.7
37030, 김천시,035005, 34세,2018,1549,827,722,114.5,1458,775,683,113.5
37030, 김천시,040,35~39세,2018,9349,4959,4390,113,9015,4735,4280,110.6
37030, 김천시,040001, 35세,2018,1705,875,830,105.4,1633,823,810,101.6
37030, 김천시,040002, 36세,2018,1970,1034,936,110.5,1899,980,919,106.6
37030, 김천시,040003, 37세,2018,1962,1068,894,119.5,1883,1017,866,117.4
37030, 김천시,040004, 38세,2018,1963,1037,926,112,1910,1006,904,111.3
37030, 김천시,040005, 39세,2018,1749,945,804,117.5,1690,909,781,116.4
37030, 김천시,045,40~44세,2018,8944,4740,4204,112.7,8735,4610,4125,111.8
37030, 김천시,045001, 40세,2018,1688,899,789,113.9,1639,868,771,112.6
37030, 김천시,045002, 41세,2018,1801,973,828,117.5,1756,944,812,116.3
37030, 김천시,045003, 42세,2018,1674,895,779,114.9,1629,867,762,113.8
37030, 김천시,045004, 43세,2018,1839,971,868,111.9,1800,949,851,111.5
37030, 김천시,045005, 44세,2018,1942,1002,940,106.6,1911,982,929,105.7
37030, 김천시,050,45~49세,2018,10669,5560,5109,108.8,10520,5477,5043,108.6
37030, 김천시,050001, 45세,2018,2018,1020,998,102.2,1992,1006,986,102
37030, 김천시,050002, 46세,2018,2047,1090,957,113.9,2015,1072,943,113.7
37030, 김천시,050003, 47세,2018,2147,1128,1019,110.7,2117,1110,1007,110.2
37030, 김천시,050004, 48세,2018,2187,1148,1039,110.5,2162,1132,1030,109.9
37030, 김천시,050005, 49세,2018,2270,1174,1096,107.1,2234,1157,1077,107.4
37030, 김천시,055,50~54세,2018,10888,5706,5182,110.1,10743,5646,5097,110.8
37030, 김천시,055001, 50세,2018,2327,1210,1117,108.3,2306,1204,1102,109.3
37030, 김천시,055002, 51세,2018,2184,1144,1040,110,2156,1132,1024,110.5
37030, 김천시,055003, 52세,2018,2192,1147,1045,109.8,2158,1129,1029,109.7
37030, 김천시,055004, 53세,2018,2102,1092,1010,108.1,2073,1080,993,108.8
37030, 김천시,055005, 54세,2018,2083,1113,970,114.7,2050,1101,949,116
37030, 김천시,060,55~59세,2018,12409,6276,6133,102.3,12317,6229,6088,102.3
37030, 김천시,060001, 55세,2018,2316,1215,1101,110.4,2296,1204,1092,110.3
37030, 김천시,060002, 56세,2018,2424,1206,1218,99,2411,1202,1209,99.4
37030, 김천시,060003, 57세,2018,2680,1363,1317,103.5,2663,1360,1303,104.4
37030, 김천시,060004, 58세,2018,2613,1296,1317,98.4,2595,1283,1312,97.8
37030, 김천시,060005, 59세,2018,2376,1196,1180,101.4,2352,1180,1172,100.7
37030, 김천시,065,60~64세,2018,10761,5293,5468,96.8,10705,5265,5440,96.8
37030, 김천시,065001, 60세,2018,2170,1094,1076,101.7,2159,1088,1071,101.6
37030, 김천시,065002, 61세,2018,2298,1164,1134,102.6,2286,1157,1129,102.5
37030, 김천시,065003, 62세,2018,2203,1071,1132,94.6,2187,1066,1121,95.1
37030, 김천시,065004, 63세,2018,2137,1038,1099,94.4,2131,1033,1098,94.1
37030, 김천시,065005, 64세,2018,1953,926,1027,90.2,1942,921,1021,90.2
37030, 김천시,070,65~69세,2018,8518,4049,4469,90.6,8487,4038,4449,90.8
37030, 김천시,070001, 65세,2018,1873,878,995,88.2,1865,876,989,88.6
37030, 김천시,070002, 66세,2018,2045,972,1073,90.6,2036,969,1067,90.8
37030, 김천시,070003, 67세,2018,1420,666,754,88.3,1413,662,751,88.1
37030, 김천시,070004, 68세,2018,1524,748,776,96.4,1521,747,774,96.5
37030, 김천시,070005, 69세,2018,1656,785,871,90.1,1652,784,868,90.3
37030, 김천시,075,70~74세,2018,6323,2886,3437,84,6304,2877,3427,84
37030, 김천시,075001, 70세,2018,1565,745,820,90.9,1562,745,817,91.2
37030, 김천시,075002, 71세,2018,1521,715,806,88.7,1514,711,803,88.5
37030, 김천시,075003, 72세,2018,1010,452,558,81,1006,450,556,80.9
37030, 김천시,075004, 73세,2018,992,460,532,86.5,989,458,531,86.3
37030, 김천시,075005, 74세,2018,1235,514,721,71.3,1233,513,720,71.3
37030, 김천시,080,75~79세,2018,6606,2500,4106,60.9,6599,2495,4104,60.8
37030, 김천시,080001, 75세,2018,1352,539,813,66.3,1349,536,813,65.9
37030, 김천시,080002, 76세,2018,1448,558,890,62.7,1448,558,890,62.7
37030, 김천시,080003, 77세,2018,1268,477,791,60.3,1265,476,789,60.3
37030, 김천시,080004, 78세,2018,1269,464,805,57.6,1268,463,805,57.5
37030, 김천시,080005, 79세,2018,1269,462,807,57.2,1269,462,807,57.2
37030, 김천시,085,80~84세,2018,4825,1698,3127,54.3,4821,1696,3125,54.3
37030, 김천시,085001, 80세,2018,1135,415,720,57.6,1132,414,718,57.7
37030, 김천시,085002, 81세,2018,1039,376,663,56.7,1039,376,663,56.7
37030, 김천시,085003, 82세,2018,982,340,642,53,981,339,642,52.8
37030, 김천시,085004, 83세,2018,925,324,601,53.9,925,324,601,53.9
37030, 김천시,085005, 84세,2018,744,243,501,48.5,744,243,501,48.5
37030, 김천시,090,85~89세,2018,2307,666,1641,40.6,2306,665,1641,40.5
37030, 김천시,090001, 85세,2018,637,196,441,44.4,637,196,441,44.4
37030, 김천시,090002, 86세,2018,536,152,384,39.6,536,152,384,39.6
37030, 김천시,090003, 87세,2018,430,130,300,43.3,429,129,300,43
37030, 김천시,090004, 88세,2018,403,112,291,38.5,403,112,291,38.5
37030, 김천시,090005, 89세,2018,301,76,225,33.8,301,76,225,33.8
37030, 김천시,095,90~94세,2018,731,162,569,28.5,731,162,569,28.5
37030, 김천시,095001, 90세,2018,252,58,194,29.9,252,58,194,29.9
37030, 김천시,095002, 91세,2018,210,51,159,32.1,210,51,159,32.1
37030, 김천시,095003, 92세,2018,115,26,89,29.2,115,26,89,29.2
37030, 김천시,095004, 93세,2018,100,19,81,23.5,100,19,81,23.5
37030, 김천시,095005, 94세,2018,54,8,46,17.4,54,8,46,17.4
37030, 김천시,100,95~99세,2018,193,27,166,16.3,193,27,166,16.3
37030, 김천시,100001, 95세,2018,65,12,53,22.6,65,12,53,22.6
37030, 김천시,100002, 96세,2018,59,9,50,18,59,9,50,18
37030, 김천시,100003, 97세,2018,34,X,30,13.3,34,X,30,13.3
37030, 김천시,100004, 98세,2018,23,X,21,9.5,23,X,21,9.5
37030, 김천시,100005, 99세,2018,12,X,12,0,12,X,12,0
37030, 김천시,101,100세이상,2018,16,X,14,14.3,16,X,14,14.3
37030, 김천시,102,15세미만,2018,16377,8475,7902,107.3,16343,8460,7883,107.3
37030, 김천시,103,15~64세,2018,93998,49451,44547,111,91030,47716,43314,110.2
37030, 김천시,104,65세이상,2018,29519,11990,17529,68.4,29457,11962,17495,68.4
37030, 김천시,086,85세이상,2018,3247,857,2390,35.9,3246,856,2390,35.8
37030, 김천시,126,평균연령,2018,45.2,43.2,47.2,,45.4,43.5,47.4,
37030, 김천시,127,중위연령,2018,47.1,44.9,49.4,,47.6,45.5,49.8,
37040, 안동시,000,합계,2018,162186,80331,81855,98.1,160257,79386,80871,98.2
37040, 안동시,005,0~4세,2018,5521,2882,2639,109.2,5513,2877,2636,109.1
37040, 안동시,005001, 0세,2018,971,514,457,112.5,970,514,456,112.7
37040, 안동시,005002, 1세,2018,1155,598,557,107.4,1154,597,557,107.2
37040, 안동시,005003, 2세,2018,1108,581,527,110.2,1105,580,525,110.5
37040, 안동시,005004, 3세,2018,1198,624,574,108.7,1196,622,574,108.4
37040, 안동시,005005, 4세,2018,1089,565,524,107.8,1088,564,524,107.6
37040, 안동시,010,5~9세,2018,6235,3291,2944,111.8,6233,3289,2944,111.7
37040, 안동시,010001, 5세,2018,1242,651,591,110.2,1242,651,591,110.2
37040, 안동시,010002, 6세,2018,1321,700,621,112.7,1321,700,621,112.7
37040, 안동시,010003, 7세,2018,1237,665,572,116.3,1236,664,572,116.1
37040, 안동시,010004, 8세,2018,1233,652,581,112.2,1232,651,581,112
37040, 안동시,010005, 9세,2018,1202,623,579,107.6,1202,623,579,107.6
37040, 안동시,015,10~14세,2018,6418,3364,3054,110.2,6413,3363,3050,110.3
37040, 안동시,015001, 10세,2018,1282,671,611,109.8,1282,671,611,109.8
37040, 안동시,015002, 11세,2018,1305,665,640,103.9,1304,665,639,104.1
37040, 안동시,015003, 12세,2018,1251,676,575,117.6,1250,675,575,117.4
37040, 안동시,015004, 13세,2018,1220,633,587,107.8,1218,633,585,108.2
37040, 안동시,015005, 14세,2018,1360,719,641,112.2,1359,719,640,112.3
37040, 안동시,020,15~19세,2018,9446,4894,4552,107.5,9405,4881,4524,107.9
37040, 안동시,020001, 15세,2018,1385,712,673,105.8,1383,712,671,106.1
37040, 안동시,020002, 16세,2018,1581,838,743,112.8,1580,838,742,112.9
37040, 안동시,020003, 17세,2018,1851,968,883,109.6,1848,968,880,110
37040, 안동시,020004, 18세,2018,2122,1117,1005,111.1,2113,1113,1000,111.3
37040, 안동시,020005, 19세,2018,2507,1259,1248,100.9,2481,1250,1231,101.5
37040, 안동시,025,20~24세,2018,11046,5898,5148,114.6,10806,5771,5035,114.6
37040, 안동시,025001, 20세,2018,2305,1028,1277,80.5,2271,1019,1252,81.4
37040, 안동시,025002, 21세,2018,2314,1118,1196,93.5,2282,1098,1184,92.7
37040, 안동시,025003, 22세,2018,2314,1272,1042,122.1,2276,1246,1030,121
37040, 안동시,025004, 23세,2018,2145,1265,880,143.8,2088,1236,852,145.1
37040, 안동시,025005, 24세,2018,1968,1215,753,161.4,1889,1172,717,163.5
37040, 안동시,030,25~29세,2018,7723,4341,3382,128.4,7349,4153,3196,129.9
37040, 안동시,030001, 25세,2018,1771,1032,739,139.6,1698,993,705,140.9
37040, 안동시,030002, 26세,2018,1577,903,674,134,1495,857,638,134.3
37040, 안동시,030003, 27세,2018,1505,823,682,120.7,1426,784,642,122.1
37040, 안동시,030004, 28세,2018,1479,843,636,132.5,1405,808,597,135.3
37040, 안동시,030005, 29세,2018,1391,740,651,113.7,1325,711,614,115.8
37040, 안동시,035,30~34세,2018,7484,3942,3542,111.3,7130,3768,3362,112.1
37040, 안동시,035001, 30세,2018,1428,760,668,113.8,1352,723,629,114.9
37040, 안동시,035002, 31세,2018,1498,779,719,108.3,1409,735,674,109.1
37040, 안동시,035003, 32세,2018,1512,792,720,110,1444,755,689,109.6
37040, 안동시,035004, 33세,2018,1452,762,690,110.4,1390,735,655,112.2
37040, 안동시,035005, 34세,2018,1594,849,745,114,1535,820,715,114.7
37040, 안동시,040,35~39세,2018,9618,4792,4826,99.3,9386,4672,4714,99.1
37040, 안동시,040001, 35세,2018,1758,872,886,98.4,1705,842,863,97.6
37040, 안동시,040002, 36세,2018,1963,944,1019,92.6,1910,915,995,92
37040, 안동시,040003, 37세,2018,1878,931,947,98.3,1834,909,925,98.3
37040, 안동시,040004, 38세,2018,2121,1064,1057,100.7,2074,1043,1031,101.2
37040, 안동시,040005, 39세,2018,1898,981,917,107,1863,963,900,107
37040, 안동시,045,40~44세,2018,10692,5506,5186,106.2,10538,5421,5117,105.9
37040, 안동시,045001, 40세,2018,1900,986,914,107.9,1875,968,907,106.7
37040, 안동시,045002, 41세,2018,2053,1027,1026,100.1,2013,1006,1007,99.9
37040, 안동시,045003, 42세,2018,2079,1070,1009,106,2046,1055,991,106.5
37040, 안동시,045004, 43세,2018,2304,1134,1170,96.9,2281,1123,1158,97
37040, 안동시,045005, 44세,2018,2356,1289,1067,120.8,2323,1269,1054,120.4
37040, 안동시,050,45~49세,2018,12594,6617,5977,110.7,12435,6546,5889,111.2
37040, 안동시,050001, 45세,2018,2439,1280,1159,110.4,2406,1260,1146,109.9
37040, 안동시,050002, 46세,2018,2337,1233,1104,111.7,2310,1225,1085,112.9
37040, 안동시,050003, 47세,2018,2550,1357,1193,113.7,2526,1345,1181,113.9
37040, 안동시,050004, 48세,2018,2597,1348,1249,107.9,2556,1330,1226,108.5
37040, 안동시,050005, 49세,2018,2671,1399,1272,110,2637,1386,1251,110.8
37040, 안동시,055,50~54세,2018,12449,6388,6061,105.4,12322,6335,5987,105.8
37040, 안동시,055001, 50세,2018,2703,1403,1300,107.9,2683,1391,1292,107.7
37040, 안동시,055002, 51세,2018,2442,1254,1188,105.6,2408,1241,1167,106.3
37040, 안동시,055003, 52세,2018,2495,1285,1210,106.2,2472,1276,1196,106.7
37040, 안동시,055004, 53세,2018,2400,1207,1193,101.2,2374,1198,1176,101.9
37040, 안동시,055005, 54세,2018,2409,1239,1170,105.9,2385,1229,1156,106.3
37040, 안동시,060,55~59세,2018,14413,7125,7288,97.8,14318,7082,7236,97.9
37040, 안동시,060001, 55세,2018,2552,1297,1255,103.3,2532,1290,1242,103.9
37040, 안동시,060002, 56세,2018,2629,1287,1342,95.9,2604,1274,1330,95.8
37040, 안동시,060003, 57세,2018,3243,1602,1641,97.6,3229,1594,1635,97.5
37040, 안동시,060004, 58세,2018,3318,1624,1694,95.9,3296,1615,1681,96.1
37040, 안동시,060005, 59세,2018,2671,1315,1356,97,2657,1309,1348,97.1
37040, 안동시,065,60~64세,2018,12650,6294,6356,99,12567,6254,6313,99.1
37040, 안동시,065001, 60세,2018,2653,1326,1327,99.9,2634,1316,1318,99.8
37040, 안동시,065002, 61세,2018,2683,1373,1310,104.8,2660,1367,1293,105.7
37040, 안동시,065003, 62세,2018,2600,1331,1269,104.9,2585,1322,1263,104.7
37040, 안동시,065004, 63세,2018,2474,1177,1297,90.7,2456,1167,1289,90.5
37040, 안동시,065005, 64세,2018,2240,1087,1153,94.3,2232,1082,1150,94.1
37040, 안동시,070,65~69세,2018,10157,4831,5326,90.7,10121,4816,5305,90.8
37040, 안동시,070001, 65세,2018,2260,1008,1252,80.5,2252,1005,1247,80.6
37040, 안동시,070002, 66세,2018,2408,1126,1282,87.8,2396,1123,1273,88.2
37040, 안동시,070003, 67세,2018,1793,834,959,87,1790,832,958,86.8
37040, 안동시,070004, 68세,2018,1731,871,860,101.3,1722,866,856,101.2
37040, 안동시,070005, 69세,2018,1965,992,973,102,1961,990,971,102
37040, 안동시,075,70~74세,2018,7781,3585,4196,85.4,7777,3582,4195,85.4
37040, 안동시,075001, 70세,2018,1907,943,964,97.8,1905,941,964,97.6
37040, 안동시,075002, 71세,2018,1776,849,927,91.6,1775,848,927,91.5
37040, 안동시,075003, 72세,2018,1235,584,651,89.7,1234,584,650,89.8
37040, 안동시,075004, 73세,2018,1290,574,716,80.2,1290,574,716,80.2
37040, 안동시,075005, 74세,2018,1573,635,938,67.7,1573,635,938,67.7
37040, 안동시,080,75~79세,2018,8457,3505,4952,70.8,8450,3502,4948,70.8
37040, 안동시,080001, 75세,2018,1819,769,1050,73.2,1816,768,1048,73.3
37040, 안동시,080002, 76세,2018,2009,865,1144,75.6,2007,864,1143,75.6
37040, 안동시,080003, 77세,2018,1545,639,906,70.5,1545,639,906,70.5
37040, 안동시,080004, 78세,2018,1505,604,901,67,1504,604,900,67.1
37040, 안동시,080005, 79세,2018,1579,628,951,66,1578,627,951,65.9
37040, 안동시,085,80~84세,2018,5548,2045,3503,58.4,5543,2044,3499,58.4
37040, 안동시,085001, 80세,2018,1293,488,805,60.6,1292,487,805,60.5
37040, 안동시,085002, 81세,2018,1149,433,716,60.5,1147,433,714,60.6
37040, 안동시,085003, 82세,2018,1098,420,678,61.9,1096,420,676,62.1
37040, 안동시,085004, 83세,2018,1113,408,705,57.9,1113,408,705,57.9
37040, 안동시,085005, 84세,2018,895,296,599,49.4,895,296,599,49.4
37040, 안동시,090,85~89세,2018,2775,777,1998,38.9,2773,776,1997,38.9
37040, 안동시,090001, 85세,2018,755,238,517,46,755,238,517,46
37040, 안동시,090002, 86세,2018,684,199,485,41,684,199,485,41
37040, 안동시,090003, 87세,2018,500,132,368,35.9,499,131,368,35.6
37040, 안동시,090004, 88세,2018,457,93,364,25.5,456,93,363,25.6
37040, 안동시,090005, 89세,2018,379,115,264,43.6,379,115,264,43.6
37040, 안동시,095,90~94세,2018,963,214,749,28.6,962,214,748,28.6
37040, 안동시,095001, 90세,2018,317,62,255,24.3,317,62,255,24.3
37040, 안동시,095002, 91세,2018,234,50,184,27.2,233,50,183,27.3
37040, 안동시,095003, 92세,2018,189,50,139,36,189,50,139,36
37040, 안동시,095004, 93세,2018,141,31,110,28.2,141,31,110,28.2
37040, 안동시,095005, 94세,2018,82,21,61,34.4,82,21,61,34.4
37040, 안동시,100,95~99세,2018,189,36,153,23.5,189,36,153,23.5
37040, 안동시,100001, 95세,2018,85,16,69,23.2,85,16,69,23.2
37040, 안동시,100002, 96세,2018,39,8,31,25.8,39,8,31,25.8
37040, 안동시,100003, 97세,2018,36,5,31,16.1,36,5,31,16.1
37040, 안동시,100004, 98세,2018,18,5,13,38.5,18,5,13,38.5
37040, 안동시,100005, 99세,2018,11,X,9,22.2,11,X,9,22.2
37040, 안동시,101,100세이상,2018,27,X,23,17.4,27,X,23,17.4
37040, 안동시,102,15세미만,2018,18174,9537,8637,110.4,18159,9529,8630,110.4
37040, 안동시,103,15~64세,2018,108115,55797,52318,106.6,106256,54883,51373,106.8
37040, 안동시,104,65세이상,2018,35897,14997,20900,71.8,35842,14974,20868,71.8
37040, 안동시,086,85세이상,2018,3954,1031,2923,35.3,3951,1030,2921,35.3
37040, 안동시,126,평균연령,2018,45.7,43.9,47.5,,45.8,44,47.6,
37040, 안동시,127,중위연령,2018,47.8,46,49.7,,48,46.2,50,
37050, 구미시,000,합계,2018,422195,218189,204006,107,415387,214273,201114,106.5
37050, 구미시,005,0~4세,2018,21397,11013,10384,106.1,21309,10971,10338,106.1
37050, 구미시,005001, 0세,2018,3439,1793,1646,108.9,3422,1785,1637,109
37050, 구미시,005002, 1세,2018,3894,1962,1932,101.6,3870,1950,1920,101.6
37050, 구미시,005003, 2세,2018,4500,2294,2206,104,4482,2284,2198,103.9
37050, 구미시,005004, 3세,2018,4881,2493,2388,104.4,4866,2487,2379,104.5
37050, 구미시,005005, 4세,2018,4683,2471,2212,111.7,4669,2465,2204,111.8
37050, 구미시,010,5~9세,2018,23650,12286,11364,108.1,23614,12264,11350,108.1
37050, 구미시,010001, 5세,2018,4727,2421,2306,105,4716,2413,2303,104.8
37050, 구미시,010002, 6세,2018,5112,2636,2476,106.5,5103,2630,2473,106.3
37050, 구미시,010003, 7세,2018,4965,2631,2334,112.7,4962,2628,2334,112.6
37050, 구미시,010004, 8세,2018,4526,2313,2213,104.5,4520,2311,2209,104.6
37050, 구미시,010005, 9세,2018,4320,2285,2035,112.3,4313,2282,2031,112.4
37050, 구미시,015,10~14세,2018,21952,11392,10560,107.9,21934,11383,10551,107.9
37050, 구미시,015001, 10세,2018,4598,2373,2225,106.7,4591,2368,2223,106.5
37050, 구미시,015002, 11세,2018,4666,2431,2235,108.8,4663,2430,2233,108.8
37050, 구미시,015003, 12세,2018,4184,2162,2022,106.9,4180,2161,2019,107
37050, 구미시,015004, 13세,2018,4151,2131,2020,105.5,4149,2130,2019,105.5
37050, 구미시,015005, 14세,2018,4353,2295,2058,111.5,4351,2294,2057,111.5
37050, 구미시,020,15~19세,2018,26866,14920,11946,124.9,26803,14895,11908,125.1
37050, 구미시,020001, 15세,2018,4703,2485,2218,112,4698,2483,2215,112.1
37050, 구미시,020002, 16세,2018,4701,2513,2188,114.9,4698,2512,2186,114.9
37050, 구미시,020003, 17세,2018,5629,2983,2646,112.7,5622,2983,2639,113
37050, 구미시,020004, 18세,2018,6173,3467,2706,128.1,6156,3460,2696,128.3
37050, 구미시,020005, 19세,2018,5660,3472,2188,158.7,5629,3457,2172,159.2
37050, 구미시,025,20~24세,2018,30310,17551,12759,137.6,29592,17124,12468,137.3
37050, 구미시,025001, 20세,2018,5529,3287,2242,146.6,5440,3239,2201,147.2
37050, 구미시,025002, 21세,2018,5940,3429,2511,136.6,5843,3382,2461,137.4
37050, 구미시,025003, 22세,2018,5974,3484,2490,139.9,5811,3387,2424,139.7
37050, 구미시,025004, 23세,2018,6419,3751,2668,140.6,6243,3642,2601,140
37050, 구미시,025005, 24세,2018,6448,3600,2848,126.4,6255,3474,2781,124.9
37050, 구미시,030,25~29세,2018,30201,16494,13707,120.3,28783,15628,13155,118.8
37050, 구미시,030001, 25세,2018,6191,3399,2792,121.7,5952,3248,2704,120.1
37050, 구미시,030002, 26세,2018,6321,3361,2960,113.5,6039,3177,2862,111
37050, 구미시,030003, 27세,2018,5898,3200,2698,118.6,5630,3044,2586,117.7
37050, 구미시,030004, 28세,2018,5956,3296,2660,123.9,5630,3093,2537,121.9
37050, 구미시,030005, 29세,2018,5835,3238,2597,124.7,5532,3066,2466,124.3
37050, 구미시,035,30~34세,2018,32976,17688,15288,115.7,31604,16864,14740,114.4
37050, 구미시,035001, 30세,2018,6202,3432,2770,123.9,5883,3244,2639,122.9
37050, 구미시,035002, 31세,2018,6525,3447,3078,112,6227,3265,2962,110.2
37050, 구미시,035003, 32세,2018,6799,3647,3152,115.7,6522,3480,3042,114.4
37050, 구미시,035004, 33세,2018,6663,3612,3051,118.4,6408,3464,2944,117.7
37050, 구미시,035005, 34세,2018,6787,3550,3237,109.7,6564,3411,3153,108.2
37050, 구미시,040,35~39세,2018,39944,20971,18973,110.5,38913,20359,18554,109.7
37050, 구미시,040001, 35세,2018,7595,3996,3599,111,7362,3864,3498,110.5
37050, 구미시,040002, 36세,2018,8242,4361,3881,112.4,8002,4223,3779,111.7
37050, 구미시,040003, 37세,2018,8129,4252,3877,109.7,7929,4136,3793,109
37050, 구미시,040004, 38세,2018,8386,4402,3984,110.5,8176,4271,3905,109.4
37050, 구미시,040005, 39세,2018,7592,3960,3632,109,7444,3865,3579,108
37050, 구미시,045,40~44세,2018,35518,17761,17757,100,34892,17411,17481,99.6
37050, 구미시,045001, 40세,2018,6878,3577,3301,108.4,6737,3501,3236,108.2
37050, 구미시,045002, 41세,2018,7089,3580,3509,102,6959,3507,3452,101.6
37050, 구미시,045003, 42세,2018,6989,3478,3511,99.1,6864,3413,3451,98.9
37050, 구미시,045004, 43세,2018,7055,3434,3621,94.8,6932,3362,3570,94.2
37050, 구미시,045005, 44세,2018,7507,3692,3815,96.8,7400,3628,3772,96.2
37050, 구미시,050,45~49세,2018,38410,19238,19172,100.3,37911,18959,18952,100
37050, 구미시,050001, 45세,2018,7495,3637,3858,94.3,7382,3572,3810,93.8
37050, 구미시,050002, 46세,2018,7455,3810,3645,104.5,7348,3747,3601,104.1
37050, 구미시,050003, 47세,2018,7712,3977,3735,106.5,7632,3934,3698,106.4
37050, 구미시,050004, 48세,2018,7838,3890,3948,98.5,7731,3829,3902,98.1
37050, 구미시,050005, 49세,2018,7910,3924,3986,98.4,7818,3877,3941,98.4
37050, 구미시,055,50~54세,2018,34794,17612,17182,102.5,34435,17428,17007,102.5
37050, 구미시,055001, 50세,2018,7804,3822,3982,96,7731,3784,3947,95.9
37050, 구미시,055002, 51세,2018,7034,3352,3682,91,6958,3315,3643,91
37050, 구미시,055003, 52세,2018,6714,3503,3211,109.1,6652,3472,3180,109.2
37050, 구미시,055004, 53세,2018,6870,3553,3317,107.1,6800,3515,3285,107
37050, 구미시,055005, 54세,2018,6372,3382,2990,113.1,6294,3342,2952,113.2
37050, 구미시,060,55~59세,2018,31278,16413,14865,110.4,31022,16283,14739,110.5
37050, 구미시,060001, 55세,2018,6451,3434,3017,113.8,6376,3391,2985,113.6
37050, 구미시,060002, 56세,2018,6452,3377,3075,109.8,6396,3349,3047,109.9
37050, 구미시,060003, 57세,2018,6678,3499,3179,110.1,6638,3475,3163,109.9
37050, 구미시,060004, 58세,2018,6385,3349,3036,110.3,6343,3335,3008,110.9
37050, 구미시,060005, 59세,2018,5312,2754,2558,107.7,5269,2733,2536,107.8
37050, 구미시,065,60~64세,2018,19754,10321,9433,109.4,19571,10225,9346,109.4
37050, 구미시,065001, 60세,2018,4533,2406,2127,113.1,4477,2373,2104,112.8
37050, 구미시,065002, 61세,2018,4433,2295,2138,107.3,4388,2271,2117,107.3
37050, 구미시,065003, 62세,2018,3981,2146,1835,116.9,3950,2131,1819,117.2
37050, 구미시,065004, 63세,2018,3628,1860,1768,105.2,3604,1850,1754,105.5
37050, 구미시,065005, 64세,2018,3179,1614,1565,103.1,3152,1600,1552,103.1
37050, 구미시,070,65~69세,2018,12085,5999,6086,98.6,12006,5968,6038,98.8
37050, 구미시,070001, 65세,2018,2936,1477,1459,101.2,2911,1468,1443,101.7
37050, 구미시,070002, 66세,2018,2958,1462,1496,97.7,2934,1452,1482,98
37050, 구미시,070003, 67세,2018,2019,968,1051,92.1,2009,965,1044,92.4
37050, 구미시,070004, 68세,2018,2081,1021,1060,96.3,2067,1015,1052,96.5
37050, 구미시,070005, 69세,2018,2091,1071,1020,105,2085,1068,1017,105
37050, 구미시,075,70~74세,2018,7686,3506,4180,83.9,7650,3495,4155,84.1
37050, 구미시,075001, 70세,2018,2007,943,1064,88.6,1999,938,1061,88.4
37050, 구미시,075002, 71세,2018,1847,893,954,93.6,1840,891,949,93.9
37050, 구미시,075003, 72세,2018,1211,577,634,91,1201,574,627,91.5
37050, 구미시,075004, 73세,2018,1191,501,690,72.6,1187,500,687,72.8
37050, 구미시,075005, 74세,2018,1430,592,838,70.6,1423,592,831,71.2
37050, 구미시,080,75~79세,2018,7196,2689,4507,59.7,7181,2684,4497,59.7
37050, 구미시,080001, 75세,2018,1600,628,972,64.6,1596,626,970,64.5
37050, 구미시,080002, 76세,2018,1719,678,1041,65.1,1716,678,1038,65.3
37050, 구미시,080003, 77세,2018,1314,471,843,55.9,1312,471,841,56
37050, 구미시,080004, 78세,2018,1254,478,776,61.6,1252,477,775,61.5
37050, 구미시,080005, 79세,2018,1309,434,875,49.6,1305,432,873,49.5
37050, 구미시,085,80~84세,2018,4874,1582,3292,48.1,4866,1579,3287,48
37050, 구미시,085001, 80세,2018,1131,403,728,55.4,1129,403,726,55.5
37050, 구미시,085002, 81세,2018,1034,331,703,47.1,1032,329,703,46.8
37050, 구미시,085003, 82세,2018,929,305,624,48.9,927,304,623,48.8
37050, 구미시,085004, 83세,2018,976,306,670,45.7,975,306,669,45.7
37050, 구미시,085005, 84세,2018,804,237,567,41.8,803,237,566,41.9
37050, 구미시,090,85~89세,2018,2291,566,1725,32.8,2290,566,1724,32.8
37050, 구미시,090001, 85세,2018,600,161,439,36.7,600,161,439,36.7
37050, 구미시,090002, 86세,2018,584,154,430,35.8,584,154,430,35.8
37050, 구미시,090003, 87세,2018,437,116,321,36.1,436,116,320,36.3
37050, 구미시,090004, 88세,2018,366,75,291,25.8,366,75,291,25.8
37050, 구미시,090005, 89세,2018,304,60,244,24.6,304,60,244,24.6
37050, 구미시,095,90~94세,2018,807,164,643,25.5,805,164,641,25.6
37050, 구미시,095001, 90세,2018,264,57,207,27.5,264,57,207,27.5
37050, 구미시,095002, 91세,2018,214,44,170,25.9,213,44,169,26
37050, 구미시,095003, 92세,2018,146,28,118,23.7,145,28,117,23.9
37050, 구미시,095004, 93세,2018,105,21,84,25,105,21,84,25
37050, 구미시,095005, 94세,2018,78,14,64,21.9,78,14,64,21.9
37050, 구미시,100,95~99세,2018,190,21,169,12.4,190,21,169,12.4
37050, 구미시,100001, 95세,2018,62,9,53,17,62,9,53,17
37050, 구미시,100002, 96세,2018,62,X,58,6.9,62,X,58,6.9
37050, 구미시,100003, 97세,2018,27,X,24,12.5,27,X,24,12.5
37050, 구미시,100004, 98세,2018,26,X,23,13,26,X,23,13
37050, 구미시,100005, 99세,2018,13,X,11,18.2,13,X,11,18.2
37050, 구미시,101,100세이상,2018,16,X,14,14.3,16,X,14,14.3
37050, 구미시,102,15세미만,2018,66999,34691,32308,107.4,66857,34618,32239,107.4
37050, 구미시,103,15~64세,2018,320051,168969,151082,111.8,313526,165176,148350,111.3
37050, 구미시,104,65세이상,2018,35145,14529,20616,70.5,35004,14479,20525,70.5
37050, 구미시,086,85세이상,2018,3304,753,2551,29.5,3301,753,2548,29.6
37050, 구미시,126,평균연령,2018,37.6,36.6,38.7,,37.6,36.6,38.7,
37050, 구미시,127,중위연령,2018,38,36.9,39.2,,38.1,37,39.3,
37060, 영주시,000,합계,2018,107034,53582,53452,100.2,105544,52819,52725,100.2
37060, 영주시,005,0~4세,2018,3023,1568,1455,107.8,3013,1562,1451,107.6
37060, 영주시,005001, 0세,2018,528,275,253,108.7,524,274,250,109.6
37060, 영주시,005002, 1세,2018,540,260,280,92.9,537,258,279,92.5
37060, 영주시,005003, 2세,2018,626,323,303,106.6,625,322,303,106.3
37060, 영주시,005004, 3세,2018,643,331,312,106.1,642,330,312,105.8
37060, 영주시,005005, 4세,2018,686,379,307,123.5,685,378,307,123.1
37060, 영주시,010,5~9세,2018,3966,2034,1932,105.3,3963,2032,1931,105.2
37060, 영주시,010001, 5세,2018,669,351,318,110.4,668,351,317,110.7
37060, 영주시,010002, 6세,2018,866,444,422,105.2,865,443,422,105
37060, 영주시,010003, 7세,2018,806,407,399,102,806,407,399,102
37060, 영주시,010004, 8세,2018,840,437,403,108.4,839,436,403,108.2
37060, 영주시,010005, 9세,2018,785,395,390,101.3,785,395,390,101.3
37060, 영주시,015,10~14세,2018,4280,2233,2047,109.1,4277,2230,2047,108.9
37060, 영주시,015001, 10세,2018,853,407,446,91.3,853,407,446,91.3
37060, 영주시,015002, 11세,2018,828,406,422,96.2,827,405,422,96
37060, 영주시,015003, 12세,2018,831,461,370,124.6,830,460,370,124.3
37060, 영주시,015004, 13세,2018,845,464,381,121.8,845,464,381,121.8
37060, 영주시,015005, 14세,2018,923,495,428,115.7,922,494,428,115.4
37060, 영주시,020,15~19세,2018,6386,3551,2835,125.3,6342,3530,2812,125.5
37060, 영주시,020001, 15세,2018,917,462,455,101.5,917,462,455,101.5
37060, 영주시,020002, 16세,2018,1023,554,469,118.1,1021,553,468,118.2
37060, 영주시,020003, 17세,2018,1293,738,555,133,1288,736,552,133.3
37060, 영주시,020004, 18세,2018,1570,911,659,138.2,1556,903,653,138.3
37060, 영주시,020005, 19세,2018,1583,886,697,127.1,1560,876,684,128.1
37060, 영주시,025,20~24세,2018,6840,4154,2686,154.7,6562,3997,2565,155.8
37060, 영주시,025001, 20세,2018,1474,813,661,123,1437,793,644,123.1
37060, 영주시,025002, 21세,2018,1438,814,624,130.4,1381,783,598,130.9
37060, 영주시,025003, 22세,2018,1460,898,562,159.8,1390,858,532,161.3
37060, 영주시,025004, 23세,2018,1317,873,444,196.6,1249,832,417,199.5
37060, 영주시,025005, 24세,2018,1151,756,395,191.4,1105,731,374,195.5
37060, 영주시,030,25~29세,2018,4439,2671,1768,151.1,4145,2505,1640,152.7
37060, 영주시,030001, 25세,2018,1045,636,409,155.5,990,607,383,158.5
37060, 영주시,030002, 26세,2018,954,575,379,151.7,900,541,359,150.7
37060, 영주시,030003, 27세,2018,819,513,306,167.6,753,470,283,166.1
37060, 영주시,030004, 28세,2018,856,498,358,139.1,781,461,320,144.1
37060, 영주시,030005, 29세,2018,765,449,316,142.1,721,426,295,144.4
37060, 영주시,035,30~34세,2018,4079,2209,1870,118.1,3827,2085,1742,119.7
37060, 영주시,035001, 30세,2018,802,456,346,131.8,736,425,311,136.7
37060, 영주시,035002, 31세,2018,783,420,363,115.7,732,391,341,114.7
37060, 영주시,035003, 32세,2018,800,419,381,110,744,394,350,112.6
37060, 영주시,035004, 33세,2018,844,472,372,126.9,801,450,351,128.2
37060, 영주시,035005, 34세,2018,850,442,408,108.3,814,425,389,109.3
37060, 영주시,040,35~39세,2018,5820,2991,2829,105.7,5648,2901,2747,105.6
37060, 영주시,040001, 35세,2018,1052,538,514,104.7,1013,515,498,103.4
37060, 영주시,040002, 36세,2018,1153,600,553,108.5,1117,578,539,107.2
37060, 영주시,040003, 37세,2018,1155,582,573,101.6,1120,566,554,102.2
37060, 영주시,040004, 38세,2018,1221,619,602,102.8,1187,602,585,102.9
37060, 영주시,040005, 39세,2018,1239,652,587,111.1,1211,640,571,112.1
37060, 영주시,045,40~44세,2018,6553,3326,3227,103.1,6446,3279,3167,103.5
37060, 영주시,045001, 40세,2018,1140,593,547,108.4,1124,587,537,109.3
37060, 영주시,045002, 41세,2018,1242,640,602,106.3,1213,629,584,107.7
37060, 영주시,045003, 42세,2018,1313,650,663,98,1293,640,653,98
37060, 영주시,045004, 43세,2018,1392,704,688,102.3,1370,692,678,102.1
37060, 영주시,045005, 44세,2018,1466,739,727,101.7,1446,731,715,102.2
37060, 영주시,050,45~49세,2018,8131,4289,3842,111.6,8029,4252,3777,112.6
37060, 영주시,050001, 45세,2018,1586,806,780,103.3,1558,798,760,105
37060, 영주시,050002, 46세,2018,1529,835,694,120.3,1513,825,688,119.9
37060, 영주시,050003, 47세,2018,1605,868,737,117.8,1586,862,724,119.1
37060, 영주시,050004, 48세,2018,1648,840,808,104,1629,834,795,104.9
37060, 영주시,050005, 49세,2018,1763,940,823,114.2,1743,933,810,115.2
37060, 영주시,055,50~54세,2018,8407,4271,4136,103.3,8334,4238,4096,103.5
37060, 영주시,055001, 50세,2018,1823,962,861,111.7,1815,957,858,111.5
37060, 영주시,055002, 51세,2018,1621,778,843,92.3,1607,772,835,92.5
37060, 영주시,055003, 52세,2018,1694,880,814,108.1,1674,871,803,108.5
37060, 영주시,055004, 53세,2018,1628,814,814,100,1617,809,808,100.1
37060, 영주시,055005, 54세,2018,1641,837,804,104.1,1621,829,792,104.7
37060, 영주시,060,55~59세,2018,9972,4971,5001,99.4,9901,4938,4963,99.5
37060, 영주시,060001, 55세,2018,1701,854,847,100.8,1685,848,837,101.3
37060, 영주시,060002, 56세,2018,1895,971,924,105.1,1886,967,919,105.2
37060, 영주시,060003, 57세,2018,2240,1125,1115,100.9,2222,1117,1105,101.1
37060, 영주시,060004, 58세,2018,2287,1127,1160,97.2,2273,1117,1156,96.6
37060, 영주시,060005, 59세,2018,1849,894,955,93.6,1835,889,946,94
37060, 영주시,065,60~64세,2018,9212,4478,4734,94.6,9163,4453,4710,94.5
37060, 영주시,065001, 60세,2018,1814,891,923,96.5,1807,886,921,96.2
37060, 영주시,065002, 61세,2018,1992,983,1009,97.4,1979,980,999,98.1
37060, 영주시,065003, 62세,2018,1817,868,949,91.5,1808,861,947,90.9
37060, 영주시,065004, 63세,2018,1803,877,926,94.7,1791,871,920,94.7
37060, 영주시,065005, 64세,2018,1786,859,927,92.7,1778,855,923,92.6
37060, 영주시,070,65~69세,2018,7388,3506,3882,90.3,7365,3493,3872,90.2
37060, 영주시,070001, 65세,2018,1644,766,878,87.2,1636,761,875,87
37060, 영주시,070002, 66세,2018,1726,782,944,82.8,1720,779,941,82.8
37060, 영주시,070003, 67세,2018,1235,575,660,87.1,1232,574,658,87.2
37060, 영주시,070004, 68세,2018,1360,679,681,99.7,1357,677,680,99.6
37060, 영주시,070005, 69세,2018,1423,704,719,97.9,1420,702,718,97.8
37060, 영주시,075,70~74세,2018,5590,2581,3009,85.8,5584,2576,3008,85.6
37060, 영주시,075001, 70세,2018,1425,694,731,94.9,1423,693,730,94.9
37060, 영주시,075002, 71세,2018,1277,617,660,93.5,1274,614,660,93
37060, 영주시,075003, 72세,2018,761,354,407,87,761,354,407,87
37060, 영주시,075004, 73세,2018,937,410,527,77.8,937,410,527,77.8
37060, 영주시,075005, 74세,2018,1190,506,684,74,1189,505,684,73.8
37060, 영주시,080,75~79세,2018,6050,2523,3527,71.5,6050,2523,3527,71.5
37060, 영주시,080001, 75세,2018,1267,550,717,76.7,1267,550,717,76.7
37060, 영주시,080002, 76세,2018,1408,593,815,72.8,1408,593,815,72.8
37060, 영주시,080003, 77세,2018,1146,479,667,71.8,1146,479,667,71.8
37060, 영주시,080004, 78세,2018,1044,409,635,64.4,1044,409,635,64.4
37060, 영주시,080005, 79세,2018,1185,492,693,71,1185,492,693,71
37060, 영주시,085,80~84세,2018,4066,1504,2562,58.7,4064,1503,2561,58.7
37060, 영주시,085001, 80세,2018,1020,398,622,64,1019,397,622,63.8
37060, 영주시,085002, 81세,2018,825,313,512,61.1,825,313,512,61.1
37060, 영주시,085003, 82세,2018,822,327,495,66.1,822,327,495,66.1
37060, 영주시,085004, 83세,2018,766,257,509,50.5,765,257,508,50.6
37060, 영주시,085005, 84세,2018,633,209,424,49.3,633,209,424,49.3
37060, 영주시,090,85~89세,2018,1956,527,1429,36.9,1955,527,1428,36.9
37060, 영주시,090001, 85세,2018,510,155,355,43.7,510,155,355,43.7
37060, 영주시,090002, 86세,2018,471,132,339,38.9,470,132,338,39.1
37060, 영주시,090003, 87세,2018,392,107,285,37.5,392,107,285,37.5
37060, 영주시,090004, 88세,2018,305,75,230,32.6,305,75,230,32.6
37060, 영주시,090005, 89세,2018,278,58,220,26.4,278,58,220,26.4
37060, 영주시,095,90~94세,2018,692,157,535,29.3,692,157,535,29.3
37060, 영주시,095001, 90세,2018,234,56,178,31.5,234,56,178,31.5
37060, 영주시,095002, 91세,2018,159,42,117,35.9,159,42,117,35.9
37060, 영주시,095003, 92세,2018,118,26,92,28.3,118,26,92,28.3
37060, 영주시,095004, 93세,2018,114,23,91,25.3,114,23,91,25.3
37060, 영주시,095005, 94세,2018,67,10,57,17.5,67,10,57,17.5
37060, 영주시,100,95~99세,2018,162,35,127,27.6,162,35,127,27.6
37060, 영주시,100001, 95세,2018,48,9,39,23.1,48,9,39,23.1
37060, 영주시,100002, 96세,2018,39,12,27,44.4,39,12,27,44.4
37060, 영주시,100003, 97세,2018,33,X,30,10,33,X,30,10
37060, 영주시,100004, 98세,2018,33,7,26,26.9,33,7,26,26.9
37060, 영주시,100005, 99세,2018,9,X,5,80,9,X,5,80
37060, 영주시,101,100세이상,2018,22,X,19,15.8,22,X,19,15.8
37060, 영주시,102,15세미만,2018,11269,5835,5434,107.4,11253,5824,5429,107.3
37060, 영주시,103,15~64세,2018,69839,36911,32928,112.1,68397,36178,32219,112.3
37060, 영주시,104,65세이상,2018,25926,10836,15090,71.8,25894,10817,15077,71.7
37060, 영주시,086,85세이상,2018,2832,722,2110,34.2,2831,722,2109,34.2
37060, 영주시,126,평균연령,2018,47.1,44.8,49.4,,47.3,45,49.6,
37060, 영주시,127,중위연령,2018,50,47.5,52.7,,50.3,47.8,53,
37070, 영천시,000,합계,2018,98686,50648,48038,105.4,94235,47432,46803,101.3
37070, 영천시,005,0~4세,2018,2793,1424,1369,104,2766,1418,1348,105.2
37070, 영천시,005001, 0세,2018,502,256,246,104.1,500,255,245,104.1
37070, 영천시,005002, 1세,2018,533,272,261,104.2,525,270,255,105.9
37070, 영천시,005003, 2세,2018,557,281,276,101.8,546,278,268,103.7
37070, 영천시,005004, 3세,2018,632,319,313,101.9,629,319,310,102.9
37070, 영천시,005005, 4세,2018,569,296,273,108.4,566,296,270,109.6
37070, 영천시,010,5~9세,2018,2951,1517,1434,105.8,2934,1509,1425,105.9
37070, 영천시,010001, 5세,2018,584,297,287,103.5,579,295,284,103.9
37070, 영천시,010002, 6세,2018,616,285,331,86.1,613,284,329,86.3
37070, 영천시,010003, 7세,2018,575,302,273,110.6,574,301,273,110.3
37070, 영천시,010004, 8세,2018,579,302,277,109,576,301,275,109.5
37070, 영천시,010005, 9세,2018,597,331,266,124.4,592,328,264,124.2
37070, 영천시,015,10~14세,2018,3053,1597,1456,109.7,3048,1596,1452,109.9
37070, 영천시,015001, 10세,2018,606,335,271,123.6,606,335,271,123.6
37070, 영천시,015002, 11세,2018,656,354,302,117.2,654,353,301,117.3
37070, 영천시,015003, 12세,2018,568,282,286,98.6,567,282,285,98.9
37070, 영천시,015004, 13세,2018,572,277,295,93.9,571,277,294,94.2
37070, 영천시,015005, 14세,2018,651,349,302,115.6,650,349,301,115.9
37070, 영천시,020,15~19세,2018,3592,2025,1567,129.2,3549,1998,1551,128.8
37070, 영천시,020001, 15세,2018,657,361,296,122,655,359,296,121.3
37070, 영천시,020002, 16세,2018,693,371,322,115.2,690,370,320,115.6
37070, 영천시,020003, 17세,2018,805,449,356,126.1,802,448,354,126.6
37070, 영천시,020004, 18세,2018,787,456,331,137.8,782,454,328,138.4
37070, 영천시,020005, 19세,2018,650,388,262,148.1,620,367,253,145.1
37070, 영천시,025,20~24세,2018,5392,3412,1980,172.3,4654,2897,1757,164.9
37070, 영천시,025001, 20세,2018,939,566,373,151.7,791,475,316,150.3
37070, 영천시,025002, 21세,2018,1085,711,374,190.1,955,623,332,187.7
37070, 영천시,025003, 22세,2018,1099,699,400,174.8,977,619,358,172.9
37070, 영천시,025004, 23세,2018,1159,741,418,177.3,1002,624,378,165.1
37070, 영천시,025005, 24세,2018,1110,695,415,167.5,929,556,373,149.1
37070, 영천시,030,25~29세,2018,5313,3274,2039,160.6,4311,2509,1802,139.2
37070, 영천시,030001, 25세,2018,1069,649,420,154.5,894,509,385,132.2
37070, 영천시,030002, 26세,2018,1142,716,426,168.1,911,539,372,144.9
37070, 영천시,030003, 27세,2018,1085,663,422,157.1,866,499,367,136
37070, 영천시,030004, 28세,2018,1037,655,382,171.5,847,509,338,150.6
37070, 영천시,030005, 29세,2018,980,591,389,151.9,793,453,340,133.2
37070, 영천시,035,30~34세,2018,4913,2931,1982,147.9,4073,2270,1803,125.9
37070, 영천시,035001, 30세,2018,976,594,382,155.5,789,448,341,131.4
37070, 영천시,035002, 31세,2018,989,572,417,137.2,789,423,366,115.6
37070, 영천시,035003, 32세,2018,982,584,398,146.7,824,451,373,120.9
37070, 영천시,035004, 33세,2018,988,585,403,145.2,822,453,369,122.8
37070, 영천시,035005, 34세,2018,978,596,382,156,849,495,354,139.8
37070, 영천시,040,35~39세,2018,5946,3359,2587,129.8,5237,2808,2429,115.6
37070, 영천시,040001, 35세,2018,1122,639,483,132.3,967,519,448,115.8
37070, 영천시,040002, 36세,2018,1205,688,517,133.1,1045,564,481,117.3
37070, 영천시,040003, 37세,2018,1243,692,551,125.6,1110,590,520,113.5
37070, 영천시,040004, 38세,2018,1240,701,539,130.1,1103,594,509,116.7
37070, 영천시,040005, 39세,2018,1136,639,497,128.6,1012,541,471,114.9
37070, 영천시,045,40~44세,2018,5797,3223,2574,125.2,5419,2947,2472,119.2
37070, 영천시,045001, 40세,2018,1029,580,449,129.2,936,510,426,119.7
37070, 영천시,045002, 41세,2018,1011,543,468,116,938,488,450,108.4
37070, 영천시,045003, 42세,2018,1169,673,496,135.7,1079,608,471,129.1
37070, 영천시,045004, 43세,2018,1230,685,545,125.7,1164,640,524,122.1
37070, 영천시,045005, 44세,2018,1358,742,616,120.5,1302,701,601,116.6
37070, 영천시,050,45~49세,2018,7200,3785,3415,110.8,6942,3610,3332,108.3
37070, 영천시,050001, 45세,2018,1295,681,614,110.9,1244,648,596,108.7
37070, 영천시,050002, 46세,2018,1417,751,666,112.8,1362,714,648,110.2
37070, 영천시,050003, 47세,2018,1491,797,694,114.8,1433,755,678,111.4
37070, 영천시,050004, 48세,2018,1446,757,689,109.9,1404,734,670,109.6
37070, 영천시,050005, 49세,2018,1551,799,752,106.3,1499,759,740,102.6
37070, 영천시,055,50~54세,2018,8153,4313,3840,112.3,7962,4207,3755,112
37070, 영천시,055001, 50세,2018,1705,904,801,112.9,1653,876,777,112.7
37070, 영천시,055002, 51세,2018,1604,866,738,117.3,1566,845,721,117.2
37070, 영천시,055003, 52세,2018,1648,882,766,115.1,1617,864,753,114.7
37070, 영천시,055004, 53세,2018,1516,774,742,104.3,1486,760,726,104.7
37070, 영천시,055005, 54세,2018,1680,887,793,111.9,1640,862,778,110.8
37070, 영천시,060,55~59세,2018,9440,4782,4658,102.7,9309,4710,4599,102.4
37070, 영천시,060001, 55세,2018,1671,882,789,111.8,1631,863,768,112.4
37070, 영천시,060002, 56세,2018,1804,926,878,105.5,1784,913,871,104.8
37070, 영천시,060003, 57세,2018,2036,1037,999,103.8,2012,1024,988,103.6
37070, 영천시,060004, 58세,2018,1960,929,1031,90.1,1937,917,1020,89.9
37070, 영천시,060005, 59세,2018,1969,1008,961,104.9,1945,993,952,104.3
37070, 영천시,065,60~64세,2018,8523,4325,4198,103,8464,4293,4171,102.9
37070, 영천시,065001, 60세,2018,1685,855,830,103,1670,848,822,103.2
37070, 영천시,065002, 61세,2018,1798,952,846,112.5,1787,945,842,112.2
37070, 영천시,065003, 62세,2018,1788,902,886,101.8,1779,896,883,101.5
37070, 영천시,065004, 63세,2018,1753,867,886,97.9,1739,860,879,97.8
37070, 영천시,065005, 64세,2018,1499,749,750,99.9,1489,744,745,99.9
37070, 영천시,070,65~69세,2018,7487,3599,3888,92.6,7457,3585,3872,92.6
37070, 영천시,070001, 65세,2018,1572,731,841,86.9,1561,728,833,87.4
37070, 영천시,070002, 66세,2018,1609,754,855,88.2,1604,750,854,87.8
37070, 영천시,070003, 67세,2018,1434,710,724,98.1,1428,707,721,98.1
37070, 영천시,070004, 68세,2018,1412,694,718,96.7,1407,693,714,97.1
37070, 영천시,070005, 69세,2018,1460,710,750,94.7,1457,707,750,94.3
37070, 영천시,075,70~74세,2018,5661,2610,3051,85.5,5649,2605,3044,85.6
37070, 영천시,075001, 70세,2018,1439,706,733,96.3,1434,704,730,96.4
37070, 영천시,075002, 71세,2018,1264,599,665,90.1,1262,599,663,90.3
37070, 영천시,075003, 72세,2018,846,395,451,87.6,843,394,449,87.8
37070, 영천시,075004, 73세,2018,996,435,561,77.5,995,434,561,77.4
37070, 영천시,075005, 74세,2018,1116,475,641,74.1,1115,474,641,73.9
37070, 영천시,080,75~79세,2018,5977,2381,3596,66.2,5973,2380,3593,66.2
37070, 영천시,080001, 75세,2018,1247,506,741,68.3,1246,506,740,68.4
37070, 영천시,080002, 76세,2018,1486,624,862,72.4,1484,623,861,72.4
37070, 영천시,080003, 77세,2018,1113,442,671,65.9,1112,442,670,66
37070, 영천시,080004, 78세,2018,1043,400,643,62.2,1043,400,643,62.2
37070, 영천시,080005, 79세,2018,1088,409,679,60.2,1088,409,679,60.2
37070, 영천시,085,80~84세,2018,4120,1420,2700,52.6,4113,1419,2694,52.7
37070, 영천시,085001, 80세,2018,959,345,614,56.2,956,344,612,56.2
37070, 영천시,085002, 81세,2018,891,311,580,53.6,890,311,579,53.7
37070, 영천시,085003, 82세,2018,839,290,549,52.8,838,290,548,52.9
37070, 영천시,085004, 83세,2018,755,245,510,48,755,245,510,48
37070, 영천시,085005, 84세,2018,676,229,447,51.2,674,229,445,51.5
37070, 영천시,090,85~89세,2018,1822,532,1290,41.2,1822,532,1290,41.2
37070, 영천시,090001, 85세,2018,522,155,367,42.2,522,155,367,42.2
37070, 영천시,090002, 86세,2018,455,139,316,44,455,139,316,44
37070, 영천시,090003, 87세,2018,335,91,244,37.3,335,91,244,37.3
37070, 영천시,090004, 88세,2018,290,92,198,46.5,290,92,198,46.5
37070, 영천시,090005, 89세,2018,220,55,165,33.3,220,55,165,33.3
37070, 영천시,095,90~94세,2018,454,123,331,37.2,454,123,331,37.2
37070, 영천시,095001, 90세,2018,169,45,124,36.3,169,45,124,36.3
37070, 영천시,095002, 91세,2018,107,30,77,39,107,30,77,39
37070, 영천시,095003, 92세,2018,78,22,56,39.3,78,22,56,39.3
37070, 영천시,095004, 93세,2018,62,19,43,44.2,62,19,43,44.2
37070, 영천시,095005, 94세,2018,38,7,31,22.6,38,7,31,22.6
37070, 영천시,100,95~99세,2018,91,14,77,18.2,91,14,77,18.2
37070, 영천시,100001, 95세,2018,22,X,20,10,22,X,20,10
37070, 영천시,100002, 96세,2018,30,5,25,20,30,5,25,20
37070, 영천시,100003, 97세,2018,22,5,17,29.4,22,5,17,29.4
37070, 영천시,100004, 98세,2018,9,X,9,0,9,X,9,0
37070, 영천시,100005, 99세,2018,8,X,6,33.3,8,X,6,33.3
37070, 영천시,101,100세이상,2018,8,X,6,33.3,8,X,6,33.3
37070, 영천시,102,15세미만,2018,8797,4538,4259,106.6,8748,4523,4225,107.1
37070, 영천시,103,15~64세,2018,64269,35429,28840,122.8,59920,32249,27671,116.5
37070, 영천시,104,65세이상,2018,25620,10681,14939,71.5,25567,10660,14907,71.5
37070, 영천시,086,85세이상,2018,2375,671,1704,39.4,2375,671,1704,39.4
37070, 영천시,126,평균연령,2018,48.6,46.2,51.2,,49.3,47,51.6,
37070, 영천시,127,중위연령,2018,51.4,48.4,54.7,,52.6,50.2,55.4,
37080, 상주시,000,합계,2018,97558,48056,49502,97.1,96291,47499,48792,97.3
37080, 상주시,005,0~4세,2018,2527,1330,1197,111.1,2520,1327,1193,111.2
37080, 상주시,005001, 0세,2018,485,264,221,119.5,482,262,220,119.1
37080, 상주시,005002, 1세,2018,445,232,213,108.9,445,232,213,108.9
37080, 상주시,005003, 2세,2018,497,246,251,98,495,246,249,98.8
37080, 상주시,005004, 3세,2018,562,304,258,117.8,561,303,258,117.4
37080, 상주시,005005, 4세,2018,538,284,254,111.8,537,284,253,112.3
37080, 상주시,010,5~9세,2018,3151,1625,1526,106.5,3145,1622,1523,106.5
37080, 상주시,010001, 5세,2018,585,296,289,102.4,585,296,289,102.4
37080, 상주시,010002, 6세,2018,622,337,285,118.2,620,337,283,119.1
37080, 상주시,010003, 7세,2018,647,331,316,104.7,647,331,316,104.7
37080, 상주시,010004, 8세,2018,633,329,304,108.2,632,328,304,107.9
37080, 상주시,010005, 9세,2018,664,332,332,100,661,330,331,99.7
37080, 상주시,015,10~14세,2018,3446,1792,1654,108.3,3441,1791,1650,108.5
37080, 상주시,015001, 10세,2018,704,375,329,114,703,375,328,114.3
37080, 상주시,015002, 11세,2018,722,383,339,113,721,383,338,113.3
37080, 상주시,015003, 12세,2018,664,332,332,100,663,332,331,100.3
37080, 상주시,015004, 13세,2018,682,348,334,104.2,680,347,333,104.2
37080, 상주시,015005, 14세,2018,674,354,320,110.6,674,354,320,110.6
37080, 상주시,020,15~19세,2018,4843,2747,2096,131.1,4834,2743,2091,131.2
37080, 상주시,020001, 15세,2018,787,422,365,115.6,787,422,365,115.6
37080, 상주시,020002, 16세,2018,859,471,388,121.4,859,471,388,121.4
37080, 상주시,020003, 17세,2018,1036,549,487,112.7,1036,549,487,112.7
37080, 상주시,020004, 18세,2018,1148,670,478,140.2,1147,669,478,140
37080, 상주시,020005, 19세,2018,1013,635,378,168,1005,632,373,169.4
37080, 상주시,025,20~24세,2018,5493,3386,2107,160.7,5327,3302,2025,163.1
37080, 상주시,025001, 20세,2018,1087,675,412,163.8,1081,673,408,165
37080, 상주시,025002, 21세,2018,1167,675,492,137.2,1133,662,471,140.6
37080, 상주시,025003, 22세,2018,1116,679,437,155.4,1085,664,421,157.7
37080, 상주시,025004, 23세,2018,1120,719,401,179.3,1083,699,384,182
37080, 상주시,025005, 24세,2018,1003,638,365,174.8,945,604,341,177.1
37080, 상주시,030,25~29세,2018,3808,2217,1591,139.3,3543,2084,1459,142.8
37080, 상주시,030001, 25세,2018,836,520,316,164.6,772,480,292,164.4
37080, 상주시,030002, 26세,2018,784,472,312,151.3,732,446,286,155.9
37080, 상주시,030003, 27세,2018,779,429,350,122.6,726,405,321,126.2
37080, 상주시,030004, 28세,2018,721,397,324,122.5,669,370,299,123.7
37080, 상주시,030005, 29세,2018,688,399,289,138.1,644,383,261,146.7
37080, 상주시,035,30~34세,2018,3696,2008,1688,119,3492,1932,1560,123.8
37080, 상주시,035001, 30세,2018,718,371,347,106.9,687,356,331,107.6
37080, 상주시,035002, 31세,2018,694,378,316,119.6,639,363,276,131.5
37080, 상주시,035003, 32세,2018,764,418,346,120.8,721,403,318,126.7
37080, 상주시,035004, 33세,2018,715,398,317,125.6,675,379,296,128
37080, 상주시,035005, 34세,2018,805,443,362,122.4,770,431,339,127.1
37080, 상주시,040,35~39세,2018,4658,2436,2222,109.6,4514,2384,2130,111.9
37080, 상주시,040001, 35세,2018,848,445,403,110.4,819,434,385,112.7
37080, 상주시,040002, 36세,2018,927,475,452,105.1,895,464,431,107.7
37080, 상주시,040003, 37세,2018,944,514,430,119.5,920,504,416,121.2
37080, 상주시,040004, 38세,2018,981,500,481,104,949,492,457,107.7
37080, 상주시,040005, 39세,2018,958,502,456,110.1,931,490,441,111.1
37080, 상주시,045,40~44세,2018,5133,2646,2487,106.4,5039,2610,2429,107.5
37080, 상주시,045001, 40세,2018,848,448,400,112,830,442,388,113.9
37080, 상주시,045002, 41세,2018,928,459,469,97.9,913,454,459,98.9
37080, 상주시,045003, 42세,2018,957,494,463,106.7,935,486,449,108.2
37080, 상주시,045004, 43세,2018,1134,585,549,106.6,1116,579,537,107.8
37080, 상주시,045005, 44세,2018,1266,660,606,108.9,1245,649,596,108.9
37080, 상주시,050,45~49세,2018,6692,3574,3118,114.6,6582,3526,3056,115.4
37080, 상주시,050001, 45세,2018,1253,652,601,108.5,1231,644,587,109.7
37080, 상주시,050002, 46세,2018,1273,652,621,105,1246,641,605,106
37080, 상주시,050003, 47세,2018,1427,771,656,117.5,1410,762,648,117.6
37080, 상주시,050004, 48세,2018,1377,738,639,115.5,1349,728,621,117.2
37080, 상주시,050005, 49세,2018,1362,761,601,126.6,1346,751,595,126.2
37080, 상주시,055,50~54세,2018,7653,3964,3689,107.5,7550,3924,3626,108.2
37080, 상주시,055001, 50세,2018,1557,824,733,112.4,1539,818,721,113.5
37080, 상주시,055002, 51세,2018,1445,746,699,106.7,1421,739,682,108.4
37080, 상주시,055003, 52세,2018,1517,821,696,118,1499,812,687,118.2
37080, 상주시,055004, 53세,2018,1519,749,770,97.3,1499,741,758,97.8
37080, 상주시,055005, 54세,2018,1615,824,791,104.2,1592,814,778,104.6
37080, 상주시,060,55~59세,2018,9529,4783,4746,100.8,9471,4753,4718,100.7
37080, 상주시,060001, 55세,2018,1707,885,822,107.7,1684,874,810,107.9
37080, 상주시,060002, 56세,2018,1778,902,876,103,1768,897,871,103
37080, 상주시,060003, 57세,2018,1971,1004,967,103.8,1962,999,963,103.7
37080, 상주시,060004, 58세,2018,2148,1054,1094,96.3,2137,1047,1090,96.1
37080, 상주시,060005, 59세,2018,1925,938,987,95,1920,936,984,95.1
37080, 상주시,065,60~64세,2018,8951,4430,4521,98,8896,4405,4491,98.1
37080, 상주시,065001, 60세,2018,1869,946,923,102.5,1855,938,917,102.3
37080, 상주시,065002, 61세,2018,1831,947,884,107.1,1818,941,877,107.3
37080, 상주시,065003, 62세,2018,1829,894,935,95.6,1818,888,930,95.5
37080, 상주시,065004, 63세,2018,1774,860,914,94.1,1768,858,910,94.3
37080, 상주시,065005, 64세,2018,1648,783,865,90.5,1637,780,857,91
37080, 상주시,070,65~69세,2018,7352,3523,3829,92,7328,3510,3818,91.9
37080, 상주시,070001, 65세,2018,1498,717,781,91.8,1491,715,776,92.1
37080, 상주시,070002, 66세,2018,1715,804,911,88.3,1708,799,909,87.9
37080, 상주시,070003, 67세,2018,1194,560,634,88.3,1191,558,633,88.2
37080, 상주시,070004, 68세,2018,1371,652,719,90.7,1365,649,716,90.6
37080, 상주시,070005, 69세,2018,1574,790,784,100.8,1573,789,784,100.6
37080, 상주시,075,70~74세,2018,5688,2545,3143,81,5676,2538,3138,80.9
37080, 상주시,075001, 70세,2018,1426,683,743,91.9,1420,681,739,92.2
37080, 상주시,075002, 71세,2018,1387,639,748,85.4,1386,639,747,85.5
37080, 상주시,075003, 72세,2018,863,413,450,91.8,861,411,450,91.3
37080, 상주시,075004, 73세,2018,925,399,526,75.9,924,398,526,75.7
37080, 상주시,075005, 74세,2018,1087,411,676,60.8,1085,409,676,60.5
37080, 상주시,080,75~79세,2018,6720,2542,4178,60.8,6717,2541,4176,60.8
37080, 상주시,080001, 75세,2018,1286,543,743,73.1,1286,543,743,73.1
37080, 상주시,080002, 76세,2018,1604,614,990,62,1604,614,990,62
37080, 상주시,080003, 77세,2018,1249,464,785,59.1,1249,464,785,59.1
37080, 상주시,080004, 78세,2018,1276,459,817,56.2,1275,459,816,56.3
37080, 상주시,080005, 79세,2018,1305,462,843,54.8,1303,461,842,54.8
37080, 상주시,085,80~84세,2018,4943,1710,3233,52.9,4942,1709,3233,52.9
37080, 상주시,085001, 80세,2018,1158,427,731,58.4,1158,427,731,58.4
37080, 상주시,085002, 81세,2018,1079,380,699,54.4,1079,380,699,54.4
37080, 상주시,085003, 82세,2018,999,330,669,49.3,999,330,669,49.3
37080, 상주시,085004, 83세,2018,911,317,594,53.4,910,316,594,53.2
37080, 상주시,085005, 84세,2018,796,256,540,47.4,796,256,540,47.4
37080, 상주시,090,85~89세,2018,2271,610,1661,36.7,2270,610,1660,36.7
37080, 상주시,090001, 85세,2018,607,173,434,39.9,607,173,434,39.9
37080, 상주시,090002, 86세,2018,560,159,401,39.7,560,159,401,39.7
37080, 상주시,090003, 87세,2018,429,120,309,38.8,429,120,309,38.8
37080, 상주시,090004, 88세,2018,387,90,297,30.3,387,90,297,30.3
37080, 상주시,090005, 89세,2018,288,68,220,30.9,287,68,219,31.1
37080, 상주시,095,90~94세,2018,803,160,643,24.9,803,160,643,24.9
37080, 상주시,095001, 90세,2018,248,53,195,27.2,248,53,195,27.2
37080, 상주시,095002, 91세,2018,202,40,162,24.7,202,40,162,24.7
37080, 상주시,095003, 92세,2018,155,25,130,19.2,155,25,130,19.2
37080, 상주시,095004, 93세,2018,115,30,85,35.3,115,30,85,35.3
37080, 상주시,095005, 94세,2018,83,12,71,16.9,83,12,71,16.9
37080, 상주시,100,95~99세,2018,187,27,160,16.9,187,27,160,16.9
37080, 상주시,100001, 95세,2018,66,11,55,20,66,11,55,20
37080, 상주시,100002, 96세,2018,58,9,49,18.4,58,9,49,18.4
37080, 상주시,100003, 97세,2018,33,X,29,13.8,33,X,29,13.8
37080, 상주시,100004, 98세,2018,19,X,17,11.8,19,X,17,11.8
37080, 상주시,100005, 99세,2018,11,X,10,10,11,X,10,10
37080, 상주시,101,100세이상,2018,14,X,13,7.7,14,X,13,7.7
37080, 상주시,102,15세미만,2018,9124,4747,4377,108.5,9106,4740,4366,108.6
37080, 상주시,103,15~64세,2018,60456,32191,28265,113.9,59248,31663,27585,114.8
37080, 상주시,104,65세이상,2018,27978,11118,16860,65.9,27937,11096,16841,65.9
37080, 상주시,086,85세이상,2018,3275,798,2477,32.2,3274,798,2476,32.2
37080, 상주시,126,평균연령,2018,49.8,46.9,52.6,,49.9,47,52.8,
37080, 상주시,127,중위연령,2018,53.5,50.3,56.6,,53.8,50.5,57,
37090, 문경시,000,합계,2018,68895,33777,35118,96.2,67961,33328,34633,96.2
37090, 문경시,005,0~4세,2018,1888,967,921,105,1884,964,920,104.8
37090, 문경시,005001, 0세,2018,300,155,145,106.9,299,154,145,106.2
37090, 문경시,005002, 1세,2018,366,196,170,115.3,365,195,170,114.7
37090, 문경시,005003, 2세,2018,400,205,195,105.1,399,204,195,104.6
37090, 문경시,005004, 3세,2018,417,200,217,92.2,416,200,216,92.6
37090, 문경시,005005, 4세,2018,405,211,194,108.8,405,211,194,108.8
37090, 문경시,010,5~9세,2018,2335,1242,1093,113.6,2326,1239,1087,114
37090, 문경시,010001, 5세,2018,447,235,212,110.8,444,234,210,111.4
37090, 문경시,010002, 6세,2018,473,252,221,114,470,250,220,113.6
37090, 문경시,010003, 7세,2018,526,285,241,118.3,525,285,240,118.8
37090, 문경시,010004, 8세,2018,444,233,211,110.4,443,233,210,111
37090, 문경시,010005, 9세,2018,445,237,208,113.9,444,237,207,114.5
37090, 문경시,015,10~14세,2018,2462,1351,1111,121.6,2460,1349,1111,121.4
37090, 문경시,015001, 10세,2018,490,274,216,126.9,490,274,216,126.9
37090, 문경시,015002, 11세,2018,490,263,227,115.9,490,263,227,115.9
37090, 문경시,015003, 12세,2018,475,269,206,130.6,475,269,206,130.6
37090, 문경시,015004, 13세,2018,493,265,228,116.2,493,265,228,116.2
37090, 문경시,015005, 14세,2018,514,280,234,119.7,512,278,234,118.8
37090, 문경시,020,15~19세,2018,3492,1955,1537,127.2,3479,1947,1532,127.1
37090, 문경시,020001, 15세,2018,609,337,272,123.9,608,336,272,123.5
37090, 문경시,020002, 16세,2018,675,362,313,115.7,675,362,313,115.7
37090, 문경시,020003, 17세,2018,818,471,347,135.7,815,468,347,134.9
37090, 문경시,020004, 18세,2018,850,483,367,131.6,846,481,365,131.8
37090, 문경시,020005, 19세,2018,540,302,238,126.9,535,300,235,127.7
37090, 문경시,025,20~24세,2018,2933,1718,1215,141.4,2807,1649,1158,142.4
37090, 문경시,025001, 20세,2018,620,393,227,173.1,613,388,225,172.4
37090, 문경시,025002, 21세,2018,624,372,252,147.6,600,361,239,151
37090, 문경시,025003, 22세,2018,623,348,275,126.5,593,331,262,126.3
37090, 문경시,025004, 23세,2018,559,324,235,137.9,530,311,219,142
37090, 문경시,025005, 24세,2018,507,281,226,124.3,471,258,213,121.1
37090, 문경시,030,25~29세,2018,2494,1383,1111,124.5,2325,1301,1024,127.1
37090, 문경시,030001, 25세,2018,536,291,245,118.8,498,271,227,119.4
37090, 문경시,030002, 26세,2018,553,296,257,115.2,524,285,239,119.2
37090, 문경시,030003, 27세,2018,449,257,192,133.9,420,239,181,132
37090, 문경시,030004, 28세,2018,484,281,203,138.4,448,264,184,143.5
37090, 문경시,030005, 29세,2018,472,258,214,120.6,435,242,193,125.4
37090, 문경시,035,30~34세,2018,2815,1548,1267,122.2,2658,1465,1193,122.8
37090, 문경시,035001, 30세,2018,524,294,230,127.8,488,278,210,132.4
37090, 문경시,035002, 31세,2018,544,308,236,130.5,518,297,221,134.4
37090, 문경시,035003, 32세,2018,537,293,244,120.1,505,274,231,118.6
37090, 문경시,035004, 33세,2018,558,307,251,122.3,524,288,236,122
37090, 문경시,035005, 34세,2018,652,346,306,113.1,623,328,295,111.2
37090, 문경시,040,35~39세,2018,3508,1824,1684,108.3,3412,1781,1631,109.2
37090, 문경시,040001, 35세,2018,624,329,295,111.5,603,319,284,112.3
37090, 문경시,040002, 36세,2018,727,352,375,93.9,704,343,361,95
37090, 문경시,040003, 37세,2018,674,339,335,101.2,657,331,326,101.5
37090, 문경시,040004, 38세,2018,747,410,337,121.7,734,407,327,124.5
37090, 문경시,040005, 39세,2018,736,394,342,115.2,714,381,333,114.4
37090, 문경시,045,40~44세,2018,4058,2138,1920,111.4,3985,2104,1881,111.9
37090, 문경시,045001, 40세,2018,699,357,342,104.4,684,352,332,106
37090, 문경시,045002, 41세,2018,733,398,335,118.8,724,395,329,120.1
37090, 문경시,045003, 42세,2018,767,401,366,109.6,757,394,363,108.5
37090, 문경시,045004, 43세,2018,887,461,426,108.2,867,452,415,108.9
37090, 문경시,045005, 44세,2018,972,521,451,115.5,953,511,442,115.6
37090, 문경시,050,45~49세,2018,4742,2515,2227,112.9,4675,2492,2183,114.2
37090, 문경시,050001, 45세,2018,886,466,420,111,872,462,410,112.7
37090, 문경시,050002, 46세,2018,928,511,417,122.5,919,507,412,123.1
37090, 문경시,050003, 47세,2018,945,491,454,108.1,933,485,448,108.3
37090, 문경시,050004, 48세,2018,967,512,455,112.5,954,507,447,113.4
37090, 문경시,050005, 49세,2018,1016,535,481,111.2,997,531,466,113.9
37090, 문경시,055,50~54세,2018,5330,2740,2590,105.8,5257,2703,2554,105.8
37090, 문경시,055001, 50세,2018,1060,573,487,117.7,1042,561,481,116.6
37090, 문경시,055002, 51세,2018,1025,527,498,105.8,1016,522,494,105.7
37090, 문경시,055003, 52세,2018,1055,534,521,102.5,1046,529,517,102.3
37090, 문경시,055004, 53세,2018,1064,524,540,97,1046,517,529,97.7
37090, 문경시,055005, 54세,2018,1126,582,544,107,1107,574,533,107.7
37090, 문경시,060,55~59세,2018,6678,3311,3367,98.3,6618,3291,3327,98.9
37090, 문경시,060001, 55세,2018,1225,617,608,101.5,1206,607,599,101.3
37090, 문경시,060002, 56세,2018,1233,636,597,106.5,1224,635,589,107.8
37090, 문경시,060003, 57세,2018,1402,691,711,97.2,1390,688,702,98
37090, 문경시,060004, 58세,2018,1496,728,768,94.8,1485,725,760,95.4
37090, 문경시,060005, 59세,2018,1322,639,683,93.6,1313,636,677,93.9
37090, 문경시,065,60~64세,2018,6580,3219,3361,95.8,6529,3197,3332,95.9
37090, 문경시,065001, 60세,2018,1360,685,675,101.5,1345,680,665,102.3
37090, 문경시,065002, 61세,2018,1380,664,716,92.7,1373,662,711,93.1
37090, 문경시,065003, 62세,2018,1376,676,700,96.6,1368,673,695,96.8
37090, 문경시,065004, 63세,2018,1298,639,659,97,1286,631,655,96.3
37090, 문경시,065005, 64세,2018,1166,555,611,90.8,1157,551,606,90.9
37090, 문경시,070,65~69세,2018,5396,2530,2866,88.3,5376,2521,2855,88.3
37090, 문경시,070001, 65세,2018,1140,524,616,85.1,1136,522,614,85
37090, 문경시,070002, 66세,2018,1200,575,625,92,1196,574,622,92.3
37090, 문경시,070003, 67세,2018,914,425,489,86.9,910,423,487,86.9
37090, 문경시,070004, 68세,2018,1056,493,563,87.6,1049,489,560,87.3
37090, 문경시,070005, 69세,2018,1086,513,573,89.5,1085,513,572,89.7
37090, 문경시,075,70~74세,2018,4171,1852,2319,79.9,4161,1845,2316,79.7
37090, 문경시,075001, 70세,2018,959,446,513,86.9,957,445,512,86.9
37090, 문경시,075002, 71세,2018,979,455,524,86.8,976,453,523,86.6
37090, 문경시,075003, 72세,2018,689,306,383,79.9,687,305,382,79.8
37090, 문경시,075004, 73세,2018,739,337,402,83.8,737,335,402,83.3
37090, 문경시,075005, 74세,2018,805,308,497,62,804,307,497,61.8
37090, 문경시,080,75~79세,2018,4657,1882,2775,67.8,4655,1880,2775,67.7
37090, 문경시,080001, 75세,2018,973,387,586,66,973,387,586,66
37090, 문경시,080002, 76세,2018,1051,447,604,74,1051,447,604,74
37090, 문경시,080003, 77세,2018,917,369,548,67.3,917,369,548,67.3
37090, 문경시,080004, 78세,2018,885,365,520,70.2,883,363,520,69.8
37090, 문경시,080005, 79세,2018,831,314,517,60.7,831,314,517,60.7
37090, 문경시,085,80~84세,2018,3253,1076,2177,49.4,3252,1075,2177,49.4
37090, 문경시,085001, 80세,2018,780,268,512,52.3,780,268,512,52.3
37090, 문경시,085002, 81세,2018,688,220,468,47,688,220,468,47
37090, 문경시,085003, 82세,2018,672,231,441,52.4,671,230,441,52.2
37090, 문경시,085004, 83세,2018,605,195,410,47.6,605,195,410,47.6
37090, 문경시,085005, 84세,2018,508,162,346,46.8,508,162,346,46.8
37090, 문경시,090,85~89세,2018,1436,389,1047,37.2,1435,388,1047,37.1
37090, 문경시,090001, 85세,2018,413,118,295,40,413,118,295,40
37090, 문경시,090002, 86세,2018,302,81,221,36.7,302,81,221,36.7
37090, 문경시,090003, 87세,2018,265,69,196,35.2,265,69,196,35.2
37090, 문경시,090004, 88세,2018,258,69,189,36.5,258,69,189,36.5
37090, 문경시,090005, 89세,2018,198,52,146,35.6,197,51,146,34.9
37090, 문경시,095,90~94세,2018,515,108,407,26.5,515,108,407,26.5
37090, 문경시,095001, 90세,2018,158,36,122,29.5,158,36,122,29.5
37090, 문경시,095002, 91세,2018,136,32,104,30.8,136,32,104,30.8
37090, 문경시,095003, 92세,2018,94,15,79,19,94,15,79,19
37090, 문경시,095004, 93세,2018,81,16,65,24.6,81,16,65,24.6
37090, 문경시,095005, 94세,2018,46,9,37,24.3,46,9,37,24.3
37090, 문경시,100,95~99세,2018,127,24,103,23.3,127,24,103,23.3
37090, 문경시,100001, 95세,2018,47,10,37,27,47,10,37,27
37090, 문경시,100002, 96세,2018,38,9,29,31,38,9,29,31
37090, 문경시,100003, 97세,2018,28,X,26,7.7,28,X,26,7.7
37090, 문경시,100004, 98세,2018,9,X,6,50,9,X,6,50
37090, 문경시,100005, 99세,2018,5,X,5,0,5,X,5,0
37090, 문경시,101,100세이상,2018,25,5,20,25,25,5,20,25
37090, 문경시,102,15세미만,2018,6685,3560,3125,113.9,6670,3552,3118,113.9
37090, 문경시,103,15~64세,2018,42630,22351,20279,110.2,41745,21930,19815,110.7
37090, 문경시,104,65세이상,2018,19580,7866,11714,67.2,19546,7846,11700,67.1
37090, 문경시,086,85세이상,2018,2103,526,1577,33.4,2102,525,1577,33.3
37090, 문경시,126,평균연령,2018,49.7,47.1,52.3,,49.9,47.2,52.5,
37090, 문경시,127,중위연령,2018,53.5,50.4,56.5,,53.8,50.7,56.8,
37100, 경산시,000,합계,2018,284517,143489,141028,101.7,271525,135754,135771,100
37100, 경산시,005,0~4세,2018,10876,5524,5352,103.2,10725,5450,5275,103.3
37100, 경산시,005001, 0세,2018,1840,932,908,102.6,1812,919,893,102.9
37100, 경산시,005002, 1세,2018,1984,1005,979,102.7,1947,982,965,101.8
37100, 경산시,005003, 2세,2018,2342,1215,1127,107.8,2312,1201,1111,108.1
37100, 경산시,005004, 3세,2018,2344,1185,1159,102.2,2317,1173,1144,102.5
37100, 경산시,005005, 4세,2018,2366,1187,1179,100.7,2337,1175,1162,101.1
37100, 경산시,010,5~9세,2018,11448,5887,5561,105.9,11375,5848,5527,105.8
37100, 경산시,010001, 5세,2018,2348,1194,1154,103.5,2326,1182,1144,103.3
37100, 경산시,010002, 6세,2018,2450,1247,1203,103.7,2428,1235,1193,103.5
37100, 경산시,010003, 7세,2018,2369,1264,1105,114.4,2357,1257,1100,114.3
37100, 경산시,010004, 8세,2018,2143,1076,1067,100.8,2135,1073,1062,101
37100, 경산시,010005, 9세,2018,2138,1106,1032,107.2,2129,1101,1028,107.1
37100, 경산시,015,10~14세,2018,10477,5467,5010,109.1,10447,5450,4997,109.1
37100, 경산시,015001, 10세,2018,2146,1125,1021,110.2,2139,1122,1017,110.3
37100, 경산시,015002, 11세,2018,2245,1165,1080,107.9,2238,1161,1077,107.8
37100, 경산시,015003, 12세,2018,2003,1056,947,111.5,1998,1053,945,111.4
37100, 경산시,015004, 13세,2018,1889,953,936,101.8,1881,948,933,101.6
37100, 경산시,015005, 14세,2018,2194,1168,1026,113.8,2191,1166,1025,113.8
37100, 경산시,020,15~19세,2018,20284,10048,10236,98.2,19218,9558,9660,98.9
37100, 경산시,020001, 15세,2018,2209,1179,1030,114.5,2204,1177,1027,114.6
37100, 경산시,020002, 16세,2018,2477,1306,1171,111.5,2466,1302,1164,111.9
37100, 경산시,020003, 17세,2018,2880,1498,1382,108.4,2814,1472,1342,109.7
37100, 경산시,020004, 18세,2018,4753,2386,2367,100.8,4478,2261,2217,102
37100, 경산시,020005, 19세,2018,7965,3679,4286,85.8,7256,3346,3910,85.6
37100, 경산시,025,20~24세,2018,29352,15025,14327,104.9,25853,13059,12794,102.1
37100, 경산시,025001, 20세,2018,6607,2700,3907,69.1,5739,2287,3452,66.3
37100, 경산시,025002, 21세,2018,5961,2649,3312,80,5245,2282,2963,77
37100, 경산시,025003, 22세,2018,6137,3287,2850,115.3,5493,2884,2609,110.5
37100, 경산시,025004, 23세,2018,5612,3293,2319,142,4965,2910,2055,141.6
37100, 경산시,025005, 24세,2018,5035,3096,1939,159.7,4411,2696,1715,157.2
37100, 경산시,030,25~29세,2018,20054,11749,8305,141.5,17413,10103,7310,138.2
37100, 경산시,030001, 25세,2018,4564,2824,1740,162.3,3955,2438,1517,160.7
37100, 경산시,030002, 26세,2018,4300,2488,1812,137.3,3702,2118,1584,133.7
37100, 경산시,030003, 27세,2018,3925,2266,1659,136.6,3448,1971,1477,133.4
37100, 경산시,030004, 28세,2018,3746,2160,1586,136.2,3251,1850,1401,132
37100, 경산시,030005, 29세,2018,3519,2011,1508,133.4,3057,1726,1331,129.7
37100, 경산시,035,30~34세,2018,17348,9628,7720,124.7,15493,8427,7066,119.3
37100, 경산시,035001, 30세,2018,3396,1978,1418,139.5,2985,1716,1269,135.2
37100, 경산시,035002, 31세,2018,3485,1888,1597,118.2,3062,1634,1428,114.4
37100, 경산시,035003, 32세,2018,3362,1860,1502,123.8,3022,1622,1400,115.9
37100, 경산시,035004, 33세,2018,3535,1950,1585,123,3194,1721,1473,116.8
37100, 경산시,035005, 34세,2018,3570,1952,1618,120.6,3230,1734,1496,115.9
37100, 경산시,040,35~39세,2018,21066,11065,10001,110.6,19748,10176,9572,106.3
37100, 경산시,040001, 35세,2018,3961,2040,1921,106.2,3663,1833,1830,100.2
37100, 경산시,040002, 36세,2018,4310,2278,2032,112.1,4007,2066,1941,106.4
37100, 경산시,040003, 37세,2018,4344,2337,2007,116.4,4089,2163,1926,112.3
37100, 경산시,040004, 38세,2018,4356,2298,2058,111.7,4135,2158,1977,109.2
37100, 경산시,040005, 39세,2018,4095,2112,1983,106.5,3854,1956,1898,103.1
37100, 경산시,045,40~44세,2018,19819,10428,9391,111,19044,9905,9139,108.4
37100, 경산시,045001, 40세,2018,3697,1973,1724,114.4,3544,1867,1677,111.3
37100, 경산시,045002, 41세,2018,3725,1957,1768,110.7,3555,1842,1713,107.5
37100, 경산시,045003, 42세,2018,3908,2063,1845,111.8,3745,1953,1792,109
37100, 경산시,045004, 43세,2018,4055,2138,1917,111.5,3902,2029,1873,108.3
37100, 경산시,045005, 44세,2018,4434,2297,2137,107.5,4298,2214,2084,106.2
37100, 경산시,050,45~49세,2018,22750,11515,11235,102.5,22130,11121,11009,101
37100, 경산시,050001, 45세,2018,4499,2286,2213,103.3,4347,2183,2164,100.9
37100, 경산시,050002, 46세,2018,4486,2287,2199,104,4349,2205,2144,102.8
37100, 경산시,050003, 47세,2018,4827,2461,2366,104,4713,2384,2329,102.4
37100, 경산시,050004, 48세,2018,4463,2263,2200,102.9,4344,2185,2159,101.2
37100, 경산시,050005, 49세,2018,4475,2218,2257,98.3,4377,2164,2213,97.8
37100, 경산시,055,50~54세,2018,21764,10965,10799,101.5,21361,10743,10618,101.2
37100, 경산시,055001, 50세,2018,4802,2368,2434,97.3,4708,2315,2393,96.7
37100, 경산시,055002, 51세,2018,4291,2166,2125,101.9,4203,2114,2089,101.2
37100, 경산시,055003, 52세,2018,4300,2264,2036,111.2,4227,2221,2006,110.7
37100, 경산시,055004, 53세,2018,4326,2127,2199,96.7,4245,2088,2157,96.8
37100, 경산시,055005, 54세,2018,4045,2040,2005,101.7,3978,2005,1973,101.6
37100, 경산시,060,55~59세,2018,22137,11051,11086,99.7,21872,10912,10960,99.6
37100, 경산시,060001, 55세,2018,4181,2090,2091,100,4108,2050,2058,99.6
37100, 경산시,060002, 56세,2018,4480,2278,2202,103.5,4422,2245,2177,103.1
37100, 경산시,060003, 57세,2018,4687,2328,2359,98.7,4641,2310,2331,99.1
37100, 경산시,060004, 58세,2018,4501,2224,2277,97.7,4454,2197,2257,97.3
37100, 경산시,060005, 59세,2018,4288,2131,2157,98.8,4247,2110,2137,98.7
37100, 경산시,065,60~64세,2018,17254,8478,8776,96.6,17099,8399,8700,96.5
37100, 경산시,065001, 60세,2018,3633,1827,1806,101.2,3594,1805,1789,100.9
37100, 경산시,065002, 61세,2018,3784,1876,1908,98.3,3755,1860,1895,98.2
37100, 경산시,065003, 62세,2018,3437,1691,1746,96.8,3404,1677,1727,97.1
37100, 경산시,065004, 63세,2018,3442,1657,1785,92.8,3411,1642,1769,92.8
37100, 경산시,065005, 64세,2018,2958,1427,1531,93.2,2935,1415,1520,93.1
37100, 경산시,070,65~69세,2018,13009,6134,6875,89.2,12930,6094,6836,89.1
37100, 경산시,070001, 65세,2018,2802,1341,1461,91.8,2776,1327,1449,91.6
37100, 경산시,070002, 66세,2018,2955,1379,1576,87.5,2939,1369,1570,87.2
37100, 경산시,070003, 67세,2018,2379,1124,1255,89.6,2365,1119,1246,89.8
37100, 경산시,070004, 68세,2018,2313,1089,1224,89,2304,1084,1220,88.9
37100, 경산시,070005, 69세,2018,2560,1201,1359,88.4,2546,1195,1351,88.5
37100, 경산시,075,70~74세,2018,9300,4178,5122,81.6,9270,4170,5100,81.8
37100, 경산시,075001, 70세,2018,2416,1093,1323,82.6,2411,1092,1319,82.8
37100, 경산시,075002, 71세,2018,2226,986,1240,79.5,2218,984,1234,79.7
37100, 경산시,075003, 72세,2018,1377,666,711,93.7,1369,665,704,94.5
37100, 경산시,075004, 73세,2018,1506,676,830,81.4,1502,674,828,81.4
37100, 경산시,075005, 74세,2018,1775,757,1018,74.4,1770,755,1015,74.4
37100, 경산시,080,75~79세,2018,8665,3515,5150,68.3,8641,3508,5133,68.3
37100, 경산시,080001, 75세,2018,1879,805,1074,75,1873,803,1070,75
37100, 경산시,080002, 76세,2018,2060,874,1186,73.7,2053,873,1180,74
37100, 경산시,080003, 77세,2018,1614,642,972,66,1610,640,970,66
37100, 경산시,080004, 78세,2018,1568,595,973,61.2,1564,594,970,61.2
37100, 경산시,080005, 79세,2018,1544,599,945,63.4,1541,598,943,63.4
37100, 경산시,085,80~84세,2018,5509,1930,3579,53.9,5503,1929,3574,54
37100, 경산시,085001, 80세,2018,1319,491,828,59.3,1318,491,827,59.4
37100, 경산시,085002, 81세,2018,1167,404,763,52.9,1167,404,763,52.9
37100, 경산시,085003, 82세,2018,1124,411,713,57.6,1122,411,711,57.8
37100, 경산시,085004, 83세,2018,1014,349,665,52.5,1012,349,663,52.6
37100, 경산시,085005, 84세,2018,885,275,610,45.1,884,274,610,44.9
37100, 경산시,090,85~89세,2018,2456,702,1754,40,2454,702,1752,40.1
37100, 경산시,090001, 85세,2018,716,234,482,48.5,716,234,482,48.5
37100, 경산시,090002, 86세,2018,613,168,445,37.8,613,168,445,37.8
37100, 경산시,090003, 87세,2018,460,145,315,46,460,145,315,46
37100, 경산시,090004, 88세,2018,377,87,290,30,376,87,289,30.1
37100, 경산시,090005, 89세,2018,290,68,222,30.6,289,68,221,30.8
37100, 경산시,095,90~94세,2018,759,166,593,28,759,166,593,28
37100, 경산시,095001, 90세,2018,243,63,180,35,243,63,180,35
37100, 경산시,095002, 91세,2018,212,50,162,30.9,212,50,162,30.9
37100, 경산시,095003, 92세,2018,123,26,97,26.8,123,26,97,26.8
37100, 경산시,095004, 93세,2018,106,16,90,17.8,106,16,90,17.8
37100, 경산시,095005, 94세,2018,75,11,64,17.2,75,11,64,17.2
37100, 경산시,100,95~99세,2018,169,29,140,20.7,169,29,140,20.7
37100, 경산시,100001, 95세,2018,61,11,50,22,61,11,50,22
37100, 경산시,100002, 96세,2018,51,8,43,18.6,51,8,43,18.6
37100, 경산시,100003, 97세,2018,33,6,27,22.2,33,6,27,22.2
37100, 경산시,100004, 98세,2018,13,X,11,18.2,13,X,11,18.2
37100, 경산시,100005, 99세,2018,11,X,9,22.2,11,X,9,22.2
37100, 경산시,101,100세이상,2018,21,5,16,31.3,21,5,16,31.3
37100, 경산시,102,15세미만,2018,32801,16878,15923,106,32547,16748,15799,106
37100, 경산시,103,15~64세,2018,211828,109952,101876,107.9,199231,102403,96828,105.8
37100, 경산시,104,65세이상,2018,39888,16659,23229,71.7,39747,16603,23144,71.7
37100, 경산시,086,85세이상,2018,3405,902,2503,36,3403,902,2501,36.1
37100, 경산시,126,평균연령,2018,40.6,39.4,41.9,,41.1,39.9,42.4,
37100, 경산시,127,중위연령,2018,40.4,38.8,42.3,,41.5,39.9,43.3,
37310, 군위군,000,합계,2018,22277,11417,10860,105.1,21569,10886,10683,101.9
37310, 군위군,005,0~4세,2018,386,209,177,118.1,386,209,177,118.1
37310, 군위군,005001, 0세,2018,81,45,36,125,81,45,36,125
37310, 군위군,005002, 1세,2018,77,44,33,133.3,77,44,33,133.3
37310, 군위군,005003, 2세,2018,74,41,33,124.2,74,41,33,124.2
37310, 군위군,005004, 3세,2018,72,39,33,118.2,72,39,33,118.2
37310, 군위군,005005, 4세,2018,82,40,42,95.2,82,40,42,95.2
37310, 군위군,010,5~9세,2018,398,224,174,128.7,396,222,174,127.6
37310, 군위군,010001, 5세,2018,70,46,24,191.7,70,46,24,191.7
37310, 군위군,010002, 6세,2018,90,47,43,109.3,89,46,43,107
37310, 군위군,010003, 7세,2018,76,42,34,123.5,76,42,34,123.5
37310, 군위군,010004, 8세,2018,79,41,38,107.9,78,40,38,105.3
37310, 군위군,010005, 9세,2018,83,48,35,137.1,83,48,35,137.1
37310, 군위군,015,10~14세,2018,438,240,198,121.2,436,239,197,121.3
37310, 군위군,015001, 10세,2018,95,55,40,137.5,95,55,40,137.5
37310, 군위군,015002, 11세,2018,89,46,43,107,88,46,42,109.5
37310, 군위군,015003, 12세,2018,88,47,41,114.6,88,47,41,114.6
37310, 군위군,015004, 13세,2018,91,50,41,122,91,50,41,122
37310, 군위군,015005, 14세,2018,75,42,33,127.3,74,41,33,124.2
37310, 군위군,020,15~19세,2018,572,313,259,120.8,569,310,259,119.7
37310, 군위군,020001, 15세,2018,94,53,41,129.3,94,53,41,129.3
37310, 군위군,020002, 16세,2018,136,75,61,123,136,75,61,123
37310, 군위군,020003, 17세,2018,123,54,69,78.3,123,54,69,78.3
37310, 군위군,020004, 18세,2018,131,72,59,122,130,71,59,120.3
37310, 군위군,020005, 19세,2018,88,59,29,203.4,86,57,29,196.6
37310, 군위군,025,20~24세,2018,802,497,305,163,719,436,283,154.1
37310, 군위군,025001, 20세,2018,141,97,44,220.5,135,94,41,229.3
37310, 군위군,025002, 21세,2018,159,98,61,160.7,143,87,56,155.4
37310, 군위군,025003, 22세,2018,146,84,62,135.5,128,67,61,109.8
37310, 군위군,025004, 23세,2018,178,104,74,140.5,155,90,65,138.5
37310, 군위군,025005, 24세,2018,178,114,64,178.1,158,98,60,163.3
37310, 군위군,030,25~29세,2018,878,564,314,179.6,685,409,276,148.2
37310, 군위군,030001, 25세,2018,148,94,54,174.1,119,70,49,142.9
37310, 군위군,030002, 26세,2018,190,130,60,216.7,151,97,54,179.6
37310, 군위군,030003, 27세,2018,174,108,66,163.6,129,74,55,134.5
37310, 군위군,030004, 28세,2018,180,115,65,176.9,144,84,60,140
37310, 군위군,030005, 29세,2018,186,117,69,169.6,142,84,58,144.8
37310, 군위군,035,30~34세,2018,833,526,307,171.3,659,383,276,138.8
37310, 군위군,035001, 30세,2018,164,105,59,178,129,77,52,148.1
37310, 군위군,035002, 31세,2018,192,125,67,186.6,141,87,54,161.1
37310, 군위군,035003, 32세,2018,165,98,67,146.3,137,74,63,117.5
37310, 군위군,035004, 33세,2018,164,107,57,187.7,132,80,52,153.8
37310, 군위군,035005, 34세,2018,148,91,57,159.6,120,65,55,118.2
37310, 군위군,040,35~39세,2018,893,516,377,136.9,786,438,348,125.9
37310, 군위군,040001, 35세,2018,182,99,83,119.3,153,81,72,112.5
37310, 군위군,040002, 36세,2018,161,93,68,136.8,143,75,68,110.3
37310, 군위군,040003, 37세,2018,184,112,72,155.6,162,96,66,145.5
37310, 군위군,040004, 38세,2018,185,102,83,122.9,160,86,74,116.2
37310, 군위군,040005, 39세,2018,181,110,71,154.9,168,100,68,147.1
37310, 군위군,045,40~44세,2018,917,549,368,149.2,866,515,351,146.7
37310, 군위군,045001, 40세,2018,170,103,67,153.7,160,98,62,158.1
37310, 군위군,045002, 41세,2018,163,101,62,162.9,152,94,58,162.1
37310, 군위군,045003, 42세,2018,194,109,85,128.2,185,102,83,122.9
37310, 군위군,045004, 43세,2018,189,111,78,142.3,183,106,77,137.7
37310, 군위군,045005, 44세,2018,201,125,76,164.5,186,115,71,162
37310, 군위군,050,45~49세,2018,1253,723,530,136.4,1211,697,514,135.6
37310, 군위군,050001, 45세,2018,217,135,82,164.6,211,132,79,167.1
37310, 군위군,050002, 46세,2018,228,126,102,123.5,219,119,100,119
37310, 군위군,050003, 47세,2018,255,146,109,133.9,242,137,105,130.5
37310, 군위군,050004, 48세,2018,256,144,112,128.6,247,138,109,126.6
37310, 군위군,050005, 49세,2018,297,172,125,137.6,292,171,121,141.3
37310, 군위군,055,50~54세,2018,1758,991,767,129.2,1736,975,761,128.1
37310, 군위군,055001, 50세,2018,301,166,135,123,295,161,134,120.1
37310, 군위군,055002, 51세,2018,321,183,138,132.6,316,180,136,132.4
37310, 군위군,055003, 52세,2018,347,197,150,131.3,342,194,148,131.1
37310, 군위군,055004, 53세,2018,405,226,179,126.3,403,224,179,125.1
37310, 군위군,055005, 54세,2018,384,219,165,132.7,380,216,164,131.7
37310, 군위군,060,55~59세,2018,2368,1233,1135,108.6,2352,1227,1125,109.1
37310, 군위군,060001, 55세,2018,396,201,195,103.1,396,201,195,103.1
37310, 군위군,060002, 56세,2018,466,259,207,125.1,459,257,202,127.2
37310, 군위군,060003, 57세,2018,479,250,229,109.2,473,248,225,110.2
37310, 군위군,060004, 58세,2018,508,264,244,108.2,507,263,244,107.8
37310, 군위군,060005, 59세,2018,519,259,260,99.6,517,258,259,99.6
37310, 군위군,065,60~64세,2018,2395,1263,1132,111.6,2390,1261,1129,111.7
37310, 군위군,065001, 60세,2018,440,235,205,114.6,438,235,203,115.8
37310, 군위군,065002, 61세,2018,499,267,232,115.1,498,266,232,114.7
37310, 군위군,065003, 62세,2018,528,279,249,112,528,279,249,112
37310, 군위군,065004, 63세,2018,496,260,236,110.2,494,259,235,110.2
37310, 군위군,065005, 64세,2018,432,222,210,105.7,432,222,210,105.7
37310, 군위군,070,65~69세,2018,2152,1076,1076,100,2148,1075,1073,100.2
37310, 군위군,070001, 65세,2018,426,226,200,113,425,226,199,113.6
37310, 군위군,070002, 66세,2018,518,250,268,93.3,518,250,268,93.3
37310, 군위군,070003, 67세,2018,391,189,202,93.6,389,189,200,94.5
37310, 군위군,070004, 68세,2018,391,178,213,83.6,391,178,213,83.6
37310, 군위군,070005, 69세,2018,426,233,193,120.7,425,232,193,120.2
37310, 군위군,075,70~74세,2018,1789,845,944,89.5,1788,845,943,89.6
37310, 군위군,075001, 70세,2018,418,205,213,96.2,418,205,213,96.2
37310, 군위군,075002, 71세,2018,444,224,220,101.8,444,224,220,101.8
37310, 군위군,075003, 72세,2018,262,130,132,98.5,262,130,132,98.5
37310, 군위군,075004, 73세,2018,328,142,186,76.3,327,142,185,76.8
37310, 군위군,075005, 74세,2018,337,144,193,74.6,337,144,193,74.6
37310, 군위군,080,75~79세,2018,2064,846,1218,69.5,2061,843,1218,69.2
37310, 군위군,080001, 75세,2018,415,174,241,72.2,413,172,241,71.4
37310, 군위군,080002, 76세,2018,498,213,285,74.7,498,213,285,74.7
37310, 군위군,080003, 77세,2018,389,161,228,70.6,389,161,228,70.6
37310, 군위군,080004, 78세,2018,386,153,233,65.7,386,153,233,65.7
37310, 군위군,080005, 79세,2018,376,145,231,62.8,375,144,231,62.3
37310, 군위군,085,80~84세,2018,1538,554,984,56.3,1538,554,984,56.3
37310, 군위군,085001, 80세,2018,368,135,233,57.9,368,135,233,57.9
37310, 군위군,085002, 81세,2018,305,119,186,64,305,119,186,64
37310, 군위군,085003, 82세,2018,298,109,189,57.7,298,109,189,57.7
37310, 군위군,085004, 83세,2018,321,107,214,50,321,107,214,50
37310, 군위군,085005, 84세,2018,246,84,162,51.9,246,84,162,51.9
37310, 군위군,090,85~89세,2018,647,210,437,48.1,647,210,437,48.1
37310, 군위군,090001, 85세,2018,179,65,114,57,179,65,114,57
37310, 군위군,090002, 86세,2018,163,59,104,56.7,163,59,104,56.7
37310, 군위군,090003, 87세,2018,117,33,84,39.3,117,33,84,39.3
37310, 군위군,090004, 88세,2018,108,36,72,50,108,36,72,50
37310, 군위군,090005, 89세,2018,80,17,63,27,80,17,63,27
37310, 군위군,095,90~94세,2018,165,37,128,28.9,165,37,128,28.9
37310, 군위군,095001, 90세,2018,61,12,49,24.5,61,12,49,24.5
37310, 군위군,095002, 91세,2018,47,11,36,30.6,47,11,36,30.6
37310, 군위군,095003, 92세,2018,24,5,19,26.3,24,5,19,26.3
37310, 군위군,095004, 93세,2018,20,7,13,53.8,20,7,13,53.8
37310, 군위군,095005, 94세,2018,13,X,11,18.2,13,X,11,18.2
37310, 군위군,100,95~99세,2018,29,X,28,3.6,29,X,28,3.6
37310, 군위군,100001, 95세,2018,6,X,6,0,6,X,6,0
37310, 군위군,100002, 96세,2018,11,X,11,0,11,X,11,0
37310, 군위군,100003, 97세,2018,X,X,X,33.3,X,X,X,33.3
37310, 군위군,100004, 98세,2018,X,X,X,0,X,X,X,0
37310, 군위군,100005, 99세,2018,5,X,5,0,5,X,5,0
37310, 군위군,101,100세이상,2018,X,X,X,0,X,X,X,0
37310, 군위군,102,15세미만,2018,1222,673,549,122.6,1218,670,548,122.3
37310, 군위군,103,15~64세,2018,12669,7175,5494,130.6,11973,6651,5322,125
37310, 군위군,104,65세이상,2018,8386,3569,4817,74.1,8378,3565,4813,74.1
37310, 군위군,086,85세이상,2018,843,248,595,41.7,843,248,595,41.7
37310, 군위군,126,평균연령,2018,55.4,52.6,58.5,,56.1,53.5,58.8,
37310, 군위군,127,중위연령,2018,59.3,56.6,62.3,,60,57.6,62.7,
37320, 의성군,000,합계,2018,49621,24008,25613,93.7,48797,23551,25246,93.3
37320, 의성군,005,0~4세,2018,1027,532,495,107.5,1026,532,494,107.7
37320, 의성군,005001, 0세,2018,235,116,119,97.5,235,116,119,97.5
37320, 의성군,005002, 1세,2018,201,113,88,128.4,201,113,88,128.4
37320, 의성군,005003, 2세,2018,214,107,107,100,214,107,107,100
37320, 의성군,005004, 3세,2018,180,91,89,102.2,179,91,88,103.4
37320, 의성군,005005, 4세,2018,197,105,92,114.1,197,105,92,114.1
37320, 의성군,010,5~9세,2018,930,472,458,103.1,927,472,455,103.7
37320, 의성군,010001, 5세,2018,178,92,86,107,178,92,86,107
37320, 의성군,010002, 6세,2018,195,98,97,101,195,98,97,101
37320, 의성군,010003, 7세,2018,180,84,96,87.5,179,84,95,88.4
37320, 의성군,010004, 8세,2018,180,97,83,116.9,179,97,82,118.3
37320, 의성군,010005, 9세,2018,197,101,96,105.2,196,101,95,106.3
37320, 의성군,015,10~14세,2018,1109,586,523,112,1106,583,523,111.5
37320, 의성군,015001, 10세,2018,237,131,106,123.6,236,130,106,122.6
37320, 의성군,015002, 11세,2018,208,99,109,90.8,208,99,109,90.8
37320, 의성군,015003, 12세,2018,217,118,99,119.2,216,117,99,118.2
37320, 의성군,015004, 13세,2018,204,109,95,114.7,204,109,95,114.7
37320, 의성군,015005, 14세,2018,243,129,114,113.2,242,128,114,112.3
37320, 의성군,020,15~19세,2018,1125,590,535,110.3,1115,585,530,110.4
37320, 의성군,020001, 15세,2018,207,106,101,105,207,106,101,105
37320, 의성군,020002, 16세,2018,231,119,112,106.3,231,119,112,106.3
37320, 의성군,020003, 17세,2018,273,145,128,113.3,271,143,128,111.7
37320, 의성군,020004, 18세,2018,240,115,125,92,240,115,125,92
37320, 의성군,020005, 19세,2018,174,105,69,152.2,166,102,64,159.4
37320, 의성군,025,20~24세,2018,1493,908,585,155.2,1393,858,535,160.4
37320, 의성군,025001, 20세,2018,247,179,68,263.2,242,177,65,272.3
37320, 의성군,025002, 21세,2018,293,172,121,142.1,280,169,111,152.3
37320, 의성군,025003, 22세,2018,286,172,114,150.9,268,157,111,141.4
37320, 의성군,025004, 23세,2018,343,196,147,133.3,316,181,135,134.1
37320, 의성군,025005, 24세,2018,324,189,135,140,287,174,113,154
37320, 의성군,030,25~29세,2018,1756,1022,734,139.2,1569,910,659,138.1
37320, 의성군,030001, 25세,2018,360,195,165,118.2,325,175,150,116.7
37320, 의성군,030002, 26세,2018,367,219,148,148,333,198,135,146.7
37320, 의성군,030003, 27세,2018,353,198,155,127.7,312,172,140,122.9
37320, 의성군,030004, 28세,2018,329,202,127,159.1,293,179,114,157
37320, 의성군,030005, 29세,2018,347,208,139,149.6,306,186,120,155
37320, 의성군,035,30~34세,2018,1588,909,679,133.9,1436,821,615,133.5
37320, 의성군,035001, 30세,2018,313,188,125,150.4,281,171,110,155.5
37320, 의성군,035002, 31세,2018,312,180,132,136.4,287,164,123,133.3
37320, 의성군,035003, 32세,2018,297,153,144,106.3,268,136,132,103
37320, 의성군,035004, 33세,2018,349,212,137,154.7,317,196,121,162
37320, 의성군,035005, 34세,2018,317,176,141,124.8,283,154,129,119.4
37320, 의성군,040,35~39세,2018,1774,974,800,121.8,1681,918,763,120.3
37320, 의성군,040001, 35세,2018,340,190,150,126.7,316,175,141,124.1
37320, 의성군,040002, 36세,2018,365,183,182,100.5,345,170,175,97.1
37320, 의성군,040003, 37세,2018,348,196,152,128.9,333,187,146,128.1
37320, 의성군,040004, 38세,2018,337,186,151,123.2,318,173,145,119.3
37320, 의성군,040005, 39세,2018,384,219,165,132.7,369,213,156,136.5
37320, 의성군,045,40~44세,2018,1927,1138,789,144.2,1861,1098,763,143.9
37320, 의성군,045001, 40세,2018,355,207,148,139.9,336,195,141,138.3
37320, 의성군,045002, 41세,2018,359,200,159,125.8,348,195,153,127.5
37320, 의성군,045003, 42세,2018,363,231,132,175,353,226,127,178
37320, 의성군,045004, 43세,2018,411,239,172,139,401,231,170,135.9
37320, 의성군,045005, 44세,2018,439,261,178,146.6,423,251,172,145.9
37320, 의성군,050,45~49세,2018,2697,1505,1192,126.3,2632,1474,1158,127.3
37320, 의성군,050001, 45세,2018,490,270,220,122.7,477,266,211,126.1
37320, 의성군,050002, 46세,2018,518,303,215,140.9,504,297,207,143.5
37320, 의성군,050003, 47세,2018,532,296,236,125.4,515,288,227,126.9
37320, 의성군,050004, 48세,2018,534,292,242,120.7,521,286,235,121.7
37320, 의성군,050005, 49세,2018,623,344,279,123.3,615,337,278,121.2
37320, 의성군,055,50~54세,2018,3599,1938,1661,116.7,3550,1918,1632,117.5
37320, 의성군,055001, 50세,2018,658,371,287,129.3,643,363,280,129.6
37320, 의성군,055002, 51세,2018,678,385,293,131.4,669,383,286,133.9
37320, 의성군,055003, 52세,2018,715,412,303,136,707,408,299,136.5
37320, 의성군,055004, 53세,2018,808,412,396,104,797,409,388,105.4
37320, 의성군,055005, 54세,2018,740,358,382,93.7,734,355,379,93.7
37320, 의성군,060,55~59세,2018,5208,2623,2585,101.5,5171,2607,2564,101.7
37320, 의성군,060001, 55세,2018,814,413,401,103,806,409,397,103
37320, 의성군,060002, 56세,2018,1060,541,519,104.2,1049,536,513,104.5
37320, 의성군,060003, 57세,2018,1083,541,542,99.8,1081,541,540,100.2
37320, 의성군,060004, 58세,2018,1184,576,608,94.7,1174,571,603,94.7
37320, 의성군,060005, 59세,2018,1067,552,515,107.2,1061,550,511,107.6
37320, 의성군,065,60~64세,2018,5582,2789,2793,99.9,5549,2767,2782,99.5
37320, 의성군,065001, 60세,2018,1127,564,563,100.2,1114,554,560,98.9
37320, 의성군,065002, 61세,2018,1143,599,544,110.1,1133,594,539,110.2
37320, 의성군,065003, 62세,2018,1131,584,547,106.8,1126,580,546,106.2
37320, 의성군,065004, 63세,2018,1109,520,589,88.3,1109,520,589,88.3
37320, 의성군,065005, 64세,2018,1072,522,550,94.9,1067,519,548,94.7
37320, 의성군,070,65~69세,2018,4923,2362,2561,92.2,4907,2351,2556,92
37320, 의성군,070001, 65세,2018,1052,508,544,93.4,1048,505,543,93
37320, 의성군,070002, 66세,2018,1075,524,551,95.1,1072,522,550,94.9
37320, 의성군,070003, 67세,2018,917,451,466,96.8,913,448,465,96.3
37320, 의성군,070004, 68세,2018,915,424,491,86.4,912,423,489,86.5
37320, 의성군,070005, 69세,2018,964,455,509,89.4,962,453,509,89
37320, 의성군,075,70~74세,2018,3914,1754,2160,81.2,3908,1752,2156,81.3
37320, 의성군,075001, 70세,2018,945,447,498,89.8,943,446,497,89.7
37320, 의성군,075002, 71세,2018,901,406,495,82,901,406,495,82
37320, 의성군,075003, 72세,2018,584,275,309,89,580,274,306,89.5
37320, 의성군,075004, 73세,2018,664,286,378,75.7,664,286,378,75.7
37320, 의성군,075005, 74세,2018,820,340,480,70.8,820,340,480,70.8
37320, 의성군,080,75~79세,2018,4985,2036,2949,69,4984,2036,2948,69.1
37320, 의성군,080001, 75세,2018,1021,423,598,70.7,1021,423,598,70.7
37320, 의성군,080002, 76세,2018,1197,499,698,71.5,1197,499,698,71.5
37320, 의성군,080003, 77세,2018,912,370,542,68.3,912,370,542,68.3
37320, 의성군,080004, 78세,2018,832,343,489,70.1,832,343,489,70.1
37320, 의성군,080005, 79세,2018,1023,401,622,64.5,1022,401,621,64.6
37320, 의성군,085,80~84세,2018,3690,1254,2436,51.5,3690,1254,2436,51.5
37320, 의성군,085001, 80세,2018,835,278,557,49.9,835,278,557,49.9
37320, 의성군,085002, 81세,2018,802,269,533,50.5,802,269,533,50.5
37320, 의성군,085003, 82세,2018,732,269,463,58.1,732,269,463,58.1
37320, 의성군,085004, 83세,2018,720,242,478,50.6,720,242,478,50.6
37320, 의성군,085005, 84세,2018,601,196,405,48.4,601,196,405,48.4
37320, 의성군,090,85~89세,2018,1639,471,1168,40.3,1637,470,1167,40.3
37320, 의성군,090001, 85세,2018,464,136,328,41.5,464,136,328,41.5
37320, 의성군,090002, 86세,2018,423,128,295,43.4,422,128,294,43.5
37320, 의성군,090003, 87세,2018,283,82,201,40.8,283,82,201,40.8
37320, 의성군,090004, 88세,2018,259,80,179,44.7,259,80,179,44.7
37320, 의성군,090005, 89세,2018,210,45,165,27.3,209,44,165,26.7
37320, 의성군,095,90~94세,2018,535,129,406,31.8,535,129,406,31.8
37320, 의성군,095001, 90세,2018,178,35,143,24.5,178,35,143,24.5
37320, 의성군,095002, 91세,2018,142,46,96,47.9,142,46,96,47.9
37320, 의성군,095003, 92세,2018,96,23,73,31.5,96,23,73,31.5
37320, 의성군,095004, 93세,2018,76,16,60,26.7,76,16,60,26.7
37320, 의성군,095005, 94세,2018,43,9,34,26.5,43,9,34,26.5
37320, 의성군,100,95~99세,2018,111,15,96,15.6,111,15,96,15.6
37320, 의성군,100001, 95세,2018,36,8,28,28.6,36,8,28,28.6
37320, 의성군,100002, 96세,2018,34,5,29,17.2,34,5,29,17.2
37320, 의성군,100003, 97세,2018,13,X,11,18.2,13,X,11,18.2
37320, 의성군,100004, 98세,2018,18,X,18,0,18,X,18,0
37320, 의성군,100005, 99세,2018,10,X,10,0,10,X,10,0
37320, 의성군,101,100세이상,2018,9,X,8,12.5,9,X,8,12.5
37320, 의성군,102,15세미만,2018,3066,1590,1476,107.7,3059,1587,1472,107.8
37320, 의성군,103,15~64세,2018,26749,14396,12353,116.5,25957,13956,12001,116.3
37320, 의성군,104,65세이상,2018,19806,8022,11784,68.1,19781,8008,11773,68
37320, 의성군,086,85세이상,2018,2294,616,1678,36.7,2292,615,1677,36.7
37320, 의성군,126,평균연령,2018,56.4,53.5,59.1,,56.8,53.9,59.5,
37320, 의성군,127,중위연령,2018,60.5,57.9,63.2,,60.8,58.2,63.5,
37330, 청송군,000,합계,2018,24160,11985,12175,98.4,23852,11888,11964,99.4
37330, 청송군,005,0~4세,2018,541,274,267,102.6,541,274,267,102.6
37330, 청송군,005001, 0세,2018,87,44,43,102.3,87,44,43,102.3
37330, 청송군,005002, 1세,2018,116,58,58,100,116,58,58,100
37330, 청송군,005003, 2세,2018,102,55,47,117,102,55,47,117
37330, 청송군,005004, 3세,2018,118,61,57,107,118,61,57,107
37330, 청송군,005005, 4세,2018,118,56,62,90.3,118,56,62,90.3
37330, 청송군,010,5~9세,2018,555,278,277,100.4,555,278,277,100.4
37330, 청송군,010001, 5세,2018,116,51,65,78.5,116,51,65,78.5
37330, 청송군,010002, 6세,2018,123,61,62,98.4,123,61,62,98.4
37330, 청송군,010003, 7세,2018,114,64,50,128,114,64,50,128
37330, 청송군,010004, 8세,2018,96,48,48,100,96,48,48,100
37330, 청송군,010005, 9세,2018,106,54,52,103.8,106,54,52,103.8
37330, 청송군,015,10~14세,2018,584,321,263,122.1,584,321,263,122.1
37330, 청송군,015001, 10세,2018,109,65,44,147.7,109,65,44,147.7
37330, 청송군,015002, 11세,2018,108,50,58,86.2,108,50,58,86.2
37330, 청송군,015003, 12세,2018,108,54,54,100,108,54,54,100
37330, 청송군,015004, 13세,2018,121,70,51,137.3,121,70,51,137.3
37330, 청송군,015005, 14세,2018,138,82,56,146.4,138,82,56,146.4
37330, 청송군,020,15~19세,2018,707,400,307,130.3,702,399,303,131.7
37330, 청송군,020001, 15세,2018,161,90,71,126.8,161,90,71,126.8
37330, 청송군,020002, 16세,2018,145,73,72,101.4,145,73,72,101.4
37330, 청송군,020003, 17세,2018,152,84,68,123.5,152,84,68,123.5
37330, 청송군,020004, 18세,2018,159,99,60,165,157,98,59,166.1
37330, 청송군,020005, 19세,2018,90,54,36,150,87,54,33,163.6
37330, 청송군,025,20~24세,2018,764,453,311,145.7,733,447,286,156.3
37330, 청송군,025001, 20세,2018,148,93,55,169.1,145,93,52,178.8
37330, 청송군,025002, 21세,2018,136,89,47,189.4,132,89,43,207
37330, 청송군,025003, 22세,2018,156,94,62,151.6,151,93,58,160.3
37330, 청송군,025004, 23세,2018,150,85,65,130.8,141,83,58,143.1
37330, 청송군,025005, 24세,2018,174,92,82,112.2,164,89,75,118.7
37330, 청송군,030,25~29세,2018,854,515,339,151.9,795,497,298,166.8
37330, 청송군,030001, 25세,2018,158,101,57,177.2,146,96,50,192
37330, 청송군,030002, 26세,2018,202,124,78,159,189,121,68,177.9
37330, 청송군,030003, 27세,2018,155,86,69,124.6,146,83,63,131.7
37330, 청송군,030004, 28세,2018,163,90,73,123.3,147,85,62,137.1
37330, 청송군,030005, 29세,2018,176,114,62,183.9,167,112,55,203.6
37330, 청송군,035,30~34세,2018,818,490,328,149.4,767,478,289,165.4
37330, 청송군,035001, 30세,2018,163,109,54,201.9,152,104,48,216.7
37330, 청송군,035002, 31세,2018,173,104,69,150.7,166,104,62,167.7
37330, 청송군,035003, 32세,2018,166,101,65,155.4,155,100,55,181.8
37330, 청송군,035004, 33세,2018,167,100,67,149.3,155,97,58,167.2
37330, 청송군,035005, 34세,2018,149,76,73,104.1,139,73,66,110.6
37330, 청송군,040,35~39세,2018,989,527,462,114.1,951,513,438,117.1
37330, 청송군,040001, 35세,2018,200,105,95,110.5,190,102,88,115.9
37330, 청송군,040002, 36세,2018,177,88,89,98.9,168,82,86,95.3
37330, 청송군,040003, 37세,2018,225,125,100,125,217,123,94,130.9
37330, 청송군,040004, 38세,2018,210,119,91,130.8,202,117,85,137.6
37330, 청송군,040005, 39세,2018,177,90,87,103.4,174,89,85,104.7
37330, 청송군,045,40~44세,2018,1067,595,472,126.1,1038,585,453,129.1
37330, 청송군,045001, 40세,2018,185,102,83,122.9,179,100,79,126.6
37330, 청송군,045002, 41세,2018,197,107,90,118.9,193,107,86,124.4
37330, 청송군,045003, 42세,2018,216,121,95,127.4,209,118,91,129.7
37330, 청송군,045004, 43세,2018,210,115,95,121.1,206,113,93,121.5
37330, 청송군,045005, 44세,2018,259,150,109,137.6,251,147,104,141.3
37330, 청송군,050,45~49세,2018,1516,861,655,131.5,1496,855,641,133.4
37330, 청송군,050001, 45세,2018,260,144,116,124.1,258,143,115,124.3
37330, 청송군,050002, 46세,2018,263,151,112,134.8,262,151,111,136
37330, 청송군,050003, 47세,2018,287,168,119,141.2,279,163,116,140.5
37330, 청송군,050004, 48세,2018,339,182,157,115.9,334,182,152,119.7
37330, 청송군,050005, 49세,2018,367,216,151,143,363,216,147,146.9
37330, 청송군,055,50~54세,2018,2004,1055,949,111.2,1975,1044,931,112.1
37330, 청송군,055001, 50세,2018,382,195,187,104.3,378,195,183,106.6
37330, 청송군,055002, 51세,2018,378,197,181,108.8,371,194,177,109.6
37330, 청송군,055003, 52세,2018,404,225,179,125.7,397,222,175,126.9
37330, 청송군,055004, 53세,2018,420,220,200,110,415,218,197,110.7
37330, 청송군,055005, 54세,2018,420,218,202,107.9,414,215,199,108
37330, 청송군,060,55~59세,2018,2623,1319,1304,101.2,2605,1314,1291,101.8
37330, 청송군,060001, 55세,2018,450,230,220,104.5,447,229,218,105
37330, 청송군,060002, 56세,2018,531,271,260,104.2,525,269,256,105.1
37330, 청송군,060003, 57세,2018,541,275,266,103.4,538,275,263,104.6
37330, 청송군,060004, 58세,2018,567,279,288,96.9,563,279,284,98.2
37330, 청송군,060005, 59세,2018,534,264,270,97.8,532,262,270,97
37330, 청송군,065,60~64세,2018,2584,1286,1298,99.1,2571,1277,1294,98.7
37330, 청송군,065001, 60세,2018,531,273,258,105.8,526,270,256,105.5
37330, 청송군,065002, 61세,2018,528,258,270,95.6,528,258,270,95.6
37330, 청송군,065003, 62세,2018,545,265,280,94.6,541,261,280,93.2
37330, 청송군,065004, 63세,2018,507,249,258,96.5,503,247,256,96.5
37330, 청송군,065005, 64세,2018,473,241,232,103.9,473,241,232,103.9
37330, 청송군,070,65~69세,2018,2234,1107,1127,98.2,2231,1106,1125,98.3
37330, 청송군,070001, 65세,2018,467,232,235,98.7,465,232,233,99.6
37330, 청송군,070002, 66세,2018,499,228,271,84.1,498,227,271,83.8
37330, 청송군,070003, 67세,2018,424,220,204,107.8,424,220,204,107.8
37330, 청송군,070004, 68세,2018,412,211,201,105,412,211,201,105
37330, 청송군,070005, 69세,2018,432,216,216,100,432,216,216,100
37330, 청송군,075,70~74세,2018,1886,860,1026,83.8,1878,858,1020,84.1
37330, 청송군,075001, 70세,2018,446,220,226,97.3,445,220,225,97.8
37330, 청송군,075002, 71세,2018,432,202,230,87.8,430,202,228,88.6
37330, 청송군,075003, 72세,2018,272,115,157,73.2,268,113,155,72.9
37330, 청송군,075004, 73세,2018,335,156,179,87.2,334,156,178,87.6
37330, 청송군,075005, 74세,2018,401,167,234,71.4,401,167,234,71.4
37330, 청송군,080,75~79세,2018,2148,852,1296,65.7,2146,851,1295,65.7
37330, 청송군,080001, 75세,2018,425,178,247,72.1,424,178,246,72.4
37330, 청송군,080002, 76세,2018,501,195,306,63.7,500,194,306,63.4
37330, 청송군,080003, 77세,2018,408,159,249,63.9,408,159,249,63.9
37330, 청송군,080004, 78세,2018,383,156,227,68.7,383,156,227,68.7
37330, 청송군,080005, 79세,2018,431,164,267,61.4,431,164,267,61.4
37330, 청송군,085,80~84세,2018,1417,526,891,59,1416,525,891,58.9
37330, 청송군,085001, 80세,2018,325,129,196,65.8,325,129,196,65.8
37330, 청송군,085002, 81세,2018,290,102,188,54.3,289,101,188,53.7
37330, 청송군,085003, 82세,2018,304,119,185,64.3,304,119,185,64.3
37330, 청송군,085004, 83세,2018,274,98,176,55.7,274,98,176,55.7
37330, 청송군,085005, 84세,2018,224,78,146,53.4,224,78,146,53.4
37330, 청송군,090,85~89세,2018,612,206,406,50.7,612,206,406,50.7
37330, 청송군,090001, 85세,2018,163,63,100,63,163,63,100,63
37330, 청송군,090002, 86세,2018,163,62,101,61.4,163,62,101,61.4
37330, 청송군,090003, 87세,2018,125,35,90,38.9,125,35,90,38.9
37330, 청송군,090004, 88세,2018,77,20,57,35.1,77,20,57,35.1
37330, 청송군,090005, 89세,2018,84,26,58,44.8,84,26,58,44.8
37330, 청송군,095,90~94세,2018,215,54,161,33.5,214,54,160,33.8
37330, 청송군,095001, 90세,2018,78,24,54,44.4,78,24,54,44.4
37330, 청송군,095002, 91세,2018,52,15,37,40.5,51,15,36,41.7
37330, 청송군,095003, 92세,2018,44,10,34,29.4,44,10,34,29.4
37330, 청송군,095004, 93세,2018,28,X,25,12,28,X,25,12
37330, 청송군,095005, 94세,2018,13,X,11,18.2,13,X,11,18.2
37330, 청송군,100,95~99세,2018,36,6,30,20,36,6,30,20
37330, 청송군,100001, 95세,2018,10,X,8,25,10,X,8,25
37330, 청송군,100002, 96세,2018,6,X,5,20,6,X,5,20
37330, 청송군,100003, 97세,2018,11,X,10,10,11,X,10,10
37330, 청송군,100004, 98세,2018,X,X,X,100,X,X,X,100
37330, 청송군,100005, 99세,2018,5,X,5,0,5,X,5,0
37330, 청송군,101,100세이상,2018,6,X,6,0,6,X,6,0
37330, 청송군,102,15세미만,2018,1680,873,807,108.2,1680,873,807,108.2
37330, 청송군,103,15~64세,2018,13926,7501,6425,116.7,13633,7409,6224,119
37330, 청송군,104,65세이상,2018,8554,3611,4943,73.1,8539,3606,4933,73.1
37330, 청송군,086,85세이상,2018,869,266,603,44.1,868,266,602,44.2
37330, 청송군,126,평균연령,2018,54.3,51.8,56.7,,54.5,51.9,57.1,
37330, 청송군,127,중위연령,2018,58.3,56,60.6,,58.5,56.1,61,
37340, 영양군,000,합계,2018,16559,7992,8567,93.3,16268,7917,8351,94.8
37340, 영양군,005,0~4세,2018,409,215,194,110.8,409,215,194,110.8
37340, 영양군,005001, 0세,2018,66,42,24,175,66,42,24,175
37340, 영양군,005002, 1세,2018,94,48,46,104.3,94,48,46,104.3
37340, 영양군,005003, 2세,2018,73,46,27,170.4,73,46,27,170.4
37340, 영양군,005004, 3세,2018,88,38,50,76,88,38,50,76
37340, 영양군,005005, 4세,2018,88,41,47,87.2,88,41,47,87.2
37340, 영양군,010,5~9세,2018,403,226,177,127.7,403,226,177,127.7
37340, 영양군,010001, 5세,2018,82,45,37,121.6,82,45,37,121.6
37340, 영양군,010002, 6세,2018,69,43,26,165.4,69,43,26,165.4
37340, 영양군,010003, 7세,2018,78,49,29,169,78,49,29,169
37340, 영양군,010004, 8세,2018,99,45,54,83.3,99,45,54,83.3
37340, 영양군,010005, 9세,2018,75,44,31,141.9,75,44,31,141.9
37340, 영양군,015,10~14세,2018,457,234,223,104.9,457,234,223,104.9
37340, 영양군,015001, 10세,2018,102,53,49,108.2,102,53,49,108.2
37340, 영양군,015002, 11세,2018,106,51,55,92.7,106,51,55,92.7
37340, 영양군,015003, 12세,2018,76,42,34,123.5,76,42,34,123.5
37340, 영양군,015004, 13세,2018,89,43,46,93.5,89,43,46,93.5
37340, 영양군,015005, 14세,2018,84,45,39,115.4,84,45,39,115.4
37340, 영양군,020,15~19세,2018,767,270,497,54.3,761,269,492,54.7
37340, 영양군,020001, 15세,2018,132,51,81,63,131,50,81,61.7
37340, 영양군,020002, 16세,2018,169,57,112,50.9,169,57,112,50.9
37340, 영양군,020003, 17세,2018,171,55,116,47.4,170,55,115,47.8
37340, 영양군,020004, 18세,2018,224,66,158,41.8,224,66,158,41.8
37340, 영양군,020005, 19세,2018,71,41,30,136.7,67,41,26,157.7
37340, 영양군,025,20~24세,2018,526,330,196,168.4,500,326,174,187.4
37340, 영양군,025001, 20세,2018,103,75,28,267.9,102,74,28,264.3
37340, 영양군,025002, 21세,2018,108,77,31,248.4,105,77,28,275
37340, 영양군,025003, 22세,2018,92,51,41,124.4,89,50,39,128.2
37340, 영양군,025004, 23세,2018,107,62,45,137.8,100,62,38,163.2
37340, 영양군,025005, 24세,2018,116,65,51,127.5,104,63,41,153.7
37340, 영양군,030,25~29세,2018,529,269,260,103.5,480,258,222,116.2
37340, 영양군,030001, 25세,2018,97,49,48,102.1,86,47,39,120.5
37340, 영양군,030002, 26세,2018,118,50,68,73.5,109,48,61,78.7
37340, 영양군,030003, 27세,2018,109,59,50,118,98,57,41,139
37340, 영양군,030004, 28세,2018,104,53,51,103.9,91,50,41,122
37340, 영양군,030005, 29세,2018,101,58,43,134.9,96,56,40,140
37340, 영양군,035,30~34세,2018,514,262,252,104,468,252,216,116.7
37340, 영양군,035001, 30세,2018,103,57,46,123.9,94,54,40,135
37340, 영양군,035002, 31세,2018,105,51,54,94.4,97,51,46,110.9
37340, 영양군,035003, 32세,2018,125,62,63,98.4,112,60,52,115.4
37340, 영양군,035004, 33세,2018,79,35,44,79.5,68,32,36,88.9
37340, 영양군,035005, 34세,2018,102,57,45,126.7,97,55,42,131
37340, 영양군,040,35~39세,2018,666,335,331,101.2,628,328,300,109.3
37340, 영양군,040001, 35세,2018,139,63,76,82.9,127,61,66,92.4
37340, 영양군,040002, 36세,2018,126,56,70,80,116,55,61,90.2
37340, 영양군,040003, 37세,2018,130,77,53,145.3,123,76,47,161.7
37340, 영양군,040004, 38세,2018,143,62,81,76.5,139,62,77,80.5
37340, 영양군,040005, 39세,2018,128,77,51,151,123,74,49,151
37340, 영양군,045,40~44세,2018,738,425,313,135.8,713,420,293,143.3
37340, 영양군,045001, 40세,2018,137,81,56,144.6,133,81,52,155.8
37340, 영양군,045002, 41세,2018,138,79,59,133.9,131,78,53,147.2
37340, 영양군,045003, 42세,2018,141,83,58,143.1,136,81,55,147.3
37340, 영양군,045004, 43세,2018,148,80,68,117.6,146,79,67,117.9
37340, 영양군,045005, 44세,2018,174,102,72,141.7,167,101,66,153
37340, 영양군,050,45~49세,2018,1113,658,455,144.6,1087,648,439,147.6
37340, 영양군,050001, 45세,2018,194,118,76,155.3,187,115,72,159.7
37340, 영양군,050002, 46세,2018,208,122,86,141.9,201,119,82,145.1
37340, 영양군,050003, 47세,2018,232,141,91,154.9,226,139,87,159.8
37340, 영양군,050004, 48세,2018,232,127,105,121,228,126,102,123.5
37340, 영양군,050005, 49세,2018,247,150,97,154.6,245,149,96,155.2
37340, 영양군,055,50~54세,2018,1241,680,561,121.2,1211,669,542,123.4
37340, 영양군,055001, 50세,2018,246,139,107,129.9,239,136,103,132
37340, 영양군,055002, 51세,2018,209,118,91,129.7,201,117,84,139.3
37340, 영양군,055003, 52세,2018,284,150,134,111.9,280,150,130,115.4
37340, 영양군,055004, 53세,2018,259,139,120,115.8,256,136,120,113.3
37340, 영양군,055005, 54세,2018,243,134,109,122.9,235,130,105,123.8
37340, 영양군,060,55~59세,2018,1750,883,867,101.8,1724,873,851,102.6
37340, 영양군,060001, 55세,2018,318,153,165,92.7,312,151,161,93.8
37340, 영양군,060002, 56세,2018,326,166,160,103.8,322,165,157,105.1
37340, 영양군,060003, 57세,2018,414,215,199,108,410,213,197,108.1
37340, 영양군,060004, 58세,2018,397,189,208,90.9,393,189,204,92.6
37340, 영양군,060005, 59세,2018,295,160,135,118.5,287,155,132,117.4
37340, 영양군,065,60~64세,2018,1669,819,850,96.4,1658,814,844,96.4
37340, 영양군,065001, 60세,2018,345,173,172,100.6,340,172,168,102.4
37340, 영양군,065002, 61세,2018,322,144,178,80.9,320,143,177,80.8
37340, 영양군,065003, 62세,2018,355,175,180,97.2,355,175,180,97.2
37340, 영양군,065004, 63세,2018,347,183,164,111.6,346,182,164,111
37340, 영양군,065005, 64세,2018,300,144,156,92.3,297,142,155,91.6
37340, 영양군,070,65~69세,2018,1415,700,715,97.9,1410,699,711,98.3
37340, 영양군,070001, 65세,2018,297,160,137,116.8,297,160,137,116.8
37340, 영양군,070002, 66세,2018,305,149,156,95.5,304,149,155,96.1
37340, 영양군,070003, 67세,2018,238,110,128,85.9,238,110,128,85.9
37340, 영양군,070004, 68세,2018,246,112,134,83.6,244,111,133,83.5
37340, 영양군,070005, 69세,2018,329,169,160,105.6,327,169,158,107
37340, 영양군,075,70~74세,2018,1197,538,659,81.6,1197,538,659,81.6
37340, 영양군,075001, 70세,2018,287,138,149,92.6,287,138,149,92.6
37340, 영양군,075002, 71세,2018,236,113,123,91.9,236,113,123,91.9
37340, 영양군,075003, 72세,2018,192,87,105,82.9,192,87,105,82.9
37340, 영양군,075004, 73세,2018,226,96,130,73.8,226,96,130,73.8
37340, 영양군,075005, 74세,2018,256,104,152,68.4,256,104,152,68.4
37340, 영양군,080,75~79세,2018,1529,643,886,72.6,1528,643,885,72.7
37340, 영양군,080001, 75세,2018,310,132,178,74.2,310,132,178,74.2
37340, 영양군,080002, 76세,2018,353,150,203,73.9,353,150,203,73.9
37340, 영양군,080003, 77세,2018,304,126,178,70.8,304,126,178,70.8
37340, 영양군,080004, 78세,2018,284,120,164,73.2,283,120,163,73.6
37340, 영양군,080005, 79세,2018,278,115,163,70.6,278,115,163,70.6
37340, 영양군,085,80~84세,2018,993,327,666,49.1,991,327,664,49.2
37340, 영양군,085001, 80세,2018,238,82,156,52.6,238,82,156,52.6
37340, 영양군,085002, 81세,2018,220,71,149,47.7,220,71,149,47.7
37340, 영양군,085003, 82세,2018,184,63,121,52.1,184,63,121,52.1
37340, 영양군,085004, 83세,2018,201,69,132,52.3,200,69,131,52.7
37340, 영양군,085005, 84세,2018,150,42,108,38.9,149,42,107,39.3
37340, 영양군,090,85~89세,2018,449,127,322,39.4,449,127,322,39.4
37340, 영양군,090001, 85세,2018,116,32,84,38.1,116,32,84,38.1
37340, 영양군,090002, 86세,2018,110,34,76,44.7,110,34,76,44.7
37340, 영양군,090003, 87세,2018,100,20,80,25,100,20,80,25
37340, 영양군,090004, 88세,2018,64,21,43,48.8,64,21,43,48.8
37340, 영양군,090005, 89세,2018,59,20,39,51.3,59,20,39,51.3
37340, 영양군,095,90~94세,2018,156,42,114,36.8,156,42,114,36.8
37340, 영양군,095001, 90세,2018,58,16,42,38.1,58,16,42,38.1
37340, 영양군,095002, 91세,2018,32,7,25,28,32,7,25,28
37340, 영양군,095003, 92세,2018,33,8,25,32,33,8,25,32
37340, 영양군,095004, 93세,2018,17,X,13,30.8,17,X,13,30.8
37340, 영양군,095005, 94세,2018,16,7,9,77.8,16,7,9,77.8
37340, 영양군,100,95~99세,2018,30,8,22,36.4,30,8,22,36.4
37340, 영양군,100001, 95세,2018,15,X,11,36.4,15,X,11,36.4
37340, 영양군,100002, 96세,2018,X,X,X,0,X,X,X,0
37340, 영양군,100003, 97세,2018,8,X,5,60,8,X,5,60
37340, 영양군,100004, 98세,2018,X,X,X,0,X,X,X,0
37340, 영양군,100005, 99세,2018,X,X,X,,X,X,X,
37340, 영양군,101,100세이상,2018,8,X,7,14.3,8,X,7,14.3
37340, 영양군,102,15세미만,2018,1269,675,594,113.6,1269,675,594,113.6
37340, 영양군,103,15~64세,2018,9513,4931,4582,107.6,9230,4857,4373,111.1
37340, 영양군,104,65세이상,2018,5777,2386,3391,70.4,5769,2385,3384,70.5
37340, 영양군,086,85세이상,2018,643,178,465,38.3,643,178,465,38.3
37340, 영양군,126,평균연령,2018,53.5,51.5,55.3,,53.7,51.6,55.7,
37340, 영양군,127,중위연령,2018,57.7,55.6,59.7,,57.9,55.7,60.3,
37350, 영덕군,000,합계,2018,36096,17444,18652,93.5,34791,16469,18322,89.9
37350, 영덕군,005,0~4세,2018,925,455,470,96.8,924,454,470,96.6
37350, 영덕군,005001, 0세,2018,156,74,82,90.2,156,74,82,90.2
37350, 영덕군,005002, 1세,2018,207,95,112,84.8,207,95,112,84.8
37350, 영덕군,005003, 2세,2018,163,81,82,98.8,163,81,82,98.8
37350, 영덕군,005004, 3세,2018,197,106,91,116.5,196,105,91,115.4
37350, 영덕군,005005, 4세,2018,202,99,103,96.1,202,99,103,96.1
37350, 영덕군,010,5~9세,2018,956,494,462,106.9,956,494,462,106.9
37350, 영덕군,010001, 5세,2018,204,108,96,112.5,204,108,96,112.5
37350, 영덕군,010002, 6세,2018,201,104,97,107.2,201,104,97,107.2
37350, 영덕군,010003, 7세,2018,167,86,81,106.2,167,86,81,106.2
37350, 영덕군,010004, 8세,2018,204,102,102,100,204,102,102,100
37350, 영덕군,010005, 9세,2018,180,94,86,109.3,180,94,86,109.3
37350, 영덕군,015,10~14세,2018,1004,509,495,102.8,1001,508,493,103
37350, 영덕군,015001, 10세,2018,160,77,83,92.8,160,77,83,92.8
37350, 영덕군,015002, 11세,2018,221,118,103,114.6,221,118,103,114.6
37350, 영덕군,015003, 12세,2018,202,101,101,100,201,101,100,101
37350, 영덕군,015004, 13세,2018,204,106,98,108.2,202,105,97,108.2
37350, 영덕군,015005, 14세,2018,217,107,110,97.3,217,107,110,97.3
37350, 영덕군,020,15~19세,2018,1006,524,482,108.7,1000,521,479,108.8
37350, 영덕군,020001, 15세,2018,211,111,100,111,211,111,100,111
37350, 영덕군,020002, 16세,2018,213,107,106,100.9,213,107,106,100.9
37350, 영덕군,020003, 17세,2018,233,114,119,95.8,233,114,119,95.8
37350, 영덕군,020004, 18세,2018,233,117,116,100.9,231,117,114,102.6
37350, 영덕군,020005, 19세,2018,116,75,41,182.9,112,72,40,180
37350, 영덕군,025,20~24세,2018,1236,807,429,188.1,1050,668,382,174.9
37350, 영덕군,025001, 20세,2018,184,134,50,268,173,126,47,268.1
37350, 영덕군,025002, 21세,2018,245,176,69,255.1,230,167,63,265.1
37350, 영덕군,025003, 22세,2018,250,155,95,163.2,210,123,87,141.4
37350, 영덕군,025004, 23세,2018,277,169,108,156.5,223,129,94,137.2
37350, 영덕군,025005, 24세,2018,280,173,107,161.7,214,123,91,135.2
37350, 영덕군,030,25~29세,2018,1441,901,540,166.9,1136,652,484,134.7
37350, 영덕군,030001, 25세,2018,291,175,116,150.9,240,129,111,116.2
37350, 영덕군,030002, 26세,2018,314,196,118,166.1,243,141,102,138.2
37350, 영덕군,030003, 27세,2018,285,193,92,209.8,220,136,84,161.9
37350, 영덕군,030004, 28세,2018,297,189,108,175,229,132,97,136.1
37350, 영덕군,030005, 29세,2018,254,148,106,139.6,204,114,90,126.7
37350, 영덕군,035,30~34세,2018,1392,772,620,124.5,1128,575,553,104
37350, 영덕군,035001, 30세,2018,237,134,103,130.1,200,106,94,112.8
37350, 영덕군,035002, 31세,2018,271,149,122,122.1,215,108,107,100.9
37350, 영덕군,035003, 32세,2018,268,154,114,135.1,203,103,100,103
37350, 영덕군,035004, 33세,2018,300,162,138,117.4,246,126,120,105
37350, 영덕군,035005, 34세,2018,316,173,143,121,264,132,132,100
37350, 영덕군,040,35~39세,2018,1714,952,762,124.9,1506,786,720,109.2
37350, 영덕군,040001, 35세,2018,340,185,155,119.4,293,149,144,103.5
37350, 영덕군,040002, 36세,2018,361,198,163,121.5,312,162,150,108
37350, 영덕군,040003, 37세,2018,333,183,150,122,298,153,145,105.5
37350, 영덕군,040004, 38세,2018,339,197,142,138.7,301,163,138,118.1
37350, 영덕군,040005, 39세,2018,341,189,152,124.3,302,159,143,111.2
37350, 영덕군,045,40~44세,2018,1771,1002,769,130.3,1632,893,739,120.8
37350, 영덕군,045001, 40세,2018,327,195,132,147.7,292,164,128,128.1
37350, 영덕군,045002, 41세,2018,355,186,169,110.1,329,166,163,101.8
37350, 영덕군,045003, 42세,2018,358,204,154,132.5,322,180,142,126.8
37350, 영덕군,045004, 43세,2018,315,180,135,133.3,290,158,132,119.7
37350, 영덕군,045005, 44세,2018,416,237,179,132.4,399,225,174,129.3
37350, 영덕군,050,45~49세,2018,2351,1374,977,140.6,2273,1311,962,136.3
37350, 영덕군,050001, 45세,2018,439,266,173,153.8,418,248,170,145.9
37350, 영덕군,050002, 46세,2018,460,274,186,147.3,439,257,182,141.2
37350, 영덕군,050003, 47세,2018,476,261,215,121.4,466,255,211,120.9
37350, 영덕군,050004, 48세,2018,483,287,196,146.4,468,274,194,141.2
37350, 영덕군,050005, 49세,2018,493,286,207,138.2,482,277,205,135.1
37350, 영덕군,055,50~54세,2018,2695,1390,1305,106.5,2641,1370,1271,107.8
37350, 영덕군,055001, 50세,2018,536,289,247,117,525,285,240,118.8
37350, 영덕군,055002, 51세,2018,489,264,225,117.3,483,263,220,119.5
37350, 영덕군,055003, 52세,2018,555,277,278,99.6,541,271,270,100.4
37350, 영덕군,055004, 53세,2018,561,291,270,107.8,550,290,260,111.5
37350, 영덕군,055005, 54세,2018,554,269,285,94.4,542,261,281,92.9
37350, 영덕군,060,55~59세,2018,3488,1730,1758,98.4,3461,1719,1742,98.7
37350, 영덕군,060001, 55세,2018,662,342,320,106.9,654,340,314,108.3
37350, 영덕군,060002, 56세,2018,630,334,296,112.8,626,332,294,112.9
37350, 영덕군,060003, 57세,2018,735,373,362,103,731,372,359,103.6
37350, 영덕군,060004, 58세,2018,773,369,404,91.3,764,364,400,91
37350, 영덕군,060005, 59세,2018,688,312,376,83,686,311,375,82.9
37350, 영덕군,065,60~64세,2018,3500,1664,1836,90.6,3482,1656,1826,90.7
37350, 영덕군,065001, 60세,2018,703,356,347,102.6,696,354,342,103.5
37350, 영덕군,065002, 61세,2018,714,326,388,84,708,324,384,84.4
37350, 영덕군,065003, 62세,2018,705,346,359,96.4,702,344,358,96.1
37350, 영덕군,065004, 63세,2018,697,324,373,86.9,696,323,373,86.6
37350, 영덕군,065005, 64세,2018,681,312,369,84.6,680,311,369,84.3
37350, 영덕군,070,65~69세,2018,3145,1472,1673,88,3137,1467,1670,87.8
37350, 영덕군,070001, 65세,2018,663,311,352,88.4,663,311,352,88.4
37350, 영덕군,070002, 66세,2018,667,306,361,84.8,666,305,361,84.5
37350, 영덕군,070003, 67세,2018,583,286,297,96.3,580,285,295,96.6
37350, 영덕군,070004, 68세,2018,549,242,307,78.8,546,239,307,77.9
37350, 영덕군,070005, 69세,2018,683,327,356,91.9,682,327,355,92.1
37350, 영덕군,075,70~74세,2018,2636,1078,1558,69.2,2634,1076,1558,69.1
37350, 영덕군,075001, 70세,2018,657,280,377,74.3,656,279,377,74
37350, 영덕군,075002, 71세,2018,578,268,310,86.5,578,268,310,86.5
37350, 영덕군,075003, 72세,2018,376,164,212,77.4,376,164,212,77.4
37350, 영덕군,075004, 73세,2018,465,173,292,59.2,465,173,292,59.2
37350, 영덕군,075005, 74세,2018,560,193,367,52.6,559,192,367,52.3
37350, 영덕군,080,75~79세,2018,3369,1264,2105,60,3365,1264,2101,60.2
37350, 영덕군,080001, 75세,2018,752,307,445,69,751,307,444,69.1
37350, 영덕군,080002, 76세,2018,766,300,466,64.4,765,300,465,64.5
37350, 영덕군,080003, 77세,2018,625,221,404,54.7,625,221,404,54.7
37350, 영덕군,080004, 78세,2018,589,214,375,57.1,588,214,374,57.2
37350, 영덕군,080005, 79세,2018,637,222,415,53.5,636,222,414,53.6
37350, 영덕군,085,80~84세,2018,2146,718,1428,50.3,2145,717,1428,50.2
37350, 영덕군,085001, 80세,2018,537,187,350,53.4,536,186,350,53.1
37350, 영덕군,085002, 81세,2018,445,154,291,52.9,445,154,291,52.9
37350, 영덕군,085003, 82세,2018,453,169,284,59.5,453,169,284,59.5
37350, 영덕군,085004, 83세,2018,393,116,277,41.9,393,116,277,41.9
37350, 영덕군,085005, 84세,2018,318,92,226,40.7,318,92,226,40.7
37350, 영덕군,090,85~89세,2018,959,271,688,39.4,958,271,687,39.4
37350, 영덕군,090001, 85세,2018,261,74,187,39.6,260,74,186,39.8
37350, 영덕군,090002, 86세,2018,229,77,152,50.7,229,77,152,50.7
37350, 영덕군,090003, 87세,2018,175,43,132,32.6,175,43,132,32.6
37350, 영덕군,090004, 88세,2018,152,38,114,33.3,152,38,114,33.3
37350, 영덕군,090005, 89세,2018,142,39,103,37.9,142,39,103,37.9
37350, 영덕군,095,90~94세,2018,303,55,248,22.2,303,55,248,22.2
37350, 영덕군,095001, 90세,2018,102,20,82,24.4,102,20,82,24.4
37350, 영덕군,095002, 91세,2018,68,10,58,17.2,68,10,58,17.2
37350, 영덕군,095003, 92세,2018,40,8,32,25,40,8,32,25
37350, 영덕군,095004, 93세,2018,69,13,56,23.2,69,13,56,23.2
37350, 영덕군,095005, 94세,2018,24,X,20,20,24,X,20,20
37350, 영덕군,100,95~99세,2018,55,12,43,27.9,55,12,43,27.9
37350, 영덕군,100001, 95세,2018,23,X,19,21.1,23,X,19,21.1
37350, 영덕군,100002, 96세,2018,16,6,10,60,16,6,10,60
37350, 영덕군,100003, 97세,2018,9,X,9,0,9,X,9,0
37350, 영덕군,100004, 98세,2018,6,X,5,20,6,X,5,20
37350, 영덕군,100005, 99세,2018,X,X,X,,X,X,X,
37350, 영덕군,101,100세이상,2018,X,X,X,0,X,X,X,0
37350, 영덕군,102,15세미만,2018,2885,1458,1427,102.2,2881,1456,1425,102.2
37350, 영덕군,103,15~64세,2018,20594,11116,9478,117.3,19309,10151,9158,110.8
37350, 영덕군,104,65세이상,2018,12617,4870,7747,62.9,12601,4862,7739,62.8
37350, 영덕군,086,85세이상,2018,1321,338,983,34.4,1320,338,982,34.4
37350, 영덕군,126,평균연령,2018,53.3,50,56.3,,54,51,56.6,
37350, 영덕군,127,중위연령,2018,57.4,53.3,60.7,,58.2,55,61.2,
37360, 청도군,000,합계,2018,40878,19745,21133,93.4,39449,19067,20382,93.5
37360, 청도군,005,0~4세,2018,719,370,349,106,719,370,349,106
37360, 청도군,005001, 0세,2018,139,73,66,110.6,139,73,66,110.6
37360, 청도군,005002, 1세,2018,138,68,70,97.1,138,68,70,97.1
37360, 청도군,005003, 2세,2018,142,75,67,111.9,142,75,67,111.9
37360, 청도군,005004, 3세,2018,154,78,76,102.6,154,78,76,102.6
37360, 청도군,005005, 4세,2018,146,76,70,108.6,146,76,70,108.6
37360, 청도군,010,5~9세,2018,859,431,428,100.7,858,431,427,100.9
37360, 청도군,010001, 5세,2018,157,75,82,91.5,157,75,82,91.5
37360, 청도군,010002, 6세,2018,164,87,77,113,164,87,77,113
37360, 청도군,010003, 7세,2018,190,88,102,86.3,189,88,101,87.1
37360, 청도군,010004, 8세,2018,163,87,76,114.5,163,87,76,114.5
37360, 청도군,010005, 9세,2018,185,94,91,103.3,185,94,91,103.3
37360, 청도군,015,10~14세,2018,985,506,479,105.6,983,505,478,105.6
37360, 청도군,015001, 10세,2018,192,104,88,118.2,191,103,88,117
37360, 청도군,015002, 11세,2018,210,97,113,85.8,210,97,113,85.8
37360, 청도군,015003, 12세,2018,182,92,90,102.2,182,92,90,102.2
37360, 청도군,015004, 13세,2018,187,88,99,88.9,186,88,98,89.8
37360, 청도군,015005, 14세,2018,214,125,89,140.4,214,125,89,140.4
37360, 청도군,020,15~19세,2018,1419,747,672,111.2,1410,745,665,112
37360, 청도군,020001, 15세,2018,244,131,113,115.9,244,131,113,115.9
37360, 청도군,020002, 16세,2018,312,159,153,103.9,310,158,152,103.9
37360, 청도군,020003, 17세,2018,321,164,157,104.5,321,164,157,104.5
37360, 청도군,020004, 18세,2018,337,160,177,90.4,336,160,176,90.9
37360, 청도군,020005, 19세,2018,205,133,72,184.7,199,132,67,197
37360, 청도군,025,20~24세,2018,1545,901,644,139.9,1319,805,514,156.6
37360, 청도군,025001, 20세,2018,277,183,94,194.7,267,178,89,200
37360, 청도군,025002, 21세,2018,269,156,113,138.1,241,145,96,151
37360, 청도군,025003, 22세,2018,284,171,113,151.3,247,155,92,168.5
37360, 청도군,025004, 23세,2018,333,192,141,136.2,263,160,103,155.3
37360, 청도군,025005, 24세,2018,382,199,183,108.7,301,167,134,124.6
37360, 청도군,030,25~29세,2018,1754,979,775,126.3,1308,773,535,144.5
37360, 청도군,030001, 25세,2018,354,206,148,139.2,266,169,97,174.2
37360, 청도군,030002, 26세,2018,362,193,169,114.2,264,151,113,133.6
37360, 청도군,030003, 27세,2018,333,187,146,128.1,247,141,106,133
37360, 청도군,030004, 28세,2018,364,201,163,123.3,275,162,113,143.4
37360, 청도군,030005, 29세,2018,341,192,149,128.9,256,150,106,141.5
37360, 청도군,035,30~34세,2018,1433,787,646,121.8,1149,622,527,118
37360, 청도군,035001, 30세,2018,289,164,125,131.2,218,126,92,137
37360, 청도군,035002, 31세,2018,316,176,140,125.7,246,137,109,125.7
37360, 청도군,035003, 32세,2018,265,143,122,117.2,213,111,102,108.8
37360, 청도군,035004, 33세,2018,256,144,112,128.6,215,116,99,117.2
37360, 청도군,035005, 34세,2018,307,160,147,108.8,257,132,125,105.6
37360, 청도군,040,35~39세,2018,1813,936,877,106.7,1653,868,785,110.6
37360, 청도군,040001, 35세,2018,319,179,140,127.9,278,163,115,141.7
37360, 청도군,040002, 36세,2018,390,190,200,95,355,177,178,99.4
37360, 청도군,040003, 37세,2018,382,188,194,96.9,351,176,175,100.6
37360, 청도군,040004, 38세,2018,369,192,177,108.5,336,176,160,110
37360, 청도군,040005, 39세,2018,353,187,166,112.7,333,176,157,112.1
37360, 청도군,045,40~44세,2018,1825,1034,791,130.7,1732,991,741,133.7
37360, 청도군,045001, 40세,2018,322,174,148,117.6,304,166,138,120.3
37360, 청도군,045002, 41세,2018,344,191,153,124.8,319,179,140,127.9
37360, 청도군,045003, 42세,2018,385,225,160,140.6,367,218,149,146.3
37360, 청도군,045004, 43세,2018,359,197,162,121.6,340,188,152,123.7
37360, 청도군,045005, 44세,2018,415,247,168,147,402,240,162,148.1
37360, 청도군,050,45~49세,2018,2494,1311,1183,110.8,2432,1281,1151,111.3
37360, 청도군,050001, 45세,2018,443,230,213,108,439,229,210,109
37360, 청도군,050002, 46세,2018,485,257,228,112.7,471,249,222,112.2
37360, 청도군,050003, 47세,2018,489,274,215,127.4,475,269,206,130.6
37360, 청도군,050004, 48세,2018,531,272,259,105,516,265,251,105.6
37360, 청도군,050005, 49세,2018,546,278,268,103.7,531,269,262,102.7
37360, 청도군,055,50~54세,2018,3062,1600,1462,109.4,3008,1578,1430,110.3
37360, 청도군,055001, 50세,2018,590,319,271,117.7,578,316,262,120.6
37360, 청도군,055002, 51세,2018,545,263,282,93.3,537,258,279,92.5
37360, 청도군,055003, 52세,2018,589,310,279,111.1,577,306,271,112.9
37360, 청도군,055004, 53세,2018,647,346,301,115,636,340,296,114.9
37360, 청도군,055005, 54세,2018,691,362,329,110,680,358,322,111.2
37360, 청도군,060,55~59세,2018,4375,2190,2185,100.2,4330,2168,2162,100.3
37360, 청도군,060001, 55세,2018,666,336,330,101.8,656,329,327,100.6
37360, 청도군,060002, 56세,2018,831,447,384,116.4,817,439,378,116.1
37360, 청도군,060003, 57세,2018,874,443,431,102.8,869,442,427,103.5
37360, 청도군,060004, 58세,2018,1017,465,552,84.2,1008,463,545,85
37360, 청도군,060005, 59세,2018,987,499,488,102.3,980,495,485,102.1
37360, 청도군,065,60~64세,2018,4249,2084,2165,96.3,4223,2074,2149,96.5
37360, 청도군,065001, 60세,2018,826,401,425,94.4,819,398,421,94.5
37360, 청도군,065002, 61세,2018,844,450,394,114.2,836,445,391,113.8
37360, 청도군,065003, 62세,2018,855,418,437,95.7,848,417,431,96.8
37360, 청도군,065004, 63세,2018,913,421,492,85.6,910,421,489,86.1
37360, 청도군,065005, 64세,2018,811,394,417,94.5,810,393,417,94.2
37360, 청도군,070,65~69세,2018,4123,1986,2137,92.9,4111,1978,2133,92.7
37360, 청도군,070001, 65세,2018,828,422,406,103.9,824,420,404,104
37360, 청도군,070002, 66세,2018,897,438,459,95.4,896,438,458,95.6
37360, 청도군,070003, 67세,2018,771,339,432,78.5,768,336,432,77.8
37360, 청도군,070004, 68세,2018,801,374,427,87.6,799,372,427,87.1
37360, 청도군,070005, 69세,2018,826,413,413,100,824,412,412,100
37360, 청도군,075,70~74세,2018,2825,1358,1467,92.6,2820,1356,1464,92.6
37360, 청도군,075001, 70세,2018,710,378,332,113.9,708,378,330,114.5
37360, 청도군,075002, 71세,2018,691,344,347,99.1,689,343,346,99.1
37360, 청도군,075003, 72세,2018,432,201,231,87,431,200,231,86.6
37360, 청도군,075004, 73세,2018,429,204,225,90.7,429,204,225,90.7
37360, 청도군,075005, 74세,2018,563,231,332,69.6,563,231,332,69.6
37360, 청도군,080,75~79세,2018,3187,1263,1924,65.6,3183,1260,1923,65.5
37360, 청도군,080001, 75세,2018,672,287,385,74.5,671,286,385,74.3
37360, 청도군,080002, 76세,2018,722,291,431,67.5,722,291,431,67.5
37360, 청도군,080003, 77세,2018,630,256,374,68.4,628,254,374,67.9
37360, 청도군,080004, 78세,2018,586,218,368,59.2,586,218,368,59.2
37360, 청도군,080005, 79세,2018,577,211,366,57.7,576,211,365,57.8
37360, 청도군,085,80~84세,2018,2528,836,1692,49.4,2528,836,1692,49.4
37360, 청도군,085001, 80세,2018,601,209,392,53.3,601,209,392,53.3
37360, 청도군,085002, 81세,2018,558,191,367,52,558,191,367,52
37360, 청도군,085003, 82세,2018,520,168,352,47.7,520,168,352,47.7
37360, 청도군,085004, 83세,2018,453,133,320,41.6,453,133,320,41.6
37360, 청도군,085005, 84세,2018,396,135,261,51.7,396,135,261,51.7
37360, 청도군,090,85~89세,2018,1238,322,916,35.2,1238,322,916,35.2
37360, 청도군,090001, 85세,2018,371,112,259,43.2,371,112,259,43.2
37360, 청도군,090002, 86세,2018,307,71,236,30.1,307,71,236,30.1
37360, 청도군,090003, 87세,2018,221,54,167,32.3,221,54,167,32.3
37360, 청도군,090004, 88세,2018,191,51,140,36.4,191,51,140,36.4
37360, 청도군,090005, 89세,2018,148,34,114,29.8,148,34,114,29.8
37360, 청도군,095,90~94세,2018,367,92,275,33.5,367,92,275,33.5
37360, 청도군,095001, 90세,2018,108,29,79,36.7,108,29,79,36.7
37360, 청도군,095002, 91세,2018,98,22,76,28.9,98,22,76,28.9
37360, 청도군,095003, 92세,2018,68,18,50,36,68,18,50,36
37360, 청도군,095004, 93세,2018,56,12,44,27.3,56,12,44,27.3
37360, 청도군,095005, 94세,2018,37,11,26,42.3,37,11,26,42.3
37360, 청도군,100,95~99세,2018,70,12,58,20.7,70,12,58,20.7
37360, 청도군,100001, 95세,2018,31,5,26,19.2,31,5,26,19.2
37360, 청도군,100002, 96세,2018,16,X,13,23.1,16,X,13,23.1
37360, 청도군,100003, 97세,2018,9,X,9,0,9,X,9,0
37360, 청도군,100004, 98세,2018,9,X,6,50,9,X,6,50
37360, 청도군,100005, 99세,2018,5,X,X,25,5,X,X,25
37360, 청도군,101,100세이상,2018,8,X,8,0,8,X,8,0
37360, 청도군,102,15세미만,2018,2563,1307,1256,104.1,2560,1306,1254,104.1
37360, 청도군,103,15~64세,2018,23969,12569,11400,110.3,22564,11905,10659,111.7
37360, 청도군,104,65세이상,2018,14346,5869,8477,69.2,14325,5856,8469,69.1
37360, 청도군,086,85세이상,2018,1683,426,1257,33.9,1683,426,1257,33.9
37360, 청도군,126,평균연령,2018,53.9,51.4,56.3,,54.7,52,57.2,
37360, 청도군,127,중위연령,2018,58.2,55.8,60.2,,58.8,56.5,61,
37370, 고령군,000,합계,2018,32660,17092,15568,109.8,30388,15300,15088,101.4
37370, 고령군,005,0~4세,2018,883,454,429,105.8,876,449,427,105.2
37370, 고령군,005001, 0세,2018,142,73,69,105.8,140,72,68,105.9
37370, 고령군,005002, 1세,2018,163,76,87,87.4,163,76,87,87.4
37370, 고령군,005003, 2세,2018,186,98,88,111.4,184,96,88,109.1
37370, 고령군,005004, 3세,2018,193,105,88,119.3,190,103,87,118.4
37370, 고령군,005005, 4세,2018,199,102,97,105.2,199,102,97,105.2
37370, 고령군,010,5~9세,2018,903,461,442,104.3,899,460,439,104.8
37370, 고령군,010001, 5세,2018,191,93,98,94.9,190,92,98,93.9
37370, 고령군,010002, 6세,2018,180,95,85,111.8,180,95,85,111.8
37370, 고령군,010003, 7세,2018,152,72,80,90,151,72,79,91.1
37370, 고령군,010004, 8세,2018,192,104,88,118.2,192,104,88,118.2
37370, 고령군,010005, 9세,2018,188,97,91,106.6,186,97,89,109
37370, 고령군,015,10~14세,2018,984,540,444,121.6,979,538,441,122
37370, 고령군,015001, 10세,2018,200,110,90,122.2,199,109,90,121.1
37370, 고령군,015002, 11세,2018,214,118,96,122.9,213,117,96,121.9
37370, 고령군,015003, 12세,2018,195,97,98,99,193,97,96,101
37370, 고령군,015004, 13세,2018,193,113,80,141.3,192,113,79,143
37370, 고령군,015005, 14세,2018,182,102,80,127.5,182,102,80,127.5
37370, 고령군,020,15~19세,2018,1099,606,493,122.9,1093,601,492,122.2
37370, 고령군,020001, 15세,2018,206,107,99,108.1,206,107,99,108.1
37370, 고령군,020002, 16세,2018,193,99,94,105.3,193,99,94,105.3
37370, 고령군,020003, 17세,2018,267,142,125,113.6,266,141,125,112.8
37370, 고령군,020004, 18세,2018,230,130,100,130,228,128,100,128
37370, 고령군,020005, 19세,2018,203,128,75,170.7,200,126,74,170.3
37370, 고령군,025,20~24세,2018,1429,901,528,170.6,1167,686,481,142.6
37370, 고령군,025001, 20세,2018,268,175,93,188.2,245,158,87,181.6
37370, 고령군,025002, 21세,2018,270,160,110,145.5,234,130,104,125
37370, 고령군,025003, 22세,2018,291,179,112,159.8,227,127,100,127
37370, 고령군,025004, 23세,2018,311,200,111,180.2,246,147,99,148.5
37370, 고령군,025005, 24세,2018,289,187,102,183.3,215,124,91,136.3
37370, 고령군,030,25~29세,2018,1698,1110,588,188.8,1189,678,511,132.7
37370, 고령군,030001, 25세,2018,374,242,132,183.3,283,163,120,135.8
37370, 고령군,030002, 26세,2018,342,221,121,182.6,242,132,110,120
37370, 고령군,030003, 27세,2018,321,211,110,191.8,219,126,93,135.5
37370, 고령군,030004, 28세,2018,326,205,121,169.4,218,121,97,124.7
37370, 고령군,030005, 29세,2018,335,231,104,222.1,227,136,91,149.5
37370, 고령군,035,30~34세,2018,1637,1064,573,185.7,1084,610,474,128.7
37370, 고령군,035001, 30세,2018,323,221,102,216.7,207,123,84,146.4
37370, 고령군,035002, 31세,2018,336,206,130,158.5,210,109,101,107.9
37370, 고령군,035003, 32세,2018,327,212,115,184.3,229,126,103,122.3
37370, 고령군,035004, 33세,2018,328,212,116,182.8,221,128,93,137.6
37370, 고령군,035005, 34세,2018,323,213,110,193.6,217,124,93,133.3
37370, 고령군,040,35~39세,2018,1861,1079,782,138,1471,763,708,107.8
37370, 고령군,040001, 35세,2018,357,219,138,158.7,253,140,113,123.9
37370, 고령군,040002, 36세,2018,398,223,175,127.4,311,153,158,96.8
37370, 고령군,040003, 37세,2018,395,236,159,148.4,320,172,148,116.2
37370, 고령군,040004, 38세,2018,356,206,150,137.3,295,159,136,116.9
37370, 고령군,040005, 39세,2018,355,195,160,121.9,292,139,153,90.8
37370, 고령군,045,40~44세,2018,1887,1076,811,132.7,1687,917,770,119.1
37370, 고령군,045001, 40세,2018,353,215,138,155.8,296,168,128,131.3
37370, 고령군,045002, 41세,2018,334,196,138,142,292,160,132,121.2
37370, 고령군,045003, 42세,2018,372,216,156,138.5,327,179,148,120.9
37370, 고령군,045004, 43세,2018,391,213,178,119.7,362,192,170,112.9
37370, 고령군,045005, 44세,2018,437,236,201,117.4,410,218,192,113.5
37370, 고령군,050,45~49세,2018,2465,1414,1051,134.5,2332,1318,1014,130
37370, 고령군,050001, 45세,2018,462,261,201,129.9,433,238,195,122.1
37370, 고령군,050002, 46세,2018,457,258,199,129.6,429,239,190,125.8
37370, 고령군,050003, 47세,2018,548,319,229,139.3,522,301,221,136.2
37370, 고령군,050004, 48세,2018,476,271,205,132.2,448,252,196,128.6
37370, 고령군,050005, 49세,2018,522,305,217,140.6,500,288,212,135.8
37370, 고령군,055,50~54세,2018,2637,1423,1214,117.2,2547,1374,1173,117.1
37370, 고령군,055001, 50세,2018,497,272,225,120.9,476,261,215,121.4
37370, 고령군,055002, 51세,2018,501,269,232,115.9,486,260,226,115
37370, 고령군,055003, 52세,2018,527,301,226,133.2,509,292,217,134.6
37370, 고령군,055004, 53세,2018,548,287,261,110,531,280,251,111.6
37370, 고령군,055005, 54세,2018,564,294,270,108.9,545,281,264,106.4
37370, 고령군,060,55~59세,2018,3304,1726,1578,109.4,3245,1697,1548,109.6
37370, 고령군,060001, 55세,2018,578,301,277,108.7,561,291,270,107.8
37370, 고령군,060002, 56세,2018,657,351,306,114.7,645,345,300,115
37370, 고령군,060003, 57세,2018,698,381,317,120.2,689,376,313,120.1
37370, 고령군,060004, 58세,2018,703,342,361,94.7,691,338,353,95.8
37370, 고령군,060005, 59세,2018,668,351,317,110.7,659,347,312,111.2
37370, 고령군,065,60~64세,2018,2881,1521,1360,111.8,2858,1508,1350,111.7
37370, 고령군,065001, 60세,2018,564,309,255,121.2,560,306,254,120.5
37370, 고령군,065002, 61세,2018,610,336,274,122.6,606,334,272,122.8
37370, 고령군,065003, 62세,2018,586,294,292,100.7,583,292,291,100.3
37370, 고령군,065004, 63세,2018,576,294,282,104.3,568,291,277,105.1
37370, 고령군,065005, 64세,2018,545,288,257,112.1,541,285,256,111.3
37370, 고령군,070,65~69세,2018,2505,1227,1278,96,2488,1220,1268,96.2
37370, 고령군,070001, 65세,2018,486,247,239,103.3,483,245,238,102.9
37370, 고령군,070002, 66세,2018,576,286,290,98.6,569,284,285,99.6
37370, 고령군,070003, 67세,2018,477,222,255,87.1,474,221,253,87.4
37370, 고령군,070004, 68세,2018,476,232,244,95.1,473,230,243,94.7
37370, 고령군,070005, 69세,2018,490,240,250,96,489,240,249,96.4
37370, 고령군,075,70~74세,2018,1902,890,1012,87.9,1893,883,1010,87.4
37370, 고령군,075001, 70세,2018,444,212,232,91.4,441,209,232,90.1
37370, 고령군,075002, 71세,2018,452,222,230,96.5,449,220,229,96.1
37370, 고령군,075003, 72세,2018,320,146,174,83.9,319,145,174,83.3
37370, 고령군,075004, 73세,2018,300,133,167,79.6,299,132,167,79
37370, 고령군,075005, 74세,2018,386,177,209,84.7,385,177,208,85.1
37370, 고령군,080,75~79세,2018,2087,794,1293,61.4,2085,793,1292,61.4
37370, 고령군,080001, 75세,2018,392,159,233,68.2,391,159,232,68.5
37370, 고령군,080002, 76세,2018,464,176,288,61.1,464,176,288,61.1
37370, 고령군,080003, 77세,2018,402,148,254,58.3,402,148,254,58.3
37370, 고령군,080004, 78세,2018,395,151,244,61.9,394,150,244,61.5
37370, 고령군,080005, 79세,2018,434,160,274,58.4,434,160,274,58.4
37370, 고령군,085,80~84세,2018,1548,542,1006,53.9,1545,541,1004,53.9
37370, 고령군,085001, 80세,2018,352,113,239,47.3,351,113,238,47.5
37370, 고령군,085002, 81세,2018,337,133,204,65.2,336,132,204,64.7
37370, 고령군,085003, 82세,2018,311,123,188,65.4,311,123,188,65.4
37370, 고령군,085004, 83세,2018,287,101,186,54.3,287,101,186,54.3
37370, 고령군,085005, 84세,2018,261,72,189,38.1,260,72,188,38.3
37370, 고령군,090,85~89세,2018,692,200,492,40.7,692,200,492,40.7
37370, 고령군,090001, 85세,2018,203,61,142,43,203,61,142,43
37370, 고령군,090002, 86세,2018,178,57,121,47.1,178,57,121,47.1
37370, 고령군,090003, 87세,2018,143,40,103,38.8,143,40,103,38.8
37370, 고령군,090004, 88세,2018,94,17,77,22.1,94,17,77,22.1
37370, 고령군,090005, 89세,2018,74,25,49,51,74,25,49,51
37370, 고령군,095,90~94세,2018,220,52,168,31,220,52,168,31
37370, 고령군,095001, 90세,2018,71,16,55,29.1,71,16,55,29.1
37370, 고령군,095002, 91세,2018,61,17,44,38.6,61,17,44,38.6
37370, 고령군,095003, 92세,2018,32,6,26,23.1,32,6,26,23.1
37370, 고령군,095004, 93세,2018,35,7,28,25,35,7,28,25
37370, 고령군,095005, 94세,2018,21,6,15,40,21,6,15,40
37370, 고령군,100,95~99세,2018,36,10,26,38.5,36,10,26,38.5
37370, 고령군,100001, 95세,2018,9,X,6,50,9,X,6,50
37370, 고령군,100002, 96세,2018,11,X,10,10,11,X,10,10
37370, 고령군,100003, 97세,2018,8,X,5,60,8,X,5,60
37370, 고령군,100004, 98세,2018,7,X,X,75,7,X,X,75
37370, 고령군,100005, 99세,2018,X,X,X,0,X,X,X,0
37370, 고령군,101,100세이상,2018,X,X,X,,X,X,X,
37370, 고령군,102,15세미만,2018,2770,1455,1315,110.6,2754,1447,1307,110.7
37370, 고령군,103,15~64세,2018,20898,11920,8978,132.8,18673,10152,8521,119.1
37370, 고령군,104,65세이상,2018,8992,3717,5275,70.5,8961,3701,5260,70.4
37370, 고령군,086,85세이상,2018,950,264,686,38.5,950,264,686,38.5
37370, 고령군,126,평균연령,2018,49.9,47.2,52.8,,51,48.7,53.3,
37370, 고령군,127,중위연령,2018,52.9,49.5,56.5,,54.8,52.4,57.1,
37380, 성주군,000,합계,2018,41299,21388,19911,107.4,39168,19828,19340,102.5
37380, 성주군,005,0~4세,2018,1111,580,531,109.2,1103,574,529,108.5
37380, 성주군,005001, 0세,2018,234,109,125,87.2,232,107,125,85.6
37380, 성주군,005002, 1세,2018,230,119,111,107.2,229,118,111,106.3
37380, 성주군,005003, 2세,2018,230,126,104,121.2,230,126,104,121.2
37380, 성주군,005004, 3세,2018,225,120,105,114.3,223,118,105,112.4
37380, 성주군,005005, 4세,2018,192,106,86,123.3,189,105,84,125
37380, 성주군,010,5~9세,2018,950,465,485,95.9,950,465,485,95.9
37380, 성주군,010001, 5세,2018,197,95,102,93.1,197,95,102,93.1
37380, 성주군,010002, 6세,2018,188,87,101,86.1,188,87,101,86.1
37380, 성주군,010003, 7세,2018,212,108,104,103.8,212,108,104,103.8
37380, 성주군,010004, 8세,2018,169,81,88,92,169,81,88,92
37380, 성주군,010005, 9세,2018,184,94,90,104.4,184,94,90,104.4
37380, 성주군,015,10~14세,2018,965,554,411,134.8,963,553,410,134.9
37380, 성주군,015001, 10세,2018,211,124,87,142.5,211,124,87,142.5
37380, 성주군,015002, 11세,2018,182,98,84,116.7,182,98,84,116.7
37380, 성주군,015003, 12세,2018,199,119,80,148.8,199,119,80,148.8
37380, 성주군,015004, 13세,2018,184,96,88,109.1,184,96,88,109.1
37380, 성주군,015005, 14세,2018,189,117,72,162.5,187,116,71,163.4
37380, 성주군,020,15~19세,2018,1181,616,565,109,1168,611,557,109.7
37380, 성주군,020001, 15세,2018,220,122,98,124.5,219,122,97,125.8
37380, 성주군,020002, 16세,2018,226,106,120,88.3,226,106,120,88.3
37380, 성주군,020003, 17세,2018,281,140,141,99.3,280,140,140,100
37380, 성주군,020004, 18세,2018,256,127,129,98.4,254,126,128,98.4
37380, 성주군,020005, 19세,2018,198,121,77,157.1,189,117,72,162.5
37380, 성주군,025,20~24세,2018,1751,1138,613,185.6,1507,954,553,172.5
37380, 성주군,025001, 20세,2018,264,183,81,225.9,243,170,73,232.9
37380, 성주군,025002, 21세,2018,329,211,118,178.8,301,197,104,189.4
37380, 성주군,025003, 22세,2018,343,216,127,170.1,294,184,110,167.3
37380, 성주군,025004, 23세,2018,377,248,129,192.2,307,188,119,158
37380, 성주군,025005, 24세,2018,438,280,158,177.2,362,215,147,146.3
37380, 성주군,030,25~29세,2018,2200,1349,851,158.5,1629,911,718,126.9
37380, 성주군,030001, 25세,2018,418,258,160,161.3,315,174,141,123.4
37380, 성주군,030002, 26세,2018,488,308,180,171.1,362,205,157,130.6
37380, 성주군,030003, 27세,2018,429,247,182,135.7,313,159,154,103.2
37380, 성주군,030004, 28세,2018,463,285,178,160.1,352,204,148,137.8
37380, 성주군,030005, 29세,2018,402,251,151,166.2,287,169,118,143.2
37380, 성주군,035,30~34세,2018,2007,1194,813,146.9,1532,827,705,117.3
37380, 성주군,035001, 30세,2018,457,274,183,149.7,346,191,155,123.2
37380, 성주군,035002, 31세,2018,384,243,141,172.3,289,164,125,131.2
37380, 성주군,035003, 32세,2018,377,217,160,135.6,282,146,136,107.4
37380, 성주군,035004, 33세,2018,387,222,165,134.5,294,150,144,104.2
37380, 성주군,035005, 34세,2018,402,238,164,145.1,321,176,145,121.4
37380, 성주군,040,35~39세,2018,2030,1191,839,142,1726,949,777,122.1
37380, 성주군,040001, 35세,2018,395,226,169,133.7,319,168,151,111.3
37380, 성주군,040002, 36세,2018,429,238,191,124.6,372,191,181,105.5
37380, 성주군,040003, 37세,2018,363,215,148,145.3,300,163,137,119
37380, 성주군,040004, 38세,2018,428,260,168,154.8,369,214,155,138.1
37380, 성주군,040005, 39세,2018,415,252,163,154.6,366,213,153,139.2
37380, 성주군,045,40~44세,2018,2087,1266,821,154.2,1897,1126,771,146
37380, 성주군,045001, 40세,2018,355,208,147,141.5,319,181,138,131.2
37380, 성주군,045002, 41세,2018,414,267,147,181.6,362,232,130,178.5
37380, 성주군,045003, 42세,2018,408,265,143,185.3,374,237,137,173
37380, 성주군,045004, 43세,2018,420,237,183,129.5,385,211,174,121.3
37380, 성주군,045005, 44세,2018,490,289,201,143.8,457,265,192,138
37380, 성주군,050,45~49세,2018,2683,1541,1142,134.9,2557,1464,1093,133.9
37380, 성주군,050001, 45세,2018,483,291,192,151.6,445,265,180,147.2
37380, 성주군,050002, 46세,2018,499,289,210,137.6,481,277,204,135.8
37380, 성주군,050003, 47세,2018,530,297,233,127.5,502,281,221,127.1
37380, 성주군,050004, 48세,2018,563,318,245,129.8,535,303,232,130.6
37380, 성주군,050005, 49세,2018,608,346,262,132.1,594,338,256,132
37380, 성주군,055,50~54세,2018,3518,1872,1646,113.7,3438,1827,1611,113.4
37380, 성주군,055001, 50세,2018,686,372,314,118.5,678,369,309,119.4
37380, 성주군,055002, 51세,2018,659,334,325,102.8,637,320,317,100.9
37380, 성주군,055003, 52세,2018,666,364,302,120.5,651,356,295,120.7
37380, 성주군,055004, 53세,2018,764,417,347,120.2,743,406,337,120.5
37380, 성주군,055005, 54세,2018,743,385,358,107.5,729,376,353,106.5
37380, 성주군,060,55~59세,2018,4684,2406,2278,105.6,4619,2374,2245,105.7
37380, 성주군,060001, 55세,2018,756,407,349,116.6,742,399,343,116.3
37380, 성주군,060002, 56세,2018,917,486,431,112.8,899,476,423,112.5
37380, 성주군,060003, 57세,2018,1021,539,482,111.8,1012,535,477,112.2
37380, 성주군,060004, 58세,2018,1011,483,528,91.5,994,477,517,92.3
37380, 성주군,060005, 59세,2018,979,491,488,100.6,972,487,485,100.4
37380, 성주군,065,60~64세,2018,3943,2070,1873,110.5,3913,2058,1855,110.9
37380, 성주군,065001, 60세,2018,793,441,352,125.3,785,439,346,126.9
37380, 성주군,065002, 61세,2018,800,435,365,119.2,794,432,362,119.3
37380, 성주군,065003, 62세,2018,796,432,364,118.7,789,428,361,118.6
37380, 성주군,065004, 63세,2018,837,395,442,89.4,830,392,438,89.5
37380, 성주군,065005, 64세,2018,717,367,350,104.9,715,367,348,105.5
37380, 성주군,070,65~69세,2018,3586,1758,1828,96.2,3570,1751,1819,96.3
37380, 성주군,070001, 65세,2018,721,375,346,108.4,717,373,344,108.4
37380, 성주군,070002, 66세,2018,838,383,455,84.2,834,383,451,84.9
37380, 성주군,070003, 67세,2018,633,313,320,97.8,630,311,319,97.5
37380, 성주군,070004, 68세,2018,696,332,364,91.2,694,330,364,90.7
37380, 성주군,070005, 69세,2018,698,355,343,103.5,695,354,341,103.8
37380, 성주군,075,70~74세,2018,2552,1214,1338,90.7,2548,1211,1337,90.6
37380, 성주군,075001, 70세,2018,663,330,333,99.1,662,329,333,98.8
37380, 성주군,075002, 71세,2018,621,298,323,92.3,621,298,323,92.3
37380, 성주군,075003, 72세,2018,404,192,212,90.6,401,190,211,90
37380, 성주군,075004, 73세,2018,391,188,203,92.6,391,188,203,92.6
37380, 성주군,075005, 74세,2018,473,206,267,77.2,473,206,267,77.2
37380, 성주군,080,75~79세,2018,2683,1160,1523,76.2,2680,1159,1521,76.2
37380, 성주군,080001, 75세,2018,562,247,315,78.4,561,246,315,78.1
37380, 성주군,080002, 76세,2018,598,258,340,75.9,597,258,339,76.1
37380, 성주군,080003, 77세,2018,499,225,274,82.1,499,225,274,82.1
37380, 성주군,080004, 78세,2018,491,196,295,66.4,490,196,294,66.7
37380, 성주군,080005, 79세,2018,533,234,299,78.3,533,234,299,78.3
37380, 성주군,085,80~84세,2018,1948,647,1301,49.7,1948,647,1301,49.7
37380, 성주군,085001, 80세,2018,434,173,261,66.3,434,173,261,66.3
37380, 성주군,085002, 81세,2018,354,134,220,60.9,354,134,220,60.9
37380, 성주군,085003, 82세,2018,427,128,299,42.8,427,128,299,42.8
37380, 성주군,085004, 83세,2018,398,110,288,38.2,398,110,288,38.2
37380, 성주군,085005, 84세,2018,335,102,233,43.8,335,102,233,43.8
37380, 성주군,090,85~89세,2018,998,276,722,38.2,998,276,722,38.2
37380, 성주군,090001, 85세,2018,273,78,195,40,273,78,195,40
37380, 성주군,090002, 86세,2018,246,72,174,41.4,246,72,174,41.4
37380, 성주군,090003, 87세,2018,180,50,130,38.5,180,50,130,38.5
37380, 성주군,090004, 88세,2018,181,42,139,30.2,181,42,139,30.2
37380, 성주군,090005, 89세,2018,118,34,84,40.5,118,34,84,40.5
37380, 성주군,095,90~94세,2018,339,78,261,29.9,339,78,261,29.9
37380, 성주군,095001, 90세,2018,127,31,96,32.3,127,31,96,32.3
37380, 성주군,095002, 91세,2018,75,20,55,36.4,75,20,55,36.4
37380, 성주군,095003, 92세,2018,48,9,39,23.1,48,9,39,23.1
37380, 성주군,095004, 93세,2018,54,12,42,28.6,54,12,42,28.6
37380, 성주군,095005, 94세,2018,35,6,29,20.7,35,6,29,20.7
37380, 성주군,100,95~99세,2018,80,12,68,17.6,80,12,68,17.6
37380, 성주군,100001, 95세,2018,25,X,22,13.6,25,X,22,13.6
37380, 성주군,100002, 96세,2018,26,5,21,23.8,26,5,21,23.8
37380, 성주군,100003, 97세,2018,12,X,10,20,12,X,10,20
37380, 성주군,100004, 98세,2018,10,X,9,11.1,10,X,9,11.1
37380, 성주군,100005, 99세,2018,7,X,6,16.7,7,X,6,16.7
37380, 성주군,101,100세이상,2018,X,X,X,50,X,X,X,50
37380, 성주군,102,15세미만,2018,3026,1599,1427,112.1,3016,1592,1424,111.8
37380, 성주군,103,15~64세,2018,26084,14643,11441,128,23986,13101,10885,120.4
37380, 성주군,104,65세이상,2018,12189,5146,7043,73.1,12166,5135,7031,73
37380, 성주군,086,85세이상,2018,1420,367,1053,34.9,1420,367,1053,34.9
37380, 성주군,126,평균연령,2018,51.4,48.8,54.2,,52.3,50,54.7,
37380, 성주군,127,중위연령,2018,55.2,52.3,58,,56.4,54.1,58.4,
37390, 칠곡군,000,합계,2018,120983,63530,57453,110.6,115638,59865,55773,107.3
37390, 칠곡군,005,0~4세,2018,5379,2831,2548,111.1,5317,2803,2514,111.5
37390, 칠곡군,005001, 0세,2018,910,473,437,108.2,899,469,430,109.1
37390, 칠곡군,005002, 1세,2018,977,522,455,114.7,963,515,448,115
37390, 칠곡군,005003, 2세,2018,1177,592,585,101.2,1161,587,574,102.3
37390, 칠곡군,005004, 3세,2018,1217,656,561,116.9,1206,651,555,117.3
37390, 칠곡군,005005, 4세,2018,1098,588,510,115.3,1088,581,507,114.6
37390, 칠곡군,010,5~9세,2018,6027,3117,2910,107.1,5984,3092,2892,106.9
37390, 칠곡군,010001, 5세,2018,1223,644,579,111.2,1209,636,573,111
37390, 칠곡군,010002, 6세,2018,1266,665,601,110.6,1260,662,598,110.7
37390, 칠곡군,010003, 7세,2018,1235,611,624,97.9,1227,607,620,97.9
37390, 칠곡군,010004, 8세,2018,1202,617,585,105.5,1193,610,583,104.6
37390, 칠곡군,010005, 9세,2018,1101,580,521,111.3,1095,577,518,111.4
37390, 칠곡군,015,10~14세,2018,5759,3038,2721,111.7,5727,3019,2708,111.5
37390, 칠곡군,015001, 10세,2018,1196,620,576,107.6,1187,615,572,107.5
37390, 칠곡군,015002, 11세,2018,1240,636,604,105.3,1232,631,601,105
37390, 칠곡군,015003, 12세,2018,1088,591,497,118.9,1081,586,495,118.4
37390, 칠곡군,015004, 13세,2018,1100,600,500,120,1094,596,498,119.7
37390, 칠곡군,015005, 14세,2018,1135,591,544,108.6,1133,591,542,109
37390, 칠곡군,020,15~19세,2018,6491,3532,2959,119.4,6376,3462,2914,118.8
37390, 칠곡군,020001, 15세,2018,1170,605,565,107.1,1164,602,562,107.1
37390, 칠곡군,020002, 16세,2018,1247,666,581,114.6,1243,664,579,114.7
37390, 칠곡군,020003, 17세,2018,1299,664,635,104.6,1290,658,632,104.1
37390, 칠곡군,020004, 18세,2018,1414,777,637,122,1357,740,617,119.9
37390, 칠곡군,020005, 19세,2018,1361,820,541,151.6,1322,798,524,152.3
37390, 칠곡군,025,20~24세,2018,7650,4501,3149,142.9,7082,4078,3004,135.8
37390, 칠곡군,025001, 20세,2018,1461,857,604,141.9,1413,824,589,139.9
37390, 칠곡군,025002, 21세,2018,1551,935,616,151.8,1474,879,595,147.7
37390, 칠곡군,025003, 22세,2018,1582,981,601,163.2,1475,899,576,156.1
37390, 칠곡군,025004, 23세,2018,1516,905,611,148.1,1360,791,569,139
37390, 칠곡군,025005, 24세,2018,1540,823,717,114.8,1360,685,675,101.5
37390, 칠곡군,030,25~29세,2018,7846,4377,3469,126.2,6733,3564,3169,112.5
37390, 칠곡군,030001, 25세,2018,1543,816,727,112.2,1350,675,675,100
37390, 칠곡군,030002, 26세,2018,1624,846,778,108.7,1433,707,726,97.4
37390, 칠곡군,030003, 27세,2018,1520,837,683,122.5,1298,670,628,106.7
37390, 칠곡군,030004, 28세,2018,1555,879,676,130,1310,703,607,115.8
37390, 칠곡군,030005, 29세,2018,1604,999,605,165.1,1342,809,533,151.8
37390, 칠곡군,035,30~34세,2018,9080,5250,3830,137.1,7912,4448,3464,128.4
37390, 칠곡군,035001, 30세,2018,1747,1033,714,144.7,1479,852,627,135.9
37390, 칠곡군,035002, 31세,2018,1874,1103,771,143.1,1630,913,717,127.3
37390, 칠곡군,035003, 32세,2018,1840,1053,787,133.8,1628,916,712,128.7
37390, 칠곡군,035004, 33세,2018,1787,1049,738,142.1,1545,895,650,137.7
37390, 칠곡군,035005, 34세,2018,1832,1012,820,123.4,1630,872,758,115
37390, 칠곡군,040,35~39세,2018,10887,6035,4852,124.4,10001,5393,4608,117
37390, 칠곡군,040001, 35세,2018,1997,1103,894,123.4,1786,950,836,113.6
37390, 칠곡군,040002, 36세,2018,2300,1270,1030,123.3,2081,1114,967,115.2
37390, 칠곡군,040003, 37세,2018,2203,1227,976,125.7,2041,1117,924,120.9
37390, 칠곡군,040004, 38세,2018,2302,1290,1012,127.5,2136,1169,967,120.9
37390, 칠곡군,040005, 39세,2018,2085,1145,940,121.8,1957,1043,914,114.1
37390, 칠곡군,045,40~44세,2018,10222,5461,4761,114.7,9726,5132,4594,111.7
37390, 칠곡군,045001, 40세,2018,1940,1042,898,116,1807,942,865,108.9
37390, 칠곡군,045002, 41세,2018,2031,1084,947,114.5,1923,1013,910,111.3
37390, 칠곡군,045003, 42세,2018,1878,1009,869,116.1,1798,954,844,113
37390, 칠곡군,045004, 43세,2018,2115,1109,1006,110.2,2030,1062,968,109.7
37390, 칠곡군,045005, 44세,2018,2258,1217,1041,116.9,2168,1161,1007,115.3
37390, 칠곡군,050,45~49세,2018,10650,5757,4893,117.7,10340,5569,4771,116.7
37390, 칠곡군,050001, 45세,2018,2140,1158,982,117.9,2085,1124,961,117
37390, 칠곡군,050002, 46세,2018,2173,1174,999,117.5,2106,1122,984,114
37390, 칠곡군,050003, 47세,2018,2127,1172,955,122.7,2054,1132,922,122.8
37390, 칠곡군,050004, 48세,2018,2140,1155,985,117.3,2082,1123,959,117.1
37390, 칠곡군,050005, 49세,2018,2070,1098,972,113,2013,1068,945,113
37390, 칠곡군,055,50~54세,2018,9341,5013,4328,115.8,9104,4868,4236,114.9
37390, 칠곡군,055001, 50세,2018,2079,1082,997,108.5,2034,1057,977,108.2
37390, 칠곡군,055002, 51세,2018,1867,976,891,109.5,1816,941,875,107.5
37390, 칠곡군,055003, 52세,2018,1869,1015,854,118.9,1824,993,831,119.5
37390, 칠곡군,055004, 53세,2018,1844,999,845,118.2,1796,963,833,115.6
37390, 칠곡군,055005, 54세,2018,1682,941,741,127,1634,914,720,126.9
37390, 칠곡군,060,55~59세,2018,8775,4658,4117,113.1,8636,4574,4062,112.6
37390, 칠곡군,060001, 55세,2018,1690,908,782,116.1,1653,884,769,115
37390, 칠곡군,060002, 56세,2018,1849,997,852,117,1820,980,840,116.7
37390, 칠곡군,060003, 57세,2018,1862,1007,855,117.8,1842,993,849,117
37390, 칠곡군,060004, 58세,2018,1821,952,869,109.6,1795,941,854,110.2
37390, 칠곡군,060005, 59세,2018,1553,794,759,104.6,1526,776,750,103.5
37390, 칠곡군,065,60~64세,2018,6660,3388,3272,103.5,6567,3334,3233,103.1
37390, 칠곡군,065001, 60세,2018,1442,793,649,122.2,1415,779,636,122.5
37390, 칠곡군,065002, 61세,2018,1452,754,698,108,1440,746,694,107.5
37390, 칠곡군,065003, 62세,2018,1353,682,671,101.6,1331,664,667,99.6
37390, 칠곡군,065004, 63세,2018,1253,601,652,92.2,1235,592,643,92.1
37390, 칠곡군,065005, 64세,2018,1160,558,602,92.7,1146,553,593,93.3
37390, 칠곡군,070,65~69세,2018,4667,2292,2375,96.5,4620,2266,2354,96.3
37390, 칠곡군,070001, 65세,2018,958,472,486,97.1,951,466,485,96.1
37390, 칠곡군,070002, 66세,2018,1129,566,563,100.5,1121,563,558,100.9
37390, 칠곡군,070003, 67세,2018,801,388,413,93.9,790,379,411,92.2
37390, 칠곡군,070004, 68세,2018,842,432,410,105.4,832,427,405,105.4
37390, 칠곡군,070005, 69세,2018,937,434,503,86.3,926,431,495,87.1
37390, 칠곡군,075,70~74세,2018,3515,1565,1950,80.3,3493,1552,1941,80
37390, 칠곡군,075001, 70세,2018,887,433,454,95.4,879,426,453,94
37390, 칠곡군,075002, 71세,2018,811,373,438,85.2,806,370,436,84.9
37390, 칠곡군,075003, 72세,2018,559,238,321,74.1,556,236,320,73.8
37390, 칠곡군,075004, 73세,2018,618,253,365,69.3,616,253,363,69.7
37390, 칠곡군,075005, 74세,2018,640,268,372,72,636,267,369,72.4
37390, 칠곡군,080,75~79세,2018,3740,1376,2364,58.2,3732,1375,2357,58.3
37390, 칠곡군,080001, 75세,2018,768,290,478,60.7,767,290,477,60.8
37390, 칠곡군,080002, 76세,2018,880,333,547,60.9,878,333,545,61.1
37390, 칠곡군,080003, 77세,2018,689,262,427,61.4,686,261,425,61.4
37390, 칠곡군,080004, 78세,2018,680,253,427,59.3,680,253,427,59.3
37390, 칠곡군,080005, 79세,2018,723,238,485,49.1,721,238,483,49.3
37390, 칠곡군,085,80~84세,2018,2564,881,1683,52.3,2560,880,1680,52.4
37390, 칠곡군,085001, 80세,2018,588,206,382,53.9,588,206,382,53.9
37390, 칠곡군,085002, 81세,2018,576,203,373,54.4,575,202,373,54.2
37390, 칠곡군,085003, 82세,2018,516,175,341,51.3,514,175,339,51.6
37390, 칠곡군,085004, 83세,2018,484,154,330,46.7,483,154,329,46.8
37390, 칠곡군,085005, 84세,2018,400,143,257,55.6,400,143,257,55.6
37390, 칠곡군,090,85~89세,2018,1215,353,862,41,1213,351,862,40.7
37390, 칠곡군,090001, 85세,2018,340,105,235,44.7,339,104,235,44.3
37390, 칠곡군,090002, 86세,2018,304,81,223,36.3,304,81,223,36.3
37390, 칠곡군,090003, 87세,2018,234,75,159,47.2,233,74,159,46.5
37390, 칠곡군,090004, 88세,2018,180,49,131,37.4,180,49,131,37.4
37390, 칠곡군,090005, 89세,2018,157,43,114,37.7,157,43,114,37.7
37390, 칠곡군,095,90~94세,2018,410,95,315,30.2,410,95,315,30.2
37390, 칠곡군,095001, 90세,2018,131,29,102,28.4,131,29,102,28.4
37390, 칠곡군,095002, 91세,2018,109,28,81,34.6,109,28,81,34.6
37390, 칠곡군,095003, 92세,2018,66,14,52,26.9,66,14,52,26.9
37390, 칠곡군,095004, 93세,2018,62,16,46,34.8,62,16,46,34.8
37390, 칠곡군,095005, 94세,2018,42,8,34,23.5,42,8,34,23.5
37390, 칠곡군,100,95~99세,2018,93,10,83,12,93,10,83,12
37390, 칠곡군,100001, 95세,2018,29,X,25,16,29,X,25,16
37390, 칠곡군,100002, 96세,2018,30,X,29,3.4,30,X,29,3.4
37390, 칠곡군,100003, 97세,2018,18,X,15,20,18,X,15,20
37390, 칠곡군,100004, 98세,2018,9,X,8,12.5,9,X,8,12.5
37390, 칠곡군,100005, 99세,2018,7,X,6,16.7,7,X,6,16.7
37390, 칠곡군,101,100세이상,2018,12,X,12,0,12,X,12,0
37390, 칠곡군,102,15세미만,2018,17165,8986,8179,109.9,17028,8914,8114,109.9
37390, 칠곡군,103,15~64세,2018,87602,47972,39630,121,82477,44422,38055,116.7
37390, 칠곡군,104,65세이상,2018,16216,6572,9644,68.1,16133,6529,9604,68
37390, 칠곡군,086,85세이상,2018,1730,458,1272,36,1728,456,1272,35.8
37390, 칠곡군,126,평균연령,2018,40.6,39.1,42.2,,40.9,39.4,42.4,
37390, 칠곡군,127,중위연령,2018,40.7,39.2,42.5,,41.5,40.1,43,
37400, 예천군,000,합계,2018,51082,25000,26082,95.9,50409,24730,25679,96.3
37400, 예천군,005,0~4세,2018,2034,1024,1010,101.4,2031,1023,1008,101.5
37400, 예천군,005001, 0세,2018,350,171,179,95.5,350,171,179,95.5
37400, 예천군,005002, 1세,2018,362,175,187,93.6,360,174,186,93.5
37400, 예천군,005003, 2세,2018,457,218,239,91.2,457,218,239,91.2
37400, 예천군,005004, 3세,2018,469,252,217,116.1,468,252,216,116.7
37400, 예천군,005005, 4세,2018,396,208,188,110.6,396,208,188,110.6
37400, 예천군,010,5~9세,2018,2266,1165,1101,105.8,2264,1165,1099,106
37400, 예천군,010001, 5세,2018,472,237,235,100.9,472,237,235,100.9
37400, 예천군,010002, 6세,2018,486,263,223,117.9,485,263,222,118.5
37400, 예천군,010003, 7세,2018,472,222,250,88.8,472,222,250,88.8
37400, 예천군,010004, 8세,2018,396,211,185,114.1,396,211,185,114.1
37400, 예천군,010005, 9세,2018,440,232,208,111.5,439,232,207,112.1
37400, 예천군,015,10~14세,2018,1991,1047,944,110.9,1991,1047,944,110.9
37400, 예천군,015001, 10세,2018,431,227,204,111.3,431,227,204,111.3
37400, 예천군,015002, 11세,2018,406,217,189,114.8,406,217,189,114.8
37400, 예천군,015003, 12세,2018,386,207,179,115.6,386,207,179,115.6
37400, 예천군,015004, 13세,2018,386,204,182,112.1,386,204,182,112.1
37400, 예천군,015005, 14세,2018,382,192,190,101.1,382,192,190,101.1
37400, 예천군,020,15~19세,2018,1739,934,805,116,1729,931,798,116.7
37400, 예천군,020001, 15세,2018,338,180,158,113.9,337,180,157,114.6
37400, 예천군,020002, 16세,2018,384,214,170,125.9,383,214,169,126.6
37400, 예천군,020003, 17세,2018,347,172,175,98.3,347,172,175,98.3
37400, 예천군,020004, 18세,2018,358,183,175,104.6,358,183,175,104.6
37400, 예천군,020005, 19세,2018,312,185,127,145.7,304,182,122,149.2
37400, 예천군,025,20~24세,2018,1855,1143,712,160.5,1786,1108,678,163.4
37400, 예천군,025001, 20세,2018,360,232,128,181.3,355,229,126,181.7
37400, 예천군,025002, 21세,2018,368,239,129,185.3,361,237,124,191.1
37400, 예천군,025003, 22세,2018,378,234,144,162.5,364,228,136,167.6
37400, 예천군,025004, 23세,2018,365,225,140,160.7,348,217,131,165.6
37400, 예천군,025005, 24세,2018,384,213,171,124.6,358,197,161,122.4
37400, 예천군,030,25~29세,2018,1905,1028,877,117.2,1753,961,792,121.3
37400, 예천군,030001, 25세,2018,394,210,184,114.1,366,197,169,116.6
37400, 예천군,030002, 26세,2018,344,177,167,106,319,168,151,111.3
37400, 예천군,030003, 27세,2018,368,202,166,121.7,333,185,148,125
37400, 예천군,030004, 28세,2018,368,217,151,143.7,338,203,135,150.4
37400, 예천군,030005, 29세,2018,431,222,209,106.2,397,208,189,110.1
37400, 예천군,035,30~34세,2018,2233,1162,1071,108.5,2121,1119,1002,111.7
37400, 예천군,035001, 30세,2018,415,201,214,93.9,387,192,195,98.5
37400, 예천군,035002, 31세,2018,460,245,215,114,441,236,205,115.1
37400, 예천군,035003, 32세,2018,436,242,194,124.7,417,235,182,129.1
37400, 예천군,035004, 33세,2018,434,228,206,110.7,409,215,194,110.8
37400, 예천군,035005, 34세,2018,488,246,242,101.7,467,241,226,106.6
37400, 예천군,040,35~39세,2018,3143,1561,1582,98.7,3064,1531,1533,99.9
37400, 예천군,040001, 35세,2018,544,268,276,97.1,530,262,268,97.8
37400, 예천군,040002, 36세,2018,649,308,341,90.3,631,300,331,90.6
37400, 예천군,040003, 37세,2018,620,301,319,94.4,604,296,308,96.1
37400, 예천군,040004, 38세,2018,673,331,342,96.8,650,322,328,98.2
37400, 예천군,040005, 39세,2018,657,353,304,116.1,649,351,298,117.8
37400, 예천군,045,40~44세,2018,3105,1665,1440,115.6,3041,1642,1399,117.4
37400, 예천군,045001, 40세,2018,615,336,279,120.4,598,330,268,123.1
37400, 예천군,045002, 41세,2018,618,304,314,96.8,605,298,307,97.1
37400, 예천군,045003, 42세,2018,612,340,272,125,600,336,264,127.3
37400, 예천군,045004, 43세,2018,631,347,284,122.2,621,343,278,123.4
37400, 예천군,045005, 44세,2018,629,338,291,116.2,617,335,282,118.8
37400, 예천군,050,45~49세,2018,3178,1790,1388,129,3126,1774,1352,131.2
37400, 예천군,050001, 45세,2018,633,366,267,137.1,622,363,259,140.2
37400, 예천군,050002, 46세,2018,601,360,241,149.4,588,356,232,153.4
37400, 예천군,050003, 47세,2018,641,370,271,136.5,636,367,269,136.4
37400, 예천군,050004, 48세,2018,641,335,306,109.5,629,334,295,113.2
37400, 예천군,050005, 49세,2018,662,359,303,118.5,651,354,297,119.2
37400, 예천군,055,50~54세,2018,3458,1820,1638,111.1,3397,1796,1601,112.2
37400, 예천군,055001, 50세,2018,671,354,317,111.7,660,349,311,112.2
37400, 예천군,055002, 51세,2018,665,370,295,125.4,651,363,288,126
37400, 예천군,055003, 52세,2018,668,351,317,110.7,655,347,308,112.7
37400, 예천군,055004, 53세,2018,702,351,351,100,693,346,347,99.7
37400, 예천군,055005, 54세,2018,752,394,358,110.1,738,391,347,112.7
37400, 예천군,060,55~59세,2018,4260,2133,2127,100.3,4230,2117,2113,100.2
37400, 예천군,060001, 55세,2018,732,362,370,97.8,728,359,369,97.3
37400, 예천군,060002, 56세,2018,801,389,412,94.4,791,385,406,94.8
37400, 예천군,060003, 57세,2018,945,492,453,108.6,939,488,451,108.2
37400, 예천군,060004, 58세,2018,971,490,481,101.9,964,485,479,101.3
37400, 예천군,060005, 59세,2018,811,400,411,97.3,808,400,408,98
37400, 예천군,065,60~64세,2018,4514,2214,2300,96.3,4493,2208,2285,96.6
37400, 예천군,065001, 60세,2018,918,477,441,108.2,914,477,437,109.2
37400, 예천군,065002, 61세,2018,932,452,480,94.2,928,451,477,94.5
37400, 예천군,065003, 62세,2018,928,472,456,103.5,924,471,453,104
37400, 예천군,065004, 63세,2018,891,396,495,80,886,394,492,80.1
37400, 예천군,065005, 64세,2018,845,417,428,97.4,841,415,426,97.4
37400, 예천군,070,65~69세,2018,3800,1814,1986,91.3,3791,1812,1979,91.6
37400, 예천군,070001, 65세,2018,829,417,412,101.2,827,415,412,100.7
37400, 예천군,070002, 66세,2018,844,418,426,98.1,842,418,424,98.6
37400, 예천군,070003, 67세,2018,640,301,339,88.8,639,301,338,89.1
37400, 예천군,070004, 68세,2018,737,321,416,77.2,734,321,413,77.7
37400, 예천군,070005, 69세,2018,750,357,393,90.8,749,357,392,91.1
37400, 예천군,075,70~74세,2018,3037,1430,1607,89,3033,1428,1605,89
37400, 예천군,075001, 70세,2018,742,373,369,101.1,740,372,368,101.1
37400, 예천군,075002, 71세,2018,747,365,382,95.5,745,364,381,95.5
37400, 예천군,075003, 72세,2018,416,194,222,87.4,416,194,222,87.4
37400, 예천군,075004, 73세,2018,499,225,274,82.1,499,225,274,82.1
37400, 예천군,075005, 74세,2018,633,273,360,75.8,633,273,360,75.8
37400, 예천군,080,75~79세,2018,3801,1523,2278,66.9,3800,1523,2277,66.9
37400, 예천군,080001, 75세,2018,719,294,425,69.2,719,294,425,69.2
37400, 예천군,080002, 76세,2018,941,396,545,72.7,941,396,545,72.7
37400, 예천군,080003, 77세,2018,696,277,419,66.1,696,277,419,66.1
37400, 예천군,080004, 78세,2018,695,283,412,68.7,695,283,412,68.7
37400, 예천군,080005, 79세,2018,750,273,477,57.2,749,273,476,57.4
37400, 예천군,085,80~84세,2018,3009,1085,1924,56.4,3005,1083,1922,56.3
37400, 예천군,085001, 80세,2018,692,278,414,67.1,691,277,414,66.9
37400, 예천군,085002, 81세,2018,634,242,392,61.7,634,242,392,61.7
37400, 예천군,085003, 82세,2018,571,185,386,47.9,569,185,384,48.2
37400, 예천군,085004, 83세,2018,623,226,397,56.9,623,226,397,56.9
37400, 예천군,085005, 84세,2018,489,154,335,46,488,153,335,45.7
37400, 예천군,090,85~89세,2018,1224,351,873,40.2,1224,351,873,40.2
37400, 예천군,090001, 85세,2018,336,114,222,51.4,336,114,222,51.4
37400, 예천군,090002, 86세,2018,317,108,209,51.7,317,108,209,51.7
37400, 예천군,090003, 87세,2018,198,56,142,39.4,198,56,142,39.4
37400, 예천군,090004, 88세,2018,214,43,171,25.1,214,43,171,25.1
37400, 예천군,090005, 89세,2018,159,30,129,23.3,159,30,129,23.3
37400, 예천군,095,90~94세,2018,423,95,328,29,423,95,328,29
37400, 예천군,095001, 90세,2018,119,26,93,28,119,26,93,28
37400, 예천군,095002, 91세,2018,121,28,93,30.1,121,28,93,30.1
37400, 예천군,095003, 92세,2018,69,14,55,25.5,69,14,55,25.5
37400, 예천군,095004, 93세,2018,68,19,49,38.8,68,19,49,38.8
37400, 예천군,095005, 94세,2018,46,8,38,21.1,46,8,38,21.1
37400, 예천군,100,95~99세,2018,91,16,75,21.3,91,16,75,21.3
37400, 예천군,100001, 95세,2018,32,8,24,33.3,32,8,24,33.3
37400, 예천군,100002, 96세,2018,23,X,20,15,23,X,20,15
37400, 예천군,100003, 97세,2018,12,X,8,50,12,X,8,50
37400, 예천군,100004, 98세,2018,12,X,12,0,12,X,12,0
37400, 예천군,100005, 99세,2018,12,X,11,9.1,12,X,11,9.1
37400, 예천군,101,100세이상,2018,16,X,16,0,16,X,16,0
37400, 예천군,102,15세미만,2018,6291,3236,3055,105.9,6286,3235,3051,106
37400, 예천군,103,15~64세,2018,29390,15450,13940,110.8,28740,15187,13553,112.1
37400, 예천군,104,65세이상,2018,15401,6314,9087,69.5,15383,6308,9075,69.5
37400, 예천군,086,85세이상,2018,1754,462,1292,35.8,1754,462,1292,35.8
37400, 예천군,126,평균연령,2018,49.5,47.1,51.8,,49.7,47.2,52,
37400, 예천군,127,중위연령,2018,53.1,49.9,56.2,,53.5,50.2,56.7,
37410, 봉화군,000,합계,2018,30872,15297,15575,98.2,30434,15142,15292,99
37410, 봉화군,005,0~4세,2018,812,432,380,113.7,812,432,380,113.7
37410, 봉화군,005001, 0세,2018,139,71,68,104.4,139,71,68,104.4
37410, 봉화군,005002, 1세,2018,157,80,77,103.9,157,80,77,103.9
37410, 봉화군,005003, 2세,2018,159,83,76,109.2,159,83,76,109.2
37410, 봉화군,005004, 3세,2018,182,109,73,149.3,182,109,73,149.3
37410, 봉화군,005005, 4세,2018,175,89,86,103.5,175,89,86,103.5
37410, 봉화군,010,5~9세,2018,825,436,389,112.1,824,435,389,111.8
37410, 봉화군,010001, 5세,2018,169,86,83,103.6,169,86,83,103.6
37410, 봉화군,010002, 6세,2018,164,88,76,115.8,164,88,76,115.8
37410, 봉화군,010003, 7세,2018,182,88,94,93.6,182,88,94,93.6
37410, 봉화군,010004, 8세,2018,150,77,73,105.5,150,77,73,105.5
37410, 봉화군,010005, 9세,2018,160,97,63,154,159,96,63,152.4
37410, 봉화군,015,10~14세,2018,852,426,426,100,851,426,425,100.2
37410, 봉화군,015001, 10세,2018,163,85,78,109,163,85,78,109
37410, 봉화군,015002, 11세,2018,186,77,109,70.6,186,77,109,70.6
37410, 봉화군,015003, 12세,2018,166,81,85,95.3,165,81,84,96.4
37410, 봉화군,015004, 13세,2018,155,79,76,103.9,155,79,76,103.9
37410, 봉화군,015005, 14세,2018,182,104,78,133.3,182,104,78,133.3
37410, 봉화군,020,15~19세,2018,986,557,429,129.8,983,557,426,130.8
37410, 봉화군,020001, 15세,2018,179,100,79,126.6,179,100,79,126.6
37410, 봉화군,020002, 16세,2018,221,130,91,142.9,220,130,90,144.4
37410, 봉화군,020003, 17세,2018,234,121,113,107.1,234,121,113,107.1
37410, 봉화군,020004, 18세,2018,213,117,96,121.9,213,117,96,121.9
37410, 봉화군,020005, 19세,2018,139,89,50,178,137,89,48,185.4
37410, 봉화군,025,20~24세,2018,945,570,375,152,895,552,343,160.9
37410, 봉화군,025001, 20세,2018,153,108,45,240,151,107,44,243.2
37410, 봉화군,025002, 21세,2018,212,135,77,175.3,205,134,71,188.7
37410, 봉화군,025003, 22세,2018,186,109,77,141.6,174,105,69,152.2
37410, 봉화군,025004, 23세,2018,188,105,83,126.5,173,98,75,130.7
37410, 봉화군,025005, 24세,2018,206,113,93,121.5,192,108,84,128.6
37410, 봉화군,030,25~29세,2018,930,493,437,112.8,850,463,387,119.6
37410, 봉화군,030001, 25세,2018,184,101,83,121.7,168,95,73,130.1
37410, 봉화군,030002, 26세,2018,183,100,83,120.5,166,90,76,118.4
37410, 봉화군,030003, 27세,2018,202,100,102,98,185,94,91,103.3
37410, 봉화군,030004, 28세,2018,184,99,85,116.5,169,95,74,128.4
37410, 봉화군,030005, 29세,2018,177,93,84,110.7,162,89,73,121.9
37410, 봉화군,035,30~34세,2018,991,521,470,110.9,912,499,413,120.8
37410, 봉화군,035001, 30세,2018,197,108,89,121.3,181,101,80,126.3
37410, 봉화군,035002, 31세,2018,188,102,86,118.6,167,96,71,135.2
37410, 봉화군,035003, 32세,2018,193,104,89,116.9,182,101,81,124.7
37410, 봉화군,035004, 33세,2018,189,97,92,105.4,169,93,76,122.4
37410, 봉화군,035005, 34세,2018,224,110,114,96.5,213,108,105,102.9
37410, 봉화군,040,35~39세,2018,1299,696,603,115.4,1251,680,571,119.1
37410, 봉화군,040001, 35세,2018,257,124,133,93.2,247,121,126,96
37410, 봉화군,040002, 36세,2018,245,122,123,99.2,237,121,116,104.3
37410, 봉화군,040003, 37세,2018,243,131,112,117,229,127,102,124.5
37410, 봉화군,040004, 38세,2018,279,160,119,134.5,270,154,116,132.8
37410, 봉화군,040005, 39세,2018,275,159,116,137.1,268,157,111,141.4
37410, 봉화군,045,40~44세,2018,1475,851,624,136.4,1442,838,604,138.7
37410, 봉화군,045001, 40세,2018,241,142,99,143.4,238,141,97,145.4
37410, 봉화군,045002, 41세,2018,277,156,121,128.9,271,153,118,129.7
37410, 봉화군,045003, 42세,2018,287,170,117,145.3,277,167,110,151.8
37410, 봉화군,045004, 43세,2018,319,183,136,134.6,313,180,133,135.3
37410, 봉화군,045005, 44세,2018,351,200,151,132.5,343,197,146,134.9
37410, 봉화군,050,45~49세,2018,1906,1084,822,131.9,1867,1073,794,135.1
37410, 봉화군,050001, 45세,2018,333,183,150,122,329,182,147,123.8
37410, 봉화군,050002, 46세,2018,346,211,135,156.3,340,208,132,157.6
37410, 봉화군,050003, 47세,2018,397,242,155,156.1,386,238,148,160.8
37410, 봉화군,050004, 48세,2018,389,217,172,126.2,384,216,168,128.6
37410, 봉화군,050005, 49세,2018,441,231,210,110,428,229,199,115.1
37410, 봉화군,055,50~54세,2018,2474,1318,1156,114,2432,1301,1131,115
37410, 봉화군,055001, 50세,2018,481,256,225,113.8,472,250,222,112.6
37410, 봉화군,055002, 51세,2018,455,249,206,120.9,449,248,201,123.4
37410, 봉화군,055003, 52세,2018,494,272,222,122.5,485,270,215,125.6
37410, 봉화군,055004, 53세,2018,542,273,269,101.5,533,270,263,102.7
37410, 봉화군,055005, 54세,2018,502,268,234,114.5,493,263,230,114.3
37410, 봉화군,060,55~59세,2018,3423,1733,1690,102.5,3388,1718,1670,102.9
37410, 봉화군,060001, 55세,2018,581,287,294,97.6,573,285,288,99
37410, 봉화군,060002, 56세,2018,686,382,304,125.7,680,378,302,125.2
37410, 봉화군,060003, 57세,2018,717,383,334,114.7,711,382,329,116.1
37410, 봉화군,060004, 58세,2018,793,371,422,87.9,786,366,420,87.1
37410, 봉화군,060005, 59세,2018,646,310,336,92.3,638,307,331,92.7
37410, 봉화군,065,60~64세,2018,3291,1734,1557,111.4,3277,1728,1549,111.6
37410, 봉화군,065001, 60세,2018,677,356,321,110.9,675,355,320,110.9
37410, 봉화군,065002, 61세,2018,685,354,331,106.9,682,354,328,107.9
37410, 봉화군,065003, 62세,2018,620,338,282,119.9,616,336,280,120
37410, 봉화군,065004, 63세,2018,701,367,334,109.9,698,365,333,109.6
37410, 봉화군,065005, 64세,2018,608,319,289,110.4,606,318,288,110.4
37410, 봉화군,070,65~69세,2018,2641,1319,1322,99.8,2633,1316,1317,99.9
37410, 봉화군,070001, 65세,2018,544,278,266,104.5,542,278,264,105.3
37410, 봉화군,070002, 66세,2018,584,287,297,96.6,581,285,296,96.3
37410, 봉화군,070003, 67세,2018,504,261,243,107.4,502,260,242,107.4
37410, 봉화군,070004, 68세,2018,493,237,256,92.6,492,237,255,92.9
37410, 봉화군,070005, 69세,2018,516,256,260,98.5,516,256,260,98.5
37410, 봉화군,075,70~74세,2018,2209,1020,1189,85.8,2205,1018,1187,85.8
37410, 봉화군,075001, 70세,2018,546,271,275,98.5,542,269,273,98.5
37410, 봉화군,075002, 71세,2018,531,238,293,81.2,531,238,293,81.2
37410, 봉화군,075003, 72세,2018,285,150,135,111.1,285,150,135,111.1
37410, 봉화군,075004, 73세,2018,380,157,223,70.4,380,157,223,70.4
37410, 봉화군,075005, 74세,2018,467,204,263,77.6,467,204,263,77.6
37410, 봉화군,080,75~79세,2018,2565,1049,1516,69.2,2565,1049,1516,69.2
37410, 봉화군,080001, 75세,2018,525,203,322,63,525,203,322,63
37410, 봉화군,080002, 76세,2018,552,235,317,74.1,552,235,317,74.1
37410, 봉화군,080003, 77세,2018,492,200,292,68.5,492,200,292,68.5
37410, 봉화군,080004, 78세,2018,521,212,309,68.6,521,212,309,68.6
37410, 봉화군,080005, 79세,2018,475,199,276,72.1,475,199,276,72.1
37410, 봉화군,085,80~84세,2018,1940,686,1254,54.7,1940,686,1254,54.7
37410, 봉화군,085001, 80세,2018,452,156,296,52.7,452,156,296,52.7
37410, 봉화군,085002, 81세,2018,392,133,259,51.4,392,133,259,51.4
37410, 봉화군,085003, 82세,2018,390,153,237,64.6,390,153,237,64.6
37410, 봉화군,085004, 83세,2018,402,131,271,48.3,402,131,271,48.3
37410, 봉화군,085005, 84세,2018,304,113,191,59.2,304,113,191,59.2
37410, 봉화군,090,85~89세,2018,898,288,610,47.2,897,287,610,47
37410, 봉화군,090001, 85세,2018,240,84,156,53.8,240,84,156,53.8
37410, 봉화군,090002, 86세,2018,207,68,139,48.9,206,67,139,48.2
37410, 봉화군,090003, 87세,2018,155,43,112,38.4,155,43,112,38.4
37410, 봉화군,090004, 88세,2018,171,53,118,44.9,171,53,118,44.9
37410, 봉화군,090005, 89세,2018,125,40,85,47.1,125,40,85,47.1
37410, 봉화군,095,90~94세,2018,323,69,254,27.2,323,69,254,27.2
37410, 봉화군,095001, 90세,2018,99,27,72,37.5,99,27,72,37.5
37410, 봉화군,095002, 91세,2018,80,17,63,27,80,17,63,27
37410, 봉화군,095003, 92세,2018,52,8,44,18.2,52,8,44,18.2
37410, 봉화군,095004, 93세,2018,64,9,55,16.4,64,9,55,16.4
37410, 봉화군,095005, 94세,2018,28,8,20,40,28,8,20,40
37410, 봉화군,100,95~99세,2018,75,14,61,23,75,14,61,23
37410, 봉화군,100001, 95세,2018,29,6,23,26.1,29,6,23,26.1
37410, 봉화군,100002, 96세,2018,17,5,12,41.7,17,5,12,41.7
37410, 봉화군,100003, 97세,2018,18,X,16,12.5,18,X,16,12.5
37410, 봉화군,100004, 98세,2018,6,X,6,0,6,X,6,0
37410, 봉화군,100005, 99세,2018,5,X,X,25,5,X,X,25
37410, 봉화군,101,100세이상,2018,12,X,11,9.1,12,X,11,9.1
37410, 봉화군,102,15세미만,2018,2489,1294,1195,108.3,2487,1293,1194,108.3
37410, 봉화군,103,15~64세,2018,17720,9557,8163,117.1,17297,9409,7888,119.3
37410, 봉화군,104,65세이상,2018,10663,4446,6217,71.5,10650,4440,6210,71.5
37410, 봉화군,086,85세이상,2018,1308,372,936,39.7,1307,371,936,39.6
37410, 봉화군,126,평균연령,2018,53.9,51.5,56.2,,54.1,51.6,56.6,
37410, 봉화군,127,중위연령,2018,57.9,55.9,60,,58.2,56.1,60.4,
37420, 울진군,000,합계,2018,48057,24778,23279,106.4,46196,23184,23012,100.7
37420, 울진군,005,0~4세,2018,1511,753,758,99.3,1507,753,754,99.9
37420, 울진군,005001, 0세,2018,242,133,109,122,240,133,107,124.3
37420, 울진군,005002, 1세,2018,260,126,134,94,260,126,134,94
37420, 울진군,005003, 2세,2018,324,147,177,83.1,323,147,176,83.5
37420, 울진군,005004, 3세,2018,334,182,152,119.7,333,182,151,120.5
37420, 울진군,005005, 4세,2018,351,165,186,88.7,351,165,186,88.7
37420, 울진군,010,5~9세,2018,1631,856,775,110.5,1628,855,773,110.6
37420, 울진군,010001, 5세,2018,337,166,171,97.1,337,166,171,97.1
37420, 울진군,010002, 6세,2018,341,194,147,132,340,194,146,132.9
37420, 울진군,010003, 7세,2018,331,164,167,98.2,331,164,167,98.2
37420, 울진군,010004, 8세,2018,323,181,142,127.5,322,180,142,126.8
37420, 울진군,010005, 9세,2018,299,151,148,102,298,151,147,102.7
37420, 울진군,015,10~14세,2018,1780,950,830,114.5,1780,950,830,114.5
37420, 울진군,015001, 10세,2018,364,196,168,116.7,364,196,168,116.7
37420, 울진군,015002, 11세,2018,378,213,165,129.1,378,213,165,129.1
37420, 울진군,015003, 12세,2018,332,183,149,122.8,332,183,149,122.8
37420, 울진군,015004, 13세,2018,340,162,178,91,340,162,178,91
37420, 울진군,015005, 14세,2018,366,196,170,115.3,366,196,170,115.3
37420, 울진군,020,15~19세,2018,2034,1220,814,149.9,2024,1210,814,148.6
37420, 울진군,020001, 15세,2018,350,183,167,109.6,350,183,167,109.6
37420, 울진군,020002, 16세,2018,491,283,208,136.1,491,283,208,136.1
37420, 울진군,020003, 17세,2018,490,287,203,141.4,489,286,203,140.9
37420, 울진군,020004, 18세,2018,477,296,181,163.5,474,293,181,161.9
37420, 울진군,020005, 19세,2018,226,171,55,310.9,220,165,55,300
37420, 울진군,025,20~24세,2018,1751,1201,550,218.4,1559,1028,531,193.6
37420, 울진군,025001, 20세,2018,318,244,74,329.7,304,233,71,328.2
37420, 울진군,025002, 21세,2018,365,276,89,310.1,344,261,83,314.5
37420, 울진군,025003, 22세,2018,306,213,93,229,278,188,90,208.9
37420, 울진군,025004, 23세,2018,373,244,129,189.1,313,187,126,148.4
37420, 울진군,025005, 24세,2018,389,224,165,135.8,320,159,161,98.8
37420, 울진군,030,25~29세,2018,2303,1491,812,183.6,1820,1064,756,140.7
37420, 울진군,030001, 25세,2018,432,270,162,166.7,335,185,150,123.3
37420, 울진군,030002, 26세,2018,436,275,161,170.8,338,193,145,133.1
37420, 울진군,030003, 27세,2018,493,315,178,177,403,233,170,137.1
37420, 울진군,030004, 28세,2018,469,309,160,193.1,377,228,149,153
37420, 울진군,030005, 29세,2018,473,322,151,213.2,367,225,142,158.5
37420, 울진군,035,30~34세,2018,2363,1446,917,157.7,1965,1095,870,125.9
37420, 울진군,035001, 30세,2018,481,302,179,168.7,400,229,171,133.9
37420, 울진군,035002, 31세,2018,527,325,202,160.9,427,235,192,122.4
37420, 울진군,035003, 32세,2018,440,275,165,166.7,371,214,157,136.3
37420, 울진군,035004, 33세,2018,458,276,182,151.6,380,209,171,122.2
37420, 울진군,035005, 34세,2018,457,268,189,141.8,387,208,179,116.2
37420, 울진군,040,35~39세,2018,2958,1682,1276,131.8,2638,1388,1250,111
37420, 울진군,040001, 35세,2018,546,320,226,141.6,464,244,220,110.9
37420, 울진군,040002, 36세,2018,610,341,269,126.8,549,284,265,107.2
37420, 울진군,040003, 37세,2018,575,329,246,133.7,514,273,241,113.3
37420, 울진군,040004, 38세,2018,625,346,279,124,562,289,273,105.9
37420, 울진군,040005, 39세,2018,602,346,256,135.2,549,298,251,118.7
37420, 울진군,045,40~44세,2018,3023,1711,1312,130.4,2840,1539,1301,118.3
37420, 울진군,045001, 40세,2018,582,340,242,140.5,539,298,241,123.7
37420, 울진군,045002, 41세,2018,606,315,291,108.2,574,288,286,100.7
37420, 울진군,045003, 42세,2018,567,342,225,152,526,303,223,135.9
37420, 울진군,045004, 43세,2018,645,372,273,136.3,604,334,270,123.7
37420, 울진군,045005, 44세,2018,623,342,281,121.7,597,316,281,112.5
37420, 울진군,050,45~49세,2018,3706,2119,1587,133.5,3583,2020,1563,129.2
37420, 울진군,050001, 45세,2018,736,424,312,135.9,712,402,310,129.7
37420, 울진군,050002, 46세,2018,654,364,290,125.5,629,347,282,123
37420, 울진군,050003, 47세,2018,818,485,333,145.6,787,460,327,140.7
37420, 울진군,050004, 48세,2018,752,439,313,140.3,734,425,309,137.5
37420, 울진군,050005, 49세,2018,746,407,339,120.1,721,386,335,115.2
37420, 울진군,055,50~54세,2018,3791,2083,1708,122,3727,2048,1679,122
37420, 울진군,055001, 50세,2018,756,407,349,116.6,737,394,343,114.9
37420, 울진군,055002, 51세,2018,729,405,324,125,717,401,316,126.9
37420, 울진군,055003, 52세,2018,765,427,338,126.3,753,420,333,126.1
37420, 울진군,055004, 53세,2018,779,424,355,119.4,771,418,353,118.4
37420, 울진군,055005, 54세,2018,762,420,342,122.8,749,415,334,124.3
37420, 울진군,060,55~59세,2018,4640,2379,2261,105.2,4601,2361,2240,105.4
37420, 울진군,060001, 55세,2018,845,456,389,117.2,841,453,388,116.8
37420, 울진군,060002, 56세,2018,873,436,437,99.8,865,433,432,100.2
37420, 울진군,060003, 57세,2018,1078,567,511,111,1067,562,505,111.3
37420, 울진군,060004, 58세,2018,997,498,499,99.8,984,493,491,100.4
37420, 울진군,060005, 59세,2018,847,422,425,99.3,844,420,424,99.1
37420, 울진군,065,60~64세,2018,4084,2030,2054,98.8,4064,2025,2039,99.3
37420, 울진군,065001, 60세,2018,830,429,401,107,826,427,399,107
37420, 울진군,065002, 61세,2018,840,426,414,102.9,836,426,410,103.9
37420, 울진군,065003, 62세,2018,883,418,465,89.9,880,418,462,90.5
37420, 울진군,065004, 63세,2018,762,384,378,101.6,758,383,375,102.1
37420, 울진군,065005, 64세,2018,769,373,396,94.2,764,371,393,94.4
37420, 울진군,070,65~69세,2018,3047,1483,1564,94.8,3035,1476,1559,94.7
37420, 울진군,070001, 65세,2018,670,327,343,95.3,668,325,343,94.8
37420, 울진군,070002, 66세,2018,644,305,339,90,640,303,337,89.9
37420, 울진군,070003, 67세,2018,494,245,249,98.4,493,244,249,98
37420, 울진군,070004, 68세,2018,594,296,298,99.3,592,295,297,99.3
37420, 울진군,070005, 69세,2018,645,310,335,92.5,642,309,333,92.8
37420, 울진군,075,70~74세,2018,2642,1189,1453,81.8,2637,1188,1449,82
37420, 울진군,075001, 70세,2018,661,331,330,100.3,660,331,329,100.6
37420, 울진군,075002, 71세,2018,515,231,284,81.3,514,231,283,81.6
37420, 울진군,075003, 72세,2018,447,228,219,104.1,447,228,219,104.1
37420, 울진군,075004, 73세,2018,502,194,308,63,501,194,307,63.2
37420, 울진군,075005, 74세,2018,517,205,312,65.7,515,204,311,65.6
37420, 울진군,080,75~79세,2018,3021,1133,1888,60,3019,1132,1887,60
37420, 울진군,080001, 75세,2018,635,254,381,66.7,634,253,381,66.4
37420, 울진군,080002, 76세,2018,683,268,415,64.6,683,268,415,64.6
37420, 울진군,080003, 77세,2018,550,213,337,63.2,550,213,337,63.2
37420, 울진군,080004, 78세,2018,554,192,362,53,554,192,362,53
37420, 울진군,080005, 79세,2018,599,206,393,52.4,598,206,392,52.6
37420, 울진군,085,80~84세,2018,2204,724,1480,48.9,2202,724,1478,49
37420, 울진군,085001, 80세,2018,506,188,318,59.1,506,188,318,59.1
37420, 울진군,085002, 81세,2018,500,165,335,49.3,500,165,335,49.3
37420, 울진군,085003, 82세,2018,442,142,300,47.3,442,142,300,47.3
37420, 울진군,085004, 83세,2018,432,125,307,40.7,430,125,305,41
37420, 울진군,085005, 84세,2018,324,104,220,47.3,324,104,220,47.3
37420, 울진군,090,85~89세,2018,1118,260,858,30.3,1117,260,857,30.3
37420, 울진군,090001, 85세,2018,295,95,200,47.5,294,95,199,47.7
37420, 울진군,090002, 86세,2018,253,42,211,19.9,253,42,211,19.9
37420, 울진군,090003, 87세,2018,227,53,174,30.5,227,53,174,30.5
37420, 울진군,090004, 88세,2018,203,46,157,29.3,203,46,157,29.3
37420, 울진군,090005, 89세,2018,140,24,116,20.7,140,24,116,20.7
37420, 울진군,095,90~94세,2018,373,57,316,18,373,57,316,18
37420, 울진군,095001, 90세,2018,121,20,101,19.8,121,20,101,19.8
37420, 울진군,095002, 91세,2018,90,17,73,23.3,90,17,73,23.3
37420, 울진군,095003, 92세,2018,62,8,54,14.8,62,8,54,14.8
37420, 울진군,095004, 93세,2018,61,6,55,10.9,61,6,55,10.9
37420, 울진군,095005, 94세,2018,39,6,33,18.2,39,6,33,18.2
37420, 울진군,100,95~99세,2018,69,11,58,19,69,11,58,19
37420, 울진군,100001, 95세,2018,29,7,22,31.8,29,7,22,31.8
37420, 울진군,100002, 96세,2018,21,X,18,16.7,21,X,18,16.7
37420, 울진군,100003, 97세,2018,8,X,7,14.3,8,X,7,14.3
37420, 울진군,100004, 98세,2018,5,X,5,0,5,X,5,0
37420, 울진군,100005, 99세,2018,6,X,6,0,6,X,6,0
37420, 울진군,101,100세이상,2018,8,X,8,0,8,X,8,0
37420, 울진군,102,15세미만,2018,4922,2559,2363,108.3,4915,2558,2357,108.5
37420, 울진군,103,15~64세,2018,30653,17362,13291,130.6,28821,15778,13043,121
37420, 울진군,104,65세이상,2018,12482,4857,7625,63.7,12460,4848,7612,63.7
37420, 울진군,086,85세이상,2018,1568,328,1240,26.5,1567,328,1239,26.5
37420, 울진군,126,평균연령,2018,48.7,45.5,52.1,,49.3,46.3,52.3,
37420, 울진군,127,중위연령,2018,51.3,47.6,55.8,,52.4,49.2,56,
37430, 울릉군,000,합계,2018,8729,4837,3892,124.3,8469,4627,3842,120.4
37430, 울릉군,005,0~4세,2018,214,113,101,111.9,212,113,99,114.1
37430, 울릉군,005001, 0세,2018,33,18,15,120,33,18,15,120
37430, 울릉군,005002, 1세,2018,30,16,14,114.3,30,16,14,114.3
37430, 울릉군,005003, 2세,2018,43,23,20,115,42,23,19,121.1
37430, 울릉군,005004, 3세,2018,57,30,27,111.1,57,30,27,111.1
37430, 울릉군,005005, 4세,2018,51,26,25,104,50,26,24,108.3
37430, 울릉군,010,5~9세,2018,248,125,123,101.6,248,125,123,101.6
37430, 울릉군,010001, 5세,2018,53,25,28,89.3,53,25,28,89.3
37430, 울릉군,010002, 6세,2018,54,21,33,63.6,54,21,33,63.6
37430, 울릉군,010003, 7세,2018,47,29,18,161.1,47,29,18,161.1
37430, 울릉군,010004, 8세,2018,48,27,21,128.6,48,27,21,128.6
37430, 울릉군,010005, 9세,2018,46,23,23,100,46,23,23,100
37430, 울릉군,015,10~14세,2018,232,115,117,98.3,232,115,117,98.3
37430, 울릉군,015001, 10세,2018,55,30,25,120,55,30,25,120
37430, 울릉군,015002, 11세,2018,49,19,30,63.3,49,19,30,63.3
37430, 울릉군,015003, 12세,2018,42,22,20,110,42,22,20,110
37430, 울릉군,015004, 13세,2018,47,24,23,104.3,47,24,23,104.3
37430, 울릉군,015005, 14세,2018,39,20,19,105.3,39,20,19,105.3
37430, 울릉군,020,15~19세,2018,202,113,89,127,200,111,89,124.7
37430, 울릉군,020001, 15세,2018,41,27,14,192.9,41,27,14,192.9
37430, 울릉군,020002, 16세,2018,40,21,19,110.5,40,21,19,110.5
37430, 울릉군,020003, 17세,2018,45,25,20,125,45,25,20,125
37430, 울릉군,020004, 18세,2018,54,22,32,68.8,54,22,32,68.8
37430, 울릉군,020005, 19세,2018,22,18,X,450,20,16,X,400
37430, 울릉군,025,20~24세,2018,314,224,90,248.9,289,203,86,236
37430, 울릉군,025001, 20세,2018,47,38,9,422.2,43,35,8,437.5
37430, 울릉군,025002, 21세,2018,69,57,12,475,67,55,12,458.3
37430, 울릉군,025003, 22세,2018,44,26,18,144.4,42,25,17,147.1
37430, 울릉군,025004, 23세,2018,79,55,24,229.2,68,45,23,195.7
37430, 울릉군,025005, 24세,2018,75,48,27,177.8,69,43,26,165.4
37430, 울릉군,030,25~29세,2018,493,307,186,165.1,428,248,180,137.8
37430, 울릉군,030001, 25세,2018,99,56,43,130.2,83,41,42,97.6
37430, 울릉군,030002, 26세,2018,92,65,27,240.7,82,55,27,203.7
37430, 울릉군,030003, 27세,2018,98,60,38,157.9,86,48,38,126.3
37430, 울릉군,030004, 28세,2018,99,60,39,153.8,86,50,36,138.9
37430, 울릉군,030005, 29세,2018,105,66,39,169.2,91,54,37,145.9
37430, 울릉군,035,30~34세,2018,452,273,179,152.5,404,230,174,132.2
37430, 울릉군,035001, 30세,2018,87,62,25,248,76,54,22,245.5
37430, 울릉군,035002, 31세,2018,76,49,27,181.5,69,43,26,165.4
37430, 울릉군,035003, 32세,2018,81,45,36,125,75,40,35,114.3
37430, 울릉군,035004, 33세,2018,91,57,34,167.6,78,44,34,129.4
37430, 울릉군,035005, 34세,2018,117,60,57,105.3,106,49,57,86
37430, 울릉군,040,35~39세,2018,551,335,216,155.1,520,305,215,141.9
37430, 울릉군,040001, 35세,2018,97,54,43,125.6,90,47,43,109.3
37430, 울릉군,040002, 36세,2018,109,67,42,159.5,102,60,42,142.9
37430, 울릉군,040003, 37세,2018,130,82,48,170.8,124,76,48,158.3
37430, 울릉군,040004, 38세,2018,125,78,47,166,117,71,46,154.3
37430, 울릉군,040005, 39세,2018,90,54,36,150,87,51,36,141.7
37430, 울릉군,045,40~44세,2018,611,374,237,157.8,596,362,234,154.7
37430, 울릉군,045001, 40세,2018,108,61,47,129.8,105,59,46,128.3
37430, 울릉군,045002, 41세,2018,118,67,51,131.4,114,65,49,132.7
37430, 울릉군,045003, 42세,2018,117,66,51,129.4,114,63,51,123.5
37430, 울릉군,045004, 43세,2018,125,86,39,220.5,122,83,39,212.8
37430, 울릉군,045005, 44세,2018,143,94,49,191.8,141,92,49,187.8
37430, 울릉군,050,45~49세,2018,759,476,283,168.2,750,469,281,166.9
37430, 울릉군,050001, 45세,2018,135,81,54,150,132,78,54,144.4
37430, 울릉군,050002, 46세,2018,131,83,48,172.9,130,82,48,170.8
37430, 울릉군,050003, 47세,2018,174,109,65,167.7,174,109,65,167.7
37430, 울릉군,050004, 48세,2018,154,96,58,165.5,153,96,57,168.4
37430, 울릉군,050005, 49세,2018,165,107,58,184.5,161,104,57,182.5
37430, 울릉군,055,50~54세,2018,801,470,331,142,790,463,327,141.6
37430, 울릉군,055001, 50세,2018,165,94,71,132.4,165,94,71,132.4
37430, 울릉군,055002, 51세,2018,149,88,61,144.3,146,87,59,147.5
37430, 울릉군,055003, 52세,2018,168,97,71,136.6,166,96,70,137.1
37430, 울릉군,055004, 53세,2018,181,116,65,178.5,175,111,64,173.4
37430, 울릉군,055005, 54세,2018,138,75,63,119,138,75,63,119
37430, 울릉군,060,55~59세,2018,1020,548,472,116.1,1001,539,462,116.7
37430, 울릉군,060001, 55세,2018,196,104,92,113,193,101,92,109.8
37430, 울릉군,060002, 56세,2018,187,113,74,152.7,184,112,72,155.6
37430, 울릉군,060003, 57세,2018,224,112,112,100,222,111,111,100
37430, 울릉군,060004, 58세,2018,195,109,86,126.7,190,107,83,128.9
37430, 울릉군,060005, 59세,2018,218,110,108,101.9,212,108,104,103.8
37430, 울릉군,065,60~64세,2018,846,457,389,117.5,822,444,378,117.5
37430, 울릉군,065001, 60세,2018,177,91,86,105.8,173,89,84,106
37430, 울릉군,065002, 61세,2018,196,107,89,120.2,192,104,88,118.2
37430, 울릉군,065003, 62세,2018,166,89,77,115.6,161,87,74,117.6
37430, 울릉군,065004, 63세,2018,168,97,71,136.6,163,93,70,132.9
37430, 울릉군,065005, 64세,2018,139,73,66,110.6,133,71,62,114.5
37430, 울릉군,070,65~69세,2018,654,317,337,94.1,647,311,336,92.6
37430, 울릉군,070001, 65세,2018,146,71,75,94.7,144,69,75,92
37430, 울릉군,070002, 66세,2018,151,72,79,91.1,149,70,79,88.6
37430, 울릉군,070003, 67세,2018,137,76,61,124.6,135,75,60,125
37430, 울릉군,070004, 68세,2018,115,47,68,69.1,114,46,68,67.6
37430, 울릉군,070005, 69세,2018,105,51,54,94.4,105,51,54,94.4
37430, 울릉군,075,70~74세,2018,520,258,262,98.5,519,257,262,98.1
37430, 울릉군,075001, 70세,2018,116,65,51,127.5,116,65,51,127.5
37430, 울릉군,075002, 71세,2018,120,64,56,114.3,120,64,56,114.3
37430, 울릉군,075003, 72세,2018,92,42,50,84,91,41,50,82
37430, 울릉군,075004, 73세,2018,96,41,55,74.5,96,41,55,74.5
37430, 울릉군,075005, 74세,2018,96,46,50,92,96,46,50,92
37430, 울릉군,080,75~79세,2018,387,183,204,89.7,386,183,203,90.1
37430, 울릉군,080001, 75세,2018,82,34,48,70.8,82,34,48,70.8
37430, 울릉군,080002, 76세,2018,96,50,46,108.7,96,50,46,108.7
37430, 울릉군,080003, 77세,2018,73,36,37,97.3,72,36,36,100
37430, 울릉군,080004, 78세,2018,65,29,36,80.6,65,29,36,80.6
37430, 울릉군,080005, 79세,2018,71,34,37,91.9,71,34,37,91.9
37430, 울릉군,085,80~84세,2018,259,103,156,66,259,103,156,66
37430, 울릉군,085001, 80세,2018,54,21,33,63.6,54,21,33,63.6
37430, 울릉군,085002, 81세,2018,60,19,41,46.3,60,19,41,46.3
37430, 울릉군,085003, 82세,2018,60,31,29,106.9,60,31,29,106.9
37430, 울릉군,085004, 83세,2018,43,20,23,87,43,20,23,87
37430, 울릉군,085005, 84세,2018,42,12,30,40,42,12,30,40
37430, 울릉군,090,85~89세,2018,127,37,90,41.1,127,37,90,41.1
37430, 울릉군,090001, 85세,2018,25,5,20,25,25,5,20,25
37430, 울릉군,090002, 86세,2018,33,10,23,43.5,33,10,23,43.5
37430, 울릉군,090003, 87세,2018,28,7,21,33.3,28,7,21,33.3
37430, 울릉군,090004, 88세,2018,25,9,16,56.3,25,9,16,56.3
37430, 울릉군,090005, 89세,2018,16,6,10,60,16,6,10,60
37430, 울릉군,095,90~94세,2018,31,9,22,40.9,31,9,22,40.9
37430, 울릉군,095001, 90세,2018,12,X,11,9.1,12,X,11,9.1
37430, 울릉군,095002, 91세,2018,6,X,X,50,6,X,X,50
37430, 울릉군,095003, 92세,2018,6,X,X,200,6,X,X,200
37430, 울릉군,095004, 93세,2018,X,X,X,0,X,X,X,0
37430, 울릉군,095005, 94세,2018,X,X,X,200,X,X,X,200
37430, 울릉군,100,95~99세,2018,8,X,8,0,8,X,8,0
37430, 울릉군,100001, 95세,2018,X,X,X,0,X,X,X,0
37430, 울릉군,100002, 96세,2018,X,X,X,0,X,X,X,0
37430, 울릉군,100003, 97세,2018,X,X,X,0,X,X,X,0
37430, 울릉군,100004, 98세,2018,X,X,X,0,X,X,X,0
37430, 울릉군,100005, 99세,2018,X,X,X,,X,X,X,
37430, 울릉군,101,100세이상,2018,X,X,X,,X,X,X,
37430, 울릉군,102,15세미만,2018,694,353,341,103.5,692,353,339,104.1
37430, 울릉군,103,15~64세,2018,6049,3577,2472,144.7,5800,3374,2426,139.1
37430, 울릉군,104,65세이상,2018,1986,907,1079,84.1,1977,900,1077,83.6
37430, 울릉군,086,85세이상,2018,166,46,120,38.3,166,46,120,38.3
37430, 울릉군,126,평균연령,2018,49.1,47.5,51,,49.4,48,51.1,
37430, 울릉군,127,중위연령,2018,51.8,49.7,54.9,,52.3,50.3,54.9,
38,경상남도,000,합계,2018,3350350,1703904,1646446,103.5,3252856,1637986,1614870,101.4
38,경상남도,005,0~4세,2018,136158,69913,66245,105.5,135000,69339,65661,105.6
38,경상남도,005001, 0세,2018,21816,11172,10644,105,21593,11055,10538,104.9
38,경상남도,005002, 1세,2018,24761,12732,12029,105.8,24530,12622,11908,106
38,경상남도,005003, 2세,2018,28348,14520,13828,105,28115,14406,13709,105.1
38,경상남도,005004, 3세,2018,30430,15648,14782,105.9,30174,15513,14661,105.8
38,경상남도,005005, 4세,2018,30803,15841,14962,105.9,30588,15743,14845,106
38,경상남도,010,5~9세,2018,160413,82823,77590,106.7,159682,82457,77225,106.8
38,경상남도,010001, 5세,2018,30764,15814,14950,105.8,30577,15719,14858,105.8
38,경상남도,010002, 6세,2018,33716,17401,16315,106.7,33553,17320,16233,106.7
38,경상남도,010003, 7세,2018,33219,17104,16115,106.1,33086,17031,16055,106.1
38,경상남도,010004, 8세,2018,31889,16540,15349,107.8,31760,16478,15282,107.8
38,경상남도,010005, 9세,2018,30825,15964,14861,107.4,30706,15909,14797,107.5
38,경상남도,015,10~14세,2018,155817,81009,74808,108.3,155327,80758,74569,108.3
38,경상남도,015001, 10세,2018,32483,16646,15837,105.1,32363,16590,15773,105.2
38,경상남도,015002, 11세,2018,32850,17022,15828,107.5,32747,16970,15777,107.6
38,경상남도,015003, 12세,2018,29799,15502,14297,108.4,29702,15451,14251,108.4
38,경상남도,015004, 13세,2018,29134,15195,13939,109,29051,15147,13904,108.9
38,경상남도,015005, 14세,2018,31551,16644,14907,111.7,31464,16600,14864,111.7
38,경상남도,020,15~19세,2018,177600,95305,82295,115.8,176316,94602,81714,115.8
38,경상남도,020001, 15세,2018,32094,16992,15102,112.5,32014,16951,15063,112.5
38,경상남도,020002, 16세,2018,33596,17781,15815,112.4,33504,17729,15775,112.4
38,경상남도,020003, 17세,2018,38037,20045,17992,111.4,37889,19961,17928,111.3
38,경상남도,020004, 18세,2018,39990,21262,18728,113.5,39673,21084,18589,113.4
38,경상남도,020005, 19세,2018,33883,19225,14658,131.2,33236,18877,14359,131.5
38,경상남도,025,20~24세,2018,198855,114850,84005,136.7,188367,108191,80176,134.9
38,경상남도,025001, 20세,2018,37378,21802,15576,140,36236,21176,15060,140.6
38,경상남도,025002, 21세,2018,40039,23325,16714,139.6,38478,22406,16072,139.4
38,경상남도,025003, 22세,2018,41035,23899,17136,139.5,38946,22557,16389,137.6
38,경상남도,025004, 23세,2018,40412,23135,17277,133.9,37754,21422,16332,131.2
38,경상남도,025005, 24세,2018,39991,22689,17302,131.1,36953,20630,16323,126.4
38,경상남도,030,25~29세,2018,194467,109699,84768,129.4,174382,95198,79184,120.2
38,경상남도,030001, 25세,2018,39996,22684,17312,131,36482,20220,16262,124.3
38,경상남도,030002, 26세,2018,40059,22299,17760,125.6,36201,19559,16642,117.5
38,경상남도,030003, 27세,2018,38451,21559,16892,127.6,34433,18666,15767,118.4
38,경상남도,030004, 28세,2018,38256,21810,16446,132.6,33820,18553,15267,121.5
38,경상남도,030005, 29세,2018,37705,21347,16358,130.5,33446,18200,15246,119.4
38,경상남도,035,30~34세,2018,201095,110616,90479,122.3,180466,95268,85198,111.8
38,경상남도,035001, 30세,2018,37233,20826,16407,126.9,32930,17637,15293,115.3
38,경상남도,035002, 31세,2018,38657,21183,17474,121.2,34167,17883,16284,109.8
38,경상남도,035003, 32세,2018,39861,22277,17584,126.7,35660,19140,16520,115.9
38,경상남도,035004, 33세,2018,41132,22607,18525,122,37162,19594,17568,111.5
38,경상남도,035005, 34세,2018,44212,23723,20489,115.8,40547,21014,19533,107.6
38,경상남도,040,35~39세,2018,265736,140598,125138,112.4,251613,130126,121487,107.1
38,경상남도,040001, 35세,2018,48942,26069,22873,114,45557,23526,22031,106.8
38,경상남도,040002, 36세,2018,53320,28175,25145,112.1,50172,25860,24312,106.4
38,경상남도,040003, 37세,2018,54505,29091,25414,114.5,51756,27043,24713,109.4
38,경상남도,040004, 38세,2018,56307,29461,26846,109.7,53794,27577,26217,105.2
38,경상남도,040005, 39세,2018,52662,27802,24860,111.8,50334,26120,24214,107.9
38,경상남도,045,40~44세,2018,254207,132335,121872,108.6,245233,126115,119118,105.9
38,경상남도,045001, 40세,2018,48836,25763,23073,111.7,46689,24233,22456,107.9
38,경상남도,045002, 41세,2018,49064,25619,23445,109.3,47262,24362,22900,106.4
38,경상남도,045003, 42세,2018,48580,25463,23117,110.1,46770,24171,22599,107
38,경상남도,045004, 43세,2018,51883,26663,25220,105.7,50220,25563,24657,103.7
38,경상남도,045005, 44세,2018,55844,28827,27017,106.7,54292,27786,26506,104.8
38,경상남도,050,45~49세,2018,295793,152356,143437,106.2,288911,148116,140795,105.2
38,경상남도,050001, 45세,2018,57903,29673,28230,105.1,56495,28781,27714,103.9
38,경상남도,050002, 46세,2018,56396,29575,26821,110.3,54935,28625,26310,108.8
38,경상남도,050003, 47세,2018,60849,31295,29554,105.9,59396,30390,29006,104.8
38,경상남도,050004, 48세,2018,60183,30837,29346,105.1,58848,30037,28811,104.3
38,경상남도,050005, 49세,2018,60462,30976,29486,105.1,59237,30283,28954,104.6
38,경상남도,055,50~54세,2018,277459,141065,136394,103.4,272262,138230,134032,103.1
38,경상남도,055001, 50세,2018,60688,30566,30122,101.5,59507,29877,29630,100.8
38,경상남도,055002, 51세,2018,56098,28128,27970,100.6,55038,27545,27493,100.2
38,경상남도,055003, 52세,2018,55451,28986,26465,109.5,54442,28434,26008,109.3
38,경상남도,055004, 53세,2018,55504,28027,27477,102,54520,27494,27026,101.7
38,경상남도,055005, 54세,2018,49718,25358,24360,104.1,48755,24880,23875,104.2
38,경상남도,060,55~59세,2018,290088,146891,143197,102.6,286442,144983,141459,102.5
38,경상남도,060001, 55세,2018,54351,28259,26092,108.3,53319,27709,25610,108.2
38,경상남도,060002, 56세,2018,58481,29928,28553,104.8,57645,29478,28167,104.7
38,경상남도,060003, 57세,2018,62835,31312,31523,99.3,62251,31020,31231,99.3
38,경상남도,060004, 58세,2018,60941,30368,30573,99.3,60257,30020,30237,99.3
38,경상남도,060005, 59세,2018,53480,27024,26456,102.1,52970,26756,26214,102.1
38,경상남도,065,60~64세,2018,233714,116896,116818,100.1,231590,115812,115778,100
38,경상남도,065001, 60세,2018,51079,25957,25122,103.3,50536,25681,24855,103.3
38,경상남도,065002, 61세,2018,49947,25153,24794,101.4,49497,24908,24589,101.3
38,경상남도,065003, 62세,2018,46398,23129,23269,99.4,45986,22919,23067,99.4
38,경상남도,065004, 63세,2018,46888,22890,23998,95.4,46516,22696,23820,95.3
38,경상남도,065005, 64세,2018,39402,19767,19635,100.7,39055,19608,19447,100.8
38,경상남도,070,65~69세,2018,160457,77932,82525,94.4,159444,77432,82012,94.4
38,경상남도,070001, 65세,2018,34112,16699,17413,95.9,33823,16555,17268,95.9
38,경상남도,070002, 66세,2018,37286,18244,19042,95.8,37064,18138,18926,95.8
38,경상남도,070003, 67세,2018,29474,14194,15280,92.9,29292,14110,15182,92.9
38,경상남도,070004, 68세,2018,29585,14351,15234,94.2,29410,14260,15150,94.1
38,경상남도,070005, 69세,2018,30000,14444,15556,92.9,29855,14369,15486,92.8
38,경상남도,075,70~74세,2018,119054,54421,64633,84.2,118700,54275,64425,84.2
38,경상남도,075001, 70세,2018,29390,13999,15391,91,29297,13959,15338,91
38,경상남도,075002, 71세,2018,27367,12692,14675,86.5,27274,12654,14620,86.6
38,경상남도,075003, 72세,2018,20122,9338,10784,86.6,20056,9310,10746,86.6
38,경상남도,075004, 73세,2018,20553,9085,11468,79.2,20496,9063,11433,79.3
38,경상남도,075005, 74세,2018,21622,9307,12315,75.6,21577,9289,12288,75.6
38,경상남도,080,75~79세,2018,108845,42401,66444,63.8,108675,42340,66335,63.8
38,경상남도,080001, 75세,2018,22337,9209,13128,70.1,22301,9194,13107,70.1
38,경상남도,080002, 76세,2018,24988,10003,14985,66.8,24958,9992,14966,66.8
38,경상남도,080003, 77세,2018,21693,8499,13194,64.4,21653,8490,13163,64.5
38,경상남도,080004, 78세,2018,20157,7548,12609,59.9,20118,7532,12586,59.8
38,경상남도,080005, 79세,2018,19670,7142,12528,57,19645,7132,12513,57
38,경상남도,085,80~84세,2018,72467,23698,48769,48.6,72364,23660,48704,48.6
38,경상남도,085001, 80세,2018,16730,5883,10847,54.2,16685,5869,10816,54.3
38,경상남도,085002, 81세,2018,16202,5539,10663,51.9,16189,5531,10658,51.9
38,경상남도,085003, 82세,2018,14603,4774,9829,48.6,14585,4766,9819,48.5
38,경상남도,085004, 83세,2018,13372,4156,9216,45.1,13358,4152,9206,45.1
38,경상남도,085005, 84세,2018,11560,3346,8214,40.7,11547,3342,8205,40.7
38,경상남도,090,85~89세,2018,35144,8623,26521,32.5,35117,8617,26500,32.5
38,경상남도,090001, 85세,2018,9493,2633,6860,38.4,9487,2631,6856,38.4
38,경상남도,090002, 86세,2018,8627,2169,6458,33.6,8619,2169,6450,33.6
38,경상남도,090003, 87세,2018,6589,1562,5027,31.1,6582,1560,5022,31.1
38,경상남도,090004, 88세,2018,5657,1189,4468,26.6,5653,1188,4465,26.6
38,경상남도,090005, 89세,2018,4778,1070,3708,28.9,4776,1069,3707,28.8
38,경상남도,095,90~94세,2018,10669,2101,8568,24.5,10655,2097,8558,24.5
38,경상남도,095001, 90세,2018,3543,756,2787,27.1,3540,755,2785,27.1
38,경상남도,095002, 91세,2018,2725,560,2165,25.9,2722,560,2162,25.9
38,경상남도,095003, 92세,2018,1895,356,1539,23.1,1892,354,1538,23
38,경상남도,095004, 93세,2018,1567,252,1315,19.2,1563,252,1311,19.2
38,경상남도,095005, 94세,2018,939,177,762,23.2,938,176,762,23.1
38,경상남도,100,95~99세,2018,2094,342,1752,19.5,2092,340,1752,19.4
38,경상남도,100001, 95세,2018,836,143,693,20.6,836,143,693,20.6
38,경상남도,100002, 96세,2018,594,98,496,19.8,594,98,496,19.8
38,경상남도,100003, 97세,2018,330,50,280,17.9,329,49,280,17.5
38,경상남도,100004, 98세,2018,236,36,200,18,235,35,200,17.5
38,경상남도,100005, 99세,2018,98,15,83,18.1,98,15,83,18.1
38,경상남도,101,100세이상,2018,218,30,188,16,218,30,188,16
38,경상남도,102,15세미만,2018,452388,233745,218643,106.9,450009,232554,217455,106.9
38,경상남도,103,15~64세,2018,2389014,1260611,1128403,111.7,2295582,1196641,1098941,108.9
38,경상남도,104,65세이상,2018,508948,209548,299400,70,507265,208791,298474,70
38,경상남도,086,85세이상,2018,48125,11096,37029,30,48082,11084,36998,30
38,경상남도,126,평균연령,2018,42.3,40.7,44,,42.5,40.9,44.1,
38,경상남도,127,중위연령,2018,43.7,41.8,45.6,,44.3,42.6,45.8,
38004, 읍부,000,합계,2018,506847,255243,251604,101.4,494426,247426,247000,100.2
38004, 읍부,005,0~4세,2018,24230,12384,11846,104.5,24057,12308,11749,104.8
38004, 읍부,005001, 0세,2018,3955,1978,1977,100.1,3923,1963,1960,100.2
38004, 읍부,005002, 1세,2018,4328,2221,2107,105.4,4293,2204,2089,105.5
38004, 읍부,005003, 2세,2018,5099,2638,2461,107.2,5062,2623,2439,107.5
38004, 읍부,005004, 3세,2018,5399,2782,2617,106.3,5363,2766,2597,106.5
38004, 읍부,005005, 4세,2018,5449,2765,2684,103,5416,2752,2664,103.3
38004, 읍부,010,5~9세,2018,27910,14352,13558,105.9,27778,14288,13490,105.9
38004, 읍부,010001, 5세,2018,5408,2765,2643,104.6,5372,2744,2628,104.4
38004, 읍부,010002, 6세,2018,5957,3073,2884,106.6,5922,3055,2867,106.6
38004, 읍부,010003, 7세,2018,5835,2992,2843,105.2,5818,2983,2835,105.2
38004, 읍부,010004, 8세,2018,5437,2818,2619,107.6,5417,2815,2602,108.2
38004, 읍부,010005, 9세,2018,5273,2704,2569,105.3,5249,2691,2558,105.2
38004, 읍부,015,10~14세,2018,25850,13394,12456,107.5,25758,13350,12408,107.6
38004, 읍부,015001, 10세,2018,5514,2859,2655,107.7,5482,2848,2634,108.1
38004, 읍부,015002, 11세,2018,5440,2873,2567,111.9,5423,2865,2558,112
38004, 읍부,015003, 12세,2018,4953,2543,2410,105.5,4937,2533,2404,105.4
38004, 읍부,015004, 13세,2018,4862,2505,2357,106.3,4847,2495,2352,106.1
38004, 읍부,015005, 14세,2018,5081,2614,2467,106,5069,2609,2460,106.1
38004, 읍부,020,15~19세,2018,28219,15237,12982,117.4,28012,15135,12877,117.5
38004, 읍부,020001, 15세,2018,5215,2786,2429,114.7,5197,2778,2419,114.8
38004, 읍부,020002, 16세,2018,5471,2929,2542,115.2,5461,2926,2535,115.4
38004, 읍부,020003, 17세,2018,6115,3250,2865,113.4,6086,3233,2853,113.3
38004, 읍부,020004, 18세,2018,6287,3346,2941,113.8,6224,3313,2911,113.8
38004, 읍부,020005, 19세,2018,5131,2926,2205,132.7,5044,2885,2159,133.6
38004, 읍부,025,20~24세,2018,28537,16663,11874,140.3,27320,15898,11422,139.2
38004, 읍부,025001, 20세,2018,5621,3281,2340,140.2,5509,3214,2295,140
38004, 읍부,025002, 21세,2018,5949,3519,2430,144.8,5766,3412,2354,144.9
38004, 읍부,025003, 22세,2018,5846,3517,2329,151,5619,3379,2240,150.8
38004, 읍부,025004, 23세,2018,5636,3273,2363,138.5,5306,3063,2243,136.6
38004, 읍부,025005, 24세,2018,5485,3073,2412,127.4,5120,2830,2290,123.6
38004, 읍부,030,25~29세,2018,27344,14797,12547,117.9,24976,13204,11772,112.2
38004, 읍부,030001, 25세,2018,5489,2983,2506,119,5068,2711,2357,115
38004, 읍부,030002, 26세,2018,5588,2946,2642,111.5,5140,2654,2486,106.8
38004, 읍부,030003, 27세,2018,5416,2939,2477,118.7,4924,2609,2315,112.7
38004, 읍부,030004, 28세,2018,5426,2983,2443,122.1,4920,2636,2284,115.4
38004, 읍부,030005, 29세,2018,5425,2946,2479,118.8,4924,2594,2330,111.3
38004, 읍부,035,30~34세,2018,30597,15921,14676,108.5,28061,14143,13918,101.6
38004, 읍부,035001, 30세,2018,5530,2949,2581,114.3,4982,2561,2421,105.8
38004, 읍부,035002, 31세,2018,5824,2997,2827,106,5290,2632,2658,99
38004, 읍부,035003, 32세,2018,6095,3186,2909,109.5,5550,2803,2747,102
38004, 읍부,035004, 33세,2018,6251,3287,2964,110.9,5784,2949,2835,104
38004, 읍부,035005, 34세,2018,6897,3502,3395,103.2,6455,3198,3257,98.2
38004, 읍부,040,35~39세,2018,42554,21749,20805,104.5,40812,20559,20253,101.5
38004, 읍부,040001, 35세,2018,7807,3994,3813,104.7,7392,3708,3684,100.7
38004, 읍부,040002, 36세,2018,8573,4381,4192,104.5,8194,4113,4081,100.8
38004, 읍부,040003, 37세,2018,8742,4481,4261,105.2,8385,4235,4150,102
38004, 읍부,040004, 38세,2018,9030,4635,4395,105.5,8713,4423,4290,103.1
38004, 읍부,040005, 39세,2018,8402,4258,4144,102.8,8128,4080,4048,100.8
38004, 읍부,045,40~44세,2018,40241,20713,19528,106.1,39016,19943,19073,104.6
38004, 읍부,045001, 40세,2018,7920,4031,3889,103.7,7633,3846,3787,101.6
38004, 읍부,045002, 41세,2018,7854,4022,3832,105,7625,3874,3751,103.3
38004, 읍부,045003, 42세,2018,7685,3998,3687,108.4,7435,3839,3596,106.8
38004, 읍부,045004, 43세,2018,8120,4161,3959,105.1,7886,4021,3865,104
38004, 읍부,045005, 44세,2018,8662,4501,4161,108.2,8437,4363,4074,107.1
38004, 읍부,050,45~49세,2018,44723,23122,21601,107,43786,22592,21194,106.6
38004, 읍부,050001, 45세,2018,8754,4459,4295,103.8,8551,4338,4213,103
38004, 읍부,050002, 46세,2018,8685,4513,4172,108.2,8500,4409,4091,107.8
38004, 읍부,050003, 47세,2018,9231,4774,4457,107.1,9038,4669,4369,106.9
38004, 읍부,050004, 48세,2018,9007,4638,4369,106.2,8826,4537,4289,105.8
38004, 읍부,050005, 49세,2018,9046,4738,4308,110,8871,4639,4232,109.6
38004, 읍부,055,50~54세,2018,40052,20544,19508,105.3,39322,20153,19169,105.1
38004, 읍부,055001, 50세,2018,8998,4576,4422,103.5,8818,4465,4353,102.6
38004, 읍부,055002, 51세,2018,8005,4048,3957,102.3,7857,3969,3888,102.1
38004, 읍부,055003, 52세,2018,7950,4191,3759,111.5,7804,4112,3692,111.4
38004, 읍부,055004, 53세,2018,7857,3978,3879,102.6,7736,3914,3822,102.4
38004, 읍부,055005, 54세,2018,7242,3751,3491,107.4,7107,3693,3414,108.2
38004, 읍부,060,55~59세,2018,40563,20540,20023,102.6,40058,20294,19764,102.7
38004, 읍부,060001, 55세,2018,7592,3926,3666,107.1,7456,3858,3598,107.2
38004, 읍부,060002, 56세,2018,8263,4277,3986,107.3,8157,4218,3939,107.1
38004, 읍부,060003, 57세,2018,8749,4358,4391,99.2,8665,4324,4341,99.6
38004, 읍부,060004, 58세,2018,8459,4238,4221,100.4,8356,4194,4162,100.8
38004, 읍부,060005, 59세,2018,7500,3741,3759,99.5,7424,3700,3724,99.4
38004, 읍부,065,60~64세,2018,32733,16257,16476,98.7,32404,16086,16318,98.6
38004, 읍부,065001, 60세,2018,7159,3625,3534,102.6,7074,3584,3490,102.7
38004, 읍부,065002, 61세,2018,7127,3556,3571,99.6,7048,3507,3541,99
38004, 읍부,065003, 62세,2018,6530,3215,3315,97,6471,3188,3283,97.1
38004, 읍부,065004, 63세,2018,6402,3132,3270,95.8,6348,3100,3248,95.4
38004, 읍부,065005, 64세,2018,5515,2729,2786,98,5463,2707,2756,98.2
38004, 읍부,070,65~69세,2018,22678,10867,11811,92,22538,10803,11735,92.1
38004, 읍부,070001, 65세,2018,4752,2314,2438,94.9,4713,2295,2418,94.9
38004, 읍부,070002, 66세,2018,5242,2508,2734,91.7,5213,2491,2722,91.5
38004, 읍부,070003, 67세,2018,4167,1974,2193,90,4140,1965,2175,90.3
38004, 읍부,070004, 68세,2018,4218,2006,2212,90.7,4191,1995,2196,90.8
38004, 읍부,070005, 69세,2018,4299,2065,2234,92.4,4281,2057,2224,92.5
38004, 읍부,075,70~74세,2018,16814,7664,9150,83.8,16769,7649,9120,83.9
38004, 읍부,075001, 70세,2018,4174,1984,2190,90.6,4161,1981,2180,90.9
38004, 읍부,075002, 71세,2018,3821,1777,2044,86.9,3812,1773,2039,87
38004, 읍부,075003, 72세,2018,2877,1364,1513,90.2,2865,1360,1505,90.4
38004, 읍부,075004, 73세,2018,2876,1246,1630,76.4,2868,1243,1625,76.5
38004, 읍부,075005, 74세,2018,3066,1293,1773,72.9,3063,1292,1771,73
38004, 읍부,080,75~79세,2018,15703,5994,9709,61.7,15678,5984,9694,61.7
38004, 읍부,080001, 75세,2018,3177,1304,1873,69.6,3169,1299,1870,69.5
38004, 읍부,080002, 76세,2018,3520,1333,2187,61,3515,1330,2185,60.9
38004, 읍부,080003, 77세,2018,3166,1219,1947,62.6,3159,1219,1940,62.8
38004, 읍부,080004, 78세,2018,2937,1099,1838,59.8,2933,1098,1835,59.8
38004, 읍부,080005, 79세,2018,2903,1039,1864,55.7,2902,1038,1864,55.7
38004, 읍부,085,80~84세,2018,10735,3394,7341,46.2,10722,3387,7335,46.2
38004, 읍부,085001, 80세,2018,2460,846,1614,52.4,2456,844,1612,52.4
38004, 읍부,085002, 81세,2018,2432,817,1615,50.6,2431,816,1615,50.5
38004, 읍부,085003, 82세,2018,2178,699,1479,47.3,2175,698,1477,47.3
38004, 읍부,085004, 83세,2018,1958,547,1411,38.8,1955,545,1410,38.7
38004, 읍부,085005, 84세,2018,1707,485,1222,39.7,1705,484,1221,39.6
38004, 읍부,090,85~89세,2018,5364,1291,4073,31.7,5362,1291,4071,31.7
38004, 읍부,090001, 85세,2018,1464,440,1024,43,1463,440,1023,43
38004, 읍부,090002, 86세,2018,1274,296,978,30.3,1273,296,977,30.3
38004, 읍부,090003, 87세,2018,996,214,782,27.4,996,214,782,27.4
38004, 읍부,090004, 88세,2018,889,186,703,26.5,889,186,703,26.5
38004, 읍부,090005, 89세,2018,741,155,586,26.5,741,155,586,26.5
38004, 읍부,095,90~94세,2018,1625,303,1322,22.9,1622,302,1320,22.9
38004, 읍부,095001, 90세,2018,553,108,445,24.3,551,107,444,24.1
38004, 읍부,095002, 91세,2018,436,85,351,24.2,435,85,350,24.3
38004, 읍부,095003, 92세,2018,281,43,238,18.1,281,43,238,18.1
38004, 읍부,095004, 93세,2018,213,34,179,19,213,34,179,19
38004, 읍부,095005, 94세,2018,142,33,109,30.3,142,33,109,30.3
38004, 읍부,100,95~99세,2018,328,50,278,18,328,50,278,18
38004, 읍부,100001, 95세,2018,140,25,115,21.7,140,25,115,21.7
38004, 읍부,100002, 96세,2018,85,10,75,13.3,85,10,75,13.3
38004, 읍부,100003, 97세,2018,52,9,43,20.9,52,9,43,20.9
38004, 읍부,100004, 98세,2018,38,X,34,11.8,38,X,34,11.8
38004, 읍부,100005, 99세,2018,13,X,11,18.2,13,X,11,18.2
38004, 읍부,101,100세이상,2018,47,7,40,17.5,47,7,40,17.5
38004, 읍부,102,15세미만,2018,77990,40130,37860,106,77593,39946,37647,106.1
38004, 읍부,103,15~64세,2018,355563,185543,170020,109.1,343767,178007,165760,107.4
38004, 읍부,104,65세이상,2018,73294,29570,43724,67.6,73066,29473,43593,67.6
38004, 읍부,086,85세이상,2018,7364,1651,5713,28.9,7359,1650,5709,28.9
38004, 읍부,126,평균연령,2018,41.2,39.6,42.8,,41.3,39.8,42.9,
38004, 읍부,127,중위연령,2018,42.3,40.8,43.9,,42.7,41.3,44.2,
38005, 면부,000,합계,2018,694866,354256,340610,104,659914,327659,332255,98.6
38005, 면부,005,0~4세,2018,22359,11448,10911,104.9,22190,11359,10831,104.9
38005, 면부,005001, 0세,2018,3631,1861,1770,105.1,3599,1842,1757,104.8
38005, 면부,005002, 1세,2018,4176,2170,2006,108.2,4137,2149,1988,108.1
38005, 면부,005003, 2세,2018,4606,2325,2281,101.9,4573,2306,2267,101.7
38005, 면부,005004, 3세,2018,4957,2510,2447,102.6,4921,2493,2428,102.7
38005, 면부,005005, 4세,2018,4989,2582,2407,107.3,4960,2569,2391,107.4
38005, 면부,010,5~9세,2018,24516,12790,11726,109.1,24398,12727,11671,109
38005, 면부,010001, 5세,2018,4836,2573,2263,113.7,4813,2560,2253,113.6
38005, 면부,010002, 6세,2018,5097,2672,2425,110.2,5070,2659,2411,110.3
38005, 면부,010003, 7세,2018,5023,2623,2400,109.3,4999,2609,2390,109.2
38005, 면부,010004, 8세,2018,4861,2517,2344,107.4,4839,2504,2335,107.2
38005, 면부,010005, 9세,2018,4699,2405,2294,104.8,4677,2395,2282,105
38005, 면부,015,10~14세,2018,22048,11472,10576,108.5,21962,11427,10535,108.5
38005, 면부,015001, 10세,2018,4827,2461,2366,104,4812,2455,2357,104.2
38005, 면부,015002, 11세,2018,4761,2482,2279,108.9,4747,2475,2272,108.9
38005, 면부,015003, 12세,2018,4151,2164,1987,108.9,4129,2149,1980,108.5
38005, 면부,015004, 13세,2018,4027,2077,1950,106.5,4009,2069,1940,106.6
38005, 면부,015005, 14세,2018,4282,2288,1994,114.7,4265,2279,1986,114.8
38005, 면부,020,15~19세,2018,24500,13411,11089,120.9,24280,13276,11004,120.6
38005, 면부,020001, 15세,2018,4403,2305,2098,109.9,4395,2300,2095,109.8
38005, 면부,020002, 16세,2018,4859,2606,2253,115.7,4840,2592,2248,115.3
38005, 면부,020003, 17세,2018,5629,3005,2624,114.5,5609,2995,2614,114.6
38005, 면부,020004, 18세,2018,5585,2994,2591,115.6,5524,2955,2569,115
38005, 면부,020005, 19세,2018,4024,2501,1523,164.2,3912,2434,1478,164.7
38005, 면부,025,20~24세,2018,28751,17967,10784,166.6,24573,15043,9530,157.8
38005, 면부,025001, 20세,2018,4851,3252,1599,203.4,4551,3067,1484,206.7
38005, 면부,025002, 21세,2018,5650,3607,2043,176.6,5068,3236,1832,176.6
38005, 면부,025003, 22세,2018,5776,3540,2236,158.3,4941,2968,1973,150.4
38005, 면부,025004, 23세,2018,6102,3687,2415,152.7,4969,2890,2079,139
38005, 면부,025005, 24세,2018,6372,3881,2491,155.8,5044,2882,2162,133.3
38005, 면부,030,25~29세,2018,33864,21060,12804,164.5,25255,14260,10995,129.7
38005, 면부,030001, 25세,2018,6575,4107,2468,166.4,4977,2886,2091,138
38005, 면부,030002, 26세,2018,6794,4225,2569,164.5,5135,2919,2216,131.7
38005, 면부,030003, 27세,2018,6690,4150,2540,163.4,4997,2829,2168,130.5
38005, 면부,030004, 28세,2018,6869,4292,2577,166.6,4981,2786,2195,126.9
38005, 면부,030005, 29세,2018,6936,4286,2650,161.7,5165,2840,2325,122.2
38005, 면부,035,30~34세,2018,36815,21988,14827,148.3,28433,15109,13324,113.4
38005, 면부,035001, 30세,2018,6956,4259,2697,157.9,5153,2799,2354,118.9
38005, 면부,035002, 31세,2018,6999,4174,2825,147.8,5206,2716,2490,109.1
38005, 면부,035003, 32세,2018,7209,4431,2778,159.5,5523,3033,2490,121.8
38005, 면부,035004, 33세,2018,7519,4471,3048,146.7,5898,3114,2784,111.9
38005, 면부,035005, 34세,2018,8132,4653,3479,133.7,6653,3447,3206,107.5
38005, 면부,040,35~39세,2018,45678,26227,19451,134.8,40306,21805,18501,117.9
38005, 면부,040001, 35세,2018,8818,5005,3813,131.3,7510,3923,3587,109.4
38005, 면부,040002, 36세,2018,9243,5298,3945,134.3,8021,4310,3711,116.1
38005, 면부,040003, 37세,2018,9311,5344,3967,134.7,8278,4484,3794,118.2
38005, 면부,040004, 38세,2018,9531,5452,4079,133.7,8569,4649,3920,118.6
38005, 면부,040005, 39세,2018,8775,5128,3647,140.6,7928,4439,3489,127.2
38005, 면부,045,40~44세,2018,40515,23461,17054,137.6,37503,21146,16357,129.3
38005, 면부,045001, 40세,2018,8011,4638,3373,137.5,7258,4030,3228,124.8
38005, 면부,045002, 41세,2018,7965,4569,3396,134.5,7313,4063,3250,125
38005, 면부,045003, 42세,2018,7829,4656,3173,146.7,7218,4175,3043,137.2
38005, 면부,045004, 43세,2018,8200,4689,3511,133.6,7680,4325,3355,128.9
38005, 면부,045005, 44세,2018,8510,4909,3601,136.3,8034,4553,3481,130.8
38005, 면부,050,45~49세,2018,47529,26737,20792,128.6,45595,25414,20181,125.9
38005, 면부,050001, 45세,2018,9126,5156,3970,129.9,8686,4850,3836,126.4
38005, 면부,050002, 46세,2018,8827,5115,3712,137.8,8393,4805,3588,133.9
38005, 면부,050003, 47세,2018,9612,5415,4197,129,9224,5144,4080,126.1
38005, 면부,050004, 48세,2018,9787,5439,4348,125.1,9440,5197,4243,122.5
38005, 면부,050005, 49세,2018,10177,5612,4565,122.9,9852,5418,4434,122.2
38005, 면부,055,50~54세,2018,52125,27648,24477,113,50920,26937,23983,112.3
38005, 면부,055001, 50세,2018,10487,5627,4860,115.8,10219,5457,4762,114.6
38005, 면부,055002, 51세,2018,10275,5433,4842,112.2,10002,5268,4734,111.3
38005, 면부,055003, 52세,2018,10507,5753,4754,121,10284,5613,4671,120.2
38005, 면부,055004, 53세,2018,10822,5659,5163,109.6,10574,5529,5045,109.6
38005, 면부,055005, 54세,2018,10034,5176,4858,106.5,9841,5070,4771,106.3
38005, 면부,060,55~59세,2018,66062,33761,32301,104.5,65208,33275,31933,104.2
38005, 면부,060001, 55세,2018,11168,5894,5274,111.8,10922,5762,5160,111.7
38005, 면부,060002, 56세,2018,12957,6753,6204,108.8,12767,6637,6130,108.3
38005, 면부,060003, 57세,2018,14520,7317,7203,101.6,14393,7240,7153,101.2
38005, 면부,060004, 58세,2018,14489,7220,7269,99.3,14323,7125,7198,99
38005, 면부,060005, 59세,2018,12928,6577,6351,103.6,12803,6511,6292,103.5
38005, 면부,065,60~64세,2018,62593,31722,30871,102.8,62125,31481,30644,102.7
38005, 면부,065001, 60세,2018,12782,6571,6211,105.8,12658,6509,6149,105.9
38005, 면부,065002, 61세,2018,13198,6732,6466,104.1,13108,6683,6425,104
38005, 면부,065003, 62세,2018,12614,6485,6129,105.8,12523,6435,6088,105.7
38005, 면부,065004, 63세,2018,12952,6390,6562,97.4,12866,6346,6520,97.3
38005, 면부,065005, 64세,2018,11047,5544,5503,100.7,10970,5508,5462,100.8
38005, 면부,070,65~69세,2018,49100,24228,24872,97.4,48879,24112,24767,97.4
38005, 면부,070001, 65세,2018,9996,4917,5079,96.8,9932,4883,5049,96.7
38005, 면부,070002, 66세,2018,11165,5552,5613,98.9,11117,5523,5594,98.7
38005, 면부,070003, 67세,2018,9080,4421,4659,94.9,9038,4406,4632,95.1
38005, 면부,070004, 68세,2018,9225,4541,4684,96.9,9192,4522,4670,96.8
38005, 면부,070005, 69세,2018,9634,4797,4837,99.2,9600,4778,4822,99.1
38005, 면부,075,70~74세,2018,40360,18300,22060,83,40292,18270,22022,83
38005, 면부,075001, 70세,2018,9538,4588,4950,92.7,9516,4577,4939,92.7
38005, 면부,075002, 71세,2018,9096,4277,4819,88.8,9079,4269,4810,88.8
38005, 면부,075003, 72세,2018,6714,3066,3648,84,6705,3062,3643,84.1
38005, 면부,075004, 73세,2018,7200,3100,4100,75.6,7189,3096,4093,75.6
38005, 면부,075005, 74세,2018,7812,3269,4543,72,7803,3266,4537,72
38005, 면부,080,75~79세,2018,43746,16510,27236,60.6,43717,16501,27216,60.6
38005, 면부,080001, 75세,2018,8271,3305,4966,66.6,8265,3304,4961,66.6
38005, 면부,080002, 76세,2018,9902,3874,6028,64.3,9898,3873,6025,64.3
38005, 면부,080003, 77세,2018,8802,3350,5452,61.4,8796,3347,5449,61.4
38005, 면부,080004, 78세,2018,8380,3038,5342,56.9,8370,3034,5336,56.9
38005, 면부,080005, 79세,2018,8391,2943,5448,54,8388,2943,5445,54
38005, 면부,085,80~84세,2018,32114,10333,21781,47.4,32098,10328,21770,47.4
38005, 면부,085001, 80세,2018,7222,2485,4737,52.5,7213,2482,4731,52.5
38005, 면부,085002, 81세,2018,7070,2364,4706,50.2,7068,2362,4706,50.2
38005, 면부,085003, 82세,2018,6447,2085,4362,47.8,6447,2085,4362,47.8
38005, 면부,085004, 83세,2018,6007,1856,4151,44.7,6005,1856,4149,44.7
38005, 면부,085005, 84세,2018,5368,1543,3825,40.3,5365,1543,3822,40.4
38005, 면부,090,85~89세,2018,16230,4031,12199,33,16223,4029,12194,33
38005, 면부,090001, 85세,2018,4407,1189,3218,36.9,4406,1189,3217,37
38005, 면부,090002, 86세,2018,3988,1031,2957,34.9,3985,1031,2954,34.9
38005, 면부,090003, 87세,2018,3069,754,2315,32.6,3068,753,2315,32.5
38005, 면부,090004, 88세,2018,2593,564,2029,27.8,2591,563,2028,27.8
38005, 면부,090005, 89세,2018,2173,493,1680,29.3,2173,493,1680,29.3
38005, 면부,095,90~94세,2018,4894,995,3899,25.5,4890,993,3897,25.5
38005, 면부,095001, 90세,2018,1637,359,1278,28.1,1637,359,1278,28.1
38005, 면부,095002, 91세,2018,1247,261,986,26.5,1246,261,985,26.5
38005, 면부,095003, 92세,2018,892,189,703,26.9,891,188,703,26.7
38005, 면부,095004, 93세,2018,717,110,607,18.1,716,110,606,18.2
38005, 면부,095005, 94세,2018,401,76,325,23.4,400,75,325,23.1
38005, 면부,100,95~99세,2018,980,159,821,19.4,980,159,821,19.4
38005, 면부,100001, 95세,2018,385,66,319,20.7,385,66,319,20.7
38005, 면부,100002, 96세,2018,281,48,233,20.6,281,48,233,20.6
38005, 면부,100003, 97세,2018,159,23,136,16.9,159,23,136,16.9
38005, 면부,100004, 98세,2018,110,19,91,20.9,110,19,91,20.9
38005, 면부,100005, 99세,2018,45,X,42,7.1,45,X,42,7.1
38005, 면부,101,100세이상,2018,87,8,79,10.1,87,8,79,10.1
38005, 면부,102,15세미만,2018,68923,35710,33213,107.5,68550,35513,33037,107.5
38005, 면부,103,15~64세,2018,438432,243982,194450,125.5,404198,217746,186452,116.8
38005, 면부,104,65세이상,2018,187511,74564,112947,66,187166,74400,112766,66
38005, 면부,086,85세이상,2018,22191,5193,16998,30.6,22180,5189,16991,30.5
38005, 면부,126,평균연령,2018,49.1,46.2,52.1,,49.9,47.2,52.5,
38005, 면부,127,중위연령,2018,52,48.3,56.1,,53.5,50.4,56.7,
38003, 동부,000,합계,2018,2148637,1094405,1054232,103.8,2098516,1062901,1035615,102.6
38003, 동부,005,0~4세,2018,89569,46081,43488,106,88753,45672,43081,106
38003, 동부,005001, 0세,2018,14230,7333,6897,106.3,14071,7250,6821,106.3
38003, 동부,005002, 1세,2018,16257,8341,7916,105.4,16100,8269,7831,105.6
38003, 동부,005003, 2세,2018,18643,9557,9086,105.2,18480,9477,9003,105.3
38003, 동부,005004, 3세,2018,20074,10356,9718,106.6,19890,10254,9636,106.4
38003, 동부,005005, 4세,2018,20365,10494,9871,106.3,20212,10422,9790,106.5
38003, 동부,010,5~9세,2018,107987,55681,52306,106.5,107506,55442,52064,106.5
38003, 동부,010001, 5세,2018,20520,10476,10044,104.3,20392,10415,9977,104.4
38003, 동부,010002, 6세,2018,22662,11656,11006,105.9,22561,11606,10955,105.9
38003, 동부,010003, 7세,2018,22361,11489,10872,105.7,22269,11439,10830,105.6
38003, 동부,010004, 8세,2018,21591,11205,10386,107.9,21504,11159,10345,107.9
38003, 동부,010005, 9세,2018,20853,10855,9998,108.6,20780,10823,9957,108.7
38003, 동부,015,10~14세,2018,107919,56143,51776,108.4,107607,55981,51626,108.4
38003, 동부,015001, 10세,2018,22142,11326,10816,104.7,22069,11287,10782,104.7
38003, 동부,015002, 11세,2018,22649,11667,10982,106.2,22577,11630,10947,106.2
38003, 동부,015003, 12세,2018,20695,10795,9900,109,20636,10769,9867,109.1
38003, 동부,015004, 13세,2018,20245,10613,9632,110.2,20195,10583,9612,110.1
38003, 동부,015005, 14세,2018,22188,11742,10446,112.4,22130,11712,10418,112.4
38003, 동부,020,15~19세,2018,124881,66657,58224,114.5,124024,66191,57833,114.5
38003, 동부,020001, 15세,2018,22476,11901,10575,112.5,22422,11873,10549,112.6
38003, 동부,020002, 16세,2018,23266,12246,11020,111.1,23203,12211,10992,111.1
38003, 동부,020003, 17세,2018,26293,13790,12503,110.3,26194,13733,12461,110.2
38003, 동부,020004, 18세,2018,28118,14922,13196,113.1,27925,14816,13109,113
38003, 동부,020005, 19세,2018,24728,13798,10930,126.2,24280,13558,10722,126.5
38003, 동부,025,20~24세,2018,141567,80220,61347,130.8,136474,77250,59224,130.4
38003, 동부,025001, 20세,2018,26906,15269,11637,131.2,26176,14895,11281,132
38003, 동부,025002, 21세,2018,28440,16199,12241,132.3,27644,15758,11886,132.6
38003, 동부,025003, 22세,2018,29413,16842,12571,134,28386,16210,12176,133.1
38003, 동부,025004, 23세,2018,28674,16175,12499,129.4,27479,15469,12010,128.8
38003, 동부,025005, 24세,2018,28134,15735,12399,126.9,26789,14918,11871,125.7
38003, 동부,030,25~29세,2018,133259,73842,59417,124.3,124151,67734,56417,120.1
38003, 동부,030001, 25세,2018,27932,15594,12338,126.4,26437,14623,11814,123.8
38003, 동부,030002, 26세,2018,27677,15128,12549,120.6,25926,13986,11940,117.1
38003, 동부,030003, 27세,2018,26345,14470,11875,121.9,24512,13228,11284,117.2
38003, 동부,030004, 28세,2018,25961,14535,11426,127.2,23919,13131,10788,121.7
38003, 동부,030005, 29세,2018,25344,14115,11229,125.7,23357,12766,10591,120.5
38003, 동부,035,30~34세,2018,133683,72707,60976,119.2,123972,66016,57956,113.9
38003, 동부,035001, 30세,2018,24747,13618,11129,122.4,22795,12277,10518,116.7
38003, 동부,035002, 31세,2018,25834,14012,11822,118.5,23671,12535,11136,112.6
38003, 동부,035003, 32세,2018,26557,14660,11897,123.2,24587,13304,11283,117.9
38003, 동부,035004, 33세,2018,27362,14849,12513,118.7,25480,13531,11949,113.2
38003, 동부,035005, 34세,2018,29183,15568,13615,114.3,27439,14369,13070,109.9
38003, 동부,040,35~39세,2018,177504,92622,84882,109.1,170495,87762,82733,106.1
38003, 동부,040001, 35세,2018,32317,17070,15247,112,30655,15895,14760,107.7
38003, 동부,040002, 36세,2018,35504,18496,17008,108.7,33957,17437,16520,105.6
38003, 동부,040003, 37세,2018,36452,19266,17186,112.1,35093,18324,16769,109.3
38003, 동부,040004, 38세,2018,37746,19374,18372,105.5,36512,18505,18007,102.8
38003, 동부,040005, 39세,2018,35485,18416,17069,107.9,34278,17601,16677,105.5
38003, 동부,045,40~44세,2018,173451,88161,85290,103.4,168714,85026,83688,101.6
38003, 동부,045001, 40세,2018,32905,17094,15811,108.1,31798,16357,15441,105.9
38003, 동부,045002, 41세,2018,33245,17028,16217,105,32324,16425,15899,103.3
38003, 동부,045003, 42세,2018,33066,16809,16257,103.4,32117,16157,15960,101.2
38003, 동부,045004, 43세,2018,35563,17813,17750,100.4,34654,17217,17437,98.7
38003, 동부,045005, 44세,2018,38672,19417,19255,100.8,37821,18870,18951,99.6
38003, 동부,050,45~49세,2018,203541,102497,101044,101.4,199530,100110,99420,100.7
38003, 동부,050001, 45세,2018,40023,20058,19965,100.5,39258,19593,19665,99.6
38003, 동부,050002, 46세,2018,38884,19947,18937,105.3,38042,19411,18631,104.2
38003, 동부,050003, 47세,2018,42006,21106,20900,101,41134,20577,20557,100.1
38003, 동부,050004, 48세,2018,41389,20760,20629,100.6,40582,20303,20279,100.1
38003, 동부,050005, 49세,2018,41239,20626,20613,100.1,40514,20226,20288,99.7
38003, 동부,055,50~54세,2018,185282,92873,92409,100.5,182020,91140,90880,100.3
38003, 동부,055001, 50세,2018,41203,20363,20840,97.7,40470,19955,20515,97.3
38003, 동부,055002, 51세,2018,37818,18647,19171,97.3,37179,18308,18871,97
38003, 동부,055003, 52세,2018,36994,19042,17952,106.1,36354,18709,17645,106
38003, 동부,055004, 53세,2018,36825,18390,18435,99.8,36210,18051,18159,99.4
38003, 동부,055005, 54세,2018,32442,16431,16011,102.6,31807,16117,15690,102.7
38003, 동부,060,55~59세,2018,183463,92590,90873,101.9,181176,91414,89762,101.8
38003, 동부,060001, 55세,2018,35591,18439,17152,107.5,34941,18089,16852,107.3
38003, 동부,060002, 56세,2018,37261,18898,18363,102.9,36721,18623,18098,102.9
38003, 동부,060003, 57세,2018,39566,19637,19929,98.5,39193,19456,19737,98.6
38003, 동부,060004, 58세,2018,37993,18910,19083,99.1,37578,18701,18877,99.1
38003, 동부,060005, 59세,2018,33052,16706,16346,102.2,32743,16545,16198,102.1
38003, 동부,065,60~64세,2018,138388,68917,69471,99.2,137061,68245,68816,99.2
38003, 동부,065001, 60세,2018,31138,15761,15377,102.5,30804,15588,15216,102.4
38003, 동부,065002, 61세,2018,29622,14865,14757,100.7,29341,14718,14623,100.6
38003, 동부,065003, 62세,2018,27254,13429,13825,97.1,26992,13296,13696,97.1
38003, 동부,065004, 63세,2018,27534,13368,14166,94.4,27302,13250,14052,94.3
38003, 동부,065005, 64세,2018,22840,11494,11346,101.3,22622,11393,11229,101.5
38003, 동부,070,65~69세,2018,88679,42837,45842,93.4,88027,42517,45510,93.4
38003, 동부,070001, 65세,2018,19364,9468,9896,95.7,19178,9377,9801,95.7
38003, 동부,070002, 66세,2018,20879,10184,10695,95.2,20734,10124,10610,95.4
38003, 동부,070003, 67세,2018,16227,7799,8428,92.5,16114,7739,8375,92.4
38003, 동부,070004, 68세,2018,16142,7804,8338,93.6,16027,7743,8284,93.5
38003, 동부,070005, 69세,2018,16067,7582,8485,89.4,15974,7534,8440,89.3
38003, 동부,075,70~74세,2018,61880,28457,33423,85.1,61639,28356,33283,85.2
38003, 동부,075001, 70세,2018,15678,7427,8251,90,15620,7401,8219,90
38003, 동부,075002, 71세,2018,14450,6638,7812,85,14383,6612,7771,85.1
38003, 동부,075003, 72세,2018,10531,4908,5623,87.3,10486,4888,5598,87.3
38003, 동부,075004, 73세,2018,10477,4739,5738,82.6,10439,4724,5715,82.7
38003, 동부,075005, 74세,2018,10744,4745,5999,79.1,10711,4731,5980,79.1
38003, 동부,080,75~79세,2018,49396,19897,29499,67.4,49280,19855,29425,67.5
38003, 동부,080001, 75세,2018,10889,4600,6289,73.1,10867,4591,6276,73.2
38003, 동부,080002, 76세,2018,11566,4796,6770,70.8,11545,4789,6756,70.9
38003, 동부,080003, 77세,2018,9725,3930,5795,67.8,9698,3924,5774,68
38003, 동부,080004, 78세,2018,8840,3411,5429,62.8,8815,3400,5415,62.8
38003, 동부,080005, 79세,2018,8376,3160,5216,60.6,8355,3151,5204,60.5
38003, 동부,085,80~84세,2018,29618,9971,19647,50.8,29544,9945,19599,50.7
38003, 동부,085001, 80세,2018,7048,2552,4496,56.8,7016,2543,4473,56.9
38003, 동부,085002, 81세,2018,6700,2358,4342,54.3,6690,2353,4337,54.3
38003, 동부,085003, 82세,2018,5978,1990,3988,49.9,5963,1983,3980,49.8
38003, 동부,085004, 83세,2018,5407,1753,3654,48,5398,1751,3647,48
38003, 동부,085005, 84세,2018,4485,1318,3167,41.6,4477,1315,3162,41.6
38003, 동부,090,85~89세,2018,13550,3301,10249,32.2,13532,3297,10235,32.2
38003, 동부,090001, 85세,2018,3622,1004,2618,38.3,3618,1002,2616,38.3
38003, 동부,090002, 86세,2018,3365,842,2523,33.4,3361,842,2519,33.4
38003, 동부,090003, 87세,2018,2524,594,1930,30.8,2518,593,1925,30.8
38003, 동부,090004, 88세,2018,2175,439,1736,25.3,2173,439,1734,25.3
38003, 동부,090005, 89세,2018,1864,422,1442,29.3,1862,421,1441,29.2
38003, 동부,095,90~94세,2018,4150,803,3347,24,4143,802,3341,24
38003, 동부,095001, 90세,2018,1353,289,1064,27.2,1352,289,1063,27.2
38003, 동부,095002, 91세,2018,1042,214,828,25.8,1041,214,827,25.9
38003, 동부,095003, 92세,2018,722,124,598,20.7,720,123,597,20.6
38003, 동부,095004, 93세,2018,637,108,529,20.4,634,108,526,20.5
38003, 동부,095005, 94세,2018,396,68,328,20.7,396,68,328,20.7
38003, 동부,100,95~99세,2018,786,133,653,20.4,784,131,653,20.1
38003, 동부,100001, 95세,2018,311,52,259,20.1,311,52,259,20.1
38003, 동부,100002, 96세,2018,228,40,188,21.3,228,40,188,21.3
38003, 동부,100003, 97세,2018,119,18,101,17.8,118,17,101,16.8
38003, 동부,100004, 98세,2018,88,13,75,17.3,87,12,75,16
38003, 동부,100005, 99세,2018,40,10,30,33.3,40,10,30,33.3
38003, 동부,101,100세이상,2018,84,15,69,21.7,84,15,69,21.7
38003, 동부,102,15세미만,2018,305475,157905,147570,107,303866,157095,146771,107
38003, 동부,103,15~64세,2018,1595019,831086,763933,108.8,1547617,800888,746729,107.3
38003, 동부,104,65세이상,2018,248143,105414,142729,73.9,247033,104918,142115,73.8
38003, 동부,086,85세이상,2018,18570,4252,14318,29.7,18543,4245,14298,29.7
38003, 동부,126,평균연령,2018,40.4,39.2,41.6,,40.5,39.3,41.7,
38003, 동부,127,중위연령,2018,41.8,40.2,43.4,,42.1,40.6,43.5,
38030, 진주시,000,합계,2018,352333,176228,176105,100.1,345841,172192,173649,99.2
38030, 진주시,005,0~4세,2018,13564,7030,6534,107.6,13506,6998,6508,107.5
38030, 진주시,005001, 0세,2018,2196,1153,1043,110.5,2187,1150,1037,110.9
38030, 진주시,005002, 1세,2018,2423,1234,1189,103.8,2412,1226,1186,103.4
38030, 진주시,005003, 2세,2018,2778,1461,1317,110.9,2766,1454,1312,110.8
38030, 진주시,005004, 3세,2018,3010,1540,1470,104.8,2998,1534,1464,104.8
38030, 진주시,005005, 4세,2018,3157,1642,1515,108.4,3143,1634,1509,108.3
38030, 진주시,010,5~9세,2018,16285,8624,7661,112.6,16260,8611,7649,112.6
38030, 진주시,010001, 5세,2018,3035,1629,1406,115.9,3029,1626,1403,115.9
38030, 진주시,010002, 6세,2018,3377,1738,1639,106,3371,1735,1636,106.1
38030, 진주시,010003, 7세,2018,3422,1832,1590,115.2,3415,1828,1587,115.2
38030, 진주시,010004, 8세,2018,3293,1762,1531,115.1,3289,1760,1529,115.1
38030, 진주시,010005, 9세,2018,3158,1663,1495,111.2,3156,1662,1494,111.2
38030, 진주시,015,10~14세,2018,16785,8785,8000,109.8,16770,8775,7995,109.8
38030, 진주시,015001, 10세,2018,3428,1778,1650,107.8,3423,1775,1648,107.7
38030, 진주시,015002, 11세,2018,3475,1748,1727,101.2,3473,1746,1727,101.1
38030, 진주시,015003, 12세,2018,3202,1687,1515,111.4,3199,1686,1513,111.4
38030, 진주시,015004, 13세,2018,3126,1646,1480,111.2,3124,1645,1479,111.2
38030, 진주시,015005, 14세,2018,3554,1926,1628,118.3,3551,1923,1628,118.1
38030, 진주시,020,15~19세,2018,21926,11664,10262,113.7,21749,11571,10178,113.7
38030, 진주시,020001, 15세,2018,3543,1849,1694,109.1,3539,1848,1691,109.3
38030, 진주시,020002, 16세,2018,3733,2061,1672,123.3,3724,2056,1668,123.3
38030, 진주시,020003, 17세,2018,4302,2313,1989,116.3,4278,2301,1977,116.4
38030, 진주시,020004, 18세,2018,4904,2605,2299,113.3,4854,2576,2278,113.1
38030, 진주시,020005, 19세,2018,5444,2836,2608,108.7,5354,2790,2564,108.8
38030, 진주시,025,20~24세,2018,28373,15738,12635,124.6,27267,15125,12142,124.6
38030, 진주시,025001, 20세,2018,5653,2770,2883,96.1,5467,2681,2786,96.2
38030, 진주시,025002, 21세,2018,5691,2925,2766,105.7,5514,2836,2678,105.9
38030, 진주시,025003, 22세,2018,6040,3489,2551,136.8,5830,3367,2463,136.7
38030, 진주시,025004, 23세,2018,5667,3399,2268,149.9,5431,3265,2166,150.7
38030, 진주시,025005, 24세,2018,5322,3155,2167,145.6,5025,2976,2049,145.2
38030, 진주시,030,25~29세,2018,21516,12155,9361,129.8,20064,11200,8864,126.4
38030, 진주시,030001, 25세,2018,4874,2828,2046,138.2,4583,2643,1940,136.2
38030, 진주시,030002, 26세,2018,4478,2531,1947,130,4208,2361,1847,127.8
38030, 진주시,030003, 27세,2018,4092,2308,1784,129.4,3806,2114,1692,124.9
38030, 진주시,030004, 28세,2018,4032,2235,1797,124.4,3702,2017,1685,119.7
38030, 진주시,030005, 29세,2018,4040,2253,1787,126.1,3765,2065,1700,121.5
38030, 진주시,035,30~34세,2018,19790,10415,9375,111.1,18552,9557,8995,106.2
38030, 진주시,035001, 30세,2018,3729,2027,1702,119.1,3477,1859,1618,114.9
38030, 진주시,035002, 31세,2018,3988,2067,1921,107.6,3716,1881,1835,102.5
38030, 진주시,035003, 32세,2018,3986,2127,1859,114.4,3735,1945,1790,108.7
38030, 진주시,035004, 33세,2018,3880,2067,1813,114,3632,1891,1741,108.6
38030, 진주시,035005, 34세,2018,4207,2127,2080,102.3,3992,1981,2011,98.5
38030, 진주시,040,35~39세,2018,25193,12740,12453,102.3,24334,12148,12186,99.7
38030, 진주시,040001, 35세,2018,4624,2310,2314,99.8,4409,2150,2259,95.2
38030, 진주시,040002, 36세,2018,5008,2538,2470,102.8,4825,2405,2420,99.4
38030, 진주시,040003, 37세,2018,5085,2560,2525,101.4,4899,2438,2461,99.1
38030, 진주시,040004, 38세,2018,5319,2693,2626,102.6,5167,2591,2576,100.6
38030, 진주시,040005, 39세,2018,5157,2639,2518,104.8,5034,2564,2470,103.8
38030, 진주시,045,40~44세,2018,25633,12761,12872,99.1,25146,12451,12695,98.1
38030, 진주시,045001, 40세,2018,4838,2437,2401,101.5,4731,2358,2373,99.4
38030, 진주시,045002, 41세,2018,4849,2395,2454,97.6,4749,2326,2423,96
38030, 진주시,045003, 42세,2018,5036,2511,2525,99.4,4919,2441,2478,98.5
38030, 진주시,045004, 43세,2018,5190,2597,2593,100.2,5105,2551,2554,99.9
38030, 진주시,045005, 44세,2018,5720,2821,2899,97.3,5642,2775,2867,96.8
38030, 진주시,050,45~49세,2018,30439,15242,15197,100.3,30076,15042,15034,100.1
38030, 진주시,050001, 45세,2018,5986,3000,2986,100.5,5927,2970,2957,100.4
38030, 진주시,050002, 46세,2018,5688,2898,2790,103.9,5601,2851,2750,103.7
38030, 진주시,050003, 47세,2018,6129,3072,3057,100.5,6051,3026,3025,100
38030, 진주시,050004, 48세,2018,6313,3135,3178,98.6,6250,3096,3154,98.2
38030, 진주시,050005, 49세,2018,6323,3137,3186,98.5,6247,3099,3148,98.4
38030, 진주시,055,50~54세,2018,27464,13707,13757,99.6,27159,13548,13611,99.5
38030, 진주시,055001, 50세,2018,6150,3087,3063,100.8,6088,3050,3038,100.4
38030, 진주시,055002, 51세,2018,5663,2771,2892,95.8,5588,2735,2853,95.9
38030, 진주시,055003, 52세,2018,5489,2857,2632,108.5,5431,2825,2606,108.4
38030, 진주시,055004, 53세,2018,5452,2687,2765,97.2,5405,2662,2743,97
38030, 진주시,055005, 54세,2018,4710,2305,2405,95.8,4647,2276,2371,96
38030, 진주시,060,55~59세,2018,29232,14361,14871,96.6,29035,14263,14772,96.6
38030, 진주시,060001, 55세,2018,5370,2714,2656,102.2,5314,2688,2626,102.4
38030, 진주시,060002, 56세,2018,5830,2909,2921,99.6,5784,2887,2897,99.7
38030, 진주시,060003, 57세,2018,6683,3253,3430,94.8,6649,3235,3414,94.8
38030, 진주시,060004, 58세,2018,6155,2920,3235,90.3,6117,2902,3215,90.3
38030, 진주시,060005, 59세,2018,5194,2565,2629,97.6,5171,2551,2620,97.4
38030, 진주시,065,60~64세,2018,23758,11690,12068,96.9,23635,11629,12006,96.9
38030, 진주시,065001, 60세,2018,5214,2554,2660,96,5178,2534,2644,95.8
38030, 진주시,065002, 61세,2018,5034,2527,2507,100.8,5005,2513,2492,100.8
38030, 진주시,065003, 62세,2018,4633,2327,2306,100.9,4609,2314,2295,100.8
38030, 진주시,065004, 63세,2018,4755,2206,2549,86.5,4739,2196,2543,86.4
38030, 진주시,065005, 64세,2018,4122,2076,2046,101.5,4104,2072,2032,102
38030, 진주시,070,65~69세,2018,16451,7686,8765,87.7,16399,7660,8739,87.7
38030, 진주시,070001, 65세,2018,3457,1626,1831,88.8,3444,1619,1825,88.7
38030, 진주시,070002, 66세,2018,3712,1738,1974,88,3701,1732,1969,88
38030, 진주시,070003, 67세,2018,2942,1393,1549,89.9,2930,1385,1545,89.6
38030, 진주시,070004, 68세,2018,3206,1502,1704,88.1,3196,1501,1695,88.6
38030, 진주시,070005, 69세,2018,3134,1427,1707,83.6,3128,1423,1705,83.5
38030, 진주시,075,70~74세,2018,12827,5849,6978,83.8,12806,5839,6967,83.8
38030, 진주시,075001, 70세,2018,3093,1430,1663,86,3088,1429,1659,86.1
38030, 진주시,075002, 71세,2018,2904,1359,1545,88,2899,1357,1542,88
38030, 진주시,075003, 72세,2018,2239,1030,1209,85.2,2236,1028,1208,85.1
38030, 진주시,075004, 73세,2018,2251,1019,1232,82.7,2248,1018,1230,82.8
38030, 진주시,075005, 74세,2018,2340,1011,1329,76.1,2335,1007,1328,75.8
38030, 진주시,080,75~79세,2018,11156,4426,6730,65.8,11148,4422,6726,65.7
38030, 진주시,080001, 75세,2018,2338,983,1355,72.5,2338,983,1355,72.5
38030, 진주시,080002, 76세,2018,2524,1025,1499,68.4,2521,1024,1497,68.4
38030, 진주시,080003, 77세,2018,2242,917,1325,69.2,2241,916,1325,69.1
38030, 진주시,080004, 78세,2018,2100,791,1309,60.4,2099,790,1309,60.4
38030, 진주시,080005, 79세,2018,1952,710,1242,57.2,1949,709,1240,57.2
38030, 진주시,085,80~84세,2018,7174,2316,4858,47.7,7169,2314,4855,47.7
38030, 진주시,085001, 80세,2018,1693,587,1106,53.1,1692,587,1105,53.1
38030, 진주시,085002, 81세,2018,1566,545,1021,53.4,1565,545,1020,53.4
38030, 진주시,085003, 82세,2018,1473,463,1010,45.8,1470,461,1009,45.7
38030, 진주시,085004, 83세,2018,1318,392,926,42.3,1318,392,926,42.3
38030, 진주시,085005, 84세,2018,1124,329,795,41.4,1124,329,795,41.4
38030, 진주시,090,85~89세,2018,3408,781,2627,29.7,3407,781,2626,29.7
38030, 진주시,090001, 85세,2018,897,220,677,32.5,896,220,676,32.5
38030, 진주시,090002, 86세,2018,835,206,629,32.8,835,206,629,32.8
38030, 진주시,090003, 87세,2018,649,154,495,31.1,649,154,495,31.1
38030, 진주시,090004, 88세,2018,568,102,466,21.9,568,102,466,21.9
38030, 진주시,090005, 89세,2018,459,99,360,27.5,459,99,360,27.5
38030, 진주시,095,90~94세,2018,1107,222,885,25.1,1107,222,885,25.1
38030, 진주시,095001, 90세,2018,366,81,285,28.4,366,81,285,28.4
38030, 진주시,095002, 91세,2018,272,52,220,23.6,272,52,220,23.6
38030, 진주시,095003, 92세,2018,189,35,154,22.7,189,35,154,22.7
38030, 진주시,095004, 93세,2018,185,32,153,20.9,185,32,153,20.9
38030, 진주시,095005, 94세,2018,95,22,73,30.1,95,22,73,30.1
38030, 진주시,100,95~99세,2018,226,31,195,15.9,226,31,195,15.9
38030, 진주시,100001, 95세,2018,76,11,65,16.9,76,11,65,16.9
38030, 진주시,100002, 96세,2018,73,11,62,17.7,73,11,62,17.7
38030, 진주시,100003, 97세,2018,42,5,37,13.5,42,5,37,13.5
38030, 진주시,100004, 98세,2018,25,X,23,8.7,25,X,23,8.7
38030, 진주시,100005, 99세,2018,10,X,8,25,10,X,8,25
38030, 진주시,101,100세이상,2018,26,5,21,23.8,26,5,21,23.8
38030, 진주시,102,15세미만,2018,46634,24439,22195,110.1,46536,24384,22152,110.1
38030, 진주시,103,15~64세,2018,253324,130473,122851,106.2,247017,126534,120483,105
38030, 진주시,104,65세이상,2018,52375,21316,31059,68.6,52288,21274,31014,68.6
38030, 진주시,086,85세이상,2018,4767,1039,3728,27.9,4766,1039,3727,27.9
38030, 진주시,126,평균연령,2018,41.5,39.8,43.3,,41.7,39.9,43.4,
38030, 진주시,127,중위연령,2018,42.6,40.4,44.6,,43,40.9,44.9,
38050, 통영시,000,합계,2018,131407,67572,63835,105.9,126574,63722,62852,101.4
38050, 통영시,005,0~4세,2018,4922,2443,2479,98.5,4917,2441,2476,98.6
38050, 통영시,005001, 0세,2018,672,322,350,92,669,322,347,92.8
38050, 통영시,005002, 1세,2018,878,427,451,94.7,878,427,451,94.7
38050, 통영시,005003, 2세,2018,1007,513,494,103.8,1007,513,494,103.8
38050, 통영시,005004, 3세,2018,1176,584,592,98.6,1174,582,592,98.3
38050, 통영시,005005, 4세,2018,1189,597,592,100.8,1189,597,592,100.8
38050, 통영시,010,5~9세,2018,6952,3596,3356,107.2,6943,3590,3353,107.1
38050, 통영시,010001, 5세,2018,1239,646,593,108.9,1237,645,592,109
38050, 통영시,010002, 6세,2018,1408,714,694,102.9,1407,714,693,103
38050, 통영시,010003, 7세,2018,1471,750,721,104,1469,748,721,103.7
38050, 통영시,010004, 8세,2018,1470,766,704,108.8,1469,765,704,108.7
38050, 통영시,010005, 9세,2018,1364,720,644,111.8,1361,718,643,111.7
38050, 통영시,015,10~14세,2018,6281,3228,3053,105.7,6271,3222,3049,105.7
38050, 통영시,015001, 10세,2018,1422,710,712,99.7,1420,709,711,99.7
38050, 통영시,015002, 11세,2018,1361,687,674,101.9,1359,685,674,101.6
38050, 통영시,015003, 12세,2018,1167,607,560,108.4,1165,606,559,108.4
38050, 통영시,015004, 13세,2018,1160,601,559,107.5,1160,601,559,107.5
38050, 통영시,015005, 14세,2018,1171,623,548,113.7,1167,621,546,113.7
38050, 통영시,020,15~19세,2018,6195,3367,2828,119.1,6171,3353,2818,119
38050, 통영시,020001, 15세,2018,1224,633,591,107.1,1223,633,590,107.3
38050, 통영시,020002, 16세,2018,1259,659,600,109.8,1258,658,600,109.7
38050, 통영시,020003, 17세,2018,1415,732,683,107.2,1413,731,682,107.2
38050, 통영시,020004, 18세,2018,1350,722,628,115,1339,716,623,114.9
38050, 통영시,020005, 19세,2018,947,621,326,190.5,938,615,323,190.4
38050, 통영시,025,20~24세,2018,5823,3620,2203,164.3,5380,3268,2112,154.7
38050, 통영시,025001, 20세,2018,1081,730,351,208,1053,711,342,207.9
38050, 통영시,025002, 21세,2018,1219,778,441,176.4,1157,726,431,168.4
38050, 통영시,025003, 22세,2018,1200,746,454,164.3,1115,677,438,154.6
38050, 통영시,025004, 23세,2018,1151,688,463,148.6,1046,608,438,138.8
38050, 통영시,025005, 24세,2018,1172,678,494,137.2,1009,546,463,117.9
38050, 통영시,030,25~29세,2018,6258,3582,2676,133.9,5235,2730,2505,109
38050, 통영시,030001, 25세,2018,1295,759,536,141.6,1099,594,505,117.6
38050, 통영시,030002, 26세,2018,1267,702,565,124.2,1069,545,524,104
38050, 통영시,030003, 27세,2018,1220,704,516,136.4,1013,533,480,111
38050, 통영시,030004, 28세,2018,1241,701,540,129.8,1017,511,506,101
38050, 통영시,030005, 29세,2018,1235,716,519,138,1037,547,490,111.6
38050, 통영시,035,30~34세,2018,7360,4168,3192,130.6,6254,3219,3035,106.1
38050, 통영시,035001, 30세,2018,1253,754,499,151.1,1032,564,468,120.5
38050, 통영시,035002, 31세,2018,1402,786,616,127.6,1162,587,575,102.1
38050, 통영시,035003, 32세,2018,1372,800,572,139.9,1172,627,545,115
38050, 통영시,035004, 33세,2018,1525,839,686,122.3,1303,639,664,96.2
38050, 통영시,035005, 34세,2018,1808,989,819,120.8,1585,802,783,102.4
38050, 통영시,040,35~39세,2018,10945,5968,4977,119.9,10125,5260,4865,108.1
38050, 통영시,040001, 35세,2018,1901,1008,893,112.9,1717,847,870,97.4
38050, 통영시,040002, 36세,2018,2220,1218,1002,121.6,2022,1049,973,107.8
38050, 통영시,040003, 37세,2018,2234,1213,1021,118.8,2072,1074,998,107.6
38050, 통영시,040004, 38세,2018,2421,1342,1079,124.4,2278,1215,1063,114.3
38050, 통영시,040005, 39세,2018,2169,1187,982,120.9,2036,1075,961,111.9
38050, 통영시,045,40~44세,2018,10510,5862,4648,126.1,9983,5431,4552,119.3
38050, 통영시,045001, 40세,2018,2047,1151,896,128.5,1907,1025,882,116.2
38050, 통영시,045002, 41세,2018,2106,1156,950,121.7,1992,1064,928,114.7
38050, 통영시,045003, 42세,2018,1982,1124,858,131,1875,1038,837,124
38050, 통영시,045004, 43세,2018,2211,1225,986,124.2,2118,1155,963,119.9
38050, 통영시,045005, 44세,2018,2164,1206,958,125.9,2091,1149,942,122
38050, 통영시,050,45~49세,2018,11392,6156,5236,117.6,11029,5884,5145,114.4
38050, 통영시,050001, 45세,2018,2332,1267,1065,119,2249,1203,1046,115
38050, 통영시,050002, 46세,2018,2259,1248,1011,123.4,2161,1174,987,118.9
38050, 통영시,050003, 47세,2018,2318,1236,1082,114.2,2245,1175,1070,109.8
38050, 통영시,050004, 48세,2018,2292,1254,1038,120.8,2228,1205,1023,117.8
38050, 통영시,050005, 49세,2018,2191,1151,1040,110.7,2146,1127,1019,110.6
38050, 통영시,055,50~54세,2018,10366,5303,5063,104.7,10140,5176,4964,104.3
38050, 통영시,055001, 50세,2018,2316,1236,1080,114.4,2256,1195,1061,112.6
38050, 통영시,055002, 51세,2018,2109,1069,1040,102.8,2066,1047,1019,102.7
38050, 통영시,055003, 52세,2018,2014,1005,1009,99.6,1980,981,999,98.2
38050, 통영시,055004, 53세,2018,2039,1015,1024,99.1,1991,995,996,99.9
38050, 통영시,055005, 54세,2018,1888,978,910,107.5,1847,958,889,107.8
38050, 통영시,060,55~59세,2018,12117,5929,6188,95.8,11972,5857,6115,95.8
38050, 통영시,060001, 55세,2018,2119,1093,1026,106.5,2076,1071,1005,106.6
38050, 통영시,060002, 56세,2018,2413,1174,1239,94.8,2381,1159,1222,94.8
38050, 통영시,060003, 57세,2018,2609,1254,1355,92.5,2588,1242,1346,92.3
38050, 통영시,060004, 58세,2018,2633,1262,1371,92,2608,1251,1357,92.2
38050, 통영시,060005, 59세,2018,2343,1146,1197,95.7,2319,1134,1185,95.7
38050, 통영시,065,60~64세,2018,10221,4978,5243,94.9,10151,4946,5205,95
38050, 통영시,065001, 60세,2018,2170,1078,1092,98.7,2152,1070,1082,98.9
38050, 통영시,065002, 61세,2018,2131,1026,1105,92.9,2116,1018,1098,92.7
38050, 통영시,065003, 62세,2018,2112,1039,1073,96.8,2098,1032,1066,96.8
38050, 통영시,065004, 63세,2018,2066,996,1070,93.1,2054,991,1063,93.2
38050, 통영시,065005, 64세,2018,1742,839,903,92.9,1731,835,896,93.2
38050, 통영시,070,65~69세,2018,7473,3702,3771,98.2,7436,3684,3752,98.2
38050, 통영시,070001, 65세,2018,1528,732,796,92,1516,725,791,91.7
38050, 통영시,070002, 66세,2018,1750,894,856,104.4,1739,889,850,104.6
38050, 통영시,070003, 67세,2018,1484,730,754,96.8,1476,727,749,97.1
38050, 통영시,070004, 68세,2018,1300,634,666,95.2,1297,633,664,95.3
38050, 통영시,070005, 69세,2018,1411,712,699,101.9,1408,710,698,101.7
38050, 통영시,075,70~74세,2018,5452,2538,2914,87.1,5434,2532,2902,87.3
38050, 통영시,075001, 70세,2018,1438,679,759,89.5,1429,676,753,89.8
38050, 통영시,075002, 71세,2018,1256,598,658,90.9,1251,596,655,91
38050, 통영시,075003, 72세,2018,831,403,428,94.2,829,402,427,94.1
38050, 통영시,075004, 73세,2018,1012,468,544,86,1011,468,543,86.2
38050, 통영시,075005, 74세,2018,915,390,525,74.3,914,390,524,74.4
38050, 통영시,080,75~79세,2018,4665,1839,2826,65.1,4661,1837,2824,65
38050, 통영시,080001, 75세,2018,1022,439,583,75.3,1020,438,582,75.3
38050, 통영시,080002, 76세,2018,1133,452,681,66.4,1133,452,681,66.4
38050, 통영시,080003, 77세,2018,942,365,577,63.3,942,365,577,63.3
38050, 통영시,080004, 78세,2018,816,304,512,59.4,816,304,512,59.4
38050, 통영시,080005, 79세,2018,752,279,473,59,750,278,472,58.9
38050, 통영시,085,80~84세,2018,2720,894,1826,49,2719,894,1825,49
38050, 통영시,085001, 80세,2018,624,193,431,44.8,624,193,431,44.8
38050, 통영시,085002, 81세,2018,638,222,416,53.4,638,222,416,53.4
38050, 통영시,085003, 82세,2018,553,193,360,53.6,553,193,360,53.6
38050, 통영시,085004, 83세,2018,503,168,335,50.1,502,168,334,50.3
38050, 통영시,085005, 84세,2018,402,118,284,41.5,402,118,284,41.5
38050, 통영시,090,85~89세,2018,1273,312,961,32.5,1273,312,961,32.5
38050, 통영시,090001, 85세,2018,353,99,254,39,353,99,254,39
38050, 통영시,090002, 86세,2018,311,78,233,33.5,311,78,233,33.5
38050, 통영시,090003, 87세,2018,260,63,197,32,260,63,197,32
38050, 통영시,090004, 88세,2018,191,43,148,29.1,191,43,148,29.1
38050, 통영시,090005, 89세,2018,158,29,129,22.5,158,29,129,22.5
38050, 통영시,095,90~94세,2018,411,78,333,23.4,409,77,332,23.2
38050, 통영시,095001, 90세,2018,143,38,105,36.2,143,38,105,36.2
38050, 통영시,095002, 91세,2018,105,13,92,14.1,104,13,91,14.3
38050, 통영시,095003, 92세,2018,70,11,59,18.6,69,10,59,16.9
38050, 통영시,095004, 93세,2018,60,11,49,22.4,60,11,49,22.4
38050, 통영시,095005, 94세,2018,33,5,28,17.9,33,5,28,17.9
38050, 통영시,100,95~99세,2018,68,8,60,13.3,68,8,60,13.3
38050, 통영시,100001, 95세,2018,22,X,18,22.2,22,X,18,22.2
38050, 통영시,100002, 96세,2018,28,X,24,16.7,28,X,24,16.7
38050, 통영시,100003, 97세,2018,10,X,10,0,10,X,10,0
38050, 통영시,100004, 98세,2018,X,X,X,0,X,X,X,0
38050, 통영시,100005, 99세,2018,5,X,5,0,5,X,5,0
38050, 통영시,101,100세이상,2018,X,X,X,50,X,X,X,50
38050, 통영시,102,15세미만,2018,18155,9267,8888,104.3,18131,9253,8878,104.2
38050, 통영시,103,15~64세,2018,91187,48933,42254,115.8,86440,45124,41316,109.2
38050, 통영시,104,65세이상,2018,22065,9372,12693,73.8,22003,9345,12658,73.8
38050, 통영시,086,85세이상,2018,1755,399,1356,29.4,1753,398,1355,29.4
38050, 통영시,126,평균연령,2018,43.5,41.8,45.2,,43.7,42.3,45.3,
38050, 통영시,127,중위연령,2018,45.2,43.3,47.4,,45.9,44.4,47.6,
38060, 사천시,000,합계,2018,112248,57715,54533,105.8,108086,54513,53573,101.8
38060, 사천시,005,0~4세,2018,4329,2208,2121,104.1,4265,2173,2092,103.9
38060, 사천시,005001, 0세,2018,674,332,342,97.1,662,325,337,96.4
38060, 사천시,005002, 1세,2018,803,417,386,108,786,409,377,108.5
38060, 사천시,005003, 2세,2018,904,484,420,115.2,892,475,417,113.9
38060, 사천시,005004, 3세,2018,929,466,463,100.6,914,458,456,100.4
38060, 사천시,005005, 4세,2018,1019,509,510,99.8,1011,506,505,100.2
38060, 사천시,010,5~9세,2018,5405,2796,2609,107.2,5350,2771,2579,107.4
38060, 사천시,010001, 5세,2018,974,527,447,117.9,965,521,444,117.3
38060, 사천시,010002, 6세,2018,1107,571,536,106.5,1091,563,528,106.6
38060, 사천시,010003, 7세,2018,1111,598,513,116.6,1104,596,508,117.3
38060, 사천시,010004, 8세,2018,1110,559,551,101.5,1099,555,544,102
38060, 사천시,010005, 9세,2018,1103,541,562,96.3,1091,536,555,96.6
38060, 사천시,015,10~14세,2018,5047,2599,2448,106.2,5002,2578,2424,106.4
38060, 사천시,015001, 10세,2018,1091,562,529,106.2,1085,560,525,106.7
38060, 사천시,015002, 11세,2018,1062,542,520,104.2,1052,540,512,105.5
38060, 사천시,015003, 12세,2018,995,518,477,108.6,984,511,473,108
38060, 사천시,015004, 13세,2018,918,464,454,102.2,911,461,450,102.4
38060, 사천시,015005, 14세,2018,981,513,468,109.6,970,506,464,109.1
38060, 사천시,020,15~19세,2018,4978,2738,2240,122.2,4932,2715,2217,122.5
38060, 사천시,020001, 15세,2018,976,516,460,112.2,974,515,459,112.2
38060, 사천시,020002, 16세,2018,976,495,481,102.9,971,493,478,103.1
38060, 사천시,020003, 17세,2018,1169,616,553,111.4,1164,614,550,111.6
38060, 사천시,020004, 18세,2018,1125,621,504,123.2,1113,614,499,123
38060, 사천시,020005, 19세,2018,732,490,242,202.5,710,479,231,207.4
38060, 사천시,025,20~24세,2018,5264,3575,1689,211.7,4880,3285,1595,206
38060, 사천시,025001, 20세,2018,910,675,235,287.2,883,656,227,289
38060, 사천시,025002, 21세,2018,1076,746,330,226.1,1035,718,317,226.5
38060, 사천시,025003, 22세,2018,1052,722,330,218.8,984,672,312,215.4
38060, 사천시,025004, 23세,2018,1096,713,383,186.2,986,628,358,175.4
38060, 사천시,025005, 24세,2018,1130,719,411,174.9,992,611,381,160.4
38060, 사천시,030,25~29세,2018,5779,3603,2176,165.6,4951,2930,2021,145
38060, 사천시,030001, 25세,2018,1079,670,409,163.8,931,556,375,148.3
38060, 사천시,030002, 26세,2018,1161,700,461,151.8,1008,584,424,137.7
38060, 사천시,030003, 27세,2018,1137,728,409,178,973,583,390,149.5
38060, 사천시,030004, 28세,2018,1207,744,463,160.7,1021,594,427,139.1
38060, 사천시,030005, 29세,2018,1195,761,434,175.3,1018,613,405,151.4
38060, 사천시,035,30~34세,2018,6015,3535,2480,142.5,5155,2816,2339,120.4
38060, 사천시,035001, 30세,2018,1102,682,420,162.4,928,533,395,134.9
38060, 사천시,035002, 31세,2018,1129,658,471,139.7,951,505,446,113.2
38060, 사천시,035003, 32세,2018,1240,759,481,157.8,1056,605,451,134.1
38060, 사천시,035004, 33세,2018,1188,673,515,130.7,1029,542,487,111.3
38060, 사천시,035005, 34세,2018,1356,763,593,128.7,1191,631,560,112.7
38060, 사천시,040,35~39세,2018,8867,4787,4080,117.3,8194,4212,3982,105.8
38060, 사천시,040001, 35세,2018,1629,896,733,122.2,1472,759,713,106.5
38060, 사천시,040002, 36세,2018,1780,989,791,125,1623,852,771,110.5
38060, 사천시,040003, 37세,2018,1810,977,833,117.3,1672,861,811,106.2
38060, 사천시,040004, 38세,2018,1885,974,911,106.9,1766,873,893,97.8
38060, 사천시,040005, 39세,2018,1763,951,812,117.1,1661,867,794,109.2
38060, 사천시,045,40~44세,2018,8684,4728,3956,119.5,8200,4349,3851,112.9
38060, 사천시,045001, 40세,2018,1695,903,792,114,1588,817,771,106
38060, 사천시,045002, 41세,2018,1719,935,784,119.3,1627,865,762,113.5
38060, 사천시,045003, 42세,2018,1674,953,721,132.2,1568,872,696,125.3
38060, 사천시,045004, 43세,2018,1745,912,833,109.5,1643,833,810,102.8
38060, 사천시,045005, 44세,2018,1851,1025,826,124.1,1774,962,812,118.5
38060, 사천시,050,45~49세,2018,9519,5181,4338,119.4,9227,4961,4266,116.3
38060, 사천시,050001, 45세,2018,1971,1081,890,121.5,1894,1015,879,115.5
38060, 사천시,050002, 46세,2018,1857,1040,817,127.3,1787,985,802,122.8
38060, 사천시,050003, 47세,2018,1950,1060,890,119.1,1899,1021,878,116.3
38060, 사천시,050004, 48세,2018,1844,978,866,112.9,1796,951,845,112.5
38060, 사천시,050005, 49세,2018,1897,1022,875,116.8,1851,989,862,114.7
38060, 사천시,055,50~54세,2018,8375,4414,3961,111.4,8201,4309,3892,110.7
38060, 사천시,055001, 50세,2018,1770,948,822,115.3,1732,920,812,113.3
38060, 사천시,055002, 51세,2018,1704,854,850,100.5,1662,829,833,99.5
38060, 사천시,055003, 52세,2018,1733,949,784,121,1707,936,771,121.4
38060, 사천시,055004, 53세,2018,1725,909,816,111.4,1681,883,798,110.7
38060, 사천시,055005, 54세,2018,1443,754,689,109.4,1419,741,678,109.3
38060, 사천시,060,55~59세,2018,9412,4758,4654,102.2,9258,4675,4583,102
38060, 사천시,060001, 55세,2018,1679,911,768,118.6,1631,882,749,117.8
38060, 사천시,060002, 56세,2018,1875,971,904,107.4,1845,954,891,107.1
38060, 사천시,060003, 57세,2018,2117,1047,1070,97.9,2091,1035,1056,98
38060, 사천시,060004, 58세,2018,2020,989,1031,95.9,1995,976,1019,95.8
38060, 사천시,060005, 59세,2018,1721,840,881,95.3,1696,828,868,95.4
38060, 사천시,065,60~64세,2018,8458,4097,4361,93.9,8406,4066,4340,93.7
38060, 사천시,065001, 60세,2018,1739,835,904,92.4,1724,827,897,92.2
38060, 사천시,065002, 61세,2018,1736,832,904,92,1723,822,901,91.2
38060, 사천시,065003, 62세,2018,1588,778,810,96,1579,773,806,95.9
38060, 사천시,065004, 63세,2018,1832,862,970,88.9,1820,856,964,88.8
38060, 사천시,065005, 64세,2018,1563,790,773,102.2,1560,788,772,102.1
38060, 사천시,070,65~69세,2018,6254,2923,3331,87.8,6223,2909,3314,87.8
38060, 사천시,070001, 65세,2018,1162,535,627,85.3,1159,533,626,85.1
38060, 사천시,070002, 66세,2018,1398,673,725,92.8,1389,668,721,92.6
38060, 사천시,070003, 67세,2018,1217,552,665,83,1211,551,660,83.5
38060, 사천시,070004, 68세,2018,1245,593,652,91,1238,590,648,91
38060, 사천시,070005, 69세,2018,1232,570,662,86.1,1226,567,659,86
38060, 사천시,075,70~74세,2018,5248,2299,2949,78,5236,2292,2944,77.9
38060, 사천시,075001, 70세,2018,1250,590,660,89.4,1246,587,659,89.1
38060, 사천시,075002, 71세,2018,1187,534,653,81.8,1185,532,653,81.5
38060, 사천시,075003, 72세,2018,898,402,496,81,893,400,493,81.1
38060, 사천시,075004, 73세,2018,964,382,582,65.6,964,382,582,65.6
38060, 사천시,075005, 74세,2018,949,391,558,70.1,948,391,557,70.2
38060, 사천시,080,75~79세,2018,4845,1880,2965,63.4,4840,1878,2962,63.4
38060, 사천시,080001, 75세,2018,975,413,562,73.5,975,413,562,73.5
38060, 사천시,080002, 76세,2018,1072,398,674,59.1,1072,398,674,59.1
38060, 사천시,080003, 77세,2018,997,405,592,68.4,996,404,592,68.2
38060, 사천시,080004, 78세,2018,893,318,575,55.3,890,317,573,55.3
38060, 사천시,080005, 79세,2018,908,346,562,61.6,907,346,561,61.7
38060, 사천시,085,80~84세,2018,3407,1125,2282,49.3,3406,1125,2281,49.3
38060, 사천시,085001, 80세,2018,750,260,490,53.1,749,260,489,53.2
38060, 사천시,085002, 81세,2018,776,276,500,55.2,776,276,500,55.2
38060, 사천시,085003, 82세,2018,748,242,506,47.8,748,242,506,47.8
38060, 사천시,085004, 83세,2018,604,190,414,45.9,604,190,414,45.9
38060, 사천시,085005, 84세,2018,529,157,372,42.2,529,157,372,42.2
38060, 사천시,090,85~89세,2018,1673,367,1306,28.1,1671,367,1304,28.1
38060, 사천시,090001, 85세,2018,432,113,319,35.4,431,113,318,35.5
38060, 사천시,090002, 86세,2018,433,99,334,29.6,433,99,334,29.6
38060, 사천시,090003, 87세,2018,340,77,263,29.3,339,77,262,29.4
38060, 사천시,090004, 88세,2018,249,43,206,20.9,249,43,206,20.9
38060, 사천시,090005, 89세,2018,219,35,184,19,219,35,184,19
38060, 사천시,095,90~94세,2018,566,87,479,18.2,566,87,479,18.2
38060, 사천시,095001, 90세,2018,169,36,133,27.1,169,36,133,27.1
38060, 사천시,095002, 91세,2018,146,22,124,17.7,146,22,124,17.7
38060, 사천시,095003, 92세,2018,102,11,91,12.1,102,11,91,12.1
38060, 사천시,095004, 93세,2018,100,15,85,17.6,100,15,85,17.6
38060, 사천시,095005, 94세,2018,49,X,46,6.5,49,X,46,6.5
38060, 사천시,100,95~99세,2018,111,15,96,15.6,111,15,96,15.6
38060, 사천시,100001, 95세,2018,37,X,34,8.8,37,X,34,8.8
38060, 사천시,100002, 96세,2018,40,X,37,8.1,40,X,37,8.1
38060, 사천시,100003, 97세,2018,18,6,12,50,18,6,12,50
38060, 사천시,100004, 98세,2018,10,X,9,11.1,10,X,9,11.1
38060, 사천시,100005, 99세,2018,6,X,X,50,6,X,X,50
38060, 사천시,101,100세이상,2018,12,X,12,0,12,X,12,0
38060, 사천시,102,15세미만,2018,14781,7603,7178,105.9,14617,7522,7095,106
38060, 사천시,103,15~64세,2018,75351,41416,33935,122,71404,38318,33086,115.8
38060, 사천시,104,65세이상,2018,22116,8696,13420,64.8,22065,8673,13392,64.8
38060, 사천시,086,85세이상,2018,2362,469,1893,24.8,2360,469,1891,24.8
38060, 사천시,126,평균연령,2018,44.6,42.1,47.2,,45,42.6,47.4,
38060, 사천시,127,중위연령,2018,45.9,43.2,49,,46.7,44.4,49.3,
38070, 김해시,000,합계,2018,539401,277024,262377,105.6,514297,259126,255171,101.5
38070, 김해시,005,0~4세,2018,23777,12151,11626,104.5,23453,11999,11454,104.8
38070, 김해시,005001, 0세,2018,3673,1875,1798,104.3,3615,1849,1766,104.7
38070, 김해시,005002, 1세,2018,4242,2168,2074,104.5,4197,2146,2051,104.6
38070, 김해시,005003, 2세,2018,4963,2539,2424,104.7,4889,2508,2381,105.3
38070, 김해시,005004, 3세,2018,5365,2778,2587,107.4,5283,2734,2549,107.3
38070, 김해시,005005, 4세,2018,5534,2791,2743,101.7,5469,2762,2707,102
38070, 김해시,010,5~9세,2018,28907,14673,14234,103.1,28686,14563,14123,103.1
38070, 김해시,010001, 5세,2018,5459,2761,2698,102.3,5401,2730,2671,102.2
38070, 김해시,010002, 6세,2018,6056,3001,3055,98.2,6008,2980,3028,98.4
38070, 김해시,010003, 7세,2018,5906,2980,2926,101.8,5870,2960,2910,101.7
38070, 김해시,010004, 8세,2018,5832,3006,2826,106.4,5791,2984,2807,106.3
38070, 김해시,010005, 9세,2018,5654,2925,2729,107.2,5616,2909,2707,107.5
38070, 김해시,015,10~14세,2018,29772,15533,14239,109.1,29626,15460,14166,109.1
38070, 김해시,015001, 10세,2018,6060,3118,2942,106,6020,3102,2918,106.3
38070, 김해시,015002, 11세,2018,6333,3238,3095,104.6,6299,3223,3076,104.8
38070, 김해시,015003, 12세,2018,5769,3004,2765,108.6,5743,2990,2753,108.6
38070, 김해시,015004, 13세,2018,5664,3022,2642,114.4,5637,3006,2631,114.3
38070, 김해시,015005, 14세,2018,5946,3151,2795,112.7,5927,3139,2788,112.6
38070, 김해시,020,15~19세,2018,32176,17014,15162,112.2,31773,16789,14984,112
38070, 김해시,020001, 15세,2018,6042,3190,2852,111.9,6013,3176,2837,111.9
38070, 김해시,020002, 16세,2018,5978,3130,2848,109.9,5953,3117,2836,109.9
38070, 김해시,020003, 17세,2018,6760,3532,3228,109.4,6721,3508,3213,109.2
38070, 김해시,020004, 18세,2018,7033,3659,3374,108.4,6945,3608,3337,108.1
38070, 김해시,020005, 19세,2018,6363,3503,2860,122.5,6141,3380,2761,122.4
38070, 김해시,025,20~24세,2018,36379,20513,15866,129.3,33698,18540,15158,122.3
38070, 김해시,025001, 20세,2018,7019,3984,3035,131.3,6674,3769,2905,129.7
38070, 김해시,025002, 21세,2018,7312,4150,3162,131.2,6895,3872,3023,128.1
38070, 김해시,025003, 22세,2018,7461,4194,3267,128.4,6961,3816,3145,121.3
38070, 김해시,025004, 23세,2018,7331,4116,3215,128,6666,3601,3065,117.5
38070, 김해시,025005, 24세,2018,7256,4069,3187,127.7,6502,3482,3020,115.3
38070, 김해시,030,25~29세,2018,34042,19429,14613,133,28978,15565,13413,116
38070, 김해시,030001, 25세,2018,7180,4132,3048,135.6,6295,3444,2851,120.8
38070, 김해시,030002, 26세,2018,7181,4052,3129,129.5,6192,3303,2889,114.3
38070, 김해시,030003, 27세,2018,6793,3843,2950,130.3,5780,3098,2682,115.5
38070, 김해시,030004, 28세,2018,6605,3810,2795,136.3,5485,2940,2545,115.5
38070, 김해시,030005, 29세,2018,6283,3592,2691,133.5,5226,2780,2446,113.7
38070, 김해시,035,30~34세,2018,33936,18769,15167,123.7,28467,14537,13930,104.4
38070, 김해시,035001, 30세,2018,6297,3510,2787,125.9,5133,2609,2524,103.4
38070, 김해시,035002, 31세,2018,6428,3581,2847,125.8,5229,2667,2562,104.1
38070, 김해시,035003, 32세,2018,6764,3770,2994,125.9,5666,2930,2736,107.1
38070, 김해시,035004, 33세,2018,6991,3893,3098,125.7,5950,3065,2885,106.2
38070, 김해시,035005, 34세,2018,7456,4015,3441,116.7,6489,3266,3223,101.3
38070, 김해시,040,35~39세,2018,46498,24331,22167,109.8,42779,21477,21302,100.8
38070, 김해시,040001, 35세,2018,8354,4424,3930,112.6,7461,3740,3721,100.5
38070, 김해시,040002, 36세,2018,9210,4826,4384,110.1,8391,4194,4197,99.9
38070, 김해시,040003, 37세,2018,9603,5104,4499,113.4,8867,4525,4342,104.2
38070, 김해시,040004, 38세,2018,9858,5081,4777,106.4,9221,4585,4636,98.9
38070, 김해시,040005, 39세,2018,9473,4896,4577,107,8839,4433,4406,100.6
38070, 김해시,045,40~44세,2018,46854,23576,23278,101.3,44497,21896,22601,96.9
38070, 김해시,045001, 40세,2018,8831,4510,4321,104.4,8271,4116,4155,99.1
38070, 김해시,045002, 41세,2018,8872,4486,4386,102.3,8409,4149,4260,97.4
38070, 김해시,045003, 42세,2018,8854,4476,4378,102.2,8377,4118,4259,96.7
38070, 김해시,045004, 43세,2018,9748,4829,4919,98.2,9297,4523,4774,94.7
38070, 김해시,045005, 44세,2018,10549,5275,5274,100,10143,4990,5153,96.8
38070, 김해시,050,45~49세,2018,54664,27523,27141,101.4,52926,26422,26504,99.7
38070, 김해시,050001, 45세,2018,10835,5332,5503,96.9,10471,5091,5380,94.6
38070, 김해시,050002, 46세,2018,10586,5351,5235,102.2,10231,5114,5117,99.9
38070, 김해시,050003, 47세,2018,11531,5842,5689,102.7,11152,5606,5546,101.1
38070, 김해시,050004, 48세,2018,10890,5517,5373,102.7,10548,5302,5246,101.1
38070, 김해시,050005, 49세,2018,10822,5481,5341,102.6,10524,5309,5215,101.8
38070, 김해시,055,50~54세,2018,47773,24466,23307,105,46490,23713,22777,104.1
38070, 김해시,055001, 50세,2018,10947,5510,5437,101.3,10651,5332,5319,100.2
38070, 김해시,055002, 51세,2018,9883,4995,4888,102.2,9637,4853,4784,101.4
38070, 김해시,055003, 52세,2018,9471,4946,4525,109.3,9205,4784,4421,108.2
38070, 김해시,055004, 53세,2018,9222,4740,4482,105.8,8986,4597,4389,104.7
38070, 김해시,055005, 54세,2018,8250,4275,3975,107.5,8011,4147,3864,107.3
38070, 김해시,060,55~59세,2018,41958,22132,19826,111.6,41106,21659,19447,111.4
38070, 김해시,060001, 55세,2018,8597,4642,3955,117.4,8361,4500,3861,116.6
38070, 김해시,060002, 56세,2018,8810,4690,4120,113.8,8592,4578,4014,114.1
38070, 김해시,060003, 57세,2018,8875,4580,4295,106.6,8737,4503,4234,106.4
38070, 김해시,060004, 58세,2018,8384,4396,3988,110.2,8223,4312,3911,110.3
38070, 김해시,060005, 59세,2018,7292,3824,3468,110.3,7193,3766,3427,109.9
38070, 김해시,065,60~64세,2018,29375,15091,14284,105.6,28908,14849,14059,105.6
38070, 김해시,065001, 60세,2018,6769,3526,3243,108.7,6650,3463,3187,108.7
38070, 김해시,065002, 61세,2018,6511,3351,3160,106,6422,3300,3122,105.7
38070, 김해시,065003, 62세,2018,5719,2919,2800,104.3,5625,2868,2757,104
38070, 김해시,065004, 63세,2018,5602,2849,2753,103.5,5522,2807,2715,103.4
38070, 김해시,065005, 64세,2018,4774,2446,2328,105.1,4689,2411,2278,105.8
38070, 김해시,070,65~69세,2018,18151,8806,9345,94.2,17916,8688,9228,94.1
38070, 김해시,070001, 65세,2018,3978,1950,2028,96.2,3912,1922,1990,96.6
38070, 김해시,070002, 66세,2018,4237,2082,2155,96.6,4182,2055,2127,96.6
38070, 김해시,070003, 67세,2018,3326,1605,1721,93.3,3281,1582,1699,93.1
38070, 김해시,070004, 68세,2018,3387,1662,1725,96.3,3352,1642,1710,96
38070, 김해시,070005, 69세,2018,3223,1507,1716,87.8,3189,1487,1702,87.4
38070, 김해시,075,70~74세,2018,12878,5726,7152,80.1,12809,5701,7108,80.2
38070, 김해시,075001, 70세,2018,3273,1469,1804,81.4,3262,1465,1797,81.5
38070, 김해시,075002, 71세,2018,2952,1317,1635,80.6,2933,1309,1624,80.6
38070, 김해시,075003, 72세,2018,2164,999,1165,85.8,2148,993,1155,86
38070, 김해시,075004, 73세,2018,2151,935,1216,76.9,2134,930,1204,77.2
38070, 김해시,075005, 74세,2018,2338,1006,1332,75.5,2332,1004,1328,75.6
38070, 김해시,080,75~79세,2018,10969,4196,6773,62,10927,4183,6744,62
38070, 김해시,080001, 75세,2018,2373,979,1394,70.2,2367,977,1390,70.3
38070, 김해시,080002, 76세,2018,2578,1010,1568,64.4,2569,1007,1562,64.5
38070, 김해시,080003, 77세,2018,2122,785,1337,58.7,2108,783,1325,59.1
38070, 김해시,080004, 78세,2018,1997,736,1261,58.4,1988,733,1255,58.4
38070, 김해시,080005, 79세,2018,1899,686,1213,56.6,1895,683,1212,56.4
38070, 김해시,085,80~84세,2018,6820,2142,4678,45.8,6793,2133,4660,45.8
38070, 김해시,085001, 80세,2018,1620,566,1054,53.7,1610,562,1048,53.6
38070, 김해시,085002, 81세,2018,1525,492,1033,47.6,1520,489,1031,47.4
38070, 김해시,085003, 82세,2018,1344,416,928,44.8,1340,415,925,44.9
38070, 김해시,085004, 83세,2018,1234,360,874,41.2,1230,359,871,41.2
38070, 김해시,085005, 84세,2018,1097,308,789,39,1093,308,785,39.2
38070, 김해시,090,85~89세,2018,3283,747,2536,29.5,3279,747,2532,29.5
38070, 김해시,090001, 85세,2018,889,226,663,34.1,889,226,663,34.1
38070, 김해시,090002, 86세,2018,798,190,608,31.3,795,190,605,31.4
38070, 김해시,090003, 87세,2018,597,127,470,27,596,127,469,27.1
38070, 김해시,090004, 88세,2018,555,113,442,25.6,555,113,442,25.6
38070, 김해시,090005, 89세,2018,444,91,353,25.8,444,91,353,25.8
38070, 김해시,095,90~94세,2018,979,176,803,21.9,977,176,801,22
38070, 김해시,095001, 90세,2018,344,54,290,18.6,343,54,289,18.7
38070, 김해시,095002, 91세,2018,263,54,209,25.8,262,54,208,26
38070, 김해시,095003, 92세,2018,158,34,124,27.4,158,34,124,27.4
38070, 김해시,095004, 93세,2018,135,19,116,16.4,135,19,116,16.4
38070, 김해시,095005, 94세,2018,79,15,64,23.4,79,15,64,23.4
38070, 김해시,100,95~99세,2018,191,25,166,15.1,190,24,166,14.5
38070, 김해시,100001, 95세,2018,86,13,73,17.8,86,13,73,17.8
38070, 김해시,100002, 96세,2018,47,5,42,11.9,47,5,42,11.9
38070, 김해시,100003, 97세,2018,30,X,28,7.1,30,X,28,7.1
38070, 김해시,100004, 98세,2018,20,X,17,17.6,19,X,17,11.8
38070, 김해시,100005, 99세,2018,8,X,6,33.3,8,X,6,33.3
38070, 김해시,101,100세이상,2018,19,5,14,35.7,19,5,14,35.7
38070, 김해시,102,15세미만,2018,82456,42357,40099,105.6,81765,42022,39743,105.7
38070, 김해시,103,15~64세,2018,403655,212844,190811,111.5,379622,195447,184175,106.1
38070, 김해시,104,65세이상,2018,53290,21823,31467,69.4,52910,21657,31253,69.3
38070, 김해시,086,85세이상,2018,4472,953,3519,27.1,4465,952,3513,27.1
38070, 김해시,126,평균연령,2018,39.1,38.1,40.3,,39.3,38.3,40.4,
38070, 김해시,127,중위연령,2018,40.5,39.2,41.9,,41.2,40.2,42.2,
38080, 밀양시,000,합계,2018,103762,50572,53190,95.1,100279,48966,51313,95.4
38080, 밀양시,005,0~4세,2018,2848,1431,1417,101,2837,1424,1413,100.8
38080, 밀양시,005001, 0세,2018,476,251,225,111.6,472,247,225,109.8
38080, 밀양시,005002, 1세,2018,582,283,299,94.6,579,282,297,94.9
38080, 밀양시,005003, 2세,2018,616,291,325,89.5,614,289,325,88.9
38080, 밀양시,005004, 3세,2018,574,301,273,110.3,573,301,272,110.7
38080, 밀양시,005005, 4세,2018,600,305,295,103.4,599,305,294,103.7
38080, 밀양시,010,5~9세,2018,3295,1691,1604,105.4,3292,1690,1602,105.5
38080, 밀양시,010001, 5세,2018,620,293,327,89.6,619,292,327,89.3
38080, 밀양시,010002, 6세,2018,671,362,309,117.2,671,362,309,117.2
38080, 밀양시,010003, 7세,2018,668,330,338,97.6,667,330,337,97.9
38080, 밀양시,010004, 8세,2018,674,363,311,116.7,673,363,310,117.1
38080, 밀양시,010005, 9세,2018,662,343,319,107.5,662,343,319,107.5
38080, 밀양시,015,10~14세,2018,3687,1905,1782,106.9,3682,1903,1779,107
38080, 밀양시,015001, 10세,2018,773,382,391,97.7,772,382,390,97.9
38080, 밀양시,015002, 11세,2018,776,401,375,106.9,775,401,374,107.2
38080, 밀양시,015003, 12세,2018,699,359,340,105.6,698,358,340,105.3
38080, 밀양시,015004, 13세,2018,696,361,335,107.8,696,361,335,107.8
38080, 밀양시,015005, 14세,2018,743,402,341,117.9,741,401,340,117.9
38080, 밀양시,020,15~19세,2018,4478,2357,2121,111.1,4439,2342,2097,111.7
38080, 밀양시,020001, 15세,2018,807,399,408,97.8,806,399,407,98
38080, 밀양시,020002, 16세,2018,864,454,410,110.7,863,453,410,110.5
38080, 밀양시,020003, 17세,2018,1027,543,484,112.2,1021,540,481,112.3
38080, 밀양시,020004, 18세,2018,996,506,490,103.3,990,504,486,103.7
38080, 밀양시,020005, 19세,2018,784,455,329,138.3,759,446,313,142.5
38080, 밀양시,025,20~24세,2018,5526,3040,2486,122.3,4672,2816,1856,151.7
38080, 밀양시,025001, 20세,2018,944,562,382,147.1,873,547,326,167.8
38080, 밀양시,025002, 21세,2018,1090,583,507,115,951,561,390,143.8
38080, 밀양시,025003, 22세,2018,1196,655,541,121.1,983,597,386,154.7
38080, 밀양시,025004, 23세,2018,1147,619,528,117.2,928,567,361,157.1
38080, 밀양시,025005, 24세,2018,1149,621,528,117.6,937,544,393,138.4
38080, 밀양시,030,25~29세,2018,4879,2754,2125,129.6,4049,2334,1715,136.1
38080, 밀양시,030001, 25세,2018,1101,646,455,142,921,574,347,165.4
38080, 밀양시,030002, 26세,2018,1007,557,450,123.8,842,482,360,133.9
38080, 밀양시,030003, 27세,2018,941,528,413,127.8,776,436,340,128.2
38080, 밀양시,030004, 28세,2018,924,520,404,128.7,759,432,327,132.1
38080, 밀양시,030005, 29세,2018,906,503,403,124.8,751,410,341,120.2
38080, 밀양시,035,30~34세,2018,4688,2524,2164,116.6,4048,2150,1898,113.3
38080, 밀양시,035001, 30세,2018,878,502,376,133.5,745,429,316,135.8
38080, 밀양시,035002, 31세,2018,880,463,417,111,751,388,363,106.9
38080, 밀양시,035003, 32세,2018,987,527,460,114.6,857,444,413,107.5
38080, 밀양시,035004, 33세,2018,918,482,436,110.6,792,411,381,107.9
38080, 밀양시,035005, 34세,2018,1025,550,475,115.8,903,478,425,112.5
38080, 밀양시,040,35~39세,2018,5783,3057,2726,112.1,5415,2830,2585,109.5
38080, 밀양시,040001, 35세,2018,1088,570,518,110,992,509,483,105.4
38080, 밀양시,040002, 36세,2018,1128,621,507,122.5,1044,571,473,120.7
38080, 밀양시,040003, 37세,2018,1217,644,573,112.4,1142,603,539,111.9
38080, 밀양시,040004, 38세,2018,1180,603,577,104.5,1114,557,557,100
38080, 밀양시,040005, 39세,2018,1170,619,551,112.3,1123,590,533,110.7
38080, 밀양시,045,40~44세,2018,5818,3104,2714,114.4,5583,2976,2607,114.2
38080, 밀양시,045001, 40세,2018,1085,582,503,115.7,1040,559,481,116.2
38080, 밀양시,045002, 41세,2018,1114,575,539,106.7,1055,543,512,106.1
38080, 밀양시,045003, 42세,2018,1101,604,497,121.5,1048,570,478,119.2
38080, 밀양시,045004, 43세,2018,1194,646,548,117.9,1155,628,527,119.2
38080, 밀양시,045005, 44세,2018,1324,697,627,111.2,1285,676,609,111
38080, 밀양시,050,45~49세,2018,7347,3799,3548,107.1,7178,3723,3455,107.8
38080, 밀양시,050001, 45세,2018,1402,725,677,107.1,1369,710,659,107.7
38080, 밀양시,050002, 46세,2018,1392,736,656,112.2,1351,718,633,113.4
38080, 밀양시,050003, 47세,2018,1533,802,731,109.7,1494,783,711,110.1
38080, 밀양시,050004, 48세,2018,1468,732,736,99.5,1440,718,722,99.4
38080, 밀양시,050005, 49세,2018,1552,804,748,107.5,1524,794,730,108.8
38080, 밀양시,055,50~54세,2018,8466,4194,4272,98.2,8363,4157,4206,98.8
38080, 밀양시,055001, 50세,2018,1660,864,796,108.5,1639,855,784,109.1
38080, 밀양시,055002, 51세,2018,1678,803,875,91.8,1658,796,862,92.3
38080, 밀양시,055003, 52세,2018,1727,871,856,101.8,1708,866,842,102.9
38080, 밀양시,055004, 53세,2018,1700,788,912,86.4,1683,785,898,87.4
38080, 밀양시,055005, 54세,2018,1701,868,833,104.2,1675,855,820,104.3
38080, 밀양시,060,55~59세,2018,10491,5184,5307,97.7,10379,5134,5245,97.9
38080, 밀양시,060001, 55세,2018,1875,947,928,102,1849,936,913,102.5
38080, 밀양시,060002, 56세,2018,2077,1036,1041,99.5,2047,1022,1025,99.7
38080, 밀양시,060003, 57세,2018,2206,1100,1106,99.5,2191,1094,1097,99.7
38080, 밀양시,060004, 58세,2018,2245,1094,1151,95,2219,1085,1134,95.7
38080, 밀양시,060005, 59세,2018,2088,1007,1081,93.2,2073,997,1076,92.7
38080, 밀양시,065,60~64세,2018,10345,5026,5319,94.5,10282,4999,5283,94.6
38080, 밀양시,065001, 60세,2018,2166,1034,1132,91.3,2153,1029,1124,91.5
38080, 밀양시,065002, 61세,2018,2259,1084,1175,92.3,2243,1078,1165,92.5
38080, 밀양시,065003, 62세,2018,2102,1041,1061,98.1,2096,1039,1057,98.3
38080, 밀양시,065004, 63세,2018,2037,1007,1030,97.8,2023,999,1024,97.6
38080, 밀양시,065005, 64세,2018,1781,860,921,93.4,1767,854,913,93.5
38080, 밀양시,070,65~69세,2018,7874,3753,4121,91.1,7846,3740,4106,91.1
38080, 밀양시,070001, 65세,2018,1632,784,848,92.5,1628,783,845,92.7
38080, 밀양시,070002, 66세,2018,1850,890,960,92.7,1844,887,957,92.7
38080, 밀양시,070003, 67세,2018,1536,702,834,84.2,1526,699,827,84.5
38080, 밀양시,070004, 68세,2018,1394,674,720,93.6,1390,670,720,93.1
38080, 밀양시,070005, 69세,2018,1462,703,759,92.6,1458,701,757,92.6
38080, 밀양시,075,70~74세,2018,5871,2629,3242,81.1,5858,2627,3231,81.3
38080, 밀양시,075001, 70세,2018,1428,653,775,84.3,1424,653,771,84.7
38080, 밀양시,075002, 71세,2018,1374,611,763,80.1,1372,611,761,80.3
38080, 밀양시,075003, 72세,2018,978,448,530,84.5,975,447,528,84.7
38080, 밀양시,075004, 73세,2018,1027,478,549,87.1,1023,477,546,87.4
38080, 밀양시,075005, 74세,2018,1064,439,625,70.2,1064,439,625,70.2
38080, 밀양시,080,75~79세,2018,5789,2197,3592,61.2,5784,2195,3589,61.2
38080, 밀양시,080001, 75세,2018,1190,473,717,66,1188,472,716,65.9
38080, 밀양시,080002, 76세,2018,1368,553,815,67.9,1368,553,815,67.9
38080, 밀양시,080003, 77세,2018,1156,434,722,60.1,1155,434,721,60.2
38080, 밀양시,080004, 78세,2018,983,359,624,57.5,981,358,623,57.5
38080, 밀양시,080005, 79세,2018,1092,378,714,52.9,1092,378,714,52.9
38080, 밀양시,085,80~84세,2018,4049,1307,2742,47.7,4044,1306,2738,47.7
38080, 밀양시,085001, 80세,2018,917,286,631,45.3,915,286,629,45.5
38080, 밀양시,085002, 81세,2018,957,324,633,51.2,957,324,633,51.2
38080, 밀양시,085003, 82세,2018,771,253,518,48.8,770,252,518,48.6
38080, 밀양시,085004, 83세,2018,764,245,519,47.2,763,245,518,47.3
38080, 밀양시,085005, 84세,2018,640,199,441,45.1,639,199,440,45.2
38080, 밀양시,090,85~89세,2018,1901,501,1400,35.8,1901,501,1400,35.8
38080, 밀양시,090001, 85세,2018,530,149,381,39.1,530,149,381,39.1
38080, 밀양시,090002, 86세,2018,482,122,360,33.9,482,122,360,33.9
38080, 밀양시,090003, 87세,2018,338,94,244,38.5,338,94,244,38.5
38080, 밀양시,090004, 88세,2018,296,76,220,34.5,296,76,220,34.5
38080, 밀양시,090005, 89세,2018,255,60,195,30.8,255,60,195,30.8
38080, 밀양시,095,90~94세,2018,502,96,406,23.6,502,96,406,23.6
38080, 밀양시,095001, 90세,2018,168,38,130,29.2,168,38,130,29.2
38080, 밀양시,095002, 91세,2018,134,26,108,24.1,134,26,108,24.1
38080, 밀양시,095003, 92세,2018,79,15,64,23.4,79,15,64,23.4
38080, 밀양시,095004, 93세,2018,79,10,69,14.5,79,10,69,14.5
38080, 밀양시,095005, 94세,2018,42,7,35,20,42,7,35,20
38080, 밀양시,100,95~99세,2018,119,22,97,22.7,119,22,97,22.7
38080, 밀양시,100001, 95세,2018,47,12,35,34.3,47,12,35,34.3
38080, 밀양시,100002, 96세,2018,31,X,28,10.7,31,X,28,10.7
38080, 밀양시,100003, 97세,2018,18,X,14,28.6,18,X,14,28.6
38080, 밀양시,100004, 98세,2018,15,X,12,25,15,X,12,25
38080, 밀양시,100005, 99세,2018,8,X,8,0,8,X,8,0
38080, 밀양시,101,100세이상,2018,6,X,5,20,6,X,5,20
38080, 밀양시,102,15세미만,2018,9830,5027,4803,104.7,9811,5017,4794,104.7
38080, 밀양시,103,15~64세,2018,67821,35039,32782,106.9,64408,33461,30947,108.1
38080, 밀양시,104,65세이상,2018,26111,10506,15605,67.3,26060,10488,15572,67.4
38080, 밀양시,086,85세이상,2018,2528,620,1908,32.5,2528,620,1908,32.5
38080, 밀양시,126,평균연령,2018,48.5,46.3,50.6,,49.1,46.7,51.3,
38080, 밀양시,127,중위연령,2018,52.1,49.5,54.6,,53,50.3,55.5,
38090, 거제시,000,합계,2018,252889,135648,117241,115.7,243724,129174,114550,112.8
38090, 거제시,005,0~4세,2018,14731,7549,7182,105.1,14492,7425,7067,105.1
38090, 거제시,005001, 0세,2018,2171,1150,1021,112.6,2126,1126,1000,112.6
38090, 거제시,005002, 1세,2018,2690,1398,1292,108.2,2630,1369,1261,108.6
38090, 거제시,005003, 2세,2018,3157,1583,1574,100.6,3118,1563,1555,100.5
38090, 거제시,005004, 3세,2018,3467,1779,1688,105.4,3417,1749,1668,104.9
38090, 거제시,005005, 4세,2018,3246,1639,1607,102,3201,1618,1583,102.2
38090, 거제시,010,5~9세,2018,16394,8475,7919,107,16217,8387,7830,107.1
38090, 거제시,010001, 5세,2018,3303,1702,1601,106.3,3259,1684,1575,106.9
38090, 거제시,010002, 6세,2018,3489,1844,1645,112.1,3453,1824,1629,112
38090, 거제시,010003, 7세,2018,3450,1755,1695,103.5,3408,1731,1677,103.2
38090, 거제시,010004, 8세,2018,3235,1658,1577,105.1,3202,1642,1560,105.3
38090, 거제시,010005, 9세,2018,2917,1516,1401,108.2,2895,1506,1389,108.4
38090, 거제시,015,10~14세,2018,13729,7140,6589,108.4,13646,7091,6555,108.2
38090, 거제시,015001, 10세,2018,2990,1547,1443,107.2,2966,1534,1432,107.1
38090, 거제시,015002, 11세,2018,2978,1555,1423,109.3,2963,1547,1416,109.3
38090, 거제시,015003, 12세,2018,2623,1335,1288,103.6,2606,1324,1282,103.3
38090, 거제시,015004, 13세,2018,2448,1276,1172,108.9,2429,1262,1167,108.1
38090, 거제시,015005, 14세,2018,2690,1427,1263,113,2682,1424,1258,113.2
38090, 거제시,020,15~19세,2018,13220,7174,6046,118.7,13130,7118,6012,118.4
38090, 거제시,020001, 15세,2018,2644,1378,1266,108.8,2634,1372,1262,108.7
38090, 거제시,020002, 16세,2018,2761,1475,1286,114.7,2752,1468,1284,114.3
38090, 거제시,020003, 17세,2018,3072,1634,1438,113.6,3060,1624,1436,113.1
38090, 거제시,020004, 18세,2018,2934,1587,1347,117.8,2918,1578,1340,117.8
38090, 거제시,020005, 19세,2018,1809,1100,709,155.1,1766,1076,690,155.9
38090, 거제시,025,20~24세,2018,11568,7077,4491,157.6,10973,6681,4292,155.7
38090, 거제시,025001, 20세,2018,2232,1455,777,187.3,2177,1424,753,189.1
38090, 거제시,025002, 21세,2018,2433,1589,844,188.3,2346,1530,816,187.5
38090, 거제시,025003, 22세,2018,2313,1416,897,157.9,2188,1325,863,153.5
38090, 거제시,025004, 23세,2018,2305,1307,998,131,2151,1210,941,128.6
38090, 거제시,025005, 24세,2018,2285,1310,975,134.4,2111,1192,919,129.7
38090, 거제시,030,25~29세,2018,13578,7722,5856,131.9,11881,6420,5461,117.6
38090, 거제시,030001, 25세,2018,2363,1317,1046,125.9,2119,1142,977,116.9
38090, 거제시,030002, 26세,2018,2500,1381,1119,123.4,2172,1125,1047,107.4
38090, 거제시,030003, 27세,2018,2650,1495,1155,129.4,2303,1232,1071,115
38090, 거제시,030004, 28세,2018,2949,1721,1228,140.1,2573,1418,1155,122.8
38090, 거제시,030005, 29세,2018,3116,1808,1308,138.2,2714,1503,1211,124.1
38090, 거제시,035,30~34세,2018,20154,11328,8826,128.3,18237,9848,8389,117.4
38090, 거제시,035001, 30세,2018,3206,1832,1374,133.3,2846,1553,1293,120.1
38090, 거제시,035002, 31세,2018,3623,2015,1608,125.3,3222,1708,1514,112.8
38090, 거제시,035003, 32세,2018,4152,2413,1739,138.8,3730,2083,1647,126.5
38090, 거제시,035004, 33세,2018,4393,2428,1965,123.6,4022,2136,1886,113.3
38090, 거제시,035005, 34세,2018,4780,2640,2140,123.4,4417,2368,2049,115.6
38090, 거제시,040,35~39세,2018,27533,15591,11942,130.6,26019,14439,11580,124.7
38090, 거제시,040001, 35세,2018,5311,3021,2290,131.9,4948,2744,2204,124.5
38090, 거제시,040002, 36세,2018,5578,3132,2446,128,5248,2875,2373,121.2
38090, 거제시,040003, 37세,2018,5654,3225,2429,132.8,5364,3009,2355,127.8
38090, 거제시,040004, 38세,2018,5769,3271,2498,130.9,5495,3062,2433,125.9
38090, 거제시,040005, 39세,2018,5221,2942,2279,129.1,4964,2749,2215,124.1
38090, 거제시,045,40~44세,2018,23527,12866,10661,120.7,22617,12211,10406,117.3
38090, 거제시,045001, 40세,2018,4674,2636,2038,129.3,4442,2470,1972,125.3
38090, 거제시,045002, 41세,2018,4598,2542,2056,123.6,4428,2421,2007,120.6
38090, 거제시,045003, 42세,2018,4657,2525,2132,118.4,4489,2391,2098,114
38090, 거제시,045004, 43세,2018,4620,2491,2129,117,4444,2369,2075,114.2
38090, 거제시,045005, 44세,2018,4978,2672,2306,115.9,4814,2560,2254,113.6
38090, 거제시,050,45~49세,2018,24421,13656,10765,126.9,23742,13210,10532,125.4
38090, 거제시,050001, 45세,2018,5086,2777,2309,120.3,4934,2681,2253,119
38090, 거제시,050002, 46세,2018,4991,2849,2142,133,4843,2746,2097,130.9
38090, 거제시,050003, 47세,2018,5057,2876,2181,131.9,4914,2783,2131,130.6
38090, 거제시,050004, 48세,2018,4750,2653,2097,126.5,4634,2580,2054,125.6
38090, 거제시,050005, 49세,2018,4537,2501,2036,122.8,4417,2420,1997,121.2
38090, 거제시,055,50~54세,2018,19352,10587,8765,120.8,18852,10304,8548,120.5
38090, 거제시,055001, 50세,2018,4391,2378,2013,118.1,4281,2310,1971,117.2
38090, 거제시,055002, 51세,2018,4019,2185,1834,119.1,3924,2128,1796,118.5
38090, 거제시,055003, 52세,2018,3965,2269,1696,133.8,3870,2221,1649,134.7
38090, 거제시,055004, 53세,2018,3849,2097,1752,119.7,3749,2040,1709,119.4
38090, 거제시,055005, 54세,2018,3128,1658,1470,112.8,3028,1605,1423,112.8
38090, 거제시,060,55~59세,2018,18100,9258,8842,104.7,17730,9041,8689,104.1
38090, 거제시,060001, 55세,2018,3424,1822,1602,113.7,3326,1761,1565,112.5
38090, 거제시,060002, 56세,2018,3612,1868,1744,107.1,3539,1818,1721,105.6
38090, 거제시,060003, 57세,2018,3898,1865,2033,91.7,3830,1829,2001,91.4
38090, 거제시,060004, 58세,2018,3814,1898,1916,99.1,3741,1860,1881,98.9
38090, 거제시,060005, 59세,2018,3352,1805,1547,116.7,3294,1773,1521,116.6
38090, 거제시,065,60~64세,2018,13827,7380,6447,114.5,13621,7250,6371,113.8
38090, 거제시,065001, 60세,2018,3229,1772,1457,121.6,3180,1744,1436,121.4
38090, 거제시,065002, 61세,2018,3127,1724,1403,122.9,3075,1691,1384,122.2
38090, 거제시,065003, 62세,2018,2751,1440,1311,109.8,2712,1415,1297,109.1
38090, 거제시,065004, 63세,2018,2647,1367,1280,106.8,2612,1345,1267,106.2
38090, 거제시,065005, 64세,2018,2073,1077,996,108.1,2042,1055,987,106.9
38090, 거제시,070,65~69세,2018,8234,4182,4052,103.2,8126,4122,4004,102.9
38090, 거제시,070001, 65세,2018,1818,907,911,99.6,1784,889,895,99.3
38090, 거제시,070002, 66세,2018,2062,1037,1025,101.2,2044,1028,1016,101.2
38090, 거제시,070003, 67세,2018,1455,747,708,105.5,1437,735,702,104.7
38090, 거제시,070004, 68세,2018,1417,738,679,108.7,1393,725,668,108.5
38090, 거제시,070005, 69세,2018,1482,753,729,103.3,1468,745,723,103
38090, 거제시,075,70~74세,2018,5236,2572,2664,96.5,5200,2552,2648,96.4
38090, 거제시,075001, 70세,2018,1401,751,650,115.5,1390,744,646,115.2
38090, 거제시,075002, 71세,2018,1283,637,646,98.6,1274,632,642,98.4
38090, 거제시,075003, 72세,2018,809,400,409,97.8,804,397,407,97.5
38090, 거제시,075004, 73세,2018,877,400,477,83.9,873,398,475,83.8
38090, 거제시,075005, 74세,2018,866,384,482,79.7,859,381,478,79.7
38090, 거제시,080,75~79세,2018,4427,1751,2676,65.4,4400,1740,2660,65.4
38090, 거제시,080001, 75세,2018,982,420,562,74.7,976,418,558,74.9
38090, 거제시,080002, 76세,2018,1085,439,646,68,1080,438,642,68.2
38090, 거제시,080003, 77세,2018,869,345,524,65.8,862,342,520,65.8
38090, 거제시,080004, 78세,2018,733,297,436,68.1,728,294,434,67.7
38090, 거제시,080005, 79세,2018,758,250,508,49.2,754,248,506,49
38090, 거제시,085,80~84세,2018,2826,901,1925,46.8,2812,897,1915,46.8
38090, 거제시,085001, 80세,2018,628,225,403,55.8,621,224,397,56.4
38090, 거제시,085002, 81세,2018,629,210,419,50.1,627,208,419,49.6
38090, 거제시,085003, 82세,2018,589,189,400,47.3,587,188,399,47.1
38090, 거제시,085004, 83세,2018,536,153,383,39.9,534,153,381,40.2
38090, 거제시,085005, 84세,2018,444,124,320,38.8,443,124,319,38.9
38090, 거제시,090,85~89세,2018,1502,351,1151,30.5,1499,350,1149,30.5
38090, 거제시,090001, 85세,2018,405,102,303,33.7,405,102,303,33.7
38090, 거제시,090002, 86세,2018,361,97,264,36.7,360,97,263,36.9
38090, 거제시,090003, 87세,2018,274,70,204,34.3,272,69,203,34
38090, 거제시,090004, 88세,2018,238,35,203,17.2,238,35,203,17.2
38090, 거제시,090005, 89세,2018,224,47,177,26.6,224,47,177,26.6
38090, 거제시,095,90~94세,2018,433,68,365,18.6,433,68,365,18.6
38090, 거제시,095001, 90세,2018,153,29,124,23.4,153,29,124,23.4
38090, 거제시,095002, 91세,2018,77,12,65,18.5,77,12,65,18.5
38090, 거제시,095003, 92세,2018,81,16,65,24.6,81,16,65,24.6
38090, 거제시,095004, 93세,2018,73,9,64,14.1,73,9,64,14.1
38090, 거제시,095005, 94세,2018,49,X,47,4.3,49,X,47,4.3
38090, 거제시,100,95~99세,2018,87,20,67,29.9,87,20,67,29.9
38090, 거제시,100001, 95세,2018,31,9,22,40.9,31,9,22,40.9
38090, 거제시,100002, 96세,2018,27,X,23,17.4,27,X,23,17.4
38090, 거제시,100003, 97세,2018,17,5,12,41.7,17,5,12,41.7
38090, 거제시,100004, 98세,2018,10,X,8,25,10,X,8,25
38090, 거제시,100005, 99세,2018,X,X,X,0,X,X,X,0
38090, 거제시,101,100세이상,2018,10,X,10,0,10,X,10,0
38090, 거제시,102,15세미만,2018,44854,23164,21690,106.8,44355,22903,21452,106.8
38090, 거제시,103,15~64세,2018,185280,102639,82641,124.2,176802,96522,80280,120.2
38090, 거제시,104,65세이상,2018,22755,9845,12910,76.3,22567,9749,12818,76.1
38090, 거제시,086,85세이상,2018,2032,439,1593,27.6,2029,438,1591,27.5
38090, 거제시,126,평균연령,2018,38.2,37.5,39,,38.3,37.5,39,
38090, 거제시,127,중위연령,2018,39.1,38.6,39.9,,39.4,39,40,
38100, 양산시,000,합계,2018,344993,173852,171141,101.6,336819,168522,168297,100.1
38100, 양산시,005,0~4세,2018,18209,9378,8831,106.2,18087,9310,8777,106.1
38100, 양산시,005001, 0세,2018,3065,1566,1499,104.5,3043,1550,1493,103.8
38100, 양산시,005002, 1세,2018,3396,1745,1651,105.7,3375,1734,1641,105.7
38100, 양산시,005003, 2세,2018,3808,1957,1851,105.7,3783,1945,1838,105.8
38100, 양산시,005004, 3세,2018,3969,2013,1956,102.9,3937,1996,1941,102.8
38100, 양산시,005005, 4세,2018,3971,2097,1874,111.9,3949,2085,1864,111.9
38100, 양산시,010,5~9세,2018,18859,9598,9261,103.6,18789,9561,9228,103.6
38100, 양산시,010001, 5세,2018,3800,1884,1916,98.3,3779,1873,1906,98.3
38100, 양산시,010002, 6세,2018,4114,2152,1962,109.7,4096,2142,1954,109.6
38100, 양산시,010003, 7세,2018,3977,2002,1975,101.4,3967,1997,1970,101.4
38100, 양산시,010004, 8세,2018,3589,1821,1768,103,3578,1817,1761,103.2
38100, 양산시,010005, 9세,2018,3379,1739,1640,106,3369,1732,1637,105.8
38100, 양산시,015,10~14세,2018,16339,8318,8021,103.7,16285,8289,7996,103.7
38100, 양산시,015001, 10세,2018,3535,1826,1709,106.8,3528,1822,1706,106.8
38100, 양산시,015002, 11세,2018,3466,1766,1700,103.9,3452,1759,1693,103.9
38100, 양산시,015003, 12세,2018,3135,1581,1554,101.7,3123,1576,1547,101.9
38100, 양산시,015004, 13세,2018,3000,1526,1474,103.5,2991,1520,1471,103.3
38100, 양산시,015005, 14세,2018,3203,1619,1584,102.2,3191,1612,1579,102.1
38100, 양산시,020,15~19세,2018,17898,9240,8658,106.7,17800,9183,8617,106.6
38100, 양산시,020001, 15세,2018,3172,1666,1506,110.6,3163,1662,1501,110.7
38100, 양산시,020002, 16세,2018,3460,1733,1727,100.3,3446,1726,1720,100.3
38100, 양산시,020003, 17세,2018,3835,1929,1906,101.2,3819,1917,1902,100.8
38100, 양산시,020004, 18세,2018,3994,1977,2017,98,3965,1960,2005,97.8
38100, 양산시,020005, 19세,2018,3437,1935,1502,128.8,3407,1918,1489,128.8
38100, 양산시,025,20~24세,2018,19702,11078,8624,128.5,18944,10564,8380,126.1
38100, 양산시,025001, 20세,2018,3716,2149,1567,137.1,3641,2104,1537,136.9
38100, 양산시,025002, 21세,2018,3901,2228,1673,133.2,3791,2149,1642,130.9
38100, 양산시,025003, 22세,2018,4092,2312,1780,129.9,3938,2202,1736,126.8
38100, 양산시,025004, 23세,2018,4041,2231,1810,123.3,3846,2098,1748,120
38100, 양산시,025005, 24세,2018,3952,2158,1794,120.3,3728,2011,1717,117.1
38100, 양산시,030,25~29세,2018,21280,11255,10025,112.3,19706,10153,9553,106.3
38100, 양산시,030001, 25세,2018,4230,2273,1957,116.1,3969,2096,1873,111.9
38100, 양산시,030002, 26세,2018,4282,2163,2119,102.1,3989,1961,2028,96.7
38100, 양산시,030003, 27세,2018,4315,2287,2028,112.8,4005,2072,1933,107.2
38100, 양산시,030004, 28세,2018,4196,2294,1902,120.6,3829,2035,1794,113.4
38100, 양산시,030005, 29세,2018,4257,2238,2019,110.8,3914,1989,1925,103.3
38100, 양산시,035,30~34세,2018,23464,12239,11225,109,21748,11060,10688,103.5
38100, 양산시,035001, 30세,2018,4302,2241,2061,108.7,3939,1994,1945,102.5
38100, 양산시,035002, 31세,2018,4472,2263,2209,102.4,4104,2011,2093,96.1
38100, 양산시,035003, 32세,2018,4501,2377,2124,111.9,4147,2130,2017,105.6
38100, 양산시,035004, 33세,2018,4787,2550,2237,114,4487,2342,2145,109.2
38100, 양산시,035005, 34세,2018,5402,2808,2594,108.2,5071,2583,2488,103.8
38100, 양산시,040,35~39세,2018,32218,16670,15548,107.2,30978,15798,15180,104.1
38100, 양산시,040001, 35세,2018,5921,3127,2794,111.9,5638,2925,2713,107.8
38100, 양산시,040002, 36세,2018,6525,3357,3168,106,6240,3170,3070,103.3
38100, 양산시,040003, 37세,2018,6655,3462,3193,108.4,6411,3281,3130,104.8
38100, 양산시,040004, 38세,2018,6894,3555,3339,106.5,6675,3402,3273,103.9
38100, 양산시,040005, 39세,2018,6223,3169,3054,103.8,6014,3020,2994,100.9
38100, 양산시,045,40~44세,2018,28702,14785,13917,106.2,27944,14269,13675,104.3
38100, 양산시,045001, 40세,2018,5638,2950,2688,109.7,5458,2823,2635,107.1
38100, 양산시,045002, 41세,2018,5756,2972,2784,106.8,5612,2877,2735,105.2
38100, 양산시,045003, 42세,2018,5396,2784,2612,106.6,5253,2680,2573,104.2
38100, 양산시,045004, 43세,2018,5905,3015,2890,104.3,5739,2907,2832,102.6
38100, 양산시,045005, 44세,2018,6007,3064,2943,104.1,5882,2982,2900,102.8
38100, 양산시,050,45~49세,2018,30670,15425,15245,101.2,30045,15067,14978,100.6
38100, 양산시,050001, 45세,2018,5998,3026,2972,101.8,5889,2965,2924,101.4
38100, 양산시,050002, 46세,2018,6006,3116,2890,107.8,5871,3030,2841,106.7
38100, 양산시,050003, 47세,2018,6150,3084,3066,100.6,6012,3010,3002,100.3
38100, 양산시,050004, 48세,2018,6296,3111,3185,97.7,6156,3031,3125,97
38100, 양산시,050005, 49세,2018,6220,3088,3132,98.6,6117,3031,3086,98.2
38100, 양산시,055,50~54세,2018,27924,13995,13929,100.5,27442,13730,13712,100.1
38100, 양산시,055001, 50세,2018,6152,2956,3196,92.5,6031,2885,3146,91.7
38100, 양산시,055002, 51세,2018,5710,2792,2918,95.7,5612,2740,2872,95.4
38100, 양산시,055003, 52세,2018,5576,2894,2682,107.9,5473,2840,2633,107.9
38100, 양산시,055004, 53세,2018,5507,2799,2708,103.4,5418,2750,2668,103.1
38100, 양산시,055005, 54세,2018,4979,2554,2425,105.3,4908,2515,2393,105.1
38100, 양산시,060,55~59세,2018,27475,13948,13527,103.1,27152,13783,13369,103.1
38100, 양산시,060001, 55세,2018,5279,2751,2528,108.8,5195,2713,2482,109.3
38100, 양산시,060002, 56세,2018,5569,2841,2728,104.1,5489,2800,2689,104.1
38100, 양산시,060003, 57세,2018,5898,2964,2934,101,5854,2942,2912,101
38100, 양산시,060004, 58세,2018,5668,2882,2786,103.4,5601,2843,2758,103.1
38100, 양산시,060005, 59세,2018,5061,2510,2551,98.4,5013,2485,2528,98.3
38100, 양산시,065,60~64세,2018,21293,10409,10884,95.6,21094,10310,10784,95.6
38100, 양산시,065001, 60세,2018,4784,2359,2425,97.3,4728,2328,2400,97
38100, 양산시,065002, 61세,2018,4575,2287,2288,100,4537,2269,2268,100
38100, 양산시,065003, 62세,2018,4100,1994,2106,94.7,4059,1979,2080,95.1
38100, 양산시,065004, 63세,2018,4295,2067,2228,92.8,4259,2048,2211,92.6
38100, 양산시,065005, 64세,2018,3539,1702,1837,92.7,3511,1686,1825,92.4
38100, 양산시,070,65~69세,2018,14150,6878,7272,94.6,14052,6833,7219,94.7
38100, 양산시,070001, 65세,2018,3094,1532,1562,98.1,3070,1518,1552,97.8
38100, 양산시,070002, 66세,2018,3340,1605,1735,92.5,3313,1594,1719,92.7
38100, 양산시,070003, 67세,2018,2539,1245,1294,96.2,2521,1239,1282,96.6
38100, 양산시,070004, 68세,2018,2693,1331,1362,97.7,2679,1324,1355,97.7
38100, 양산시,070005, 69세,2018,2484,1165,1319,88.3,2469,1158,1311,88.3
38100, 양산시,075,70~74세,2018,10108,4605,5503,83.7,10076,4593,5483,83.8
38100, 양산시,075001, 70세,2018,2593,1201,1392,86.3,2577,1195,1382,86.5
38100, 양산시,075002, 71세,2018,2273,1009,1264,79.8,2266,1007,1259,80
38100, 양산시,075003, 72세,2018,1741,765,976,78.4,1738,764,974,78.4
38100, 양산시,075004, 73세,2018,1739,809,930,87,1736,807,929,86.9
38100, 양산시,075005, 74세,2018,1762,821,941,87.2,1759,820,939,87.3
38100, 양산시,080,75~79세,2018,8668,3504,5164,67.9,8654,3497,5157,67.8
38100, 양산시,080001, 75세,2018,1946,824,1122,73.4,1939,819,1120,73.1
38100, 양산시,080002, 76세,2018,2029,853,1176,72.5,2027,851,1176,72.4
38100, 양산시,080003, 77세,2018,1615,639,976,65.5,1614,639,975,65.5
38100, 양산시,080004, 78세,2018,1592,607,985,61.6,1589,607,982,61.8
38100, 양산시,080005, 79세,2018,1486,581,905,64.2,1485,581,904,64.3
38100, 양산시,085,80~84세,2018,4947,1751,3196,54.8,4940,1747,3193,54.7
38100, 양산시,085001, 80세,2018,1196,447,749,59.7,1192,445,747,59.6
38100, 양산시,085002, 81세,2018,1088,390,698,55.9,1087,389,698,55.7
38100, 양산시,085003, 82세,2018,996,356,640,55.6,996,356,640,55.6
38100, 양산시,085004, 83세,2018,927,328,599,54.8,926,328,598,54.8
38100, 양산시,085005, 84세,2018,740,230,510,45.1,739,229,510,44.9
38100, 양산시,090,85~89세,2018,2205,590,1615,36.5,2203,590,1613,36.6
38100, 양산시,090001, 85세,2018,610,199,411,48.4,610,199,411,48.4
38100, 양산시,090002, 86세,2018,519,137,382,35.9,518,137,381,36
38100, 양산시,090003, 87세,2018,411,102,309,33,411,102,309,33
38100, 양산시,090004, 88세,2018,350,80,270,29.6,350,80,270,29.6
38100, 양산시,090005, 89세,2018,315,72,243,29.6,314,72,242,29.8
38100, 양산시,095,90~94세,2018,714,149,565,26.4,712,148,564,26.2
38100, 양산시,095001, 90세,2018,223,52,171,30.4,223,52,171,30.4
38100, 양산시,095002, 91세,2018,203,49,154,31.8,203,49,154,31.8
38100, 양산시,095003, 92세,2018,126,18,108,16.7,126,18,108,16.7
38100, 양산시,095004, 93세,2018,95,16,79,20.3,94,16,78,20.5
38100, 양산시,095005, 94세,2018,67,14,53,26.4,66,13,53,24.5
38100, 양산시,100,95~99세,2018,154,34,120,28.3,154,34,120,28.3
38100, 양산시,100001, 95세,2018,67,17,50,34,67,17,50,34
38100, 양산시,100002, 96세,2018,44,11,33,33.3,44,11,33,33.3
38100, 양산시,100003, 97세,2018,21,X,19,10.5,21,X,19,10.5
38100, 양산시,100004, 98세,2018,15,X,12,25,15,X,12,25
38100, 양산시,100005, 99세,2018,7,X,6,16.7,7,X,6,16.7
38100, 양산시,101,100세이상,2018,14,X,11,27.3,14,X,11,27.3
38100, 양산시,102,15세미만,2018,53407,27294,26113,104.5,53161,27160,26001,104.5
38100, 양산시,103,15~64세,2018,250626,129044,121582,106.1,242853,123917,118936,104.2
38100, 양산시,104,65세이상,2018,40960,17514,23446,74.7,40805,17445,23360,74.7
38100, 양산시,086,85세이상,2018,3087,776,2311,33.6,3083,775,2308,33.6
38100, 양산시,126,평균연령,2018,40,38.9,41,,40.1,39.1,41.1,
38100, 양산시,127,중위연령,2018,40.8,39.7,42,,41.1,40.1,42.1,
38110, 창원시,000,합계,2018,1044215,532363,511852,104,1023746,519400,504346,103
38110, 창원시,005,0~4세,2018,42086,21757,20329,107,41817,21634,20183,107.2
38110, 창원시,005001, 0세,2018,6980,3582,3398,105.4,6920,3549,3371,105.3
38110, 창원시,005002, 1세,2018,7672,3964,3708,106.9,7614,3940,3674,107.2
38110, 창원시,005003, 2세,2018,8722,4477,4245,105.5,8667,4452,4215,105.6
38110, 창원시,005004, 3세,2018,9347,4857,4490,108.2,9301,4837,4464,108.4
38110, 창원시,005005, 4세,2018,9365,4877,4488,108.7,9315,4856,4459,108.9
38110, 창원시,010,5~9세,2018,49236,25481,23755,107.3,49126,25424,23702,107.3
38110, 창원시,010001, 5세,2018,9552,4914,4638,106,9522,4899,4623,106
38110, 창원시,010002, 6세,2018,10500,5460,5040,108.3,10475,5448,5027,108.4
38110, 창원시,010003, 7세,2018,10093,5214,4879,106.9,10077,5205,4872,106.8
38110, 창원시,010004, 8세,2018,9628,4979,4649,107.1,9610,4967,4643,107
38110, 창원시,010005, 9세,2018,9463,4914,4549,108,9442,4905,4537,108.1
38110, 창원시,015,10~14세,2018,48140,25031,23109,108.3,48054,24992,23062,108.4
38110, 창원시,015001, 10세,2018,9862,4982,4880,102.1,9840,4970,4870,102.1
38110, 창원시,015002, 11세,2018,10055,5294,4761,111.2,10038,5284,4754,111.1
38110, 창원시,015003, 12세,2018,9190,4827,4363,110.6,9175,4821,4354,110.7
38110, 창원시,015004, 13세,2018,9021,4683,4338,108,9010,4679,4331,108
38110, 창원시,015005, 14세,2018,10012,5245,4767,110,9991,5238,4753,110.2
38110, 창원시,020,15~19세,2018,56326,30453,25873,117.7,56041,30299,25742,117.7
38110, 창원시,020001, 15세,2018,10100,5455,4645,117.4,10085,5445,4640,117.3
38110, 창원시,020002, 16세,2018,10288,5462,4826,113.2,10267,5450,4817,113.1
38110, 창원시,020003, 17세,2018,11761,6235,5526,112.8,11730,6222,5508,113
38110, 창원시,020004, 18세,2018,12863,6969,5894,118.2,12787,6930,5857,118.3
38110, 창원시,020005, 19세,2018,11314,6332,4982,127.1,11172,6252,4920,127.1
38110, 창원시,025,20~24세,2018,66448,37604,28844,130.4,64530,36497,28033,130.2
38110, 창원시,025001, 20세,2018,12201,7010,5191,135,11966,6891,5075,135.8
38110, 창원시,025002, 21세,2018,13308,7615,5693,133.8,13006,7453,5553,134.2
38110, 창원시,025003, 22세,2018,13600,7753,5847,132.6,13215,7535,5680,132.7
38110, 창원시,025004, 23세,2018,13578,7562,6016,125.7,13085,7265,5820,124.8
38110, 창원시,025005, 24세,2018,13761,7664,6097,125.7,13258,7353,5905,124.5
38110, 창원시,030,25~29세,2018,67437,37605,29832,126.1,63524,34889,28635,121.8
38110, 창원시,030001, 25세,2018,13817,7707,6110,126.1,13196,7281,5915,123.1
38110, 창원시,030002, 26세,2018,14062,7798,6264,124.5,13349,7311,6038,121.1
38110, 창원시,030003, 27세,2018,13379,7362,6017,122.4,12606,6819,5787,117.8
38110, 창원시,030004, 28세,2018,13252,7480,5772,129.6,12363,6862,5501,124.7
38110, 창원시,030005, 29세,2018,12927,7258,5669,128,12010,6616,5394,122.7
38110, 창원시,035,30~34세,2018,66406,36539,29867,122.3,62175,33543,28632,117.2
38110, 창원시,035001, 30세,2018,12677,7012,5665,123.8,11828,6417,5411,118.6
38110, 창원시,035002, 31세,2018,12949,7156,5793,123.5,11987,6485,5502,117.9
38110, 창원시,035003, 32세,2018,13004,7260,5744,126.4,12149,6660,5489,121.3
38110, 창원시,035004, 33세,2018,13643,7474,6169,121.2,12783,6853,5930,115.6
38110, 창원시,035005, 34세,2018,14133,7637,6496,117.6,13428,7128,6300,113.1
38110, 창원시,040,35~39세,2018,84758,44311,40447,109.6,82027,42460,39567,107.3
38110, 창원시,040001, 35세,2018,15727,8332,7395,112.7,15061,7872,7189,109.5
38110, 창원시,040002, 36세,2018,17146,8956,8190,109.4,16538,8559,7979,107.3
38110, 창원시,040003, 37세,2018,17413,9202,8211,112.1,16894,8847,8047,109.9
38110, 창원시,040004, 38세,2018,17854,9155,8699,105.2,17378,8823,8555,103.1
38110, 창원시,040005, 39세,2018,16618,8666,7952,109,16156,8359,7797,107.2
38110, 창원시,045,40~44세,2018,79425,40941,38484,106.4,77600,39736,37864,104.9
38110, 창원시,045001, 40세,2018,15452,8115,7337,110.6,15031,7830,7201,108.7
38110, 창원시,045002, 41세,2018,15401,8017,7384,108.6,15028,7763,7265,106.9
38110, 창원시,045003, 42세,2018,15069,7843,7226,108.5,14701,7602,7099,107.1
38110, 창원시,045004, 43세,2018,15970,8086,7884,102.6,15652,7880,7772,101.4
38110, 창원시,045005, 44세,2018,17533,8880,8653,102.6,17188,8661,8527,101.6
38110, 창원시,050,45~49세,2018,93772,46814,46958,99.7,92083,45801,46282,99
38110, 창원시,050001, 45세,2018,18081,9099,8982,101.3,17758,8906,8852,100.6
38110, 창원시,050002, 46세,2018,17554,8936,8618,103.7,17218,8716,8502,102.5
38110, 창원시,050003, 47세,2018,19212,9451,9761,96.8,18843,9220,9623,95.8
38110, 창원시,050004, 48세,2018,19300,9563,9737,98.2,18951,9369,9582,97.8
38110, 창원시,050005, 49세,2018,19625,9765,9860,99,19313,9590,9723,98.6
38110, 창원시,055,50~54세,2018,91228,44890,46338,96.9,89812,44129,45683,96.6
38110, 창원시,055001, 50세,2018,19831,9563,10268,93.1,19515,9393,10122,92.8
38110, 창원시,055002, 51세,2018,18186,8819,9367,94.1,17905,8658,9247,93.6
38110, 창원시,055003, 52세,2018,18181,9183,8998,102.1,17903,9038,8865,102
38110, 창원시,055004, 53세,2018,18534,9120,9414,96.9,18270,8972,9298,96.5
38110, 창원시,055005, 54세,2018,16496,8205,8291,99,16219,8068,8151,99
38110, 창원시,060,55~59세,2018,95755,48119,47636,101,94799,47657,47142,101.1
38110, 창원시,060001, 55세,2018,18294,9286,9008,103.1,18010,9150,8860,103.3
38110, 창원시,060002, 56세,2018,19260,9733,9527,102.2,19050,9628,9422,102.2
38110, 창원시,060003, 57세,2018,20541,10253,10288,99.7,20385,10185,10200,99.9
38110, 창원시,060004, 58세,2018,20178,10023,10155,98.7,20009,9938,10071,98.7
38110, 창원시,060005, 59세,2018,17482,8824,8658,101.9,17345,8756,8589,101.9
38110, 창원시,065,60~64세,2018,73446,36523,36923,98.9,72872,36246,36626,99
38110, 창원시,065001, 60세,2018,16282,8300,7982,104,16138,8225,7913,103.9
38110, 창원시,065002, 61세,2018,15610,7756,7854,98.8,15490,7693,7797,98.7
38110, 창원시,065003, 62세,2018,14608,7102,7506,94.6,14494,7046,7448,94.6
38110, 창원시,065004, 63세,2018,14784,7168,7616,94.1,14680,7122,7558,94.2
38110, 창원시,065005, 64세,2018,12162,6197,5965,103.9,12070,6160,5910,104.2
38110, 창원시,070,65~69세,2018,47354,23375,23979,97.5,47088,23245,23843,97.5
38110, 창원시,070001, 65세,2018,10603,5313,5290,100.4,10514,5267,5247,100.4
38110, 창원시,070002, 66세,2018,11157,5599,5558,100.7,11105,5576,5529,100.9
38110, 창원시,070003, 67세,2018,8617,4153,4464,93,8578,4134,4444,93
38110, 창원시,070004, 68세,2018,8403,4086,4317,94.6,8356,4061,4295,94.6
38110, 창원시,070005, 69세,2018,8574,4224,4350,97.1,8535,4207,4328,97.2
38110, 창원시,075,70~74세,2018,31797,15076,16721,90.2,31690,15033,16657,90.3
38110, 창원시,075001, 70세,2018,8025,3947,4078,96.8,8006,3939,4067,96.9
38110, 창원시,075002, 71세,2018,7504,3579,3925,91.2,7470,3565,3905,91.3
38110, 창원시,075003, 72세,2018,5407,2633,2774,94.9,5386,2625,2761,95.1
38110, 창원시,075004, 73세,2018,5299,2414,2885,83.7,5282,2406,2876,83.7
38110, 창원시,075005, 74세,2018,5562,2503,3059,81.8,5546,2498,3048,82
38110, 창원시,080,75~79세,2018,24982,10273,14709,69.8,24937,10260,14677,69.9
38110, 창원시,080001, 75세,2018,5432,2339,3093,75.6,5425,2338,3087,75.7
38110, 창원시,080002, 76세,2018,5769,2484,3285,75.6,5761,2481,3280,75.6
38110, 창원시,080003, 77세,2018,4997,2063,2934,70.3,4986,2061,2925,70.5
38110, 창원시,080004, 78세,2018,4534,1782,2752,64.8,4523,1777,2746,64.7
38110, 창원시,080005, 79세,2018,4250,1605,2645,60.7,4242,1603,2639,60.7
38110, 창원시,085,80~84세,2018,15602,5285,10317,51.2,15572,5274,10298,51.2
38110, 창원시,085001, 80세,2018,3650,1374,2276,60.4,3636,1370,2266,60.5
38110, 창원시,085002, 81세,2018,3480,1209,2271,53.2,3478,1209,2269,53.3
38110, 창원시,085003, 82세,2018,3138,1062,2076,51.2,3131,1059,2072,51.1
38110, 창원시,085004, 83세,2018,2889,934,1955,47.8,2885,932,1953,47.7
38110, 창원시,085005, 84세,2018,2445,706,1739,40.6,2442,704,1738,40.5
38110, 창원시,090,85~89세,2018,7395,1788,5607,31.9,7384,1785,5599,31.9
38110, 창원시,090001, 85세,2018,1938,548,1390,39.4,1934,546,1388,39.3
38110, 창원시,090002, 86세,2018,1864,467,1397,33.4,1862,467,1395,33.5
38110, 창원시,090003, 87세,2018,1372,302,1070,28.2,1370,302,1068,28.3
38110, 창원시,090004, 88세,2018,1190,229,961,23.8,1188,229,959,23.9
38110, 창원시,090005, 89세,2018,1031,242,789,30.7,1030,241,789,30.5
38110, 창원시,095,90~94세,2018,2163,431,1732,24.9,2157,430,1727,24.9
38110, 창원시,095001, 90세,2018,725,155,570,27.2,724,155,569,27.2
38110, 창원시,095002, 91세,2018,529,114,415,27.5,529,114,415,27.5
38110, 창원시,095003, 92세,2018,395,73,322,22.7,393,72,321,22.4
38110, 창원시,095004, 93세,2018,319,55,264,20.8,316,55,261,21.1
38110, 창원시,095005, 94세,2018,195,34,161,21.1,195,34,161,21.1
38110, 창원시,100,95~99세,2018,411,63,348,18.1,410,62,348,17.8
38110, 창원시,100001, 95세,2018,174,25,149,16.8,174,25,149,16.8
38110, 창원시,100002, 96세,2018,113,21,92,22.8,113,21,92,22.8
38110, 창원시,100003, 97세,2018,61,8,53,15.1,60,7,53,13.2
38110, 창원시,100004, 98세,2018,46,5,41,12.2,46,5,41,12.2
38110, 창원시,100005, 99세,2018,17,X,13,30.8,17,X,13,30.8
38110, 창원시,101,100세이상,2018,48,X,44,9.1,48,X,44,9.1
38110, 창원시,102,15세미만,2018,139462,72269,67193,107.6,138997,72050,66947,107.6
38110, 창원시,103,15~64세,2018,775001,403799,371202,108.8,755463,391257,364206,107.4
38110, 창원시,104,65세이상,2018,129752,56295,73457,76.6,129286,56093,73193,76.6
38110, 창원시,086,85세이상,2018,10017,2286,7731,29.6,9999,2281,7718,29.6
38110, 창원시,126,평균연령,2018,41.2,40,42.5,,41.3,40.1,42.6,
38110, 창원시,127,중위연령,2018,42.7,40.9,44.5,,43,41.3,44.6,
38111, 의창구,000,합계,2018,251931,128682,123249,104.4,246857,125652,121205,103.7
38111, 의창구,005,0~4세,2018,10117,5241,4876,107.5,10041,5209,4832,107.8
38111, 의창구,005001, 0세,2018,1677,871,806,108.1,1649,859,790,108.7
38111, 의창구,005002, 1세,2018,1918,1003,915,109.6,1903,997,906,110
38111, 의창구,005003, 2세,2018,2051,1049,1002,104.7,2038,1043,995,104.8
38111, 의창구,005004, 3세,2018,2254,1152,1102,104.5,2246,1148,1098,104.6
38111, 의창구,005005, 4세,2018,2217,1166,1051,110.9,2205,1162,1043,111.4
38111, 의창구,010,5~9세,2018,11166,5731,5435,105.4,11129,5709,5420,105.3
38111, 의창구,010001, 5세,2018,2167,1101,1066,103.3,2155,1095,1060,103.3
38111, 의창구,010002, 6세,2018,2392,1225,1167,105,2387,1222,1165,104.9
38111, 의창구,010003, 7세,2018,2286,1200,1086,110.5,2278,1195,1083,110.3
38111, 의창구,010004, 8세,2018,2191,1124,1067,105.3,2182,1118,1064,105.1
38111, 의창구,010005, 9세,2018,2130,1081,1049,103.1,2127,1079,1048,103
38111, 의창구,015,10~14세,2018,10430,5476,4954,110.5,10408,5470,4938,110.8
38111, 의창구,015001, 10세,2018,2148,1126,1022,110.2,2143,1122,1021,109.9
38111, 의창구,015002, 11세,2018,2152,1125,1027,109.5,2150,1124,1026,109.6
38111, 의창구,015003, 12세,2018,1951,1000,951,105.2,1947,1000,947,105.6
38111, 의창구,015004, 13세,2018,1961,1064,897,118.6,1957,1064,893,119.1
38111, 의창구,015005, 14세,2018,2218,1161,1057,109.8,2211,1160,1051,110.4
38111, 의창구,020,15~19세,2018,13758,7478,6280,119.1,13697,7455,6242,119.4
38111, 의창구,020001, 15세,2018,2233,1184,1049,112.9,2231,1183,1048,112.9
38111, 의창구,020002, 16세,2018,2389,1323,1066,124.1,2382,1319,1063,124.1
38111, 의창구,020003, 17세,2018,2786,1455,1331,109.3,2780,1454,1326,109.7
38111, 의창구,020004, 18세,2018,3253,1790,1463,122.4,3244,1786,1458,122.5
38111, 의창구,020005, 19세,2018,3097,1726,1371,125.9,3060,1713,1347,127.2
38111, 의창구,025,20~24세,2018,18456,10401,8055,129.1,17965,10137,7828,129.5
38111, 의창구,025001, 20세,2018,3302,1849,1453,127.3,3239,1819,1420,128.1
38111, 의창구,025002, 21세,2018,3655,2035,1620,125.6,3565,1994,1571,126.9
38111, 의창구,025003, 22세,2018,3805,2173,1632,133.1,3715,2127,1588,133.9
38111, 의창구,025004, 23세,2018,3860,2198,1662,132.3,3751,2128,1623,131.1
38111, 의창구,025005, 24세,2018,3834,2146,1688,127.1,3695,2069,1626,127.2
38111, 의창구,030,25~29세,2018,17488,9753,7735,126.1,16564,9139,7425,123.1
38111, 의창구,030001, 25세,2018,3764,2074,1690,122.7,3604,1979,1625,121.8
38111, 의창구,030002, 26세,2018,3720,2080,1640,126.8,3557,1970,1587,124.1
38111, 의창구,030003, 27세,2018,3527,1932,1595,121.1,3359,1811,1548,117
38111, 의창구,030004, 28세,2018,3362,1905,1457,130.7,3147,1755,1392,126.1
38111, 의창구,030005, 29세,2018,3115,1762,1353,130.2,2897,1624,1273,127.6
38111, 의창구,035,30~34세,2018,15933,8711,7222,120.6,14963,8059,6904,116.7
38111, 의창구,035001, 30세,2018,3045,1646,1399,117.7,2848,1520,1328,114.5
38111, 의창구,035002, 31세,2018,3044,1702,1342,126.8,2820,1557,1263,123.3
38111, 의창구,035003, 32세,2018,3083,1740,1343,129.6,2890,1606,1284,125.1
38111, 의창구,035004, 33세,2018,3384,1838,1546,118.9,3181,1703,1478,115.2
38111, 의창구,035005, 34세,2018,3377,1785,1592,112.1,3224,1673,1551,107.9
38111, 의창구,040,35~39세,2018,19899,10411,9488,109.7,19255,10003,9252,108.1
38111, 의창구,040001, 35세,2018,3789,1983,1806,109.8,3647,1893,1754,107.9
38111, 의창구,040002, 36세,2018,4077,2149,1928,111.5,3922,2047,1875,109.2
38111, 의창구,040003, 37세,2018,4099,2126,1973,107.8,3983,2049,1934,105.9
38111, 의창구,040004, 38세,2018,4249,2213,2036,108.7,4124,2137,1987,107.5
38111, 의창구,040005, 39세,2018,3685,1940,1745,111.2,3579,1877,1702,110.3
38111, 의창구,045,40~44세,2018,18043,9371,8672,108.1,17557,9068,8489,106.8
38111, 의창구,045001, 40세,2018,3572,1885,1687,111.7,3458,1815,1643,110.5
38111, 의창구,045002, 41세,2018,3429,1810,1619,111.8,3332,1749,1583,110.5
38111, 의창구,045003, 42세,2018,3481,1824,1657,110.1,3378,1760,1618,108.8
38111, 의창구,045004, 43세,2018,3582,1847,1735,106.5,3496,1789,1707,104.8
38111, 의창구,045005, 44세,2018,3979,2005,1974,101.6,3893,1955,1938,100.9
38111, 의창구,050,45~49세,2018,22893,11068,11825,93.6,22461,10821,11640,93
38111, 의창구,050001, 45세,2018,4277,2087,2190,95.3,4192,2043,2149,95.1
38111, 의창구,050002, 46세,2018,4213,2124,2089,101.7,4129,2072,2057,100.7
38111, 의창구,050003, 47세,2018,4626,2174,2452,88.7,4543,2124,2419,87.8
38111, 의창구,050004, 48세,2018,4776,2282,2494,91.5,4686,2228,2458,90.6
38111, 의창구,050005, 49세,2018,5001,2401,2600,92.3,4911,2354,2557,92.1
38111, 의창구,055,50~54세,2018,23905,11528,12377,93.1,23498,11318,12180,92.9
38111, 의창구,055001, 50세,2018,5134,2378,2756,86.3,5029,2324,2705,85.9
38111, 의창구,055002, 51세,2018,4772,2230,2542,87.7,4700,2195,2505,87.6
38111, 의창구,055003, 52세,2018,4762,2365,2397,98.7,4690,2323,2367,98.1
38111, 의창구,055004, 53세,2018,4975,2460,2515,97.8,4894,2418,2476,97.7
38111, 의창구,055005, 54세,2018,4262,2095,2167,96.7,4185,2058,2127,96.8
38111, 의창구,060,55~59세,2018,24291,12489,11802,105.8,24043,12366,11677,105.9
38111, 의창구,060001, 55세,2018,4736,2445,2291,106.7,4659,2406,2253,106.8
38111, 의창구,060002, 56세,2018,4991,2584,2407,107.4,4930,2553,2377,107.4
38111, 의창구,060003, 57세,2018,5209,2659,2550,104.3,5168,2644,2524,104.8
38111, 의창구,060004, 58세,2018,5080,2576,2504,102.9,5038,2554,2484,102.8
38111, 의창구,060005, 59세,2018,4275,2225,2050,108.5,4248,2209,2039,108.3
38111, 의창구,065,60~64세,2018,17389,8719,8670,100.6,17245,8649,8596,100.6
38111, 의창구,065001, 60세,2018,3965,2051,1914,107.2,3923,2027,1896,106.9
38111, 의창구,065002, 61세,2018,3781,1864,1917,97.2,3752,1847,1905,97
38111, 의창구,065003, 62세,2018,3485,1705,1780,95.8,3458,1694,1764,96
38111, 의창구,065004, 63세,2018,3339,1652,1687,97.9,3313,1643,1670,98.4
38111, 의창구,065005, 64세,2018,2819,1447,1372,105.5,2799,1438,1361,105.7
38111, 의창구,070,65~69세,2018,10463,5373,5090,105.6,10392,5338,5054,105.6
38111, 의창구,070001, 65세,2018,2422,1232,1190,103.5,2402,1223,1179,103.7
38111, 의창구,070002, 66세,2018,2524,1309,1215,107.7,2510,1303,1207,108
38111, 의창구,070003, 67세,2018,1905,963,942,102.2,1895,956,939,101.8
38111, 의창구,070004, 68세,2018,1811,941,870,108.2,1795,931,864,107.8
38111, 의창구,070005, 69세,2018,1801,928,873,106.3,1790,925,865,106.9
38111, 의창구,075,70~74세,2018,6554,3210,3344,96,6524,3197,3327,96.1
38111, 의창구,075001, 70세,2018,1697,858,839,102.3,1688,851,837,101.7
38111, 의창구,075002, 71세,2018,1569,773,796,97.1,1560,770,790,97.5
38111, 의창구,075003, 72세,2018,1111,557,554,100.5,1104,555,549,101.1
38111, 의창구,075004, 73세,2018,1067,507,560,90.5,1065,506,559,90.5
38111, 의창구,075005, 74세,2018,1110,515,595,86.6,1107,515,592,87
38111, 의창구,080,75~79세,2018,5259,2093,3166,66.1,5245,2090,3155,66.2
38111, 의창구,080001, 75세,2018,1174,510,664,76.8,1172,510,662,77
38111, 의창구,080002, 76세,2018,1210,508,702,72.4,1207,507,700,72.4
38111, 의창구,080003, 77세,2018,1008,410,598,68.6,1003,409,594,68.9
38111, 의창구,080004, 78세,2018,989,366,623,58.7,988,366,622,58.8
38111, 의창구,080005, 79세,2018,878,299,579,51.6,875,298,577,51.6
38111, 의창구,085,80~84세,2018,3491,1117,2374,47.1,3480,1114,2366,47.1
38111, 의창구,085001, 80세,2018,768,271,497,54.5,763,270,493,54.8
38111, 의창구,085002, 81세,2018,776,256,520,49.2,775,256,519,49.3
38111, 의창구,085003, 82세,2018,694,236,458,51.5,690,234,456,51.3
38111, 의창구,085004, 83세,2018,706,230,476,48.3,705,230,475,48.4
38111, 의창구,085005, 84세,2018,547,124,423,29.3,547,124,423,29.3
38111, 의창구,090,85~89세,2018,1763,400,1363,29.3,1759,399,1360,29.3
38111, 의창구,090001, 85세,2018,469,120,349,34.4,468,119,349,34.1
38111, 의창구,090002, 86세,2018,458,105,353,29.7,457,105,352,29.8
38111, 의창구,090003, 87세,2018,323,77,246,31.3,322,77,245,31.4
38111, 의창구,090004, 88세,2018,271,49,222,22.1,270,49,221,22.2
38111, 의창구,090005, 89세,2018,242,49,193,25.4,242,49,193,25.4
38111, 의창구,095,90~94세,2018,527,99,428,23.1,525,98,427,23
38111, 의창구,095001, 90세,2018,167,33,134,24.6,167,33,134,24.6
38111, 의창구,095002, 91세,2018,140,23,117,19.7,140,23,117,19.7
38111, 의창구,095003, 92세,2018,97,18,79,22.8,96,17,79,21.5
38111, 의창구,095004, 93세,2018,81,20,61,32.8,80,20,60,33.3
38111, 의창구,095005, 94세,2018,42,5,37,13.5,42,5,37,13.5
38111, 의창구,100,95~99세,2018,93,12,81,14.8,93,12,81,14.8
38111, 의창구,100001, 95세,2018,37,6,31,19.4,37,6,31,19.4
38111, 의창구,100002, 96세,2018,34,5,29,17.2,34,5,29,17.2
38111, 의창구,100003, 97세,2018,10,X,10,0,10,X,10,0
38111, 의창구,100004, 98세,2018,10,X,9,11.1,10,X,9,11.1
38111, 의창구,100005, 99세,2018,X,X,X,0,X,X,X,0
38111, 의창구,101,100세이상,2018,13,X,12,8.3,13,X,12,8.3
38111, 의창구,102,15세미만,2018,31713,16448,15265,107.7,31578,16388,15190,107.9
38111, 의창구,103,15~64세,2018,192055,99929,92126,108.5,187248,97015,90233,107.5
38111, 의창구,104,65세이상,2018,28163,12305,15858,77.6,28031,12249,15782,77.6
38111, 의창구,086,85세이상,2018,2396,512,1884,27.2,2390,510,1880,27.1
38111, 의창구,126,평균연령,2018,41,39.8,42.2,,41,39.8,42.3,
38111, 의창구,127,중위연령,2018,42.5,40.6,44.4,,42.8,40.9,44.6,
38112, 성산구,000,합계,2018,225894,117727,108167,108.8,220793,114085,106708,106.9
38112, 성산구,005,0~4세,2018,8821,4499,4322,104.1,8761,4467,4294,104
38112, 성산구,005001, 0세,2018,1633,839,794,105.7,1615,826,789,104.7
38112, 성산구,005002, 1세,2018,1580,811,769,105.5,1571,807,764,105.6
38112, 성산구,005003, 2세,2018,1827,923,904,102.1,1816,918,898,102.2
38112, 성산구,005004, 3세,2018,1886,964,922,104.6,1879,962,917,104.9
38112, 성산구,005005, 4세,2018,1895,962,933,103.1,1880,954,926,103
38112, 성산구,010,5~9세,2018,10291,5320,4971,107,10268,5311,4957,107.1
38112, 성산구,010001, 5세,2018,1914,986,928,106.3,1909,983,926,106.2
38112, 성산구,010002, 6세,2018,2188,1120,1068,104.9,2182,1118,1064,105.1
38112, 성산구,010003, 7세,2018,2095,1079,1016,106.2,2094,1079,1015,106.3
38112, 성산구,010004, 8세,2018,2043,1050,993,105.7,2040,1049,991,105.9
38112, 성산구,010005, 9세,2018,2051,1085,966,112.3,2043,1082,961,112.6
38112, 성산구,015,10~14세,2018,11336,5978,5358,111.6,11317,5968,5349,111.6
38112, 성산구,015001, 10세,2018,2219,1125,1094,102.8,2214,1121,1093,102.6
38112, 성산구,015002, 11세,2018,2308,1250,1058,118.1,2305,1248,1057,118.1
38112, 성산구,015003, 12세,2018,2179,1176,1003,117.2,2176,1175,1001,117.4
38112, 성산구,015004, 13세,2018,2208,1152,1056,109.1,2206,1151,1055,109.1
38112, 성산구,015005, 14세,2018,2422,1275,1147,111.2,2416,1273,1143,111.4
38112, 성산구,020,15~19세,2018,13842,7756,6086,127.4,13803,7734,6069,127.4
38112, 성산구,020001, 15세,2018,2572,1407,1165,120.8,2567,1404,1163,120.7
38112, 성산구,020002, 16세,2018,2610,1366,1244,109.8,2608,1366,1242,110
38112, 성산구,020003, 17세,2018,3152,1706,1446,118,3148,1703,1445,117.9
38112, 성산구,020004, 18세,2018,3273,1919,1354,141.7,3266,1915,1351,141.7
38112, 성산구,020005, 19세,2018,2235,1358,877,154.8,2214,1346,868,155.1
38112, 성산구,025,20~24세,2018,15851,9249,6602,140.1,15446,8959,6487,138.1
38112, 성산구,025001, 20세,2018,2725,1709,1016,168.2,2682,1684,998,168.7
38112, 성산구,025002, 21세,2018,3006,1850,1156,160,2955,1812,1143,158.5
38112, 성산구,025003, 22세,2018,3359,1968,1391,141.5,3271,1902,1369,138.9
38112, 성산구,025004, 23세,2018,3364,1835,1529,120,3247,1749,1498,116.8
38112, 성산구,025005, 24세,2018,3397,1887,1510,125,3291,1812,1479,122.5
38112, 성산구,030,25~29세,2018,18230,10297,7933,129.8,17077,9404,7673,122.6
38112, 성산구,030001, 25세,2018,3534,1955,1579,123.8,3376,1838,1538,119.5
38112, 성산구,030002, 26세,2018,3738,2083,1655,125.9,3483,1884,1599,117.8
38112, 성산구,030003, 27세,2018,3712,2057,1655,124.3,3485,1885,1600,117.8
38112, 성산구,030004, 28세,2018,3651,2116,1535,137.9,3402,1918,1484,129.2
38112, 성산구,030005, 29세,2018,3595,2086,1509,138.2,3331,1879,1452,129.4
38112, 성산구,035,30~34세,2018,16945,9877,7068,139.7,15734,8906,6828,130.4
38112, 성산구,035001, 30세,2018,3498,2049,1449,141.4,3246,1840,1406,130.9
38112, 성산구,035002, 31세,2018,3517,2073,1444,143.6,3246,1861,1385,134.4
38112, 성산구,035003, 32세,2018,3370,1981,1389,142.6,3123,1792,1331,134.6
38112, 성산구,035004, 33세,2018,3344,1966,1378,142.7,3095,1765,1330,132.7
38112, 성산구,035005, 34세,2018,3216,1808,1408,128.4,3024,1648,1376,119.8
38112, 성산구,040,35~39세,2018,17515,9125,8390,108.8,16769,8555,8214,104.2
38112, 성산구,040001, 35세,2018,3474,1900,1574,120.7,3275,1746,1529,114.2
38112, 성산구,040002, 36세,2018,3511,1831,1680,109,3346,1706,1640,104
38112, 성산구,040003, 37세,2018,3503,1824,1679,108.6,3358,1721,1637,105.1
38112, 성산구,040004, 38세,2018,3585,1819,1766,103,3467,1727,1740,99.3
38112, 성산구,040005, 39세,2018,3442,1751,1691,103.5,3323,1655,1668,99.2
38112, 성산구,045,40~44세,2018,17342,8372,8970,93.3,16917,8084,8833,91.5
38112, 성산구,045001, 40세,2018,3234,1650,1584,104.2,3126,1575,1551,101.5
38112, 성산구,045002, 41세,2018,3334,1652,1682,98.2,3236,1582,1654,95.6
38112, 성산구,045003, 42세,2018,3303,1596,1707,93.5,3236,1554,1682,92.4
38112, 성산구,045004, 43세,2018,3483,1615,1868,86.5,3406,1566,1840,85.1
38112, 성산구,045005, 44세,2018,3988,1859,2129,87.3,3913,1807,2106,85.8
38112, 성산구,050,45~49세,2018,23122,10937,12185,89.8,22746,10699,12047,88.8
38112, 성산구,050001, 45세,2018,4194,1956,2238,87.4,4128,1909,2219,86
38112, 성산구,050002, 46세,2018,4343,2088,2255,92.6,4265,2035,2230,91.3
38112, 성산구,050003, 47세,2018,4784,2277,2507,90.8,4712,2235,2477,90.2
38112, 성산구,050004, 48세,2018,4921,2339,2582,90.6,4834,2287,2547,89.8
38112, 성산구,050005, 49세,2018,4880,2277,2603,87.5,4807,2233,2574,86.8
38112, 성산구,055,50~54세,2018,22990,11081,11909,93,22725,10935,11790,92.7
38112, 성산구,055001, 50세,2018,4956,2291,2665,86,4905,2264,2641,85.7
38112, 성산구,055002, 51세,2018,4574,2142,2432,88.1,4519,2105,2414,87.2
38112, 성산구,055003, 52세,2018,4583,2297,2286,100.5,4524,2266,2258,100.4
38112, 성산구,055004, 53세,2018,4765,2324,2441,95.2,4716,2297,2419,95
38112, 성산구,055005, 54세,2018,4112,2027,2085,97.2,4061,2003,2058,97.3
38112, 성산구,060,55~59세,2018,22038,11660,10378,112.4,21837,11572,10265,112.7
38112, 성산구,060001, 55세,2018,4559,2359,2200,107.2,4499,2329,2170,107.3
38112, 성산구,060002, 56세,2018,4577,2368,2209,107.2,4534,2349,2185,107.5
38112, 성산구,060003, 57세,2018,4779,2456,2323,105.7,4743,2444,2299,106.3
38112, 성산구,060004, 58세,2018,4517,2443,2074,117.8,4485,2430,2055,118.2
38112, 성산구,060005, 59세,2018,3606,2034,1572,129.4,3576,2020,1556,129.8
38112, 성산구,065,60~64세,2018,12415,6691,5724,116.9,12310,6642,5668,117.2
38112, 성산구,065001, 60세,2018,3194,1817,1377,132,3168,1803,1365,132.1
38112, 성산구,065002, 61세,2018,2709,1477,1232,119.9,2686,1464,1222,119.8
38112, 성산구,065003, 62세,2018,2414,1238,1176,105.3,2394,1230,1164,105.7
38112, 성산구,065004, 63세,2018,2337,1195,1142,104.6,2313,1185,1128,105.1
38112, 성산구,065005, 64세,2018,1761,964,797,121,1749,960,789,121.7
38112, 성산구,070,65~69세,2018,6396,3431,2965,115.7,6355,3408,2947,115.6
38112, 성산구,070001, 65세,2018,1603,880,723,121.7,1587,871,716,121.6
38112, 성산구,070002, 66세,2018,1503,833,670,124.3,1496,829,667,124.3
38112, 성산구,070003, 67세,2018,1209,630,579,108.8,1201,625,576,108.5
38112, 성산구,070004, 68세,2018,1054,584,470,124.3,1047,581,466,124.7
38112, 성산구,070005, 69세,2018,1027,504,523,96.4,1024,502,522,96.2
38112, 성산구,075,70~74세,2018,3496,1714,1782,96.2,3478,1707,1771,96.4
38112, 성산구,075001, 70세,2018,945,469,476,98.5,943,469,474,98.9
38112, 성산구,075002, 71세,2018,894,471,423,111.3,888,468,420,111.4
38112, 성산구,075003, 72세,2018,578,288,290,99.3,573,286,287,99.7
38112, 성산구,075004, 73세,2018,535,257,278,92.4,532,256,276,92.8
38112, 성산구,075005, 74세,2018,544,229,315,72.7,542,228,314,72.6
38112, 성산구,080,75~79세,2018,2581,987,1594,61.9,2575,985,1590,61.9
38112, 성산구,080001, 75세,2018,546,230,316,72.8,545,230,315,73
38112, 성산구,080002, 76세,2018,601,247,354,69.8,597,246,351,70.1
38112, 성산구,080003, 77세,2018,495,195,300,65,494,194,300,64.7
38112, 성산구,080004, 78세,2018,468,160,308,51.9,468,160,308,51.9
38112, 성산구,080005, 79세,2018,471,155,316,49.1,471,155,316,49.1
38112, 성산구,085,80~84세,2018,1666,521,1145,45.5,1662,518,1144,45.3
38112, 성산구,085001, 80세,2018,400,149,251,59.4,398,148,250,59.2
38112, 성산구,085002, 81세,2018,341,106,235,45.1,341,106,235,45.1
38112, 성산구,085003, 82세,2018,337,98,239,41,337,98,239,41
38112, 성산구,085004, 83세,2018,323,97,226,42.9,322,96,226,42.5
38112, 성산구,085005, 84세,2018,265,71,194,36.6,264,70,194,36.1
38112, 성산구,090,85~89세,2018,773,180,593,30.4,770,179,591,30.3
38112, 성산구,090001, 85세,2018,223,67,156,42.9,222,67,155,43.2
38112, 성산구,090002, 86세,2018,178,35,143,24.5,178,35,143,24.5
38112, 성산구,090003, 87세,2018,131,28,103,27.2,131,28,103,27.2
38112, 성산구,090004, 88세,2018,134,21,113,18.6,133,21,112,18.8
38112, 성산구,090005, 89세,2018,107,29,78,37.2,106,28,78,35.9
38112, 성산구,095,90~94세,2018,208,48,160,30,207,48,159,30.2
38112, 성산구,095001, 90세,2018,67,14,53,26.4,66,14,52,26.9
38112, 성산구,095002, 91세,2018,51,16,35,45.7,51,16,35,45.7
38112, 성산구,095003, 92세,2018,35,5,30,16.7,35,5,30,16.7
38112, 성산구,095004, 93세,2018,33,9,24,37.5,33,9,24,37.5
38112, 성산구,095005, 94세,2018,22,X,18,22.2,22,X,18,22.2
38112, 성산구,100,95~99세,2018,31,X,27,14.8,31,X,27,14.8
38112, 성산구,100001, 95세,2018,11,X,8,37.5,11,X,8,37.5
38112, 성산구,100002, 96세,2018,11,X,11,0,11,X,11,0
38112, 성산구,100003, 97세,2018,X,X,X,0,X,X,X,0
38112, 성산구,100004, 98세,2018,X,X,X,0,X,X,X,0
38112, 성산구,100005, 99세,2018,5,X,X,25,5,X,X,25
38112, 성산구,101,100세이상,2018,5,X,5,0,5,X,5,0
38112, 성산구,102,15세미만,2018,30448,15797,14651,107.8,30346,15746,14600,107.8
38112, 성산구,103,15~64세,2018,180290,95045,85245,111.5,175364,91490,83874,109.1
38112, 성산구,104,65세이상,2018,15156,6885,8271,83.2,15083,6849,8234,83.2
38112, 성산구,086,85세이상,2018,1017,232,785,29.6,1013,231,782,29.5
38112, 성산구,126,평균연령,2018,38.7,37.8,39.6,,38.8,37.9,39.7,
38112, 성산구,127,중위연령,2018,40,38.2,42.1,,40.4,38.6,42.2,
38113, 마산합포구,000,합계,2018,178431,89077,89354,99.7,175558,87351,88207,99
38113, 마산합포구,005,0~4세,2018,6476,3369,3107,108.4,6459,3364,3095,108.7
38113, 마산합포구,005001, 0세,2018,1060,533,527,101.1,1059,532,527,100.9
38113, 마산합포구,005002, 1세,2018,1178,621,557,111.5,1173,621,552,112.5
38113, 마산합포구,005003, 2세,2018,1361,728,633,115,1358,726,632,114.9
38113, 마산합포구,005004, 3세,2018,1446,738,708,104.2,1442,738,704,104.8
38113, 마산합포구,005005, 4세,2018,1431,749,682,109.8,1427,747,680,109.9
38113, 마산합포구,010,5~9세,2018,7318,3769,3549,106.2,7312,3767,3545,106.3
38113, 마산합포구,010001, 5세,2018,1510,776,734,105.7,1509,776,733,105.9
38113, 마산합포구,010002, 6세,2018,1571,814,757,107.5,1568,813,755,107.7
38113, 마산합포구,010003, 7세,2018,1524,769,755,101.9,1524,769,755,101.9
38113, 마산합포구,010004, 8세,2018,1352,690,662,104.2,1352,690,662,104.2
38113, 마산합포구,010005, 9세,2018,1361,720,641,112.3,1359,719,640,112.3
38113, 마산합포구,015,10~14세,2018,6553,3358,3195,105.1,6542,3354,3188,105.2
38113, 마산합포구,015001, 10세,2018,1327,680,647,105.1,1325,680,645,105.4
38113, 마산합포구,015002, 11세,2018,1412,720,692,104,1410,719,691,104.1
38113, 마산합포구,015003, 12세,2018,1260,629,631,99.7,1257,627,630,99.5
38113, 마산합포구,015004, 13세,2018,1199,634,565,112.2,1198,634,564,112.4
38113, 마산합포구,015005, 14세,2018,1355,695,660,105.3,1352,694,658,105.5
38113, 마산합포구,020,15~19세,2018,8785,4597,4188,109.8,8684,4540,4144,109.6
38113, 마산합포구,020001, 15세,2018,1378,731,647,113,1376,730,646,113
38113, 마산합포구,020002, 16세,2018,1497,729,768,94.9,1494,728,766,95
38113, 마산합포구,020003, 17세,2018,1718,883,835,105.7,1706,879,827,106.3
38113, 마산합포구,020004, 18세,2018,2026,1051,975,107.8,1992,1037,955,108.6
38113, 마산합포구,020005, 19세,2018,2166,1203,963,124.9,2116,1166,950,122.7
38113, 마산합포구,025,20~24세,2018,11084,6240,4844,128.8,10651,6021,4630,130
38113, 마산합포구,025001, 20세,2018,2158,1209,949,127.4,2080,1172,908,129.1
38113, 마산합포구,025002, 21세,2018,2199,1219,980,124.4,2120,1184,936,126.5
38113, 마산합포구,025003, 22세,2018,2248,1273,975,130.6,2162,1234,928,133
38113, 마산합포구,025004, 23세,2018,2251,1259,992,126.9,2149,1209,940,128.6
38113, 마산합포구,025005, 24세,2018,2228,1280,948,135,2140,1222,918,133.1
38113, 마산합포구,030,25~29세,2018,9841,5502,4339,126.8,9311,5164,4147,124.5
38113, 마산합포구,030001, 25세,2018,2055,1171,884,132.5,1962,1110,852,130.3
38113, 마산합포구,030002, 26세,2018,2071,1135,936,121.3,1989,1089,900,121
38113, 마산합포구,030003, 27세,2018,1946,1094,852,128.4,1823,1013,810,125.1
38113, 마산합포구,030004, 28세,2018,1877,1044,833,125.3,1758,971,787,123.4
38113, 마산합포구,030005, 29세,2018,1892,1058,834,126.9,1779,981,798,122.9
38113, 마산합포구,035,30~34세,2018,9990,5429,4561,119,9485,5082,4403,115.4
38113, 마산합포구,035001, 30세,2018,1829,1012,817,123.9,1724,945,779,121.3
38113, 마산합포구,035002, 31세,2018,1875,987,888,111.1,1774,919,855,107.5
38113, 마산합포구,035003, 32세,2018,1985,1089,896,121.5,1876,1017,859,118.4
38113, 마산합포구,035004, 33세,2018,2102,1145,957,119.6,1998,1067,931,114.6
38113, 마산합포구,035005, 34세,2018,2199,1196,1003,119.2,2113,1134,979,115.8
38113, 마산합포구,040,35~39세,2018,13668,7221,6447,112,13319,6994,6325,110.6
38113, 마산합포구,040001, 35세,2018,2456,1279,1177,108.7,2370,1220,1150,106.1
38113, 마산합포구,040002, 36세,2018,2804,1462,1342,108.9,2732,1419,1313,108.1
38113, 마산합포구,040003, 37세,2018,2869,1592,1277,124.7,2792,1541,1251,123.2
38113, 마산합포구,040004, 38세,2018,2857,1468,1389,105.7,2792,1423,1369,103.9
38113, 마산합포구,040005, 39세,2018,2682,1420,1262,112.5,2633,1391,1242,112
38113, 마산합포구,045,40~44세,2018,11929,6429,5500,116.9,11668,6249,5419,115.3
38113, 마산합포구,045001, 40세,2018,2402,1307,1095,119.4,2347,1265,1082,116.9
38113, 마산합포구,045002, 41세,2018,2347,1307,1040,125.7,2285,1266,1019,124.2
38113, 마산합포구,045003, 42세,2018,2213,1192,1021,116.7,2167,1159,1008,115
38113, 마산합포구,045004, 43세,2018,2422,1283,1139,112.6,2370,1248,1122,111.2
38113, 마산합포구,045005, 44세,2018,2545,1340,1205,111.2,2499,1311,1188,110.4
38113, 마산합포구,050,45~49세,2018,13806,7061,6745,104.7,13587,6933,6654,104.2
38113, 마산합포구,050001, 45세,2018,2699,1417,1282,110.5,2656,1391,1265,110
38113, 마산합포구,050002, 46세,2018,2501,1316,1185,111.1,2454,1284,1170,109.7
38113, 마산합포구,050003, 47세,2018,2834,1399,1435,97.5,2789,1369,1420,96.4
38113, 마산합포구,050004, 48세,2018,2841,1456,1385,105.1,2794,1434,1360,105.4
38113, 마산합포구,050005, 49세,2018,2931,1473,1458,101,2894,1455,1439,101.1
38113, 마산합포구,055,50~54세,2018,13851,6883,6968,98.8,13669,6792,6877,98.8
38113, 마산합포구,055001, 50세,2018,2970,1441,1529,94.2,2925,1414,1511,93.6
38113, 마산합포구,055002, 51세,2018,2707,1369,1338,102.3,2677,1353,1324,102.2
38113, 마산합포구,055003, 52세,2018,2714,1389,1325,104.8,2676,1371,1305,105.1
38113, 마산합포구,055004, 53세,2018,2891,1414,1477,95.7,2857,1396,1461,95.6
38113, 마산합포구,055005, 54세,2018,2569,1270,1299,97.8,2534,1258,1276,98.6
38113, 마산합포구,060,55~59세,2018,16568,7839,8729,89.8,16446,7778,8668,89.7
38113, 마산합포구,060001, 55세,2018,2852,1382,1470,94,2810,1364,1446,94.3
38113, 마산합포구,060002, 56세,2018,3200,1553,1647,94.3,3172,1538,1634,94.1
38113, 마산합포구,060003, 57세,2018,3555,1656,1899,87.2,3538,1647,1891,87.1
38113, 마산합포구,060004, 58세,2018,3560,1668,1892,88.2,3536,1654,1882,87.9
38113, 마산합포구,060005, 59세,2018,3401,1580,1821,86.8,3390,1575,1815,86.8
38113, 마산합포구,065,60~64세,2018,15550,7438,8112,91.7,15473,7400,8073,91.7
38113, 마산합포구,065001, 60세,2018,3178,1522,1656,91.9,3164,1512,1652,91.5
38113, 마산합포구,065002, 61세,2018,3185,1532,1653,92.7,3163,1522,1641,92.7
38113, 마산합포구,065003, 62세,2018,3139,1466,1673,87.6,3126,1461,1665,87.7
38113, 마산합포구,065004, 63세,2018,3307,1559,1748,89.2,3294,1552,1742,89.1
38113, 마산합포구,065005, 64세,2018,2741,1359,1382,98.3,2726,1353,1373,98.5
38113, 마산합포구,070,65~69세,2018,11230,5359,5871,91.3,11195,5342,5853,91.3
38113, 마산합포구,070001, 65세,2018,2374,1123,1251,89.8,2361,1118,1243,89.9
38113, 마산합포구,070002, 66세,2018,2597,1236,1361,90.8,2589,1232,1357,90.8
38113, 마산합포구,070003, 67세,2018,1975,931,1044,89.2,1971,929,1042,89.2
38113, 마산합포구,070004, 68세,2018,2128,1012,1116,90.7,2122,1009,1113,90.7
38113, 마산합포구,070005, 69세,2018,2156,1057,1099,96.2,2152,1054,1098,96
38113, 마산합포구,075,70~74세,2018,8204,3738,4466,83.7,8188,3731,4457,83.7
38113, 마산합포구,075001, 70세,2018,1994,949,1045,90.8,1993,949,1044,90.9
38113, 마산합포구,075002, 71세,2018,1898,852,1046,81.5,1893,851,1042,81.7
38113, 마산합포구,075003, 72세,2018,1381,631,750,84.1,1380,631,749,84.2
38113, 마산합포구,075004, 73세,2018,1441,645,796,81,1434,641,793,80.8
38113, 마산합포구,075005, 74세,2018,1490,661,829,79.7,1488,659,829,79.5
38113, 마산합포구,080,75~79세,2018,6673,2760,3913,70.5,6668,2757,3911,70.5
38113, 마산합포구,080001, 75세,2018,1434,601,833,72.1,1433,601,832,72.2
38113, 마산합포구,080002, 76세,2018,1536,684,852,80.3,1536,684,852,80.3
38113, 마산합포구,080003, 77세,2018,1409,582,827,70.4,1409,582,827,70.4
38113, 마산합포구,080004, 78세,2018,1185,477,708,67.4,1182,474,708,66.9
38113, 마산합포구,080005, 79세,2018,1109,416,693,60,1108,416,692,60.1
38113, 마산합포구,085,80~84세,2018,4141,1430,2711,52.7,4139,1429,2710,52.7
38113, 마산합포구,085001, 80세,2018,957,361,596,60.6,956,361,595,60.7
38113, 마산합포구,085002, 81세,2018,953,330,623,53,953,330,623,53
38113, 마산합포구,085003, 82세,2018,853,285,568,50.2,853,285,568,50.2
38113, 마산합포구,085004, 83세,2018,707,237,470,50.4,707,237,470,50.4
38113, 마산합포구,085005, 84세,2018,671,217,454,47.8,670,216,454,47.6
38113, 마산합포구,090,85~89세,2018,2042,517,1525,33.9,2042,517,1525,33.9
38113, 마산합포구,090001, 85세,2018,506,135,371,36.4,506,135,371,36.4
38113, 마산합포구,090002, 86세,2018,511,147,364,40.4,511,147,364,40.4
38113, 마산합포구,090003, 87세,2018,386,86,300,28.7,386,86,300,28.7
38113, 마산합포구,090004, 88세,2018,355,74,281,26.3,355,74,281,26.3
38113, 마산합포구,090005, 89세,2018,284,75,209,35.9,284,75,209,35.9
38113, 마산합포구,095,90~94세,2018,581,117,464,25.2,580,117,463,25.3
38113, 마산합포구,095001, 90세,2018,193,37,156,23.7,193,37,156,23.7
38113, 마산합포구,095002, 91세,2018,143,36,107,33.6,143,36,107,33.6
38113, 마산합포구,095003, 92세,2018,112,25,87,28.7,112,25,87,28.7
38113, 마산합포구,095004, 93세,2018,82,8,74,10.8,81,8,73,11
38113, 마산합포구,095005, 94세,2018,51,11,40,27.5,51,11,40,27.5
38113, 마산합포구,100,95~99세,2018,131,21,110,19.1,130,20,110,18.2
38113, 마산합포구,100001, 95세,2018,57,6,51,11.8,57,6,51,11.8
38113, 마산합포구,100002, 96세,2018,34,8,26,30.8,34,8,26,30.8
38113, 마산합포구,100003, 97세,2018,23,X,19,21.1,22,X,19,15.8
38113, 마산합포구,100004, 98세,2018,12,X,11,9.1,12,X,11,9.1
38113, 마산합포구,100005, 99세,2018,5,X,X,66.7,5,X,X,66.7
38113, 마산합포구,101,100세이상,2018,10,X,10,0,10,X,10,0
38113, 마산합포구,102,15세미만,2018,20347,10496,9851,106.5,20313,10485,9828,106.7
38113, 마산합포구,103,15~64세,2018,125072,64639,60433,107,122293,62953,59340,106.1
38113, 마산합포구,104,65세이상,2018,33012,13942,19070,73.1,32952,13913,19039,73.1
38113, 마산합포구,086,85세이상,2018,2764,655,2109,31.1,2762,654,2108,31
38113, 마산합포구,126,평균연령,2018,44.5,42.7,46.2,,44.6,42.9,46.3,
38113, 마산합포구,127,중위연령,2018,46.3,44,48.8,,46.7,44.3,49,
38114, 마산회원구,000,합계,2018,197683,99217,98466,100.8,194913,97603,97310,100.3
38114, 마산회원구,005,0~4세,2018,6610,3430,3180,107.9,6587,3415,3172,107.7
38114, 마산회원구,005001, 0세,2018,1002,501,501,100,998,498,500,99.6
38114, 마산회원구,005002, 1세,2018,1175,605,570,106.1,1169,602,567,106.2
38114, 마산회원구,005003, 2세,2018,1360,691,669,103.3,1353,686,667,102.8
38114, 마산회원구,005004, 3세,2018,1531,800,731,109.4,1527,797,730,109.2
38114, 마산회원구,005005, 4세,2018,1542,833,709,117.5,1540,832,708,117.5
38114, 마산회원구,010,5~9세,2018,8712,4579,4133,110.8,8700,4573,4127,110.8
38114, 마산회원구,010001, 5세,2018,1599,814,785,103.7,1597,813,784,103.7
38114, 마산회원구,010002, 6세,2018,1839,972,867,112.1,1834,969,865,112
38114, 마산회원구,010003, 7세,2018,1804,960,844,113.7,1803,959,844,113.6
38114, 마산회원구,010004, 8세,2018,1757,902,855,105.5,1755,901,854,105.5
38114, 마산회원구,010005, 9세,2018,1713,931,782,119.1,1711,931,780,119.4
38114, 마산회원구,015,10~14세,2018,9206,4757,4449,106.9,9198,4752,4446,106.9
38114, 마산회원구,015001, 10세,2018,1836,936,900,104,1833,934,899,103.9
38114, 마산회원구,015002, 11세,2018,1916,1029,887,116,1914,1028,886,116
38114, 마산회원구,015003, 12세,2018,1772,935,837,111.7,1769,933,836,111.6
38114, 마산회원구,015004, 13세,2018,1763,875,888,98.5,1763,875,888,98.5
38114, 마산회원구,015005, 14세,2018,1919,982,937,104.8,1919,982,937,104.8
38114, 마산회원구,020,15~19세,2018,10791,5699,5092,111.9,10752,5674,5078,111.7
38114, 마산회원구,020001, 15세,2018,1959,1071,888,120.6,1958,1070,888,120.5
38114, 마산회원구,020002, 16세,2018,1877,1000,877,114,1873,997,876,113.8
38114, 마산회원구,020003, 17세,2018,2129,1158,971,119.3,2126,1156,970,119.2
38114, 마산회원구,020004, 18세,2018,2432,1263,1169,108,2414,1253,1161,107.9
38114, 마산회원구,020005, 19세,2018,2394,1207,1187,101.7,2381,1198,1183,101.3
38114, 마산회원구,025,20~24세,2018,12376,6617,5759,114.9,12114,6489,5625,115.4
38114, 마산회원구,025001, 20세,2018,2428,1262,1166,108.2,2405,1251,1154,108.4
38114, 마산회원구,025002, 21세,2018,2661,1426,1235,115.5,2625,1408,1217,115.7
38114, 마산회원구,025003, 22세,2018,2454,1354,1100,123.1,2394,1321,1073,123.1
38114, 마산회원구,025004, 23세,2018,2405,1289,1116,115.5,2328,1251,1077,116.2
38114, 마산회원구,025005, 24세,2018,2428,1286,1142,112.6,2362,1258,1104,113.9
38114, 마산회원구,030,25~29세,2018,11438,6291,5147,122.2,10906,5937,4969,119.5
38114, 마산회원구,030001, 25세,2018,2467,1338,1129,118.5,2388,1286,1102,116.7
38114, 마산회원구,030002, 26세,2018,2394,1313,1081,121.5,2313,1264,1049,120.5
38114, 마산회원구,030003, 27세,2018,2219,1223,996,122.8,2106,1146,960,119.4
38114, 마산회원구,030004, 28세,2018,2231,1240,991,125.1,2101,1152,949,121.4
38114, 마산회원구,030005, 29세,2018,2127,1177,950,123.9,1998,1089,909,119.8
38114, 마산회원구,035,30~34세,2018,10667,5686,4981,114.2,10079,5318,4761,111.7
38114, 마산회원구,035001, 30세,2018,2062,1112,950,117.1,1944,1040,904,115
38114, 마산회원구,035002, 31세,2018,2117,1125,992,113.4,1973,1030,943,109.2
38114, 마산회원구,035003, 32세,2018,2034,1086,948,114.6,1913,1005,908,110.7
38114, 마산회원구,035004, 33세,2018,2091,1099,992,110.8,1988,1034,954,108.4
38114, 마산회원구,035005, 34세,2018,2363,1264,1099,115,2261,1209,1052,114.9
38114, 마산회원구,040,35~39세,2018,14641,7671,6970,110.1,14324,7489,6835,109.6
38114, 마산회원구,040001, 35세,2018,2591,1389,1202,115.6,2518,1345,1173,114.7
38114, 마산회원구,040002, 36세,2018,2957,1529,1428,107.1,2884,1494,1390,107.5
38114, 마산회원구,040003, 37세,2018,2987,1564,1423,109.9,2919,1524,1395,109.2
38114, 마산회원구,040004, 38세,2018,3109,1601,1508,106.2,3063,1571,1492,105.3
38114, 마산회원구,040005, 39세,2018,2997,1588,1409,112.7,2940,1555,1385,112.3
38114, 마산회원구,045,40~44세,2018,14938,7604,7334,103.7,14729,7479,7250,103.2
38114, 마산회원구,045001, 40세,2018,2881,1480,1401,105.6,2836,1455,1381,105.4
38114, 마산회원구,045002, 41세,2018,2929,1469,1460,100.6,2889,1445,1444,100.1
38114, 마산회원구,045003, 42세,2018,2775,1437,1338,107.4,2725,1404,1321,106.3
38114, 마산회원구,045004, 43세,2018,3045,1512,1533,98.6,3006,1488,1518,98
38114, 마산회원구,045005, 44세,2018,3308,1706,1602,106.5,3273,1687,1586,106.4
38114, 마산회원구,050,45~49세,2018,17440,8837,8603,102.7,17202,8693,8509,102.2
38114, 마산회원구,050001, 45세,2018,3392,1741,1651,105.5,3349,1715,1634,105
38114, 마산회원구,050002, 46세,2018,3206,1640,1566,104.7,3157,1609,1548,103.9
38114, 마산회원구,050003, 47세,2018,3576,1775,1801,98.6,3512,1735,1777,97.6
38114, 마산회원구,050004, 48세,2018,3553,1784,1769,100.8,3510,1758,1752,100.3
38114, 마산회원구,050005, 49세,2018,3713,1897,1816,104.5,3674,1876,1798,104.3
38114, 마산회원구,055,50~54세,2018,16965,8409,8556,98.3,16764,8300,8464,98.1
38114, 마산회원구,055001, 50세,2018,3711,1827,1884,97,3673,1805,1868,96.6
38114, 마산회원구,055002, 51세,2018,3425,1684,1741,96.7,3386,1662,1724,96.4
38114, 마산회원구,055003, 52세,2018,3469,1784,1685,105.9,3420,1765,1655,106.6
38114, 마산회원구,055004, 53세,2018,3354,1618,1736,93.2,3318,1595,1723,92.6
38114, 마산회원구,055005, 54세,2018,3006,1496,1510,99.1,2967,1473,1494,98.6
38114, 마산회원구,060,55~59세,2018,18589,9156,9433,97.1,18422,9073,9349,97
38114, 마산회원구,060001, 55세,2018,3377,1686,1691,99.7,3332,1667,1665,100.1
38114, 마산회원구,060002, 56세,2018,3831,1894,1937,97.8,3793,1872,1921,97.4
38114, 마산회원구,060003, 57세,2018,3968,2006,1962,102.2,3946,1993,1953,102
38114, 마산회원구,060004, 58세,2018,3946,1888,2058,91.7,3914,1874,2040,91.9
38114, 마산회원구,060005, 59세,2018,3467,1682,1785,94.2,3437,1667,1770,94.2
38114, 마산회원구,065,60~64세,2018,15828,7607,8221,92.5,15728,7563,8165,92.6
38114, 마산회원구,065001, 60세,2018,3319,1603,1716,93.4,3293,1593,1700,93.7
38114, 마산회원구,065002, 61세,2018,3385,1622,1763,92,3367,1610,1757,91.6
38114, 마산회원구,065003, 62세,2018,3113,1487,1626,91.5,3087,1475,1612,91.5
38114, 마산회원구,065004, 63세,2018,3288,1558,1730,90.1,3277,1556,1721,90.4
38114, 마산회원구,065005, 64세,2018,2723,1337,1386,96.5,2704,1329,1375,96.7
38114, 마산회원구,070,65~69세,2018,11092,5254,5838,90,11053,5237,5816,90
38114, 마산회원구,070001, 65세,2018,2407,1167,1240,94.1,2394,1161,1233,94.2
38114, 마산회원구,070002, 66세,2018,2604,1284,1320,97.3,2594,1280,1314,97.4
38114, 마산회원구,070003, 67세,2018,2045,944,1101,85.7,2038,942,1096,85.9
38114, 마산회원구,070004, 68세,2018,1986,885,1101,80.4,1981,881,1100,80.1
38114, 마산회원구,070005, 69세,2018,2050,974,1076,90.5,2046,973,1073,90.7
38114, 마산회원구,075,70~74세,2018,7630,3662,3968,92.3,7612,3657,3955,92.5
38114, 마산회원구,075001, 70세,2018,1981,969,1012,95.8,1978,969,1009,96
38114, 마산회원구,075002, 71세,2018,1763,854,909,93.9,1759,853,906,94.2
38114, 마산회원구,075003, 72세,2018,1265,632,633,99.8,1260,629,631,99.7
38114, 마산회원구,075004, 73세,2018,1242,575,667,86.2,1240,575,665,86.5
38114, 마산회원구,075005, 74세,2018,1379,632,747,84.6,1375,631,744,84.8
38114, 마산회원구,080,75~79세,2018,5649,2427,3222,75.3,5640,2425,3215,75.4
38114, 마산회원구,080001, 75세,2018,1268,564,704,80.1,1266,563,703,80.1
38114, 마산회원구,080002, 76세,2018,1269,566,703,80.5,1269,566,703,80.5
38114, 마산회원구,080003, 77세,2018,1166,497,669,74.3,1164,497,667,74.5
38114, 마산회원구,080004, 78세,2018,1003,415,588,70.6,999,414,585,70.8
38114, 마산회원구,080005, 79세,2018,943,385,558,69,942,385,557,69.1
38114, 마산회원구,085,80~84세,2018,3212,1118,2094,53.4,3204,1116,2088,53.4
38114, 마산회원구,085001, 80세,2018,791,307,484,63.4,788,307,481,63.8
38114, 마산회원구,085002, 81세,2018,682,253,429,59,681,253,428,59.1
38114, 마산회원구,085003, 82세,2018,661,224,437,51.3,659,223,436,51.1
38114, 마산회원구,085004, 83세,2018,596,188,408,46.1,594,187,407,45.9
38114, 마산회원구,085005, 84세,2018,482,146,336,43.5,482,146,336,43.5
38114, 마산회원구,090,85~89세,2018,1403,321,1082,29.7,1403,321,1082,29.7
38114, 마산회원구,090001, 85세,2018,364,104,260,40,364,104,260,40
38114, 마산회원구,090002, 86세,2018,361,95,266,35.7,361,95,266,35.7
38114, 마산회원구,090003, 87세,2018,269,45,224,20.1,269,45,224,20.1
38114, 마산회원구,090004, 88세,2018,209,38,171,22.2,209,38,171,22.2
38114, 마산회원구,090005, 89세,2018,200,39,161,24.2,200,39,161,24.2
38114, 마산회원구,095,90~94세,2018,406,78,328,23.8,406,78,328,23.8
38114, 마산회원구,095001, 90세,2018,136,33,103,32,136,33,103,32
38114, 마산회원구,095002, 91세,2018,109,19,90,21.1,109,19,90,21.1
38114, 마산회원구,095003, 92세,2018,63,9,54,16.7,63,9,54,16.7
38114, 마산회원구,095004, 93세,2018,63,11,52,21.2,63,11,52,21.2
38114, 마산회원구,095005, 94세,2018,35,6,29,20.7,35,6,29,20.7
38114, 마산회원구,100,95~99세,2018,82,13,69,18.8,82,13,69,18.8
38114, 마산회원구,100001, 95세,2018,36,6,30,20,36,6,30,20
38114, 마산회원구,100002, 96세,2018,18,X,16,12.5,18,X,16,12.5
38114, 마산회원구,100003, 97세,2018,15,X,12,25,15,X,12,25
38114, 마산회원구,100004, 98세,2018,9,X,8,12.5,9,X,8,12.5
38114, 마산회원구,100005, 99세,2018,X,X,X,33.3,X,X,X,33.3
38114, 마산회원구,101,100세이상,2018,8,X,7,14.3,8,X,7,14.3
38114, 마산회원구,102,15세미만,2018,24528,12766,11762,108.5,24485,12740,11745,108.5
38114, 마산회원구,103,15~64세,2018,143673,73577,70096,105,141020,72015,69005,104.4
38114, 마산회원구,104,65세이상,2018,29482,12874,16608,77.5,29408,12848,16560,77.6
38114, 마산회원구,086,85세이상,2018,1899,413,1486,27.8,1899,413,1486,27.8
38114, 마산회원구,126,평균연령,2018,42.8,41.5,44.1,,42.9,41.6,44.1,
38114, 마산회원구,127,중위연령,2018,44.8,43.3,46.3,,45,43.6,46.5,
38115, 진해구,000,합계,2018,190276,97660,92616,105.4,185625,94709,90916,104.2
38115, 진해구,005,0~4세,2018,10062,5218,4844,107.7,9969,5179,4790,108.1
38115, 진해구,005001, 0세,2018,1608,838,770,108.8,1599,834,765,109
38115, 진해구,005002, 1세,2018,1821,924,897,103,1798,913,885,103.2
38115, 진해구,005003, 2세,2018,2123,1086,1037,104.7,2102,1079,1023,105.5
38115, 진해구,005004, 3세,2018,2230,1203,1027,117.1,2207,1192,1015,117.4
38115, 진해구,005005, 4세,2018,2280,1167,1113,104.9,2263,1161,1102,105.4
38115, 진해구,010,5~9세,2018,11749,6082,5667,107.3,11717,6064,5653,107.3
38115, 진해구,010001, 5세,2018,2362,1237,1125,110,2352,1232,1120,110
38115, 진해구,010002, 6세,2018,2510,1329,1181,112.5,2504,1326,1178,112.6
38115, 진해구,010003, 7세,2018,2384,1206,1178,102.4,2378,1203,1175,102.4
38115, 진해구,010004, 8세,2018,2285,1213,1072,113.2,2281,1209,1072,112.8
38115, 진해구,010005, 9세,2018,2208,1097,1111,98.7,2202,1094,1108,98.7
38115, 진해구,015,10~14세,2018,10615,5462,5153,106,10589,5448,5141,106
38115, 진해구,015001, 10세,2018,2332,1115,1217,91.6,2325,1113,1212,91.8
38115, 진해구,015002, 11세,2018,2267,1170,1097,106.7,2259,1165,1094,106.5
38115, 진해구,015003, 12세,2018,2028,1087,941,115.5,2026,1086,940,115.5
38115, 진해구,015004, 13세,2018,1890,958,932,102.8,1886,955,931,102.6
38115, 진해구,015005, 14세,2018,2098,1132,966,117.2,2093,1129,964,117.1
38115, 진해구,020,15~19세,2018,9150,4923,4227,116.5,9105,4896,4209,116.3
38115, 진해구,020001, 15세,2018,1958,1062,896,118.5,1953,1058,895,118.2
38115, 진해구,020002, 16세,2018,1915,1044,871,119.9,1910,1040,870,119.5
38115, 진해구,020003, 17세,2018,1976,1033,943,109.5,1970,1030,940,109.6
38115, 진해구,020004, 18세,2018,1879,946,933,101.4,1871,939,932,100.8
38115, 진해구,020005, 19세,2018,1422,838,584,143.5,1401,829,572,144.9
38115, 진해구,025,20~24세,2018,8681,5097,3584,142.2,8354,4891,3463,141.2
38115, 진해구,025001, 20세,2018,1588,981,607,161.6,1560,965,595,162.2
38115, 진해구,025002, 21세,2018,1787,1085,702,154.6,1741,1055,686,153.8
38115, 진해구,025003, 22세,2018,1734,985,749,131.5,1673,951,722,131.7
38115, 진해구,025004, 23세,2018,1698,981,717,136.8,1610,928,682,136.1
38115, 진해구,025005, 24세,2018,1874,1065,809,131.6,1770,992,778,127.5
38115, 진해구,030,25~29세,2018,10440,5762,4678,123.2,9666,5245,4421,118.6
38115, 진해구,030001, 25세,2018,1997,1169,828,141.2,1866,1068,798,133.8
38115, 진해구,030002, 26세,2018,2139,1187,952,124.7,2007,1104,903,122.3
38115, 진해구,030003, 27세,2018,1975,1056,919,114.9,1833,964,869,110.9
38115, 진해구,030004, 28세,2018,2131,1175,956,122.9,1955,1066,889,119.9
38115, 진해구,030005, 29세,2018,2198,1175,1023,114.9,2005,1043,962,108.4
38115, 진해구,035,30~34세,2018,12871,6836,6035,113.3,11914,6178,5736,107.7
38115, 진해구,035001, 30세,2018,2243,1193,1050,113.6,2066,1072,994,107.8
38115, 진해구,035002, 31세,2018,2396,1269,1127,112.6,2174,1118,1056,105.9
38115, 진해구,035003, 32세,2018,2532,1364,1168,116.8,2347,1240,1107,112
38115, 진해구,035004, 33세,2018,2722,1426,1296,110,2521,1284,1237,103.8
38115, 진해구,035005, 34세,2018,2978,1584,1394,113.6,2806,1464,1342,109.1
38115, 진해구,040,35~39세,2018,19035,9883,9152,108,18360,9419,8941,105.3
38115, 진해구,040001, 35세,2018,3417,1781,1636,108.9,3251,1668,1583,105.4
38115, 진해구,040002, 36세,2018,3797,1985,1812,109.5,3654,1893,1761,107.5
38115, 진해구,040003, 37세,2018,3955,2096,1859,112.7,3842,2012,1830,109.9
38115, 진해구,040004, 38세,2018,4054,2054,2000,102.7,3932,1965,1967,99.9
38115, 진해구,040005, 39세,2018,3812,1967,1845,106.6,3681,1881,1800,104.5
38115, 진해구,045,40~44세,2018,17173,9165,8008,114.4,16729,8856,7873,112.5
38115, 진해구,045001, 40세,2018,3363,1793,1570,114.2,3264,1720,1544,111.4
38115, 진해구,045002, 41세,2018,3362,1779,1583,112.4,3286,1721,1565,110
38115, 진해구,045003, 42세,2018,3297,1794,1503,119.4,3195,1725,1470,117.3
38115, 진해구,045004, 43세,2018,3438,1829,1609,113.7,3374,1789,1585,112.9
38115, 진해구,045005, 44세,2018,3713,1970,1743,113,3610,1901,1709,111.2
38115, 진해구,050,45~49세,2018,16511,8911,7600,117.3,16087,8655,7432,116.5
38115, 진해구,050001, 45세,2018,3519,1898,1621,117.1,3433,1848,1585,116.6
38115, 진해구,050002, 46세,2018,3291,1768,1523,116.1,3213,1716,1497,114.6
38115, 진해구,050003, 47세,2018,3392,1826,1566,116.6,3287,1757,1530,114.8
38115, 진해구,050004, 48세,2018,3209,1702,1507,112.9,3127,1662,1465,113.4
38115, 진해구,050005, 49세,2018,3100,1717,1383,124.2,3027,1672,1355,123.4
38115, 진해구,055,50~54세,2018,13517,6989,6528,107.1,13156,6784,6372,106.5
38115, 진해구,055001, 50세,2018,3060,1626,1434,113.4,2983,1586,1397,113.5
38115, 진해구,055002, 51세,2018,2708,1394,1314,106.1,2623,1343,1280,104.9
38115, 진해구,055003, 52세,2018,2653,1348,1305,103.3,2593,1313,1280,102.6
38115, 진해구,055004, 53세,2018,2549,1304,1245,104.7,2485,1266,1219,103.9
38115, 진해구,055005, 54세,2018,2547,1317,1230,107.1,2472,1276,1196,106.7
38115, 진해구,060,55~59세,2018,14269,6975,7294,95.6,14051,6868,7183,95.6
38115, 진해구,060001, 55세,2018,2770,1414,1356,104.3,2710,1384,1326,104.4
38115, 진해구,060002, 56세,2018,2661,1334,1327,100.5,2621,1316,1305,100.8
38115, 진해구,060003, 57세,2018,3030,1476,1554,95,2990,1457,1533,95
38115, 진해구,060004, 58세,2018,3075,1448,1627,89,3036,1426,1610,88.6
38115, 진해구,060005, 59세,2018,2733,1303,1430,91.1,2694,1285,1409,91.2
38115, 진해구,065,60~64세,2018,12264,6068,6196,97.9,12116,5992,6124,97.8
38115, 진해구,065001, 60세,2018,2626,1307,1319,99.1,2590,1290,1300,99.2
38115, 진해구,065002, 61세,2018,2550,1261,1289,97.8,2522,1250,1272,98.3
38115, 진해구,065003, 62세,2018,2457,1206,1251,96.4,2429,1186,1243,95.4
38115, 진해구,065004, 63세,2018,2513,1204,1309,92,2483,1186,1297,91.4
38115, 진해구,065005, 64세,2018,2118,1090,1028,106,2092,1080,1012,106.7
38115, 진해구,070,65~69세,2018,8173,3958,4215,93.9,8093,3920,4173,93.9
38115, 진해구,070001, 65세,2018,1797,911,886,102.8,1770,894,876,102.1
38115, 진해구,070002, 66세,2018,1929,937,992,94.5,1916,932,984,94.7
38115, 진해구,070003, 67세,2018,1483,685,798,85.8,1473,682,791,86.2
38115, 진해구,070004, 68세,2018,1424,664,760,87.4,1411,659,752,87.6
38115, 진해구,070005, 69세,2018,1540,761,779,97.7,1523,753,770,97.8
38115, 진해구,075,70~74세,2018,5913,2752,3161,87.1,5888,2741,3147,87.1
38115, 진해구,075001, 70세,2018,1408,702,706,99.4,1404,701,703,99.7
38115, 진해구,075002, 71세,2018,1380,629,751,83.8,1370,623,747,83.4
38115, 진해구,075003, 72세,2018,1072,525,547,96,1069,524,545,96.1
38115, 진해구,075004, 73세,2018,1014,430,584,73.6,1011,428,583,73.4
38115, 진해구,075005, 74세,2018,1039,466,573,81.3,1034,465,569,81.7
38115, 진해구,080,75~79세,2018,4820,2006,2814,71.3,4809,2003,2806,71.4
38115, 진해구,080001, 75세,2018,1010,434,576,75.3,1009,434,575,75.5
38115, 진해구,080002, 76세,2018,1153,479,674,71.1,1152,478,674,70.9
38115, 진해구,080003, 77세,2018,919,379,540,70.2,916,379,537,70.6
38115, 진해구,080004, 78세,2018,889,364,525,69.3,886,363,523,69.4
38115, 진해구,080005, 79세,2018,849,350,499,70.1,846,349,497,70.2
38115, 진해구,085,80~84세,2018,3092,1099,1993,55.1,3087,1097,1990,55.1
38115, 진해구,085001, 80세,2018,734,286,448,63.8,731,284,447,63.5
38115, 진해구,085002, 81세,2018,728,264,464,56.9,728,264,464,56.9
38115, 진해구,085003, 82세,2018,593,219,374,58.6,592,219,373,58.7
38115, 진해구,085004, 83세,2018,557,182,375,48.5,557,182,375,48.5
38115, 진해구,085005, 84세,2018,480,148,332,44.6,479,148,331,44.7
38115, 진해구,090,85~89세,2018,1414,370,1044,35.4,1410,369,1041,35.4
38115, 진해구,090001, 85세,2018,376,122,254,48,374,121,253,47.8
38115, 진해구,090002, 86세,2018,356,85,271,31.4,355,85,270,31.5
38115, 진해구,090003, 87세,2018,263,66,197,33.5,262,66,196,33.7
38115, 진해구,090004, 88세,2018,221,47,174,27,221,47,174,27
38115, 진해구,090005, 89세,2018,198,50,148,33.8,198,50,148,33.8
38115, 진해구,095,90~94세,2018,441,89,352,25.3,439,89,350,25.4
38115, 진해구,095001, 90세,2018,162,38,124,30.6,162,38,124,30.6
38115, 진해구,095002, 91세,2018,86,20,66,30.3,86,20,66,30.3
38115, 진해구,095003, 92세,2018,88,16,72,22.2,87,16,71,22.5
38115, 진해구,095004, 93세,2018,60,7,53,13.2,59,7,52,13.5
38115, 진해구,095005, 94세,2018,45,8,37,21.6,45,8,37,21.6
38115, 진해구,100,95~99세,2018,74,13,61,21.3,74,13,61,21.3
38115, 진해구,100001, 95세,2018,33,X,29,13.8,33,X,29,13.8
38115, 진해구,100002, 96세,2018,16,6,10,60,16,6,10,60
38115, 진해구,100003, 97세,2018,10,X,9,11.1,10,X,9,11.1
38115, 진해구,100004, 98세,2018,14,X,12,16.7,14,X,12,16.7
38115, 진해구,100005, 99세,2018,X,X,X,0,X,X,X,0
38115, 진해구,101,100세이상,2018,12,X,10,20,12,X,10,20
38115, 진해구,102,15세미만,2018,32426,16762,15664,107,32275,16691,15584,107.1
38115, 진해구,103,15~64세,2018,133911,70609,63302,111.5,129538,67784,61754,109.8
38115, 진해구,104,65세이상,2018,23939,10289,13650,75.4,23812,10234,13578,75.4
38115, 진해구,086,85세이상,2018,1941,474,1467,32.3,1935,473,1462,32.4
38115, 진해구,126,평균연령,2018,40,38.8,41.2,,40.1,38.9,41.3,
38115, 진해구,127,중위연령,2018,40.8,39.8,41.9,,41,40,42,
38310, 의령군,000,합계,2018,26401,12837,13564,94.6,25378,12219,13159,92.9
38310, 의령군,005,0~4세,2018,575,301,274,109.9,574,301,273,110.3
38310, 의령군,005001, 0세,2018,108,43,65,66.2,108,43,65,66.2
38310, 의령군,005002, 1세,2018,105,60,45,133.3,105,60,45,133.3
38310, 의령군,005003, 2세,2018,109,46,63,73,109,46,63,73
38310, 의령군,005004, 3세,2018,125,76,49,155.1,124,76,48,158.3
38310, 의령군,005005, 4세,2018,128,76,52,146.2,128,76,52,146.2
38310, 의령군,010,5~9세,2018,660,356,304,117.1,658,355,303,117.2
38310, 의령군,010001, 5세,2018,126,71,55,129.1,125,70,55,127.3
38310, 의령군,010002, 6세,2018,141,86,55,156.4,141,86,55,156.4
38310, 의령군,010003, 7세,2018,133,63,70,90,133,63,70,90
38310, 의령군,010004, 8세,2018,124,59,65,90.8,124,59,65,90.8
38310, 의령군,010005, 9세,2018,136,77,59,130.5,135,77,58,132.8
38310, 의령군,015,10~14세,2018,690,365,325,112.3,689,364,325,112
38310, 의령군,015001, 10세,2018,129,67,62,108.1,129,67,62,108.1
38310, 의령군,015002, 11세,2018,134,62,72,86.1,134,62,72,86.1
38310, 의령군,015003, 12세,2018,127,74,53,139.6,126,73,53,137.7
38310, 의령군,015004, 13세,2018,132,78,54,144.4,132,78,54,144.4
38310, 의령군,015005, 14세,2018,168,84,84,100,168,84,84,100
38310, 의령군,020,15~19세,2018,909,505,404,125,903,502,401,125.2
38310, 의령군,020001, 15세,2018,158,89,69,129,158,89,69,129
38310, 의령군,020002, 16세,2018,202,106,96,110.4,202,106,96,110.4
38310, 의령군,020003, 17세,2018,191,102,89,114.6,191,102,89,114.6
38310, 의령군,020004, 18세,2018,218,125,93,134.4,215,124,91,136.3
38310, 의령군,020005, 19세,2018,140,83,57,145.6,137,81,56,144.6
38310, 의령군,025,20~24세,2018,999,590,409,144.3,887,527,360,146.4
38310, 의령군,025001, 20세,2018,171,114,57,200,157,104,53,196.2
38310, 의령군,025002, 21세,2018,217,143,74,193.2,197,130,67,194
38310, 의령군,025003, 22세,2018,200,100,100,100,180,90,90,100
38310, 의령군,025004, 23세,2018,204,119,85,140,180,106,74,143.2
38310, 의령군,025005, 24세,2018,207,114,93,122.6,173,97,76,127.6
38310, 의령군,030,25~29세,2018,1154,622,532,116.9,898,478,420,113.8
38310, 의령군,030001, 25세,2018,231,125,106,117.9,188,102,86,118.6
38310, 의령군,030002, 26세,2018,267,149,118,126.3,200,112,88,127.3
38310, 의령군,030003, 27세,2018,219,113,106,106.6,176,92,84,109.5
38310, 의령군,030004, 28세,2018,217,117,100,117,170,89,81,109.9
38310, 의령군,030005, 29세,2018,220,118,102,115.7,164,83,81,102.5
38310, 의령군,035,30~34세,2018,1094,623,471,132.3,855,460,395,116.5
38310, 의령군,035001, 30세,2018,220,130,90,144.4,170,92,78,117.9
38310, 의령군,035002, 31세,2018,220,127,93,136.6,162,92,70,131.4
38310, 의령군,035003, 32세,2018,241,127,114,111.4,186,93,93,100
38310, 의령군,035004, 33세,2018,191,113,78,144.9,158,90,68,132.4
38310, 의령군,035005, 34세,2018,222,126,96,131.3,179,93,86,108.1
38310, 의령군,040,35~39세,2018,1187,648,539,120.2,1050,558,492,113.4
38310, 의령군,040001, 35세,2018,239,129,110,117.3,195,101,94,107.4
38310, 의령군,040002, 36세,2018,219,118,101,116.8,186,97,89,109
38310, 의령군,040003, 37세,2018,230,120,110,109.1,215,109,106,102.8
38310, 의령군,040004, 38세,2018,246,132,114,115.8,221,116,105,110.5
38310, 의령군,040005, 39세,2018,253,149,104,143.3,233,135,98,137.8
38310, 의령군,045,40~44세,2018,1237,709,528,134.3,1151,653,498,131.1
38310, 의령군,045001, 40세,2018,226,133,93,143,205,119,86,138.4
38310, 의령군,045002, 41세,2018,208,117,91,128.6,199,114,85,134.1
38310, 의령군,045003, 42세,2018,234,137,97,141.2,212,118,94,125.5
38310, 의령군,045004, 43세,2018,274,144,130,110.8,258,134,124,108.1
38310, 의령군,045005, 44세,2018,295,178,117,152.1,277,168,109,154.1
38310, 의령군,050,45~49세,2018,1678,961,717,134,1614,926,688,134.6
38310, 의령군,050001, 45세,2018,311,176,135,130.4,295,164,131,125.2
38310, 의령군,050002, 46세,2018,304,161,143,112.6,289,154,135,114.1
38310, 의령군,050003, 47세,2018,344,201,143,140.6,336,197,139,141.7
38310, 의령군,050004, 48세,2018,326,185,141,131.2,315,181,134,135.1
38310, 의령군,050005, 49세,2018,393,238,155,153.5,379,230,149,154.4
38310, 의령군,055,50~54세,2018,1966,1052,914,115.1,1912,1025,887,115.6
38310, 의령군,055001, 50세,2018,405,216,189,114.3,394,210,184,114.1
38310, 의령군,055002, 51세,2018,376,203,173,117.3,365,196,169,116
38310, 의령군,055003, 52세,2018,386,208,178,116.9,378,204,174,117.2
38310, 의령군,055004, 53세,2018,419,223,196,113.8,402,215,187,115
38310, 의령군,055005, 54세,2018,380,202,178,113.5,373,200,173,115.6
38310, 의령군,060,55~59세,2018,2585,1352,1233,109.7,2555,1333,1222,109.1
38310, 의령군,060001, 55세,2018,409,224,185,121.1,400,220,180,122.2
38310, 의령군,060002, 56세,2018,519,269,250,107.6,513,265,248,106.9
38310, 의령군,060003, 57세,2018,574,306,268,114.2,568,302,266,113.5
38310, 의령군,060004, 58세,2018,560,281,279,100.7,553,275,278,98.9
38310, 의령군,060005, 59세,2018,523,272,251,108.4,521,271,250,108.4
38310, 의령군,065,60~64세,2018,2560,1318,1242,106.1,2535,1309,1226,106.8
38310, 의령군,065001, 60세,2018,508,259,249,104,499,257,242,106.2
38310, 의령군,065002, 61세,2018,530,286,244,117.2,527,285,242,117.8
38310, 의령군,065003, 62세,2018,516,267,249,107.2,514,267,247,108.1
38310, 의령군,065004, 63세,2018,550,278,272,102.2,544,274,270,101.5
38310, 의령군,065005, 64세,2018,456,228,228,100,451,226,225,100.4
38310, 의령군,070,65~69세,2018,2069,998,1071,93.2,2064,993,1071,92.7
38310, 의령군,070001, 65세,2018,364,181,183,98.9,364,181,183,98.9
38310, 의령군,070002, 66세,2018,501,253,248,102,499,251,248,101.2
38310, 의령군,070003, 67세,2018,360,175,185,94.6,358,173,185,93.5
38310, 의령군,070004, 68세,2018,406,194,212,91.5,405,193,212,91
38310, 의령군,070005, 69세,2018,438,195,243,80.2,438,195,243,80.2
38310, 의령군,075,70~74세,2018,1764,775,989,78.4,1760,774,986,78.5
38310, 의령군,075001, 70세,2018,400,200,200,100,397,199,198,100.5
38310, 의령군,075002, 71세,2018,388,180,208,86.5,388,180,208,86.5
38310, 의령군,075003, 72세,2018,300,133,167,79.6,299,133,166,80.1
38310, 의령군,075004, 73세,2018,310,126,184,68.5,310,126,184,68.5
38310, 의령군,075005, 74세,2018,366,136,230,59.1,366,136,230,59.1
38310, 의령군,080,75~79세,2018,2243,791,1452,54.5,2243,791,1452,54.5
38310, 의령군,080001, 75세,2018,409,140,269,52,409,140,269,52
38310, 의령군,080002, 76세,2018,482,176,306,57.5,482,176,306,57.5
38310, 의령군,080003, 77세,2018,486,170,316,53.8,486,170,316,53.8
38310, 의령군,080004, 78세,2018,426,148,278,53.2,426,148,278,53.2
38310, 의령군,080005, 79세,2018,440,157,283,55.5,440,157,283,55.5
38310, 의령군,085,80~84세,2018,1768,557,1211,46,1767,556,1211,45.9
38310, 의령군,085001, 80세,2018,362,135,227,59.5,362,135,227,59.5
38310, 의령군,085002, 81세,2018,400,138,262,52.7,400,138,262,52.7
38310, 의령군,085003, 82세,2018,392,114,278,41,392,114,278,41
38310, 의령군,085004, 83세,2018,326,98,228,43,325,97,228,42.5
38310, 의령군,085005, 84세,2018,288,72,216,33.3,288,72,216,33.3
38310, 의령군,090,85~89세,2018,942,240,702,34.2,942,240,702,34.2
38310, 의령군,090001, 85세,2018,246,76,170,44.7,246,76,170,44.7
38310, 의령군,090002, 86세,2018,241,58,183,31.7,241,58,183,31.7
38310, 의령군,090003, 87세,2018,176,44,132,33.3,176,44,132,33.3
38310, 의령군,090004, 88세,2018,158,36,122,29.5,158,36,122,29.5
38310, 의령군,090005, 89세,2018,121,26,95,27.4,121,26,95,27.4
38310, 의령군,095,90~94세,2018,254,59,195,30.3,254,59,195,30.3
38310, 의령군,095001, 90세,2018,94,26,68,38.2,94,26,68,38.2
38310, 의령군,095002, 91세,2018,64,13,51,25.5,64,13,51,25.5
38310, 의령군,095003, 92세,2018,49,11,38,28.9,49,11,38,28.9
38310, 의령군,095004, 93세,2018,28,6,22,27.3,28,6,22,27.3
38310, 의령군,095005, 94세,2018,19,X,16,18.8,19,X,16,18.8
38310, 의령군,100,95~99세,2018,62,15,47,31.9,62,15,47,31.9
38310, 의령군,100001, 95세,2018,24,X,20,20,24,X,20,20
38310, 의령군,100002, 96세,2018,16,5,11,45.5,16,5,11,45.5
38310, 의령군,100003, 97세,2018,8,X,6,33.3,8,X,6,33.3
38310, 의령군,100004, 98세,2018,11,X,8,37.5,11,X,8,37.5
38310, 의령군,100005, 99세,2018,X,X,X,50,X,X,X,50
38310, 의령군,101,100세이상,2018,5,X,5,0,5,X,5,0
38310, 의령군,102,15세미만,2018,1925,1022,903,113.2,1921,1020,901,113.2
38310, 의령군,103,15~64세,2018,15369,8380,6989,119.9,14360,7771,6589,117.9
38310, 의령군,104,65세이상,2018,9107,3435,5672,60.6,9097,3428,5669,60.5
38310, 의령군,086,85세이상,2018,1263,314,949,33.1,1263,314,949,33.1
38310, 의령군,126,평균연령,2018,53.4,50,56.6,,54.1,50.7,57.2,
38310, 의령군,127,중위연령,2018,57.2,53.5,60.5,,58,54.8,61.3,
38320, 함안군,000,합계,2018,67520,35459,32061,110.6,62886,31720,31166,101.8
38320, 함안군,005,0~4세,2018,2142,1079,1063,101.5,2122,1071,1051,101.9
38320, 함안군,005001, 0세,2018,311,159,152,104.6,308,159,149,106.7
38320, 함안군,005002, 1세,2018,371,190,181,105,365,187,178,105.1
38320, 함안군,005003, 2세,2018,465,236,229,103.1,461,234,227,103.1
38320, 함안군,005004, 3세,2018,497,252,245,102.9,493,251,242,103.7
38320, 함안군,005005, 4세,2018,498,242,256,94.5,495,240,255,94.1
38320, 함안군,010,5~9세,2018,2957,1499,1458,102.8,2946,1494,1452,102.9
38320, 함안군,010001, 5세,2018,545,289,256,112.9,545,289,256,112.9
38320, 함안군,010002, 6세,2018,582,286,296,96.6,580,284,296,95.9
38320, 함안군,010003, 7세,2018,610,295,315,93.7,605,294,311,94.5
38320, 함안군,010004, 8세,2018,575,299,276,108.3,574,299,275,108.7
38320, 함안군,010005, 9세,2018,645,330,315,104.8,642,328,314,104.5
38320, 함안군,015,10~14세,2018,2895,1510,1385,109,2883,1506,1377,109.4
38320, 함안군,015001, 10세,2018,643,325,318,102.2,639,324,315,102.9
38320, 함안군,015002, 11세,2018,610,313,297,105.4,609,313,296,105.7
38320, 함안군,015003, 12세,2018,557,296,261,113.4,556,295,261,113
38320, 함안군,015004, 13세,2018,553,281,272,103.3,551,280,271,103.3
38320, 함안군,015005, 14세,2018,532,295,237,124.5,528,294,234,125.6
38320, 함안군,020,15~19세,2018,2935,1580,1355,116.6,2903,1559,1344,116
38320, 함안군,020001, 15세,2018,571,312,259,120.5,568,310,258,120.2
38320, 함안군,020002, 16세,2018,605,321,284,113,601,318,283,112.4
38320, 함안군,020003, 17세,2018,673,350,323,108.4,670,348,322,108.1
38320, 함안군,020004, 18세,2018,645,326,319,102.2,637,321,316,101.6
38320, 함안군,020005, 19세,2018,441,271,170,159.4,427,262,165,158.8
38320, 함안군,025,20~24세,2018,3304,2145,1159,185.1,2776,1701,1075,158.2
38320, 함안군,025001, 20세,2018,582,391,191,204.7,549,366,183,200
38320, 함안군,025002, 21세,2018,619,410,209,196.2,560,358,202,177.2
38320, 함안군,025003, 22세,2018,640,429,211,203.3,531,339,192,176.6
38320, 함안군,025004, 23세,2018,723,446,277,161,575,323,252,128.2
38320, 함안군,025005, 24세,2018,740,469,271,173.1,561,315,246,128
38320, 함안군,030,25~29세,2018,3715,2388,1327,180,2581,1432,1149,124.6
38320, 함안군,030001, 25세,2018,761,482,279,172.8,572,327,245,133.5
38320, 함안군,030002, 26세,2018,771,486,285,170.5,554,301,253,119
38320, 함안군,030003, 27세,2018,729,485,244,198.8,499,291,208,139.9
38320, 함안군,030004, 28세,2018,736,476,260,183.1,490,272,218,124.8
38320, 함안군,030005, 29세,2018,718,459,259,177.2,466,241,225,107.1
38320, 함안군,035,30~34세,2018,3755,2313,1442,160.4,2654,1367,1287,106.2
38320, 함안군,035001, 30세,2018,740,473,267,177.2,486,253,233,108.6
38320, 함안군,035002, 31세,2018,728,467,261,178.9,484,258,226,114.2
38320, 함안군,035003, 32세,2018,742,474,268,176.9,522,279,243,114.8
38320, 함안군,035004, 33세,2018,763,478,285,167.7,562,301,261,115.3
38320, 함안군,035005, 34세,2018,782,421,361,116.6,600,276,324,85.2
38320, 함안군,040,35~39세,2018,4736,2683,2053,130.7,4006,2076,1930,107.6
38320, 함안군,040001, 35세,2018,895,501,394,127.2,724,353,371,95.1
38320, 함안군,040002, 36세,2018,902,520,382,136.1,737,385,352,109.4
38320, 함안군,040003, 37세,2018,942,530,412,128.6,822,434,388,111.9
38320, 함안군,040004, 38세,2018,1068,599,469,127.7,920,478,442,108.1
38320, 함안군,040005, 39세,2018,929,533,396,134.6,803,426,377,113
38320, 함안군,045,40~44세,2018,4861,2719,2142,126.9,4433,2375,2058,115.4
38320, 함안군,045001, 40세,2018,915,502,413,121.5,792,406,386,105.2
38320, 함안군,045002, 41세,2018,973,542,431,125.8,871,457,414,110.4
38320, 함안군,045003, 42세,2018,926,525,401,130.9,846,457,389,117.5
38320, 함안군,045004, 43세,2018,1028,574,454,126.4,962,527,435,121.1
38320, 함안군,045005, 44세,2018,1019,576,443,130,962,528,434,121.7
38320, 함안군,050,45~49세,2018,5315,2987,2328,128.3,5048,2802,2246,124.8
38320, 함안군,050001, 45세,2018,1025,569,456,124.8,971,530,441,120.2
38320, 함안군,050002, 46세,2018,1057,603,454,132.8,998,566,432,131
38320, 함안군,050003, 47세,2018,1107,624,483,129.2,1060,589,471,125.1
38320, 함안군,050004, 48세,2018,1070,595,475,125.3,1019,557,462,120.6
38320, 함안군,050005, 49세,2018,1056,596,460,129.6,1000,560,440,127.3
38320, 함안군,055,50~54세,2018,5242,2842,2400,118.4,5101,2758,2343,117.7
38320, 함안군,055001, 50세,2018,1089,603,486,124.1,1062,584,478,122.2
38320, 함안군,055002, 51세,2018,1030,567,463,122.5,998,548,450,121.8
38320, 함안군,055003, 52세,2018,1081,596,485,122.9,1050,576,474,121.5
38320, 함안군,055004, 53세,2018,1052,530,522,101.5,1022,514,508,101.2
38320, 함안군,055005, 54세,2018,990,546,444,123,969,536,433,123.8
38320, 함안군,060,55~59세,2018,5899,3126,2773,112.7,5785,3057,2728,112.1
38320, 함안군,060001, 55세,2018,1056,572,484,118.2,1022,553,469,117.9
38320, 함안군,060002, 56세,2018,1159,623,536,116.2,1135,606,529,114.6
38320, 함안군,060003, 57세,2018,1294,671,623,107.7,1276,661,615,107.5
38320, 함안군,060004, 58세,2018,1252,650,602,108,1230,636,594,107.1
38320, 함안군,060005, 59세,2018,1138,610,528,115.5,1122,601,521,115.4
38320, 함안군,065,60~64세,2018,5570,2919,2651,110.1,5503,2879,2624,109.7
38320, 함안군,065001, 60세,2018,1208,665,543,122.5,1195,658,537,122.5
38320, 함안군,065002, 61세,2018,1171,616,555,111,1160,610,550,110.9
38320, 함안군,065003, 62세,2018,1117,566,551,102.7,1099,557,542,102.8
38320, 함안군,065004, 63세,2018,1093,593,500,118.6,1080,583,497,117.3
38320, 함안군,065005, 64세,2018,981,479,502,95.4,969,471,498,94.6
38320, 함안군,070,65~69세,2018,3986,1972,2014,97.9,3951,1955,1996,97.9
38320, 함안군,070001, 65세,2018,852,441,411,107.3,847,437,410,106.6
38320, 함안군,070002, 66세,2018,877,404,473,85.4,870,400,470,85.1
38320, 함안군,070003, 67세,2018,687,353,334,105.7,681,351,330,106.4
38320, 함안군,070004, 68세,2018,821,401,420,95.5,810,396,414,95.7
38320, 함안군,070005, 69세,2018,749,373,376,99.2,743,371,372,99.7
38320, 함안군,075,70~74세,2018,3099,1427,1672,85.3,3091,1421,1670,85.1
38320, 함안군,075001, 70세,2018,787,405,382,106,784,403,381,105.8
38320, 함안군,075002, 71세,2018,692,332,360,92.2,690,330,360,91.7
38320, 함안군,075003, 72세,2018,506,228,278,82,504,227,277,81.9
38320, 함안군,075004, 73세,2018,520,214,306,69.9,519,213,306,69.6
38320, 함안군,075005, 74세,2018,594,248,346,71.7,594,248,346,71.7
38320, 함안군,080,75~79세,2018,3255,1199,2056,58.3,3251,1197,2054,58.3
38320, 함안군,080001, 75세,2018,609,251,358,70.1,606,249,357,69.7
38320, 함안군,080002, 76세,2018,722,278,444,62.6,722,278,444,62.6
38320, 함안군,080003, 77세,2018,692,252,440,57.3,692,252,440,57.3
38320, 함안군,080004, 78세,2018,634,223,411,54.3,633,223,410,54.4
38320, 함안군,080005, 79세,2018,598,195,403,48.4,598,195,403,48.4
38320, 함안군,085,80~84세,2018,2363,736,1627,45.2,2361,735,1626,45.2
38320, 함안군,085001, 80세,2018,547,172,375,45.9,546,172,374,46
38320, 함안군,085002, 81세,2018,549,182,367,49.6,548,181,367,49.3
38320, 함안군,085003, 82세,2018,443,141,302,46.7,443,141,302,46.7
38320, 함안군,085004, 83세,2018,426,128,298,43,426,128,298,43
38320, 함안군,085005, 84세,2018,398,113,285,39.6,398,113,285,39.6
38320, 함안군,090,85~89세,2018,1116,267,849,31.4,1116,267,849,31.4
38320, 함안군,090001, 85세,2018,305,80,225,35.6,305,80,225,35.6
38320, 함안군,090002, 86세,2018,275,72,203,35.5,275,72,203,35.5
38320, 함안군,090003, 87세,2018,208,47,161,29.2,208,47,161,29.2
38320, 함안군,090004, 88세,2018,169,41,128,32,169,41,128,32
38320, 함안군,090005, 89세,2018,159,27,132,20.5,159,27,132,20.5
38320, 함안군,095,90~94세,2018,329,61,268,22.8,329,61,268,22.8
38320, 함안군,095001, 90세,2018,121,21,100,21,121,21,100,21
38320, 함안군,095002, 91세,2018,67,12,55,21.8,67,12,55,21.8
38320, 함안군,095003, 92세,2018,65,14,51,27.5,65,14,51,27.5
38320, 함안군,095004, 93세,2018,51,8,43,18.6,51,8,43,18.6
38320, 함안군,095005, 94세,2018,25,6,19,31.6,25,6,19,31.6
38320, 함안군,100,95~99세,2018,43,7,36,19.4,43,7,36,19.4
38320, 함안군,100001, 95세,2018,17,X,16,6.3,17,X,16,6.3
38320, 함안군,100002, 96세,2018,12,X,8,50,12,X,8,50
38320, 함안군,100003, 97세,2018,5,X,5,0,5,X,5,0
38320, 함안군,100004, 98세,2018,6,X,X,50,6,X,X,50
38320, 함안군,100005, 99세,2018,X,X,X,0,X,X,X,0
38320, 함안군,101,100세이상,2018,X,X,X,0,X,X,X,0
38320, 함안군,102,15세미만,2018,7994,4088,3906,104.7,7951,4071,3880,104.9
38320, 함안군,103,15~64세,2018,45332,25702,19630,130.9,40790,22006,18784,117.2
38320, 함안군,104,65세이상,2018,14194,5669,8525,66.5,14145,5643,8502,66.4
38320, 함안군,086,85세이상,2018,1491,335,1156,29,1491,335,1156,29
38320, 함안군,126,평균연령,2018,45.7,43.4,48.3,,46.5,44.5,48.6,
38320, 함안군,127,중위연령,2018,47.3,44.7,50.7,,49.1,47.3,51.3,
38330, 창녕군,000,합계,2018,62703,31746,30957,102.5,59142,29330,29812,98.4
38330, 창녕군,005,0~4세,2018,1767,912,855,106.7,1726,892,834,107
38330, 창녕군,005001, 0세,2018,326,158,168,94,320,155,165,93.9
38330, 창녕군,005002, 1세,2018,334,172,162,106.2,324,168,156,107.7
38330, 창녕군,005003, 2세,2018,366,197,169,116.6,357,191,166,115.1
38330, 창녕군,005004, 3세,2018,363,188,175,107.4,353,182,171,106.4
38330, 창녕군,005005, 4세,2018,378,197,181,108.8,372,196,176,111.4
38330, 창녕군,010,5~9세,2018,1957,1028,929,110.7,1921,1012,909,111.3
38330, 창녕군,010001, 5세,2018,407,217,190,114.2,396,210,186,112.9
38330, 창녕군,010002, 6세,2018,379,186,193,96.4,370,183,187,97.9
38330, 창녕군,010003, 7세,2018,419,222,197,112.7,414,218,196,111.2
38330, 창녕군,010004, 8세,2018,377,204,173,117.9,372,204,168,121.4
38330, 창녕군,010005, 9세,2018,375,199,176,113.1,369,197,172,114.5
38330, 창녕군,015,10~14세,2018,1803,999,804,124.3,1783,988,795,124.3
38330, 창녕군,015001, 10세,2018,372,199,173,115,365,195,170,114.7
38330, 창녕군,015002, 11세,2018,395,230,165,139.4,392,227,165,137.6
38330, 창녕군,015003, 12세,2018,350,174,176,98.9,346,174,172,101.2
38330, 창녕군,015004, 13세,2018,338,196,142,138,333,193,140,137.9
38330, 창녕군,015005, 14세,2018,348,200,148,135.1,347,199,148,134.5
38330, 창녕군,020,15~19세,2018,2674,1511,1163,129.9,2647,1492,1155,129.2
38330, 창녕군,020001, 15세,2018,423,222,201,110.4,420,221,199,111.1
38330, 창녕군,020002, 16세,2018,576,337,239,141,575,336,239,140.6
38330, 창녕군,020003, 17세,2018,676,371,305,121.6,672,369,303,121.8
38330, 창녕군,020004, 18세,2018,623,337,286,117.8,616,332,284,116.9
38330, 창녕군,020005, 19세,2018,376,244,132,184.8,364,234,130,180
38330, 창녕군,025,20~24세,2018,2788,1756,1032,170.2,2376,1463,913,160.2
38330, 창녕군,025001, 20세,2018,500,336,164,204.9,473,318,155,205.2
38330, 창녕군,025002, 21세,2018,524,335,189,177.2,471,301,170,177.1
38330, 창녕군,025003, 22세,2018,585,362,223,162.3,494,296,198,149.5
38330, 창녕군,025004, 23세,2018,586,367,219,167.6,475,291,184,158.2
38330, 창녕군,025005, 24세,2018,593,356,237,150.2,463,257,206,124.8
38330, 창녕군,030,25~29세,2018,3296,2010,1286,156.3,2451,1400,1051,133.2
38330, 창녕군,030001, 25세,2018,658,387,271,142.8,486,264,222,118.9
38330, 창녕군,030002, 26세,2018,665,409,256,159.8,490,278,212,131.1
38330, 창녕군,030003, 27세,2018,650,386,264,146.2,482,268,214,125.2
38330, 창녕군,030004, 28세,2018,647,405,242,167.4,475,275,200,137.5
38330, 창녕군,030005, 29세,2018,676,423,253,167.2,518,315,203,155.2
38330, 창녕군,035,30~34세,2018,3097,1871,1226,152.6,2340,1309,1031,127
38330, 창녕군,035001, 30세,2018,612,381,231,164.9,428,250,178,140.4
38330, 창녕군,035002, 31세,2018,627,397,230,172.6,461,270,191,141.4
38330, 창녕군,035003, 32세,2018,618,368,250,147.2,465,248,217,114.3
38330, 창녕군,035004, 33세,2018,580,343,237,144.7,444,246,198,124.2
38330, 창녕군,035005, 34세,2018,660,382,278,137.4,542,295,247,119.4
38330, 창녕군,040,35~39세,2018,3565,2012,1553,129.6,3084,1668,1416,117.8
38330, 창녕군,040001, 35세,2018,663,380,283,134.3,537,284,253,112.3
38330, 창녕군,040002, 36세,2018,738,392,346,113.3,647,328,319,102.8
38330, 창녕군,040003, 37세,2018,690,423,267,158.4,596,358,238,150.4
38330, 창녕군,040004, 38세,2018,756,421,335,125.7,658,352,306,115
38330, 창녕군,040005, 39세,2018,718,396,322,123,646,346,300,115.3
38330, 창녕군,045,40~44세,2018,3291,1871,1420,131.8,2970,1671,1299,128.6
38330, 창녕군,045001, 40세,2018,659,359,300,119.7,572,306,266,115
38330, 창녕군,045002, 41세,2018,598,356,242,147.1,542,319,223,143
38330, 창녕군,045003, 42세,2018,607,351,256,137.1,550,316,234,135
38330, 창녕군,045004, 43세,2018,670,373,297,125.6,615,342,273,125.3
38330, 창녕군,045005, 44세,2018,757,432,325,132.9,691,388,303,128.1
38330, 창녕군,050,45~49세,2018,4271,2377,1894,125.5,4046,2248,1798,125
38330, 창녕군,050001, 45세,2018,775,422,353,119.5,727,397,330,120.3
38330, 창녕군,050002, 46세,2018,773,411,362,113.5,731,389,342,113.7
38330, 창녕군,050003, 47세,2018,874,497,377,131.8,825,467,358,130.4
38330, 창녕군,050004, 48세,2018,895,532,363,146.6,853,505,348,145.1
38330, 창녕군,050005, 49세,2018,954,515,439,117.3,910,490,420,116.7
38330, 창녕군,055,50~54세,2018,4858,2582,2276,113.4,4702,2504,2198,113.9
38330, 창녕군,055001, 50세,2018,962,525,437,120.1,928,506,422,119.9
38330, 창녕군,055002, 51세,2018,924,493,431,114.4,882,467,415,112.5
38330, 창녕군,055003, 52세,2018,963,538,425,126.6,934,524,410,127.8
38330, 창녕군,055004, 53세,2018,985,534,451,118.4,959,522,437,119.5
38330, 창녕군,055005, 54세,2018,1024,492,532,92.5,999,485,514,94.4
38330, 창녕군,060,55~59세,2018,6195,3098,3097,100,6069,3023,3046,99.2
38330, 창녕군,060001, 55세,2018,1118,568,550,103.3,1080,544,536,101.5
38330, 창녕군,060002, 56세,2018,1207,626,581,107.7,1178,609,569,107
38330, 창녕군,060003, 57세,2018,1247,596,651,91.6,1231,584,647,90.3
38330, 창녕군,060004, 58세,2018,1354,657,697,94.3,1332,647,685,94.5
38330, 창녕군,060005, 59세,2018,1269,651,618,105.3,1248,639,609,104.9
38330, 창녕군,065,60~64세,2018,5868,2952,2916,101.2,5790,2907,2883,100.8
38330, 창녕군,065001, 60세,2018,1205,634,571,111,1177,621,556,111.7
38330, 창녕군,065002, 61세,2018,1273,637,636,100.2,1254,624,630,99
38330, 창녕군,065003, 62세,2018,1197,611,586,104.3,1188,605,583,103.8
38330, 창녕군,065004, 63세,2018,1199,571,628,90.9,1189,565,624,90.5
38330, 창녕군,065005, 64세,2018,994,499,495,100.8,982,492,490,100.4
38330, 창녕군,070,65~69세,2018,4564,2189,2375,92.2,4539,2181,2358,92.5
38330, 창녕군,070001, 65세,2018,913,431,482,89.4,899,426,473,90.1
38330, 창녕군,070002, 66세,2018,1058,507,551,92,1055,507,548,92.5
38330, 창녕군,070003, 67세,2018,821,401,420,95.5,820,401,419,95.7
38330, 창녕군,070004, 68세,2018,891,429,462,92.9,885,427,458,93.2
38330, 창녕군,070005, 69세,2018,881,421,460,91.5,880,420,460,91.3
38330, 창녕군,075,70~74세,2018,3763,1713,2050,83.6,3757,1710,2047,83.5
38330, 창녕군,075001, 70세,2018,872,430,442,97.3,871,429,442,97.1
38330, 창녕군,075002, 71세,2018,867,416,451,92.2,865,416,449,92.7
38330, 창녕군,075003, 72세,2018,637,292,345,84.6,636,291,345,84.3
38330, 창녕군,075004, 73세,2018,639,285,354,80.5,638,284,354,80.2
38330, 창녕군,075005, 74세,2018,748,290,458,63.3,747,290,457,63.5
38330, 창녕군,080,75~79세,2018,4078,1483,2595,57.1,4076,1482,2594,57.1
38330, 창녕군,080001, 75세,2018,772,297,475,62.5,772,297,475,62.5
38330, 창녕군,080002, 76세,2018,912,338,574,58.9,911,338,573,59
38330, 창녕군,080003, 77세,2018,864,329,535,61.5,864,329,535,61.5
38330, 창녕군,080004, 78세,2018,759,269,490,54.9,758,268,490,54.7
38330, 창녕군,080005, 79세,2018,771,250,521,48,771,250,521,48
38330, 창녕군,085,80~84세,2018,2981,945,2036,46.4,2978,943,2035,46.3
38330, 창녕군,085001, 80세,2018,762,245,517,47.4,762,245,517,47.4
38330, 창녕군,085002, 81세,2018,652,232,420,55.2,651,231,420,55
38330, 창녕군,085003, 82세,2018,540,171,369,46.3,540,171,369,46.3
38330, 창녕군,085004, 83세,2018,545,176,369,47.7,545,176,369,47.7
38330, 창녕군,085005, 84세,2018,482,121,361,33.5,480,120,360,33.3
38330, 창녕군,090,85~89세,2018,1444,369,1075,34.3,1444,369,1075,34.3
38330, 창녕군,090001, 85세,2018,415,112,303,37,415,112,303,37
38330, 창녕군,090002, 86세,2018,380,112,268,41.8,380,112,268,41.8
38330, 창녕군,090003, 87세,2018,244,59,185,31.9,244,59,185,31.9
38330, 창녕군,090004, 88세,2018,218,46,172,26.7,218,46,172,26.7
38330, 창녕군,090005, 89세,2018,187,40,147,27.2,187,40,147,27.2
38330, 창녕군,095,90~94세,2018,377,61,316,19.3,377,61,316,19.3
38330, 창녕군,095001, 90세,2018,139,22,117,18.8,139,22,117,18.8
38330, 창녕군,095002, 91세,2018,96,15,81,18.5,96,15,81,18.5
38330, 창녕군,095003, 92세,2018,68,12,56,21.4,68,12,56,21.4
38330, 창녕군,095004, 93세,2018,44,8,36,22.2,44,8,36,22.2
38330, 창녕군,095005, 94세,2018,30,X,26,15.4,30,X,26,15.4
38330, 창녕군,100,95~99세,2018,58,5,53,9.4,58,5,53,9.4
38330, 창녕군,100001, 95세,2018,25,X,25,0,25,X,25,0
38330, 창녕군,100002, 96세,2018,17,X,14,21.4,17,X,14,21.4
38330, 창녕군,100003, 97세,2018,5,X,X,25,5,X,X,25
38330, 창녕군,100004, 98세,2018,9,X,8,12.5,9,X,8,12.5
38330, 창녕군,100005, 99세,2018,X,X,X,0,X,X,X,0
38330, 창녕군,101,100세이상,2018,8,X,6,33.3,8,X,6,33.3
38330, 창녕군,102,15세미만,2018,5527,2939,2588,113.6,5430,2892,2538,113.9
38330, 창녕군,103,15~64세,2018,39903,22040,17863,123.4,36475,19685,16790,117.2
38330, 창녕군,104,65세이상,2018,17273,6767,10506,64.4,17237,6753,10484,64.4
38330, 창녕군,086,85세이상,2018,1887,437,1450,30.1,1887,437,1450,30.1
38330, 창녕군,126,평균연령,2018,49.5,46.4,52.7,,50.4,47.4,53.4,
38330, 창녕군,127,중위연령,2018,53,49.1,56.8,,54.5,51,57.6,
38340, 고성군,000,합계,2018,51778,26326,25452,103.4,50009,25081,24928,100.6
38340, 고성군,005,0~4세,2018,1278,639,639,100,1276,637,639,99.7
38340, 고성군,005001, 0세,2018,198,102,96,106.3,198,102,96,106.3
38340, 고성군,005002, 1세,2018,193,107,86,124.4,193,107,86,124.4
38340, 고성군,005003, 2세,2018,246,133,113,117.7,246,133,113,117.7
38340, 고성군,005004, 3세,2018,311,142,169,84,310,141,169,83.4
38340, 고성군,005005, 4세,2018,330,155,175,88.6,329,154,175,88
38340, 고성군,010,5~9세,2018,1846,958,888,107.9,1844,957,887,107.9
38340, 고성군,010001, 5세,2018,339,165,174,94.8,338,165,173,95.4
38340, 고성군,010002, 6세,2018,370,186,184,101.1,370,186,184,101.1
38340, 고성군,010003, 7세,2018,391,204,187,109.1,390,203,187,108.6
38340, 고성군,010004, 8세,2018,395,219,176,124.4,395,219,176,124.4
38340, 고성군,010005, 9세,2018,351,184,167,110.2,351,184,167,110.2
38340, 고성군,015,10~14세,2018,1835,957,878,109,1831,954,877,108.8
38340, 고성군,015001, 10세,2018,390,193,197,98,390,193,197,98
38340, 고성군,015002, 11세,2018,376,222,154,144.2,375,221,154,143.5
38340, 고성군,015003, 12세,2018,353,185,168,110.1,351,183,168,108.9
38340, 고성군,015004, 13세,2018,370,180,190,94.7,369,180,189,95.2
38340, 고성군,015005, 14세,2018,346,177,169,104.7,346,177,169,104.7
38340, 고성군,020,15~19세,2018,2547,1527,1020,149.7,2538,1522,1016,149.8
38340, 고성군,020001, 15세,2018,419,211,208,101.4,419,211,208,101.4
38340, 고성군,020002, 16세,2018,509,279,230,121.3,508,279,229,121.8
38340, 고성군,020003, 17세,2018,654,409,245,166.9,654,409,245,166.9
38340, 고성군,020004, 18세,2018,677,442,235,188.1,674,439,235,186.8
38340, 고성군,020005, 19세,2018,288,186,102,182.4,283,184,99,185.9
38340, 고성군,025,20~24세,2018,2050,1295,755,171.5,1914,1204,710,169.6
38340, 고성군,025001, 20세,2018,374,250,124,201.6,369,247,122,202.5
38340, 고성군,025002, 21세,2018,410,281,129,217.8,401,279,122,228.7
38340, 고성군,025003, 22세,2018,450,277,173,160.1,419,253,166,152.4
38340, 고성군,025004, 23세,2018,404,256,148,173,366,231,135,171.1
38340, 고성군,025005, 24세,2018,412,231,181,127.6,359,194,165,117.6
38340, 고성군,030,25~29세,2018,2070,1241,829,149.7,1677,965,712,135.5
38340, 고성군,030001, 25세,2018,381,221,160,138.1,320,181,139,130.2
38340, 고성군,030002, 26세,2018,436,267,169,158,356,209,147,142.2
38340, 고성군,030003, 27세,2018,417,256,161,159,341,204,137,148.9
38340, 고성군,030004, 28세,2018,401,239,162,147.5,318,182,136,133.8
38340, 고성군,030005, 29세,2018,435,258,177,145.8,342,189,153,123.5
38340, 고성군,035,30~34세,2018,2254,1321,933,141.6,1809,977,832,117.4
38340, 고성군,035001, 30세,2018,394,222,172,129.1,303,156,147,106.1
38340, 고성군,035002, 31세,2018,437,263,174,151.1,345,193,152,127
38340, 고성군,035003, 32세,2018,444,272,172,158.1,351,201,150,134
38340, 고성군,035004, 33세,2018,482,285,197,144.7,392,209,183,114.2
38340, 고성군,035005, 34세,2018,497,279,218,128,418,218,200,109
38340, 고성군,040,35~39세,2018,3055,1798,1257,143,2782,1575,1207,130.5
38340, 고성군,040001, 35세,2018,554,332,222,149.5,489,279,210,132.9
38340, 고성군,040002, 36세,2018,610,370,240,154.2,543,315,228,138.2
38340, 고성군,040003, 37세,2018,620,341,279,122.2,575,304,271,112.2
38340, 고성군,040004, 38세,2018,661,382,279,136.9,609,339,270,125.6
38340, 고성군,040005, 39세,2018,610,373,237,157.4,566,338,228,148.2
38340, 고성군,045,40~44세,2018,2916,1600,1316,121.6,2737,1478,1259,117.4
38340, 고성군,045001, 40세,2018,547,311,236,131.8,501,278,223,124.7
38340, 고성군,045002, 41세,2018,534,286,248,115.3,499,266,233,114.2
38340, 고성군,045003, 42세,2018,567,313,254,123.2,540,296,244,121.3
38340, 고성군,045004, 43세,2018,626,343,283,121.2,590,316,274,115.3
38340, 고성군,045005, 44세,2018,642,347,295,117.6,607,322,285,113
38340, 고성군,050,45~49세,2018,3824,2154,1670,129,3692,2074,1618,128.2
38340, 고성군,050001, 45세,2018,685,385,300,128.3,660,366,294,124.5
38340, 고성군,050002, 46세,2018,675,393,282,139.4,649,377,272,138.6
38340, 고성군,050003, 47세,2018,846,448,398,112.6,818,429,389,110.3
38340, 고성군,050004, 48세,2018,851,484,367,131.9,819,466,353,132
38340, 고성군,050005, 49세,2018,767,444,323,137.5,746,436,310,140.6
38340, 고성군,055,50~54세,2018,3984,2161,1823,118.5,3892,2115,1777,119
38340, 고성군,055001, 50세,2018,805,433,372,116.4,781,421,360,116.9
38340, 고성군,055002, 51세,2018,808,470,338,139.1,791,457,334,136.8
38340, 고성군,055003, 52세,2018,790,423,367,115.3,777,417,360,115.8
38340, 고성군,055004, 53세,2018,809,404,405,99.8,787,394,393,100.3
38340, 고성군,055005, 54세,2018,772,431,341,126.4,756,426,330,129.1
38340, 고성군,060,55~59세,2018,4940,2496,2444,102.1,4894,2473,2421,102.1
38340, 고성군,060001, 55세,2018,835,438,397,110.3,822,431,391,110.2
38340, 고성군,060002, 56세,2018,981,497,484,102.7,972,490,482,101.7
38340, 고성군,060003, 57세,2018,1075,541,534,101.3,1067,536,531,100.9
38340, 고성군,060004, 58세,2018,1067,524,543,96.5,1057,521,536,97.2
38340, 고성군,060005, 59세,2018,982,496,486,102.1,976,495,481,102.9
38340, 고성군,065,60~64세,2018,4675,2357,2318,101.7,4643,2337,2306,101.3
38340, 고성군,065001, 60세,2018,929,472,457,103.3,924,467,457,102.2
38340, 고성군,065002, 61세,2018,956,504,452,111.5,945,497,448,110.9
38340, 고성군,065003, 62세,2018,963,498,465,107.1,955,495,460,107.6
38340, 고성군,065004, 63세,2018,941,440,501,87.8,939,439,500,87.8
38340, 고성군,065005, 64세,2018,886,443,443,100,880,439,441,99.5
38340, 고성군,070,65~69세,2018,3830,1874,1956,95.8,3818,1867,1951,95.7
38340, 고성군,070001, 65세,2018,753,368,385,95.6,750,365,385,94.8
38340, 고성군,070002, 66세,2018,860,417,443,94.1,860,417,443,94.1
38340, 고성군,070003, 67세,2018,749,375,374,100.3,748,375,373,100.5
38340, 고성군,070004, 68세,2018,698,320,378,84.7,692,317,375,84.5
38340, 고성군,070005, 69세,2018,770,394,376,104.8,768,393,375,104.8
38340, 고성군,075,70~74세,2018,3237,1469,1768,83.1,3229,1467,1762,83.3
38340, 고성군,075001, 70세,2018,773,377,396,95.2,771,376,395,95.2
38340, 고성군,075002, 71세,2018,748,347,401,86.5,747,347,400,86.8
38340, 고성군,075003, 72세,2018,539,240,299,80.3,538,239,299,79.9
38340, 고성군,075004, 73세,2018,612,250,362,69.1,610,250,360,69.4
38340, 고성군,075005, 74세,2018,565,255,310,82.3,563,255,308,82.8
38340, 고성군,080,75~79세,2018,3312,1284,2028,63.3,3311,1284,2027,63.3
38340, 고성군,080001, 75세,2018,651,274,377,72.7,651,274,377,72.7
38340, 고성군,080002, 76세,2018,714,270,444,60.8,714,270,444,60.8
38340, 고성군,080003, 77세,2018,663,255,408,62.5,662,255,407,62.7
38340, 고성군,080004, 78세,2018,638,253,385,65.7,638,253,385,65.7
38340, 고성군,080005, 79세,2018,646,232,414,56,646,232,414,56
38340, 고성군,085,80~84세,2018,2401,810,1591,50.9,2399,810,1589,51
38340, 고성군,085001, 80세,2018,505,179,326,54.9,505,179,326,54.9
38340, 고성군,085002, 81세,2018,512,173,339,51,512,173,339,51
38340, 고성군,085003, 82세,2018,516,184,332,55.4,515,184,331,55.6
38340, 고성군,085004, 83세,2018,460,151,309,48.9,460,151,309,48.9
38340, 고성군,085005, 84세,2018,408,123,285,43.2,407,123,284,43.3
38340, 고성군,090,85~89세,2018,1272,302,970,31.1,1272,302,970,31.1
38340, 고성군,090001, 85세,2018,355,101,254,39.8,355,101,254,39.8
38340, 고성군,090002, 86세,2018,299,57,242,23.6,299,57,242,23.6
38340, 고성군,090003, 87세,2018,231,47,184,25.5,231,47,184,25.5
38340, 고성군,090004, 88세,2018,206,48,158,30.4,206,48,158,30.4
38340, 고성군,090005, 89세,2018,181,49,132,37.1,181,49,132,37.1
38340, 고성군,095,90~94세,2018,375,72,303,23.8,374,72,302,23.8
38340, 고성군,095001, 90세,2018,123,25,98,25.5,123,25,98,25.5
38340, 고성군,095002, 91세,2018,95,18,77,23.4,94,18,76,23.7
38340, 고성군,095003, 92세,2018,82,12,70,17.1,82,12,70,17.1
38340, 고성군,095004, 93세,2018,39,6,33,18.2,39,6,33,18.2
38340, 고성군,095005, 94세,2018,36,11,25,44,36,11,25,44
38340, 고성군,100,95~99세,2018,71,11,60,18.3,71,11,60,18.3
38340, 고성군,100001, 95세,2018,31,6,25,24,31,6,25,24
38340, 고성군,100002, 96세,2018,17,X,13,30.8,17,X,13,30.8
38340, 고성군,100003, 97세,2018,15,X,14,7.1,15,X,14,7.1
38340, 고성군,100004, 98세,2018,6,X,6,0,6,X,6,0
38340, 고성군,100005, 99세,2018,X,X,X,0,X,X,X,0
38340, 고성군,101,100세이상,2018,6,X,6,0,6,X,6,0
38340, 고성군,102,15세미만,2018,4959,2554,2405,106.2,4951,2548,2403,106
38340, 고성군,103,15~64세,2018,32315,17950,14365,125,30578,16720,13858,120.7
38340, 고성군,104,65세이상,2018,14504,5822,8682,67.1,14480,5813,8667,67.1
38340, 고성군,086,85세이상,2018,1724,385,1339,28.8,1723,385,1338,28.8
38340, 고성군,126,평균연령,2018,49.6,46.7,52.6,,50.1,47.3,52.9,
38340, 고성군,127,중위연령,2018,52.8,49.3,56.7,,53.7,50.5,57.1,
38350, 남해군,000,합계,2018,42696,20796,21900,95,41615,19942,21673,92
38350, 남해군,005,0~4세,2018,718,382,336,113.7,718,382,336,113.7
38350, 남해군,005001, 0세,2018,92,48,44,109.1,92,48,44,109.1
38350, 남해군,005002, 1세,2018,129,73,56,130.4,129,73,56,130.4
38350, 남해군,005003, 2세,2018,147,66,81,81.5,147,66,81,81.5
38350, 남해군,005004, 3세,2018,163,90,73,123.3,163,90,73,123.3
38350, 남해군,005005, 4세,2018,187,105,82,128,187,105,82,128
38350, 남해군,010,5~9세,2018,1005,543,462,117.5,1003,541,462,117.1
38350, 남해군,010001, 5세,2018,149,71,78,91,149,71,78,91
38350, 남해군,010002, 6세,2018,197,100,97,103.1,196,99,97,102.1
38350, 남해군,010003, 7세,2018,204,133,71,187.3,204,133,71,187.3
38350, 남해군,010004, 8세,2018,231,118,113,104.4,230,117,113,103.5
38350, 남해군,010005, 9세,2018,224,121,103,117.5,224,121,103,117.5
38350, 남해군,015,10~14세,2018,1246,655,591,110.8,1243,654,589,111
38350, 남해군,015001, 10세,2018,241,136,105,129.5,241,136,105,129.5
38350, 남해군,015002, 11세,2018,252,127,125,101.6,250,126,124,101.6
38350, 남해군,015003, 12세,2018,225,116,109,106.4,225,116,109,106.4
38350, 남해군,015004, 13세,2018,243,126,117,107.7,243,126,117,107.7
38350, 남해군,015005, 14세,2018,285,150,135,111.1,284,150,134,111.9
38350, 남해군,020,15~19세,2018,2090,1138,952,119.5,2073,1132,941,120.3
38350, 남해군,020001, 15세,2018,343,176,167,105.4,342,175,167,104.8
38350, 남해군,020002, 16세,2018,499,287,212,135.4,498,287,211,136
38350, 남해군,020003, 17세,2018,416,203,213,95.3,414,202,212,95.3
38350, 남해군,020004, 18세,2018,501,277,224,123.7,499,275,224,122.8
38350, 남해군,020005, 19세,2018,331,195,136,143.4,320,193,127,152
38350, 남해군,025,20~24세,2018,1775,1197,578,207.1,1641,1081,560,193
38350, 남해군,025001, 20세,2018,339,226,113,200,331,218,113,192.9
38350, 남해군,025002, 21세,2018,372,275,97,283.5,344,251,93,269.9
38350, 남해군,025003, 22세,2018,376,258,118,218.6,354,238,116,205.2
38350, 남해군,025004, 23세,2018,357,238,119,200,322,211,111,190.1
38350, 남해군,025005, 24세,2018,331,200,131,152.7,290,163,127,128.3
38350, 남해군,030,25~29세,2018,1542,964,578,166.8,1287,735,552,133.2
38350, 남해군,030001, 25세,2018,328,216,112,192.9,265,158,107,147.7
38350, 남해군,030002, 26세,2018,312,192,120,160,269,154,115,133.9
38350, 남해군,030003, 27세,2018,294,174,120,145,246,129,117,110.3
38350, 남해군,030004, 28세,2018,333,213,120,177.5,279,162,117,138.5
38350, 남해군,030005, 29세,2018,275,169,106,159.4,228,132,96,137.5
38350, 남해군,035,30~34세,2018,1339,792,547,144.8,1098,595,503,118.3
38350, 남해군,035001, 30세,2018,263,153,110,139.1,212,110,102,107.8
38350, 남해군,035002, 31세,2018,261,151,110,137.3,214,111,103,107.8
38350, 남해군,035003, 32세,2018,273,165,108,152.8,226,127,99,128.3
38350, 남해군,035004, 33세,2018,282,179,103,173.8,226,132,94,140.4
38350, 남해군,035005, 34세,2018,260,144,116,124.1,220,115,105,109.5
38350, 남해군,040,35~39세,2018,1674,909,765,118.8,1510,765,745,102.7
38350, 남해군,040001, 35세,2018,307,164,143,114.7,273,133,140,95
38350, 남해군,040002, 36세,2018,315,172,143,120.3,280,142,138,102.9
38350, 남해군,040003, 37세,2018,360,196,164,119.5,324,165,159,103.8
38350, 남해군,040004, 38세,2018,366,198,168,117.9,333,168,165,101.8
38350, 남해군,040005, 39세,2018,326,179,147,121.8,300,157,143,109.8
38350, 남해군,045,40~44세,2018,1948,1060,888,119.4,1858,988,870,113.6
38350, 남해군,045001, 40세,2018,311,172,139,123.7,293,157,136,115.4
38350, 남해군,045002, 41세,2018,343,188,155,121.3,331,178,153,116.3
38350, 남해군,045003, 42세,2018,397,217,180,120.6,371,197,174,113.2
38350, 남해군,045004, 43세,2018,439,230,209,110,422,215,207,103.9
38350, 남해군,045005, 44세,2018,458,253,205,123.4,441,241,200,120.5
38350, 남해군,050,45~49세,2018,2912,1612,1300,124,2860,1575,1285,122.6
38350, 남해군,050001, 45세,2018,548,288,260,110.8,537,281,256,109.8
38350, 남해군,050002, 46세,2018,538,303,235,128.9,527,294,233,126.2
38350, 남해군,050003, 47세,2018,614,365,249,146.6,604,359,245,146.5
38350, 남해군,050004, 48세,2018,568,316,252,125.4,563,311,252,123.4
38350, 남해군,050005, 49세,2018,644,340,304,111.8,629,330,299,110.4
38350, 남해군,055,50~54세,2018,3082,1646,1436,114.6,3053,1636,1417,115.5
38350, 남해군,055001, 50세,2018,596,328,268,122.4,589,324,265,122.3
38350, 남해군,055002, 51세,2018,573,307,266,115.4,562,306,256,119.5
38350, 남해군,055003, 52세,2018,630,357,273,130.8,628,356,272,130.9
38350, 남해군,055004, 53세,2018,641,330,311,106.1,637,329,308,106.8
38350, 남해군,055005, 54세,2018,642,324,318,101.9,637,321,316,101.6
38350, 남해군,060,55~59세,2018,4254,2101,2153,97.6,4218,2090,2128,98.2
38350, 남해군,060001, 55세,2018,690,360,330,109.1,682,358,324,110.5
38350, 남해군,060002, 56세,2018,896,458,438,104.6,892,457,435,105.1
38350, 남해군,060003, 57세,2018,956,448,508,88.2,952,448,504,88.9
38350, 남해군,060004, 58세,2018,917,464,453,102.4,909,460,449,102.4
38350, 남해군,060005, 59세,2018,795,371,424,87.5,783,367,416,88.2
38350, 남해군,065,60~64세,2018,3975,1963,2012,97.6,3942,1948,1994,97.7
38350, 남해군,065001, 60세,2018,798,410,388,105.7,792,409,383,106.8
38350, 남해군,065002, 61세,2018,868,429,439,97.7,867,428,439,97.5
38350, 남해군,065003, 62세,2018,774,391,383,102.1,764,386,378,102.1
38350, 남해군,065004, 63세,2018,864,398,466,85.4,857,395,462,85.5
38350, 남해군,065005, 64세,2018,671,335,336,99.7,662,330,332,99.4
38350, 남해군,070,65~69세,2018,3589,1700,1889,90,3577,1693,1884,89.9
38350, 남해군,070001, 65세,2018,662,319,343,93,659,317,342,92.7
38350, 남해군,070002, 66세,2018,788,361,427,84.5,784,359,425,84.5
38350, 남해군,070003, 67세,2018,725,338,387,87.3,725,338,387,87.3
38350, 남해군,070004, 68세,2018,618,306,312,98.1,615,304,311,97.7
38350, 남해군,070005, 69세,2018,796,376,420,89.5,794,375,419,89.5
38350, 남해군,075,70~74세,2018,3136,1435,1701,84.4,3130,1431,1699,84.2
38350, 남해군,075001, 70세,2018,684,312,372,83.9,682,310,372,83.3
38350, 남해군,075002, 71세,2018,718,339,379,89.4,717,339,378,89.7
38350, 남해군,075003, 72세,2018,591,276,315,87.6,591,276,315,87.6
38350, 남해군,075004, 73세,2018,591,271,320,84.7,590,271,319,85
38350, 남해군,075005, 74세,2018,552,237,315,75.2,550,235,315,74.6
38350, 남해군,080,75~79세,2018,3569,1348,2221,60.7,3565,1347,2218,60.7
38350, 남해군,080001, 75세,2018,616,237,379,62.5,616,237,379,62.5
38350, 남해군,080002, 76세,2018,819,309,510,60.6,819,309,510,60.6
38350, 남해군,080003, 77세,2018,726,277,449,61.7,724,277,447,62
38350, 남해군,080004, 78세,2018,716,266,450,59.1,714,265,449,59
38350, 남해군,080005, 79세,2018,692,259,433,59.8,692,259,433,59.8
38350, 남해군,085,80~84세,2018,2680,845,1835,46,2678,844,1834,46
38350, 남해군,085001, 80세,2018,567,210,357,58.8,565,209,356,58.7
38350, 남해군,085002, 81세,2018,599,197,402,49,599,197,402,49
38350, 남해군,085003, 82세,2018,512,150,362,41.4,512,150,362,41.4
38350, 남해군,085004, 83세,2018,525,145,380,38.2,525,145,380,38.2
38350, 남해군,085005, 84세,2018,477,143,334,42.8,477,143,334,42.8
38350, 남해군,090,85~89세,2018,1546,395,1151,34.3,1545,394,1151,34.2
38350, 남해군,090001, 85세,2018,381,115,266,43.2,381,115,266,43.2
38350, 남해군,090002, 86세,2018,384,100,284,35.2,384,100,284,35.2
38350, 남해군,090003, 87세,2018,306,70,236,29.7,306,70,236,29.7
38350, 남해군,090004, 88세,2018,270,72,198,36.4,269,71,198,35.9
38350, 남해군,090005, 89세,2018,205,38,167,22.8,205,38,167,22.8
38350, 남해군,095,90~94세,2018,513,100,413,24.2,513,100,413,24.2
38350, 남해군,095001, 90세,2018,144,31,113,27.4,144,31,113,27.4
38350, 남해군,095002, 91세,2018,130,31,99,31.3,130,31,99,31.3
38350, 남해군,095003, 92세,2018,104,20,84,23.8,104,20,84,23.8
38350, 남해군,095004, 93세,2018,87,14,73,19.2,87,14,73,19.2
38350, 남해군,095005, 94세,2018,48,X,44,9.1,48,X,44,9.1
38350, 남해군,100,95~99세,2018,94,11,83,13.3,94,11,83,13.3
38350, 남해군,100001, 95세,2018,38,9,29,31,38,9,29,31
38350, 남해군,100002, 96세,2018,31,X,30,3.3,31,X,30,3.3
38350, 남해군,100003, 97세,2018,15,X,14,7.1,15,X,14,7.1
38350, 남해군,100004, 98세,2018,7,X,7,0,7,X,7,0
38350, 남해군,100005, 99세,2018,X,X,X,0,X,X,X,0
38350, 남해군,101,100세이상,2018,9,X,9,0,9,X,9,0
38350, 남해군,102,15세미만,2018,2969,1580,1389,113.8,2964,1577,1387,113.7
38350, 남해군,103,15~64세,2018,24591,13382,11209,119.4,23540,12545,10995,114.1
38350, 남해군,104,65세이상,2018,15136,5834,9302,62.7,15111,5820,9291,62.6
38350, 남해군,086,85세이상,2018,2162,506,1656,30.6,2161,505,1656,30.5
38350, 남해군,126,평균연령,2018,53.5,49.8,57.1,,54,50.5,57.3,
38350, 남해군,127,중위연령,2018,57.5,53.5,60.9,,57.9,54.6,61.1,
38360, 하동군,000,합계,2018,43001,21043,21958,95.8,42282,20738,21544,96.3
38360, 하동군,005,0~4세,2018,975,485,490,99,975,485,490,99
38360, 하동군,005001, 0세,2018,171,84,87,96.6,171,84,87,96.6
38360, 하동군,005002, 1세,2018,181,95,86,110.5,181,95,86,110.5
38360, 하동군,005003, 2세,2018,190,74,116,63.8,190,74,116,63.8
38360, 하동군,005004, 3세,2018,217,115,102,112.7,217,115,102,112.7
38360, 하동군,005005, 4세,2018,216,117,99,118.2,216,117,99,118.2
38360, 하동군,010,5~9세,2018,1178,616,562,109.6,1177,616,561,109.8
38360, 하동군,010001, 5세,2018,188,107,81,132.1,188,107,81,132.1
38360, 하동군,010002, 6세,2018,230,119,111,107.2,230,119,111,107.2
38360, 하동군,010003, 7세,2018,250,139,111,125.2,250,139,111,125.2
38360, 하동군,010004, 8세,2018,267,141,126,111.9,266,141,125,112.8
38360, 하동군,010005, 9세,2018,243,110,133,82.7,243,110,133,82.7
38360, 하동군,015,10~14세,2018,1446,808,638,126.6,1445,808,637,126.8
38360, 하동군,015001, 10세,2018,317,176,141,124.8,316,176,140,125.7
38360, 하동군,015002, 11세,2018,267,159,108,147.2,267,159,108,147.2
38360, 하동군,015003, 12세,2018,293,165,128,128.9,293,165,128,128.9
38360, 하동군,015004, 13세,2018,277,145,132,109.8,277,145,132,109.8
38360, 하동군,015005, 14세,2018,292,163,129,126.4,292,163,129,126.4
38360, 하동군,020,15~19세,2018,1404,805,599,134.4,1399,803,596,134.7
38360, 하동군,020001, 15세,2018,274,149,125,119.2,274,149,125,119.2
38360, 하동군,020002, 16세,2018,286,159,127,125.2,286,159,127,125.2
38360, 하동군,020003, 17세,2018,316,162,154,105.2,316,162,154,105.2
38360, 하동군,020004, 18세,2018,308,178,130,136.9,305,176,129,136.4
38360, 하동군,020005, 19세,2018,220,157,63,249.2,218,157,61,257.4
38360, 하동군,025,20~24세,2018,1608,1014,594,170.7,1518,985,533,184.8
38360, 하동군,025001, 20세,2018,305,232,73,317.8,299,230,69,333.3
38360, 하동군,025002, 21세,2018,355,248,107,231.8,339,242,97,249.5
38360, 하동군,025003, 22세,2018,337,205,132,155.3,321,199,122,163.1
38360, 하동군,025004, 23세,2018,295,152,143,106.3,266,142,124,114.5
38360, 하동군,025005, 24세,2018,316,177,139,127.3,293,172,121,142.1
38360, 하동군,030,25~29세,2018,1672,916,756,121.2,1484,828,656,126.2
38360, 하동군,030001, 25세,2018,342,184,158,116.5,306,173,133,130.1
38360, 하동군,030002, 26세,2018,341,175,166,105.4,305,159,146,108.9
38360, 하동군,030003, 27세,2018,357,213,144,147.9,316,190,126,150.8
38360, 하동군,030004, 28세,2018,303,172,131,131.3,262,153,109,140.4
38360, 하동군,030005, 29세,2018,329,172,157,109.6,295,153,142,107.7
38360, 하동군,035,30~34세,2018,1466,799,667,119.8,1340,741,599,123.7
38360, 하동군,035001, 30세,2018,328,190,138,137.7,293,174,119,146.2
38360, 하동군,035002, 31세,2018,265,148,117,126.5,241,137,104,131.7
38360, 하동군,035003, 32세,2018,277,154,123,125.2,255,143,112,127.7
38360, 하동군,035004, 33세,2018,244,124,120,103.3,219,114,105,108.6
38360, 하동군,035005, 34세,2018,352,183,169,108.3,332,173,159,108.8
38360, 하동군,040,35~39세,2018,1730,922,808,114.1,1653,887,766,115.8
38360, 하동군,040001, 35세,2018,296,143,153,93.5,276,136,140,97.1
38360, 하동군,040002, 36세,2018,364,186,178,104.5,349,180,169,106.5
38360, 하동군,040003, 37세,2018,340,184,156,117.9,325,175,150,116.7
38360, 하동군,040004, 38세,2018,347,192,155,123.9,334,187,147,127.2
38360, 하동군,040005, 39세,2018,383,217,166,130.7,369,209,160,130.6
38360, 하동군,045,40~44세,2018,2132,1144,988,115.8,2079,1120,959,116.8
38360, 하동군,045001, 40세,2018,389,198,191,103.7,381,192,189,101.6
38360, 하동군,045002, 41세,2018,355,187,168,111.3,346,184,162,113.6
38360, 하동군,045003, 42세,2018,411,240,171,140.4,401,234,167,140.1
38360, 하동군,045004, 43세,2018,469,242,227,106.6,456,240,216,111.1
38360, 하동군,045005, 44세,2018,508,277,231,119.9,495,270,225,120
38360, 하동군,050,45~49세,2018,3185,1776,1409,126,3144,1758,1386,126.8
38360, 하동군,050001, 45세,2018,603,338,265,127.5,592,334,258,129.5
38360, 하동군,050002, 46세,2018,548,304,244,124.6,540,297,243,122.2
38360, 하동군,050003, 47세,2018,627,334,293,114,616,333,283,117.7
38360, 하동군,050004, 48세,2018,702,389,313,124.3,697,385,312,123.4
38360, 하동군,050005, 49세,2018,705,411,294,139.8,699,409,290,141
38360, 하동군,055,50~54세,2018,3501,1820,1681,108.3,3455,1804,1651,109.3
38360, 하동군,055001, 50세,2018,699,374,325,115.1,687,369,318,116
38360, 하동군,055002, 51세,2018,738,400,338,118.3,726,396,330,120
38360, 하동군,055003, 52세,2018,695,372,323,115.2,687,370,317,116.7
38360, 하동군,055004, 53세,2018,701,343,358,95.8,696,342,354,96.6
38360, 하동군,055005, 54세,2018,668,331,337,98.2,659,327,332,98.5
38360, 하동군,060,55~59세,2018,4520,2331,2189,106.5,4480,2316,2164,107
38360, 하동군,060001, 55세,2018,784,420,364,115.4,774,416,358,116.2
38360, 하동군,060002, 56세,2018,909,482,427,112.9,899,477,422,113
38360, 하동군,060003, 57세,2018,993,496,497,99.8,990,495,495,100
38360, 하동군,060004, 58세,2018,996,514,482,106.6,988,512,476,107.6
38360, 하동군,060005, 59세,2018,838,419,419,100,829,416,413,100.7
38360, 하동군,065,60~64세,2018,4248,2162,2086,103.6,4214,2148,2066,104
38360, 하동군,065001, 60세,2018,890,450,440,102.3,879,446,433,103
38360, 하동군,065002, 61세,2018,867,442,425,104,863,442,421,105
38360, 하동군,065003, 62세,2018,843,454,389,116.7,834,448,386,116.1
38360, 하동군,065004, 63세,2018,875,425,450,94.4,870,422,448,94.2
38360, 하동군,065005, 64세,2018,773,391,382,102.4,768,390,378,103.2
38360, 하동군,070,65~69세,2018,3378,1610,1768,91.1,3364,1605,1759,91.2
38360, 하동군,070001, 65세,2018,673,307,366,83.9,668,306,362,84.5
38360, 하동군,070002, 66세,2018,721,351,370,94.9,716,348,368,94.6
38360, 하동군,070003, 67세,2018,657,318,339,93.8,654,317,337,94.1
38360, 하동군,070004, 68세,2018,656,320,336,95.2,656,320,336,95.2
38360, 하동군,070005, 69세,2018,671,314,357,88,670,314,356,88.2
38360, 하동군,075,70~74세,2018,3009,1344,1665,80.7,3006,1343,1663,80.8
38360, 하동군,075001, 70세,2018,684,323,361,89.5,683,323,360,89.7
38360, 하동군,075002, 71세,2018,675,306,369,82.9,674,305,369,82.7
38360, 하동군,075003, 72세,2018,507,229,278,82.4,506,229,277,82.7
38360, 하동군,075004, 73세,2018,542,222,320,69.4,542,222,320,69.4
38360, 하동군,075005, 74세,2018,601,264,337,78.3,601,264,337,78.3
38360, 하동군,080,75~79세,2018,3287,1235,2052,60.2,3287,1235,2052,60.2
38360, 하동군,080001, 75세,2018,586,247,339,72.9,586,247,339,72.9
38360, 하동군,080002, 76세,2018,757,279,478,58.4,757,279,478,58.4
38360, 하동군,080003, 77세,2018,619,237,382,62,619,237,382,62
38360, 하동군,080004, 78세,2018,642,225,417,54,642,225,417,54
38360, 하동군,080005, 79세,2018,683,247,436,56.7,683,247,436,56.7
38360, 하동군,085,80~84세,2018,2468,801,1667,48.1,2468,801,1667,48.1
38360, 하동군,085001, 80세,2018,516,176,340,51.8,516,176,340,51.8
38360, 하동군,085002, 81세,2018,561,203,358,56.7,561,203,358,56.7
38360, 하동군,085003, 82세,2018,521,155,366,42.3,521,155,366,42.3
38360, 하동군,085004, 83세,2018,456,139,317,43.8,456,139,317,43.8
38360, 하동군,085005, 84세,2018,414,128,286,44.8,414,128,286,44.8
38360, 하동군,090,85~89세,2018,1265,346,919,37.6,1265,346,919,37.6
38360, 하동군,090001, 85세,2018,296,81,215,37.7,296,81,215,37.7
38360, 하동군,090002, 86세,2018,319,87,232,37.5,319,87,232,37.5
38360, 하동군,090003, 87세,2018,257,78,179,43.6,257,78,179,43.6
38360, 하동군,090004, 88세,2018,220,54,166,32.5,220,54,166,32.5
38360, 하동군,090005, 89세,2018,173,46,127,36.2,173,46,127,36.2
38360, 하동군,095,90~94세,2018,446,96,350,27.4,446,96,350,27.4
38360, 하동군,095001, 90세,2018,131,26,105,24.8,131,26,105,24.8
38360, 하동군,095002, 91세,2018,131,34,97,35.1,131,34,97,35.1
38360, 하동군,095003, 92세,2018,84,19,65,29.2,84,19,65,29.2
38360, 하동군,095004, 93세,2018,59,6,53,11.3,59,6,53,11.3
38360, 하동군,095005, 94세,2018,41,11,30,36.7,41,11,30,36.7
38360, 하동군,100,95~99세,2018,70,12,58,20.7,70,12,58,20.7
38360, 하동군,100001, 95세,2018,32,X,30,6.7,32,X,30,6.7
38360, 하동군,100002, 96세,2018,13,5,8,62.5,13,5,8,62.5
38360, 하동군,100003, 97세,2018,10,X,7,42.9,10,X,7,42.9
38360, 하동군,100004, 98세,2018,9,X,7,28.6,9,X,7,28.6
38360, 하동군,100005, 99세,2018,6,X,6,0,6,X,6,0
38360, 하동군,101,100세이상,2018,13,X,12,8.3,13,X,12,8.3
38360, 하동군,102,15세미만,2018,3599,1909,1690,113,3597,1909,1688,113.1
38360, 하동군,103,15~64세,2018,25466,13689,11777,116.2,24766,13390,11376,117.7
38360, 하동군,104,65세이상,2018,13936,5445,8491,64.1,13919,5439,8480,64.1
38360, 하동군,086,85세이상,2018,1794,455,1339,34,1794,455,1339,34
38360, 하동군,126,평균연령,2018,52.6,49.6,55.5,,52.9,49.8,55.9,
38360, 하동군,127,중위연령,2018,56.5,53.3,59,,56.8,53.6,59.5,
38370, 산청군,000,합계,2018,34122,16597,17525,94.7,33227,16151,17076,94.6
38370, 산청군,005,0~4세,2018,805,415,390,106.4,805,415,390,106.4
38370, 산청군,005001, 0세,2018,141,74,67,110.4,141,74,67,110.4
38370, 산청군,005002, 1세,2018,179,92,87,105.7,179,92,87,105.7
38370, 산청군,005003, 2세,2018,156,72,84,85.7,156,72,84,85.7
38370, 산청군,005004, 3세,2018,184,104,80,130,184,104,80,130
38370, 산청군,005005, 4세,2018,145,73,72,101.4,145,73,72,101.4
38370, 산청군,010,5~9세,2018,854,470,384,122.4,853,469,384,122.1
38370, 산청군,010001, 5세,2018,165,89,76,117.1,165,89,76,117.1
38370, 산청군,010002, 6세,2018,160,91,69,131.9,159,90,69,130.4
38370, 산청군,010003, 7세,2018,170,101,69,146.4,170,101,69,146.4
38370, 산청군,010004, 8세,2018,185,101,84,120.2,185,101,84,120.2
38370, 산청군,010005, 9세,2018,174,88,86,102.3,174,88,86,102.3
38370, 산청군,015,10~14세,2018,1003,530,473,112.1,1001,529,472,112.1
38370, 산청군,015001, 10세,2018,183,108,75,144,183,108,75,144
38370, 산청군,015002, 11세,2018,227,116,111,104.5,226,115,111,103.6
38370, 산청군,015003, 12세,2018,192,99,93,106.5,191,99,92,107.6
38370, 산청군,015004, 13세,2018,205,102,103,99,205,102,103,99
38370, 산청군,015005, 14세,2018,196,105,91,115.4,196,105,91,115.4
38370, 산청군,020,15~19세,2018,1296,652,644,101.2,1285,648,637,101.7
38370, 산청군,020001, 15세,2018,249,136,113,120.4,248,136,112,121.4
38370, 산청군,020002, 16세,2018,273,132,141,93.6,273,132,141,93.6
38370, 산청군,020003, 17세,2018,302,154,148,104.1,301,153,148,103.4
38370, 산청군,020004, 18세,2018,291,127,164,77.4,289,127,162,78.4
38370, 산청군,020005, 19세,2018,181,103,78,132.1,174,100,74,135.1
38370, 산청군,025,20~24세,2018,1207,711,496,143.3,1082,672,410,163.9
38370, 산청군,025001, 20세,2018,219,148,71,208.5,208,147,61,241
38370, 산청군,025002, 21세,2018,240,143,97,147.4,228,141,87,162.1
38370, 산청군,025003, 22세,2018,226,142,84,169,209,136,73,186.3
38370, 산청군,025004, 23세,2018,253,141,112,125.9,215,129,86,150
38370, 산청군,025005, 24세,2018,269,137,132,103.8,222,119,103,115.5
38370, 산청군,030,25~29세,2018,1275,683,592,115.4,1033,567,466,121.7
38370, 산청군,030001, 25세,2018,258,132,126,104.8,212,115,97,118.6
38370, 산청군,030002, 26세,2018,285,158,127,124.4,230,132,98,134.7
38370, 산청군,030003, 27세,2018,248,126,122,103.3,196,104,92,113
38370, 산청군,030004, 28세,2018,244,143,101,141.6,190,111,79,140.5
38370, 산청군,030005, 29세,2018,240,124,116,106.9,205,105,100,105
38370, 산청군,035,30~34세,2018,1236,675,561,120.3,1053,578,475,121.7
38370, 산청군,035001, 30세,2018,275,164,111,147.7,228,138,90,153.3
38370, 산청군,035002, 31세,2018,239,123,116,106,201,101,100,101
38370, 산청군,035003, 32세,2018,231,123,108,113.9,201,108,93,116.1
38370, 산청군,035004, 33세,2018,241,128,113,113.3,200,107,93,115.1
38370, 산청군,035005, 34세,2018,250,137,113,121.2,223,124,99,125.3
38370, 산청군,040,35~39세,2018,1436,802,634,126.5,1331,733,598,122.6
38370, 산청군,040001, 35세,2018,250,124,126,98.4,233,115,118,97.5
38370, 산청군,040002, 36세,2018,282,157,125,125.6,258,142,116,122.4
38370, 산청군,040003, 37세,2018,308,183,125,146.4,278,163,115,141.7
38370, 산청군,040004, 38세,2018,313,182,131,138.9,293,166,127,130.7
38370, 산청군,040005, 39세,2018,283,156,127,122.8,269,147,122,120.5
38370, 산청군,045,40~44세,2018,1493,823,670,122.8,1439,794,645,123.1
38370, 산청군,045001, 40세,2018,279,159,120,132.5,266,149,117,127.4
38370, 산청군,045002, 41세,2018,282,157,125,125.6,269,151,118,128
38370, 산청군,045003, 42세,2018,259,139,120,115.8,249,133,116,114.7
38370, 산청군,045004, 43세,2018,297,160,137,116.8,289,154,135,114.1
38370, 산청군,045005, 44세,2018,376,208,168,123.8,366,207,159,130.2
38370, 산청군,050,45~49세,2018,2296,1280,1016,126,2250,1254,996,125.9
38370, 산청군,050001, 45세,2018,405,228,177,128.8,395,222,173,128.3
38370, 산청군,050002, 46세,2018,385,231,154,150,377,226,151,149.7
38370, 산청군,050003, 47세,2018,464,261,203,128.6,455,257,198,129.8
38370, 산청군,050004, 48세,2018,483,250,233,107.3,473,244,229,106.6
38370, 산청군,050005, 49세,2018,559,310,249,124.5,550,305,245,124.5
38370, 산청군,055,50~54세,2018,2728,1484,1244,119.3,2678,1458,1220,119.5
38370, 산청군,055001, 50세,2018,552,287,265,108.3,540,279,261,106.9
38370, 산청군,055002, 51세,2018,546,292,254,115,541,289,252,114.7
38370, 산청군,055003, 52세,2018,564,328,236,139,549,320,229,139.7
38370, 산청군,055004, 53세,2018,572,303,269,112.6,562,301,261,115.3
38370, 산청군,055005, 54세,2018,494,274,220,124.5,486,269,217,124
38370, 산청군,060,55~59세,2018,3485,1789,1696,105.5,3457,1773,1684,105.3
38370, 산청군,060001, 55세,2018,570,314,256,122.7,560,306,254,120.5
38370, 산청군,060002, 56세,2018,724,375,349,107.4,716,370,346,106.9
38370, 산청군,060003, 57세,2018,799,411,388,105.9,795,410,385,106.5
38370, 산청군,060004, 58세,2018,768,371,397,93.5,764,369,395,93.4
38370, 산청군,060005, 59세,2018,624,318,306,103.9,622,318,304,104.6
38370, 산청군,065,60~64세,2018,3458,1749,1709,102.3,3433,1739,1694,102.7
38370, 산청군,065001, 60세,2018,697,371,326,113.8,693,371,322,115.2
38370, 산청군,065002, 61세,2018,674,341,333,102.4,668,338,330,102.4
38370, 산청군,065003, 62세,2018,700,360,340,105.9,696,357,339,105.3
38370, 산청군,065004, 63세,2018,745,368,377,97.6,739,366,373,98.1
38370, 산청군,065005, 64세,2018,642,309,333,92.8,637,307,330,93
38370, 산청군,070,65~69세,2018,2707,1371,1336,102.6,2692,1362,1330,102.4
38370, 산청군,070001, 65세,2018,571,292,279,104.7,571,292,279,104.7
38370, 산청군,070002, 66세,2018,603,303,300,101,599,301,298,101
38370, 산청군,070003, 67세,2018,490,245,245,100,487,243,244,99.6
38370, 산청군,070004, 68세,2018,513,254,259,98.1,511,252,259,97.3
38370, 산청군,070005, 69세,2018,530,277,253,109.5,524,274,250,109.6
38370, 산청군,075,70~74세,2018,2468,1119,1349,83,2463,1117,1346,83
38370, 산청군,075001, 70세,2018,557,294,263,111.8,556,293,263,111.4
38370, 산청군,075002, 71세,2018,546,256,290,88.3,545,256,289,88.6
38370, 산청군,075003, 72세,2018,428,186,242,76.9,426,185,241,76.8
38370, 산청군,075004, 73세,2018,423,172,251,68.5,422,172,250,68.8
38370, 산청군,075005, 74세,2018,514,211,303,69.6,514,211,303,69.6
38370, 산청군,080,75~79세,2018,2770,1018,1752,58.1,2768,1017,1751,58.1
38370, 산청군,080001, 75세,2018,499,181,318,56.9,499,181,318,56.9
38370, 산청군,080002, 76세,2018,634,247,387,63.8,633,247,386,64
38370, 산청군,080003, 77세,2018,567,217,350,62,567,217,350,62
38370, 산청군,080004, 78세,2018,545,185,360,51.4,545,185,360,51.4
38370, 산청군,080005, 79세,2018,525,188,337,55.8,524,187,337,55.5
38370, 산청군,085,80~84세,2018,2160,670,1490,45,2160,670,1490,45
38370, 산청군,085001, 80세,2018,532,177,355,49.9,532,177,355,49.9
38370, 산청군,085002, 81세,2018,447,138,309,44.7,447,138,309,44.7
38370, 산청군,085003, 82세,2018,434,136,298,45.6,434,136,298,45.6
38370, 산청군,085004, 83세,2018,402,120,282,42.6,402,120,282,42.6
38370, 산청군,085005, 84세,2018,345,99,246,40.2,345,99,246,40.2
38370, 산청군,090,85~89세,2018,1039,279,760,36.7,1038,279,759,36.8
38370, 산청군,090001, 85세,2018,298,86,212,40.6,298,86,212,40.6
38370, 산청군,090002, 86세,2018,258,75,183,41,258,75,183,41
38370, 산청군,090003, 87세,2018,188,45,143,31.5,188,45,143,31.5
38370, 산청군,090004, 88세,2018,156,34,122,27.9,155,34,121,28.1
38370, 산청군,090005, 89세,2018,139,39,100,39,139,39,100,39
38370, 산청군,095,90~94세,2018,325,57,268,21.3,325,57,268,21.3
38370, 산청군,095001, 90세,2018,116,24,92,26.1,116,24,92,26.1
38370, 산청군,095002, 91세,2018,89,16,73,21.9,89,16,73,21.9
38370, 산청군,095003, 92세,2018,49,8,41,19.5,49,8,41,19.5
38370, 산청군,095004, 93세,2018,48,X,45,6.7,48,X,45,6.7
38370, 산청군,095005, 94세,2018,23,6,17,35.3,23,6,17,35.3
38370, 산청군,100,95~99세,2018,77,19,58,32.8,77,19,58,32.8
38370, 산청군,100001, 95세,2018,32,5,27,18.5,32,5,27,18.5
38370, 산청군,100002, 96세,2018,26,8,18,44.4,26,8,18,44.4
38370, 산청군,100003, 97세,2018,9,X,6,50,9,X,6,50
38370, 산청군,100004, 98세,2018,5,X,X,66.7,5,X,X,66.7
38370, 산청군,100005, 99세,2018,5,X,X,25,5,X,X,25
38370, 산청군,101,100세이상,2018,X,X,X,33.3,X,X,X,33.3
38370, 산청군,102,15세미만,2018,2662,1415,1247,113.5,2659,1413,1246,113.4
38370, 산청군,103,15~64세,2018,19910,10648,9262,115,19041,10216,8825,115.8
38370, 산청군,104,65세이상,2018,11550,4534,7016,64.6,11527,4522,7005,64.6
38370, 산청군,086,85세이상,2018,1445,356,1089,32.7,1444,356,1088,32.7
38370, 산청군,126,평균연령,2018,53.2,50.3,55.9,,53.7,50.6,56.5,
38370, 산청군,127,중위연령,2018,57.2,54.2,59.9,,57.7,54.8,60.5,
38380, 함양군,000,합계,2018,38005,18230,19775,92.2,37432,17953,19479,92.2
38380, 함양군,005,0~4세,2018,888,428,460,93,886,427,459,93
38380, 함양군,005001, 0세,2018,157,67,90,74.4,156,66,90,73.3
38380, 함양군,005002, 1세,2018,160,76,84,90.5,160,76,84,90.5
38380, 함양군,005003, 2세,2018,165,86,79,108.9,164,86,78,110.3
38380, 함양군,005004, 3세,2018,201,93,108,86.1,201,93,108,86.1
38380, 함양군,005005, 4세,2018,205,106,99,107.1,205,106,99,107.1
38380, 함양군,010,5~9세,2018,1162,610,552,110.5,1159,608,551,110.3
38380, 함양군,010001, 5세,2018,220,116,104,111.5,220,116,104,111.5
38380, 함양군,010002, 6세,2018,227,128,99,129.3,227,128,99,129.3
38380, 함양군,010003, 7세,2018,209,105,104,101,208,104,104,100
38380, 함양군,010004, 8세,2018,259,139,120,115.8,258,139,119,116.8
38380, 함양군,010005, 9세,2018,247,122,125,97.6,246,121,125,96.8
38380, 함양군,015,10~14세,2018,1408,752,656,114.6,1406,751,655,114.7
38380, 함양군,015001, 10세,2018,288,150,138,108.7,287,150,137,109.5
38380, 함양군,015002, 11세,2018,290,156,134,116.4,290,156,134,116.4
38380, 함양군,015003, 12세,2018,284,150,134,111.9,283,149,134,111.2
38380, 함양군,015004, 13세,2018,257,133,124,107.3,257,133,124,107.3
38380, 함양군,015005, 14세,2018,289,163,126,129.4,289,163,126,129.4
38380, 함양군,020,15~19세,2018,1701,877,824,106.4,1697,876,821,106.7
38380, 함양군,020001, 15세,2018,315,155,160,96.9,315,155,160,96.9
38380, 함양군,020002, 16세,2018,331,162,169,95.9,331,162,169,95.9
38380, 함양군,020003, 17세,2018,411,213,198,107.6,411,213,198,107.6
38380, 함양군,020004, 18세,2018,429,212,217,97.7,428,212,216,98.1
38380, 함양군,020005, 19세,2018,215,135,80,168.8,212,134,78,171.8
38380, 함양군,025,20~24세,2018,1424,894,530,168.7,1360,855,505,169.3
38380, 함양군,025001, 20세,2018,257,194,63,307.9,253,193,60,321.7
38380, 함양군,025002, 21세,2018,291,207,84,246.4,283,203,80,253.8
38380, 함양군,025003, 22세,2018,295,175,120,145.8,281,163,118,138.1
38380, 함양군,025004, 23세,2018,293,166,127,130.7,271,152,119,127.7
38380, 함양군,025005, 24세,2018,288,152,136,111.8,272,144,128,112.5
38380, 함양군,030,25~29세,2018,1215,643,572,112.4,1110,592,518,114.3
38380, 함양군,030001, 25세,2018,260,135,125,108,239,127,112,113.4
38380, 함양군,030002, 26세,2018,250,135,115,117.4,228,124,104,119.2
38380, 함양군,030003, 27세,2018,268,137,131,104.6,237,121,116,104.3
38380, 함양군,030004, 28세,2018,245,134,111,120.7,225,126,99,127.3
38380, 함양군,030005, 29세,2018,192,102,90,113.3,181,94,87,108
38380, 함양군,035,30~34세,2018,1328,704,624,112.8,1224,647,577,112.1
38380, 함양군,035001, 30세,2018,263,147,116,126.7,241,133,108,123.1
38380, 함양군,035002, 31세,2018,258,127,131,96.9,244,122,122,100
38380, 함양군,035003, 32세,2018,241,134,107,125.2,221,123,98,125.5
38380, 함양군,035004, 33세,2018,300,163,137,119,278,150,128,117.2
38380, 함양군,035005, 34세,2018,266,133,133,100,240,119,121,98.3
38380, 함양군,040,35~39세,2018,1681,872,809,107.8,1621,836,785,106.5
38380, 함양군,040001, 35세,2018,291,147,144,102.1,277,138,139,99.3
38380, 함양군,040002, 36세,2018,329,160,169,94.7,314,151,163,92.6
38380, 함양군,040003, 37세,2018,368,210,158,132.9,355,199,156,127.6
38380, 함양군,040004, 38세,2018,344,175,169,103.6,337,173,164,105.5
38380, 함양군,040005, 39세,2018,349,180,169,106.5,338,175,163,107.4
38380, 함양군,045,40~44세,2018,1953,1049,904,116,1892,1029,863,119.2
38380, 함양군,045001, 40세,2018,338,172,166,103.6,329,169,160,105.6
38380, 함양군,045002, 41세,2018,353,179,174,102.9,336,172,164,104.9
38380, 함양군,045003, 42세,2018,353,183,170,107.6,339,179,160,111.9
38380, 함양군,045004, 43세,2018,443,250,193,129.5,432,247,185,133.5
38380, 함양군,045005, 44세,2018,466,265,201,131.8,456,262,194,135.1
38380, 함양군,050,45~49세,2018,2822,1534,1288,119.1,2784,1523,1261,120.8
38380, 함양군,050001, 45세,2018,506,277,229,121,501,276,225,122.7
38380, 함양군,050002, 46세,2018,490,282,208,135.6,484,280,204,137.3
38380, 함양군,050003, 47세,2018,578,320,258,124,573,319,254,125.6
38380, 함양군,050004, 48세,2018,605,328,277,118.4,595,324,271,119.6
38380, 함양군,050005, 49세,2018,643,327,316,103.5,631,324,307,105.5
38380, 함양군,055,50~54세,2018,3074,1671,1403,119.1,3037,1656,1381,119.9
38380, 함양군,055001, 50세,2018,648,358,290,123.4,642,354,288,122.9
38380, 함양군,055002, 51세,2018,590,309,281,110,578,305,273,111.7
38380, 함양군,055003, 52세,2018,573,317,256,123.8,567,312,255,122.4
38380, 함양군,055004, 53세,2018,656,361,295,122.4,654,361,293,123.2
38380, 함양군,055005, 54세,2018,607,326,281,116,596,324,272,119.1
38380, 함양군,060,55~59세,2018,3691,1881,1810,103.9,3658,1864,1794,103.9
38380, 함양군,060001, 55세,2018,628,324,304,106.6,616,316,300,105.3
38380, 함양군,060002, 56세,2018,704,361,343,105.2,698,359,339,105.9
38380, 함양군,060003, 57세,2018,811,413,398,103.8,807,413,394,104.8
38380, 함양군,060004, 58세,2018,829,417,412,101.2,821,411,410,100.2
38380, 함양군,060005, 59세,2018,719,366,353,103.7,716,365,351,104
38380, 함양군,065,60~64세,2018,3561,1727,1834,94.2,3528,1714,1814,94.5
38380, 함양군,065001, 60세,2018,665,309,356,86.8,661,307,354,86.7
38380, 함양군,065002, 61세,2018,734,362,372,97.3,725,359,366,98.1
38380, 함양군,065003, 62세,2018,791,373,418,89.2,784,371,413,89.8
38380, 함양군,065004, 63세,2018,771,384,387,99.2,764,380,384,99
38380, 함양군,065005, 64세,2018,600,299,301,99.3,594,297,297,100
38380, 함양군,070,65~69세,2018,2848,1359,1489,91.3,2832,1352,1480,91.4
38380, 함양군,070001, 65세,2018,529,254,275,92.4,525,252,273,92.3
38380, 함양군,070002, 66세,2018,669,325,344,94.5,663,321,342,93.9
38380, 함양군,070003, 67세,2018,510,237,273,86.8,506,237,269,88.1
38380, 함양군,070004, 68세,2018,547,255,292,87.3,547,255,292,87.3
38380, 함양군,070005, 69세,2018,593,288,305,94.4,591,287,304,94.4
38380, 함양군,075,70~74세,2018,2566,1077,1489,72.3,2563,1075,1488,72.2
38380, 함양군,075001, 70세,2018,572,262,310,84.5,572,262,310,84.5
38380, 함양군,075002, 71세,2018,585,241,344,70.1,584,241,343,70.3
38380, 함양군,075003, 72세,2018,418,183,235,77.9,418,183,235,77.9
38380, 함양군,075004, 73세,2018,465,180,285,63.2,464,179,285,62.8
38380, 함양군,075005, 74세,2018,526,211,315,67,525,210,315,66.7
38380, 함양군,080,75~79세,2018,2990,1086,1904,57,2985,1084,1901,57
38380, 함양군,080001, 75세,2018,546,171,375,45.6,544,170,374,45.5
38380, 함양군,080002, 76세,2018,667,262,405,64.7,666,261,405,64.4
38380, 함양군,080003, 77세,2018,583,214,369,58,583,214,369,58
38380, 함양군,080004, 78세,2018,598,225,373,60.3,597,225,372,60.5
38380, 함양군,080005, 79세,2018,596,214,382,56,595,214,381,56.2
38380, 함양군,085,80~84세,2018,2214,723,1491,48.5,2212,721,1491,48.4
38380, 함양군,085001, 80세,2018,533,190,343,55.4,531,188,343,54.8
38380, 함양군,085002, 81세,2018,510,192,318,60.4,510,192,318,60.4
38380, 함양군,085003, 82세,2018,438,138,300,46,438,138,300,46
38380, 함양군,085004, 83세,2018,372,101,271,37.3,372,101,271,37.3
38380, 함양군,085005, 84세,2018,361,102,259,39.4,361,102,259,39.4
38380, 함양군,090,85~89세,2018,1054,243,811,30,1053,243,810,30
38380, 함양군,090001, 85세,2018,280,63,217,29,280,63,217,29
38380, 함양군,090002, 86세,2018,248,63,185,34.1,247,63,184,34.2
38380, 함양군,090003, 87세,2018,214,49,165,29.7,214,49,165,29.7
38380, 함양군,090004, 88세,2018,178,34,144,23.6,178,34,144,23.6
38380, 함양군,090005, 89세,2018,134,34,100,34,134,34,100,34
38380, 함양군,095,90~94세,2018,356,85,271,31.4,356,85,271,31.4
38380, 함양군,095001, 90세,2018,109,24,85,28.2,109,24,85,28.2
38380, 함양군,095002, 91세,2018,97,20,77,26,97,20,77,26
38380, 함양군,095003, 92세,2018,62,21,41,51.2,62,21,41,51.2
38380, 함양군,095004, 93세,2018,52,11,41,26.8,52,11,41,26.8
38380, 함양군,095005, 94세,2018,36,9,27,33.3,36,9,27,33.3
38380, 함양군,100,95~99세,2018,60,14,46,30.4,60,14,46,30.4
38380, 함양군,100001, 95세,2018,23,8,15,53.3,23,8,15,53.3
38380, 함양군,100002, 96세,2018,17,X,14,21.4,17,X,14,21.4
38380, 함양군,100003, 97세,2018,9,X,7,28.6,9,X,7,28.6
38380, 함양군,100004, 98세,2018,7,X,6,16.7,7,X,6,16.7
38380, 함양군,100005, 99세,2018,X,X,X,0,X,X,X,0
38380, 함양군,101,100세이상,2018,9,X,8,12.5,9,X,8,12.5
38380, 함양군,102,15세미만,2018,3458,1790,1668,107.3,3451,1786,1665,107.3
38380, 함양군,103,15~64세,2018,22450,11852,10598,111.8,21911,11592,10319,112.3
38380, 함양군,104,65세이상,2018,12097,4588,7509,61.1,12070,4575,7495,61
38380, 함양군,086,85세이상,2018,1479,343,1136,30.2,1478,343,1135,30.2
38380, 함양군,126,평균연령,2018,51.8,48.8,54.5,,52,49,54.7,
38380, 함양군,127,중위연령,2018,55.6,52.3,58.5,,55.9,52.6,58.8,
38390, 거창군,000,합계,2018,60020,29398,30622,96,59363,29091,30272,96.1
38390, 거창군,005,0~4세,2018,1773,915,858,106.6,1773,915,858,106.6
38390, 거창군,005001, 0세,2018,282,145,137,105.8,282,145,137,105.8
38390, 거창군,005002, 1세,2018,296,161,135,119.3,296,161,135,119.3
38390, 거창군,005003, 2세,2018,379,202,177,114.1,379,202,177,114.1
38390, 거창군,005004, 3세,2018,371,184,187,98.4,371,184,187,98.4
38390, 거창군,005005, 4세,2018,445,223,222,100.5,445,223,222,100.5
38390, 거창군,010,5~9세,2018,2428,1272,1156,110,2426,1271,1155,110
38390, 거창군,010001, 5세,2018,431,221,210,105.2,429,220,209,105.3
38390, 거창군,010002, 6세,2018,500,270,230,117.4,500,270,230,117.4
38390, 거창군,010003, 7세,2018,515,262,253,103.6,515,262,253,103.6
38390, 거창군,010004, 8세,2018,466,251,215,116.7,466,251,215,116.7
38390, 거창군,010005, 9세,2018,516,268,248,108.1,516,268,248,108.1
38390, 거창군,015,10~14세,2018,2540,1294,1246,103.9,2539,1294,1245,103.9
38390, 거창군,015001, 10세,2018,524,265,259,102.3,524,265,259,102.3
38390, 거창군,015002, 11세,2018,529,267,262,101.9,529,267,262,101.9
38390, 거창군,015003, 12세,2018,432,217,215,100.9,432,217,215,100.9
38390, 거창군,015004, 13세,2018,503,261,242,107.9,503,261,242,107.9
38390, 거창군,015005, 14세,2018,552,284,268,106,551,284,267,106.4
38390, 거창군,020,15~19세,2018,3431,1912,1519,125.9,3428,1910,1518,125.8
38390, 거창군,020001, 15세,2018,577,315,262,120.2,577,315,262,120.2
38390, 거창군,020002, 16세,2018,705,362,343,105.5,705,362,343,105.5
38390, 거창군,020003, 17세,2018,733,379,354,107.1,731,378,353,107.1
38390, 거창군,020004, 18세,2018,804,430,374,115,804,430,374,115
38390, 거창군,020005, 19세,2018,612,426,186,229,611,425,186,228.5
38390, 거창군,025,20~24세,2018,3144,2105,1039,202.6,3086,2082,1004,207.4
38390, 거창군,025001, 20세,2018,578,389,189,205.8,570,384,186,206.5
38390, 거창군,025002, 21세,2018,669,453,216,209.7,664,453,211,214.7
38390, 거창군,025003, 22세,2018,684,492,192,256.3,674,489,185,264.3
38390, 거창군,025004, 23세,2018,686,452,234,193.2,672,447,225,198.7
38390, 거창군,025005, 24세,2018,527,319,208,153.4,506,309,197,156.9
38390, 거창군,030,25~29세,2018,2332,1304,1028,126.8,2208,1243,965,128.8
38390, 거창군,030001, 25세,2018,551,306,245,124.9,526,295,231,127.7
38390, 거창군,030002, 26세,2018,481,256,225,113.8,463,248,215,115.3
38390, 거창군,030003, 27세,2018,447,261,186,140.3,414,240,174,137.9
38390, 거창군,030004, 28세,2018,454,252,202,124.8,424,239,185,129.2
38390, 거창군,030005, 29세,2018,399,229,170,134.7,381,221,160,138.1
38390, 거창군,035,30~34세,2018,2373,1243,1130,110,2248,1179,1069,110.3
38390, 거창군,035001, 30세,2018,434,246,188,130.9,411,231,180,128.3
38390, 거창군,035002, 31세,2018,484,251,233,107.7,451,241,210,114.8
38390, 거창군,035003, 32세,2018,508,265,243,109.1,476,250,226,110.6
38390, 거창군,035004, 33세,2018,458,233,225,103.6,437,219,218,100.5
38390, 거창군,035005, 34세,2018,489,248,241,102.9,473,238,235,101.3
38390, 거창군,040,35~39세,2018,3172,1575,1597,98.6,3083,1527,1556,98.1
38390, 거창군,040001, 35세,2018,578,294,284,103.5,560,284,276,102.9
38390, 거창군,040002, 36세,2018,633,295,338,87.3,608,282,326,86.5
38390, 거창군,040003, 37세,2018,637,335,302,110.9,623,326,297,109.8
38390, 거창군,040004, 38세,2018,673,309,364,84.9,653,301,352,85.5
38390, 거창군,040005, 39세,2018,651,342,309,110.7,639,334,305,109.5
38390, 거창군,045,40~44세,2018,3400,1724,1676,102.9,3341,1702,1639,103.8
38390, 거창군,045001, 40세,2018,571,286,285,100.4,558,281,277,101.4
38390, 거창군,045002, 41세,2018,642,332,310,107.1,623,320,303,105.6
38390, 거창군,045003, 42세,2018,700,343,357,96.1,689,342,347,98.6
38390, 거창군,045004, 43세,2018,690,349,341,102.3,686,349,337,103.6
38390, 거창군,045005, 44세,2018,797,414,383,108.1,785,410,375,109.3
38390, 거창군,050,45~49세,2018,4556,2356,2200,107.1,4510,2341,2169,107.9
38390, 거창군,050001, 45세,2018,871,416,455,91.4,856,407,449,90.6
38390, 거창군,050002, 46세,2018,800,427,373,114.5,791,426,365,116.7
38390, 거창군,050003, 47세,2018,955,506,449,112.7,950,505,445,113.5
38390, 거창군,050004, 48세,2018,953,498,455,109.5,944,496,448,110.7
38390, 거창군,050005, 49세,2018,977,509,468,108.8,969,507,462,109.7
38390, 거창군,055,50~54세,2018,4788,2452,2336,105,4728,2423,2305,105.1
38390, 거창군,055001, 50세,2018,1044,522,522,100,1028,513,515,99.6
38390, 거창군,055002, 51세,2018,935,478,457,104.6,924,474,450,105.3
38390, 거창군,055003, 52세,2018,942,502,440,114.1,937,499,438,113.9
38390, 거창군,055004, 53세,2018,998,489,509,96.1,981,480,501,95.8
38390, 거창군,055005, 54세,2018,869,461,408,113,858,457,401,114
38390, 거창군,060,55~59세,2018,5549,2772,2777,99.8,5505,2751,2754,99.9
38390, 거창군,060001, 55세,2018,931,506,425,119.1,919,500,419,119.3
38390, 거창군,060002, 56세,2018,1105,567,538,105.4,1095,561,534,105.1
38390, 거창군,060003, 57세,2018,1225,591,634,93.2,1215,587,628,93.5
38390, 거창군,060004, 58세,2018,1160,573,587,97.6,1155,572,583,98.1
38390, 거창군,060005, 59세,2018,1128,535,593,90.2,1121,531,590,90
38390, 거창군,065,60~64세,2018,4930,2456,2474,99.3,4894,2440,2454,99.4
38390, 거창군,065001, 60세,2018,984,478,506,94.5,972,475,497,95.6
38390, 거창군,065002, 61세,2018,1056,528,528,100,1044,521,523,99.6
38390, 거창군,065003, 62세,2018,1004,506,498,101.6,1001,504,497,101.4
38390, 거창군,065004, 63세,2018,994,519,475,109.3,989,516,473,109.1
38390, 거창군,065005, 64세,2018,892,425,467,91,888,424,464,91.4
38390, 거창군,070,65~69세,2018,3856,1790,2066,86.6,3847,1785,2062,86.6
38390, 거창군,070001, 65세,2018,811,382,429,89,807,380,427,89
38390, 거창군,070002, 66세,2018,903,420,483,87,902,420,482,87.1
38390, 거창군,070003, 67세,2018,656,298,358,83.2,655,298,357,83.5
38390, 거창군,070004, 68세,2018,688,314,374,84,686,312,374,83.4
38390, 거창군,070005, 69세,2018,798,376,422,89.1,797,375,422,88.9
38390, 거창군,075,70~74세,2018,3319,1405,1914,73.4,3319,1405,1914,73.4
38390, 거창군,075001, 70세,2018,822,354,468,75.6,822,354,468,75.6
38390, 거창군,075002, 71세,2018,693,323,370,87.3,693,323,370,87.3
38390, 거창군,075003, 72세,2018,580,255,325,78.5,580,255,325,78.5
38390, 거창군,075004, 73세,2018,549,221,328,67.4,549,221,328,67.4
38390, 거창군,075005, 74세,2018,675,252,423,59.6,675,252,423,59.6
38390, 거창군,080,75~79세,2018,3718,1404,2314,60.7,3718,1404,2314,60.7
38390, 거창군,080001, 75세,2018,682,271,411,65.9,682,271,411,65.9
38390, 거창군,080002, 76세,2018,807,292,515,56.7,807,292,515,56.7
38390, 거창군,080003, 77세,2018,735,292,443,65.9,735,292,443,65.9
38390, 거창군,080004, 78세,2018,728,264,464,56.9,728,264,464,56.9
38390, 거창군,080005, 79세,2018,766,285,481,59.3,766,285,481,59.3
38390, 거창군,085,80~84세,2018,2767,898,1869,48,2766,898,1868,48.1
38390, 거창군,085001, 80세,2018,645,233,412,56.6,644,233,411,56.7
38390, 거창군,085002, 81세,2018,603,183,420,43.6,603,183,420,43.6
38390, 거창군,085003, 82세,2018,598,201,397,50.6,598,201,397,50.6
38390, 거창군,085004, 83세,2018,495,145,350,41.4,495,145,350,41.4
38390, 거창군,085005, 84세,2018,426,136,290,46.9,426,136,290,46.9
38390, 거창군,090,85~89세,2018,1407,385,1022,37.7,1407,385,1022,37.7
38390, 거창군,090001, 85세,2018,421,139,282,49.3,421,139,282,49.3
38390, 거창군,090002, 86세,2018,286,69,217,31.8,286,69,217,31.8
38390, 거창군,090003, 87세,2018,279,80,199,40.2,279,80,199,40.2
38390, 거창군,090004, 88세,2018,230,53,177,29.9,230,53,177,29.9
38390, 거창군,090005, 89세,2018,191,44,147,29.9,191,44,147,29.9
38390, 거창군,095,90~94세,2018,432,110,322,34.2,432,110,322,34.2
38390, 거창군,095001, 90세,2018,138,38,100,38,138,38,100,38
38390, 거창군,095002, 91세,2018,121,32,89,36,121,32,89,36
38390, 거창군,095003, 92세,2018,70,17,53,32.1,70,17,53,32.1
38390, 거창군,095004, 93세,2018,63,11,52,21.2,63,11,52,21.2
38390, 거창군,095005, 94세,2018,40,12,28,42.9,40,12,28,42.9
38390, 거창군,100,95~99세,2018,88,20,68,29.4,88,20,68,29.4
38390, 거창군,100001, 95세,2018,32,10,22,45.5,32,10,22,45.5
38390, 거창군,100002, 96세,2018,19,X,18,5.6,19,X,18,5.6
38390, 거창군,100003, 97세,2018,17,X,13,30.8,17,X,13,30.8
38390, 거창군,100004, 98세,2018,17,5,12,41.7,17,5,12,41.7
38390, 거창군,100005, 99세,2018,X,X,X,0,X,X,X,0
38390, 거창군,101,100세이상,2018,17,6,11,54.5,17,6,11,54.5
38390, 거창군,102,15세미만,2018,6741,3481,3260,106.8,6738,3480,3258,106.8
38390, 거창군,103,15~64세,2018,37675,19899,17776,111.9,37031,19598,17433,112.4
38390, 거창군,104,65세이상,2018,15604,6018,9586,62.8,15594,6013,9581,62.8
38390, 거창군,086,85세이상,2018,1944,521,1423,36.6,1944,521,1423,36.6
38390, 거창군,126,평균연령,2018,47.9,45,50.7,,48,45.1,50.8,
38390, 거창군,127,중위연령,2018,50.8,48,53.9,,51,48.2,54.1,
38400, 합천군,000,합계,2018,42856,20498,22358,91.7,42156,20146,22010,91.5
38400, 합천군,005,0~4세,2018,771,410,361,113.6,771,410,361,113.6
38400, 합천군,005001, 0세,2018,123,61,62,98.4,123,61,62,98.4
38400, 합천군,005002, 1세,2018,127,70,57,122.8,127,70,57,122.8
38400, 합천군,005003, 2세,2018,170,103,67,153.7,170,103,67,153.7
38400, 합천군,005004, 3세,2018,161,86,75,114.7,161,86,75,114.7
38400, 합천군,005005, 4세,2018,190,90,100,90,190,90,100,90
38400, 합천군,010,5~9세,2018,1033,537,496,108.3,1032,537,495,108.5
38400, 합천군,010001, 5세,2018,212,112,100,112,211,112,99,113.1
38400, 합천군,010002, 6세,2018,208,107,101,105.9,208,107,101,105.9
38400, 합천군,010003, 7세,2018,220,119,101,117.8,220,119,101,117.8
38400, 합천군,010004, 8세,2018,179,95,84,113.1,179,95,84,113.1
38400, 합천군,010005, 9세,2018,214,104,110,94.5,214,104,110,94.5
38400, 합천군,015,10~14세,2018,1171,600,571,105.1,1171,600,571,105.1
38400, 합천군,015001, 10세,2018,235,122,113,108,235,122,113,108
38400, 합천군,015002, 11세,2018,264,139,125,111.2,264,139,125,111.2
38400, 합천군,015003, 12세,2018,206,108,98,110.2,206,108,98,110.2
38400, 합천군,015004, 13세,2018,223,114,109,104.6,223,114,109,104.6
38400, 합천군,015005, 14세,2018,243,117,126,92.9,243,117,126,92.9
38400, 합천군,020,15~19세,2018,1416,791,625,126.6,1408,788,620,127.1
38400, 합천군,020001, 15세,2018,257,141,116,121.6,256,140,116,120.7
38400, 합천군,020002, 16세,2018,291,167,124,134.7,291,167,124,134.7
38400, 합천군,020003, 17세,2018,324,168,156,107.7,323,168,155,108.4
38400, 합천군,020004, 18세,2018,295,162,133,121.8,295,162,133,121.8
38400, 합천군,020005, 19세,2018,249,153,96,159.4,243,151,92,164.1
38400, 합천군,025,20~24세,2018,1473,898,575,156.2,1383,845,538,157.1
38400, 합천군,025001, 20세,2018,297,187,110,170,293,186,107,173.8
38400, 합천군,025002, 21세,2018,312,216,96,225,296,203,93,218.3
38400, 합천군,025003, 22세,2018,288,172,116,148.3,269,163,106,153.8
38400, 합천군,025004, 23세,2018,295,163,132,123.5,273,148,125,118.4
38400, 합천군,025005, 24세,2018,281,160,121,132.2,252,145,107,135.5
38400, 합천군,030,25~29세,2018,1427,823,604,136.3,1265,737,528,139.6
38400, 합천군,030001, 25세,2018,287,164,123,133.3,255,148,107,138.3
38400, 합천군,030002, 26세,2018,313,188,125,150.4,277,170,107,158.9
38400, 합천군,030003, 27세,2018,295,153,142,107.7,264,140,124,112.9
38400, 합천군,030004, 28세,2018,270,154,116,132.8,238,135,103,131.1
38400, 합천군,030005, 29세,2018,262,164,98,167.3,231,144,87,165.5
38400, 합천군,035,30~34세,2018,1340,758,582,130.2,1209,685,524,130.7
38400, 합천군,035001, 30세,2018,260,160,100,160,230,142,88,161.4
38400, 합천군,035002, 31세,2018,267,140,127,110.2,242,126,116,108.6
38400, 합천군,035003, 32세,2018,280,162,118,137.3,245,144,101,142.6
38400, 합천군,035004, 33세,2018,266,155,111,139.6,248,147,101,145.5
38400, 합천군,035005, 34세,2018,267,141,126,111.9,244,126,118,106.8
38400, 합천군,040,35~39세,2018,1705,922,783,117.8,1622,877,745,117.7
38400, 합천군,040001, 35세,2018,314,167,147,113.6,295,157,138,113.8
38400, 합천군,040002, 36세,2018,333,168,165,101.8,319,163,156,104.5
38400, 합천군,040003, 37세,2018,339,182,157,115.9,322,172,150,114.7
38400, 합천군,040004, 38세,2018,353,197,156,126.3,342,189,153,123.5
38400, 합천군,040005, 39세,2018,366,208,158,131.6,344,196,148,132.4
38400, 합천군,045,40~44세,2018,1823,1013,810,125.1,1763,986,777,126.9
38400, 합천군,045001, 40세,2018,341,187,154,121.4,324,178,146,121.9
38400, 합천군,045002, 41세,2018,361,197,164,120.1,346,193,153,126.1
38400, 합천군,045003, 42세,2018,357,195,162,120.4,343,187,156,119.9
38400, 합천군,045004, 43세,2018,364,197,167,118,357,193,164,117.7
38400, 합천군,045005, 44세,2018,400,237,163,145.4,393,235,158,148.7
38400, 합천군,050,45~49세,2018,2710,1523,1187,128.3,2657,1505,1152,130.6
38400, 합천군,050001, 45세,2018,483,267,216,123.6,470,263,207,127.1
38400, 합천군,050002, 46세,2018,493,286,207,138.2,486,282,204,138.2
38400, 합천군,050003, 47세,2018,560,316,244,129.5,549,311,238,130.7
38400, 합천군,050004, 48세,2018,577,317,260,121.9,567,316,251,125.9
38400, 합천군,050005, 49세,2018,597,337,260,129.6,585,333,252,132.1
38400, 합천군,055,50~54세,2018,3288,1799,1489,120.8,3245,1785,1460,122.3
38400, 합천군,055001, 50세,2018,671,378,293,129,663,377,286,131.8
38400, 합천군,055002, 51세,2018,626,321,305,105.2,619,321,298,107.7
38400, 합천군,055003, 52세,2018,671,371,300,123.7,658,365,293,124.6
38400, 합천군,055004, 53세,2018,643,355,288,123.3,637,352,285,123.5
38400, 합천군,055005, 54세,2018,677,374,303,123.4,668,370,298,124.2
38400, 합천군,060,55~59세,2018,4430,2256,2174,103.8,4390,2234,2156,103.6
38400, 합천군,060001, 55세,2018,693,367,326,112.6,682,364,318,114.5
38400, 합천군,060002, 56세,2018,831,448,383,117,820,438,382,114.7
38400, 합천군,060003, 57세,2018,1034,523,511,102.3,1025,519,506,102.6
38400, 합천군,060004, 58세,2018,941,453,488,92.8,935,450,485,92.8
38400, 합천군,060005, 59세,2018,931,465,466,99.8,928,463,465,99.6
38400, 합천군,065,60~64세,2018,4146,2099,2047,102.5,4139,2096,2043,102.6
38400, 합천군,065001, 60세,2018,842,451,391,115.3,841,450,391,115.1
38400, 합천군,065002, 61세,2018,835,421,414,101.7,833,420,413,101.7
38400, 합천군,065003, 62세,2018,880,463,417,111,879,463,416,111.3
38400, 합천군,065004, 63세,2018,838,392,446,87.9,836,392,444,88.3
38400, 합천군,065005, 64세,2018,751,372,379,98.2,750,371,379,97.9
38400, 합천군,070,65~69세,2018,3689,1764,1925,91.6,3674,1758,1916,91.8
38400, 합천군,070001, 65세,2018,712,345,367,94,706,343,363,94.5
38400, 합천군,070002, 66세,2018,800,385,415,92.8,799,385,414,93
38400, 합천군,070003, 67세,2018,703,327,376,87,698,325,373,87.1
38400, 합천군,070004, 68세,2018,702,338,364,92.9,702,338,364,92.9
38400, 합천군,070005, 69세,2018,772,369,403,91.6,769,367,402,91.3
38400, 합천군,075,70~74세,2018,3276,1363,1913,71.2,3273,1363,1910,71.4
38400, 합천군,075001, 70세,2018,738,322,416,77.4,737,322,415,77.6
38400, 합천군,075002, 71세,2018,722,308,414,74.4,721,308,413,74.6
38400, 합천군,075003, 72세,2018,549,236,313,75.4,549,236,313,75.4
38400, 합천군,075004, 73세,2018,582,239,343,69.7,581,239,342,69.9
38400, 합천군,075005, 74세,2018,685,258,427,60.4,685,258,427,60.4
38400, 합천군,080,75~79세,2018,4122,1487,2635,56.4,4120,1487,2633,56.5
38400, 합천군,080001, 75세,2018,709,270,439,61.5,708,270,438,61.6
38400, 합천군,080002, 76세,2018,916,338,578,58.5,916,338,578,58.5
38400, 합천군,080003, 77세,2018,818,303,515,58.8,817,303,514,58.9
38400, 합천군,080004, 78세,2018,823,296,527,56.2,823,296,527,56.2
38400, 합천군,080005, 79세,2018,856,280,576,48.6,856,280,576,48.6
38400, 합천군,085,80~84세,2018,3120,992,2128,46.6,3120,992,2128,46.6
38400, 합천군,085001, 80세,2018,683,228,455,50.1,683,228,455,50.1
38400, 합천군,085002, 81세,2018,710,233,477,48.8,710,233,477,48.8
38400, 합천군,085003, 82세,2018,597,210,387,54.3,597,210,387,54.3
38400, 합천군,085004, 83세,2018,590,183,407,45,590,183,407,45
38400, 합천군,085005, 84세,2018,540,138,402,34.3,540,138,402,34.3
38400, 합천군,090,85~89세,2018,1419,360,1059,34,1418,359,1059,33.9
38400, 합천군,090001, 85세,2018,442,124,318,39,442,124,318,39
38400, 합천군,090002, 86세,2018,334,80,254,31.5,334,80,254,31.5
38400, 합천군,090003, 87세,2018,245,54,191,28.3,244,53,191,27.7
38400, 합천군,090004, 88세,2018,215,50,165,30.3,215,50,165,30.3
38400, 합천군,090005, 89세,2018,183,52,131,39.7,183,52,131,39.7
38400, 합천군,095,90~94세,2018,387,93,294,31.6,386,92,294,31.3
38400, 합천군,095001, 90세,2018,137,36,101,35.6,136,35,101,34.7
38400, 합천군,095002, 91세,2018,106,27,79,34.2,106,27,79,34.2
38400, 합천군,095003, 92세,2018,62,9,53,17,62,9,53,17
38400, 합천군,095004, 93세,2018,50,12,38,31.6,50,12,38,31.6
38400, 합천군,095005, 94세,2018,32,9,23,39.1,32,9,23,39.1
38400, 합천군,100,95~99세,2018,104,10,94,10.6,104,10,94,10.6
38400, 합천군,100001, 95세,2018,42,X,38,10.5,42,X,38,10.5
38400, 합천군,100002, 96세,2018,23,X,21,9.5,23,X,21,9.5
38400, 합천군,100003, 97세,2018,20,X,19,5.3,20,X,19,5.3
38400, 합천군,100004, 98세,2018,15,X,14,7.1,15,X,14,7.1
38400, 합천군,100005, 99세,2018,X,X,X,100,X,X,X,100
38400, 합천군,101,100세이상,2018,6,X,6,0,6,X,6,0
38400, 합천군,102,15세미만,2018,2975,1547,1428,108.3,2974,1547,1427,108.4
38400, 합천군,103,15~64세,2018,23758,12882,10876,118.4,23081,12538,10543,118.9
38400, 합천군,104,65세이상,2018,16123,6069,10054,60.4,16101,6061,10040,60.4
38400, 합천군,086,85세이상,2018,1916,463,1453,31.9,1914,461,1453,31.7
38400, 합천군,126,평균연령,2018,55,51.5,58.2,,55.3,51.7,58.5,
38400, 합천군,127,중위연령,2018,58.8,55.5,62.3,,59.1,55.9,62.7,
39,제주특별자치도,000,합계,2018,658282,333019,325263,102.4,632995,318135,314860,101
39,제주특별자치도,005,0~4세,2018,29154,15054,14100,106.8,28713,14823,13890,106.7
39,제주특별자치도,005001, 0세,2018,4959,2548,2411,105.7,4879,2508,2371,105.8
39,제주특별자치도,005002, 1세,2018,5369,2787,2582,107.9,5257,2739,2518,108.8
39,제주특별자치도,005003, 2세,2018,6019,3126,2893,108.1,5925,3074,2851,107.8
39,제주특별자치도,005004, 3세,2018,6309,3267,3042,107.4,6231,3224,3007,107.2
39,제주특별자치도,005005, 4세,2018,6498,3326,3172,104.9,6421,3278,3143,104.3
39,제주특별자치도,010,5~9세,2018,34673,17851,16822,106.1,34378,17707,16671,106.2
39,제주특별자치도,010001, 5세,2018,6622,3378,3244,104.1,6556,3339,3217,103.8
39,제주특별자치도,010002, 6세,2018,7317,3712,3605,103,7257,3683,3574,103
39,제주특별자치도,010003, 7세,2018,7167,3705,3462,107,7114,3683,3431,107.3
39,제주특별자치도,010004, 8세,2018,6896,3621,3275,110.6,6834,3589,3245,110.6
39,제주특별자치도,010005, 9세,2018,6671,3435,3236,106.1,6617,3413,3204,106.5
39,제주특별자치도,015,10~14세,2018,34064,17779,16285,109.2,33827,17657,16170,109.2
39,제주특별자치도,015001, 10세,2018,6925,3550,3375,105.2,6858,3519,3339,105.4
39,제주특별자치도,015002, 11세,2018,7282,3731,3551,105.1,7235,3704,3531,104.9
39,제주특별자치도,015003, 12세,2018,6583,3432,3151,108.9,6540,3410,3130,108.9
39,제주특별자치도,015004, 13세,2018,6424,3445,2979,115.6,6379,3421,2958,115.7
39,제주특별자치도,015005, 14세,2018,6850,3621,3229,112.1,6815,3603,3212,112.2
39,제주특별자치도,020,15~19세,2018,36701,19298,17403,110.9,36027,18959,17068,111.1
39,제주특별자치도,020001, 15세,2018,7015,3665,3350,109.4,6976,3647,3329,109.6
39,제주특별자치도,020002, 16세,2018,6877,3678,3199,115,6840,3658,3182,115
39,제주특별자치도,020003, 17세,2018,7788,4096,3692,110.9,7708,4065,3643,111.6
39,제주특별자치도,020004, 18세,2018,8155,4211,3944,106.8,7987,4123,3864,106.7
39,제주특별자치도,020005, 19세,2018,6866,3648,3218,113.4,6516,3466,3050,113.6
39,제주특별자치도,025,20~24세,2018,40705,22515,18190,123.8,36904,20012,16892,118.5
39,제주특별자치도,025001, 20세,2018,7492,4193,3299,127.1,6935,3876,3059,126.7
39,제주특별자치도,025002, 21세,2018,8155,4709,3446,136.7,7495,4298,3197,134.4
39,제주특별자치도,025003, 22세,2018,8095,4494,3601,124.8,7330,3981,3349,118.9
39,제주특별자치도,025004, 23세,2018,8318,4434,3884,114.2,7446,3839,3607,106.4
39,제주특별자치도,025005, 24세,2018,8645,4685,3960,118.3,7698,4018,3680,109.2
39,제주특별자치도,030,25~29세,2018,40788,21853,18935,115.4,35763,18549,17214,107.8
39,제주특별자치도,030001, 25세,2018,8784,4689,4095,114.5,7795,3980,3815,104.3
39,제주특별자치도,030002, 26세,2018,8675,4778,3897,122.6,7671,4082,3589,113.7
39,제주특별자치도,030003, 27세,2018,8055,4293,3762,114.1,7125,3689,3436,107.4
39,제주특별자치도,030004, 28세,2018,7836,4194,3642,115.2,6763,3516,3247,108.3
39,제주특별자치도,030005, 29세,2018,7438,3899,3539,110.2,6409,3282,3127,105
39,제주특별자치도,035,30~34세,2018,39187,20486,18701,109.5,34726,17809,16917,105.3
39,제주특별자치도,035001, 30세,2018,7131,3839,3292,116.6,6169,3234,2935,110.2
39,제주특별자치도,035002, 31세,2018,7634,3985,3649,109.2,6642,3437,3205,107.2
39,제주특별자치도,035003, 32세,2018,7704,4033,3671,109.9,6802,3490,3312,105.4
39,제주특별자치도,035004, 33세,2018,8054,4200,3854,109,7228,3684,3544,104
39,제주특별자치도,035005, 34세,2018,8664,4429,4235,104.6,7885,3964,3921,101.1
39,제주특별자치도,040,35~39세,2018,52990,27038,25952,104.2,49481,25024,24457,102.3
39,제주특별자치도,040001, 35세,2018,9512,4847,4665,103.9,8808,4438,4370,101.6
39,제주특별자치도,040002, 36세,2018,10775,5499,5276,104.2,9981,5028,4953,101.5
39,제주특별자치도,040003, 37세,2018,10886,5604,5282,106.1,10196,5194,5002,103.8
39,제주특별자치도,040004, 38세,2018,10957,5626,5331,105.5,10282,5239,5043,103.9
39,제주특별자치도,040005, 39세,2018,10860,5462,5398,101.2,10214,5125,5089,100.7
39,제주특별자치도,045,40~44세,2018,51822,26995,24827,108.7,49601,25817,23784,108.5
39,제주특별자치도,045001, 40세,2018,9488,4832,4656,103.8,8930,4529,4401,102.9
39,제주특별자치도,045002, 41세,2018,10092,5186,4906,105.7,9639,4956,4683,105.8
39,제주특별자치도,045003, 42세,2018,10087,5380,4707,114.3,9653,5144,4509,114.1
39,제주특별자치도,045004, 43세,2018,10426,5431,4995,108.7,10029,5224,4805,108.7
39,제주특별자치도,045005, 44세,2018,11729,6166,5563,110.8,11350,5964,5386,110.7
39,제주특별자치도,050,45~49세,2018,59931,31155,28776,108.3,58362,30269,28093,107.7
39,제주특별자치도,050001, 45세,2018,11677,5977,5700,104.9,11317,5773,5544,104.1
39,제주특별자치도,050002, 46세,2018,12091,6251,5840,107,11762,6065,5697,106.5
39,제주특별자치도,050003, 47세,2018,12669,6628,6041,109.7,12348,6440,5908,109
39,제주특별자치도,050004, 48세,2018,11898,6176,5722,107.9,11596,6012,5584,107.7
39,제주특별자치도,050005, 49세,2018,11596,6123,5473,111.9,11339,5979,5360,111.5
39,제주특별자치도,055,50~54세,2018,53139,27792,25347,109.6,52096,27253,24843,109.7
39,제주특별자치도,055001, 50세,2018,11575,6030,5545,108.7,11316,5885,5431,108.4
39,제주특별자치도,055002, 51세,2018,10518,5494,5024,109.4,10306,5383,4923,109.3
39,제주특별자치도,055003, 52세,2018,10863,5756,5107,112.7,10665,5661,5004,113.1
39,제주특별자치도,055004, 53세,2018,10104,5263,4841,108.7,9908,5156,4752,108.5
39,제주특별자치도,055005, 54세,2018,10079,5249,4830,108.7,9901,5168,4733,109.2
39,제주특별자치도,060,55~59세,2018,50973,25959,25014,103.8,50182,25561,24621,103.8
39,제주특별자치도,060001, 55세,2018,10793,5544,5249,105.6,10591,5451,5140,106.1
39,제주특별자치도,060002, 56세,2018,10230,5272,4958,106.3,10058,5178,4880,106.1
39,제주특별자치도,060003, 57세,2018,10133,5104,5029,101.5,10007,5039,4968,101.4
39,제주특별자치도,060004, 58세,2018,10405,5303,5102,103.9,10243,5218,5025,103.8
39,제주특별자치도,060005, 59세,2018,9412,4736,4676,101.3,9283,4675,4608,101.5
39,제주특별자치도,065,60~64세,2018,40709,20441,20268,100.9,40067,20157,19910,101.2
39,제주특별자치도,065001, 60세,2018,8931,4572,4359,104.9,8791,4515,4276,105.6
39,제주특별자치도,065002, 61세,2018,8648,4369,4279,102.1,8511,4308,4203,102.5
39,제주특별자치도,065003, 62세,2018,8191,4126,4065,101.5,8058,4066,3992,101.9
39,제주특별자치도,065004, 63세,2018,8250,4041,4209,96,8139,3993,4146,96.3
39,제주특별자치도,065005, 64세,2018,6689,3333,3356,99.3,6568,3275,3293,99.5
39,제주특별자치도,070,65~69세,2018,26678,12801,13877,92.2,26370,12668,13702,92.5
39,제주특별자치도,070001, 65세,2018,5542,2660,2882,92.3,5472,2620,2852,91.9
39,제주특별자치도,070002, 66세,2018,5880,2864,3016,95,5817,2844,2973,95.7
39,제주특별자치도,070003, 67세,2018,5101,2505,2596,96.5,5027,2473,2554,96.8
39,제주특별자치도,070004, 68세,2018,5055,2366,2689,88,5010,2347,2663,88.1
39,제주특별자치도,070005, 69세,2018,5100,2406,2694,89.3,5044,2384,2660,89.6
39,제주특별자치도,075,70~74세,2018,23414,10997,12417,88.6,23267,10920,12347,88.4
39,제주특별자치도,075001, 70세,2018,5393,2615,2778,94.1,5355,2597,2758,94.2
39,제주특별자치도,075002, 71세,2018,5168,2435,2733,89.1,5132,2417,2715,89
39,제주특별자치도,075003, 72세,2018,4514,2103,2411,87.2,4485,2087,2398,87
39,제주특별자치도,075004, 73세,2018,4171,1961,2210,88.7,4148,1947,2201,88.5
39,제주특별자치도,075005, 74세,2018,4168,1883,2285,82.4,4147,1872,2275,82.3
39,제주특별자치도,080,75~79세,2018,19337,8111,11226,72.3,19281,8086,11195,72.2
39,제주특별자치도,080001, 75세,2018,3978,1745,2233,78.1,3962,1734,2228,77.8
39,제주특별자치도,080002, 76세,2018,4245,1864,2381,78.3,4233,1860,2373,78.4
39,제주특별자치도,080003, 77세,2018,4057,1706,2351,72.6,4046,1701,2345,72.5
39,제주특별자치도,080004, 78세,2018,3563,1422,2141,66.4,3557,1420,2137,66.4
39,제주특별자치도,080005, 79세,2018,3494,1374,2120,64.8,3483,1371,2112,64.9
39,제주특별자치도,085,80~84세,2018,13658,4818,8840,54.5,13620,4798,8822,54.4
39,제주특별자치도,085001, 80세,2018,3227,1240,1987,62.4,3222,1240,1982,62.6
39,제주특별자치도,085002, 81세,2018,2936,1065,1871,56.9,2925,1059,1866,56.8
39,제주특별자치도,085003, 82세,2018,2591,908,1683,54,2581,903,1678,53.8
39,제주특별자치도,085004, 83세,2018,2510,845,1665,50.8,2503,841,1662,50.6
39,제주특별자치도,085005, 84세,2018,2394,760,1634,46.5,2389,755,1634,46.2
39,제주특별자치도,090,85~89세,2018,7173,1691,5482,30.8,7153,1684,5469,30.8
39,제주특별자치도,090001, 85세,2018,2145,587,1558,37.7,2138,585,1553,37.7
39,제주특별자치도,090002, 86세,2018,1646,407,1239,32.8,1641,406,1235,32.9
39,제주특별자치도,090003, 87세,2018,1246,299,947,31.6,1243,299,944,31.7
39,제주특별자치도,090004, 88세,2018,1210,228,982,23.2,1206,225,981,22.9
39,제주특별자치도,090005, 89세,2018,926,170,756,22.5,925,169,756,22.4
39,제주특별자치도,095,90~94세,2018,2030,288,1742,16.5,2023,286,1737,16.5
39,제주특별자치도,095001, 90세,2018,682,98,584,16.8,681,97,584,16.6
39,제주특별자치도,095002, 91세,2018,520,74,446,16.6,518,74,444,16.7
39,제주특별자치도,095003, 92세,2018,364,56,308,18.2,362,55,307,17.9
39,제주특별자치도,095004, 93세,2018,276,29,247,11.7,275,29,246,11.8
39,제주특별자치도,095005, 94세,2018,188,31,157,19.7,187,31,156,19.9
39,제주특별자치도,100,95~99세,2018,1052,92,960,9.6,1051,92,959,9.6
39,제주특별자치도,100001, 95세,2018,476,38,438,8.7,476,38,438,8.7
39,제주특별자치도,100002, 96세,2018,260,31,229,13.5,260,31,229,13.5
39,제주특별자치도,100003, 97세,2018,165,11,154,7.1,165,11,154,7.1
39,제주특별자치도,100004, 98세,2018,90,10,80,12.5,90,10,80,12.5
39,제주특별자치도,100005, 99세,2018,61,X,59,3.4,60,X,58,3.4
39,제주특별자치도,101,100세이상,2018,104,5,99,5.1,103,X,99,4
39,제주특별자치도,102,15세미만,2018,97891,50684,47207,107.4,96918,50187,46731,107.4
39,제주특별자치도,103,15~64세,2018,466945,243532,223413,109,443209,229410,213799,107.3
39,제주특별자치도,104,65세이상,2018,93446,38803,54643,71,92868,38538,54330,70.9
39,제주특별자치도,086,85세이상,2018,10359,2076,8283,25.1,10330,2066,8264,25
39,제주특별자치도,126,평균연령,2018,41.1,39.8,42.5,,41.4,40.1,42.7,
39,제주특별자치도,127,중위연령,2018,42.1,41,43.4,,42.8,41.8,43.9,
39004, 읍부,000,합계,2018,147773,76399,71374,107,138640,70329,68311,103
39004, 읍부,005,0~4세,2018,5222,2750,2472,111.2,5010,2643,2367,111.7
39004, 읍부,005001, 0세,2018,838,409,429,95.3,804,394,410,96.1
39004, 읍부,005002, 1세,2018,930,503,427,117.8,878,481,397,121.2
39004, 읍부,005003, 2세,2018,1099,579,520,111.3,1050,551,499,110.4
39004, 읍부,005004, 3세,2018,1200,652,548,119,1157,628,529,118.7
39004, 읍부,005005, 4세,2018,1155,607,548,110.8,1121,589,532,110.7
39004, 읍부,010,5~9세,2018,6943,3624,3319,109.2,6796,3557,3239,109.8
39004, 읍부,010001, 5세,2018,1315,670,645,103.9,1286,654,632,103.5
39004, 읍부,010002, 6세,2018,1399,741,658,112.6,1365,726,639,113.6
39004, 읍부,010003, 7세,2018,1487,790,697,113.3,1458,779,679,114.7
39004, 읍부,010004, 8세,2018,1343,698,645,108.2,1308,683,625,109.3
39004, 읍부,010005, 9세,2018,1399,725,674,107.6,1379,715,664,107.7
39004, 읍부,015,10~14세,2018,6601,3459,3142,110.1,6478,3394,3084,110.1
39004, 읍부,015001, 10세,2018,1421,719,702,102.4,1386,703,683,102.9
39004, 읍부,015002, 11세,2018,1411,695,716,97.1,1386,679,707,96
39004, 읍부,015003, 12세,2018,1281,703,578,121.6,1259,692,567,122
39004, 읍부,015004, 13세,2018,1207,647,560,115.5,1183,633,550,115.1
39004, 읍부,015005, 14세,2018,1281,695,586,118.6,1264,687,577,119.1
39004, 읍부,020,15~19세,2018,6633,3556,3077,115.6,6403,3450,2953,116.8
39004, 읍부,020001, 15세,2018,1245,672,573,117.3,1230,665,565,117.7
39004, 읍부,020002, 16세,2018,1257,693,564,122.9,1242,686,556,123.4
39004, 읍부,020003, 17세,2018,1413,737,676,109,1385,727,658,110.5
39004, 읍부,020004, 18세,2018,1447,747,700,106.7,1402,722,680,106.2
39004, 읍부,020005, 19세,2018,1271,707,564,125.4,1144,650,494,131.6
39004, 읍부,025,20~24세,2018,7863,4756,3107,153.1,6573,3744,2829,132.3
39004, 읍부,025001, 20세,2018,1445,862,583,147.9,1284,759,525,144.6
39004, 읍부,025002, 21세,2018,1568,998,570,175.1,1376,862,514,167.7
39004, 읍부,025003, 22세,2018,1563,926,637,145.4,1316,730,586,124.6
39004, 읍부,025004, 23세,2018,1572,915,657,139.3,1262,658,604,108.9
39004, 읍부,025005, 24세,2018,1715,1055,660,159.8,1335,735,600,122.5
39004, 읍부,030,25~29세,2018,8369,4940,3429,144.1,6402,3459,2943,117.5
39004, 읍부,030001, 25세,2018,1823,1065,758,140.5,1406,734,672,109.2
39004, 읍부,030002, 26세,2018,1741,1070,671,159.5,1317,741,576,128.6
39004, 읍부,030003, 27세,2018,1640,940,700,134.3,1270,670,600,111.7
39004, 읍부,030004, 28세,2018,1619,936,683,137,1230,649,581,111.7
39004, 읍부,030005, 29세,2018,1546,929,617,150.6,1179,665,514,129.4
39004, 읍부,035,30~34세,2018,7897,4423,3474,127.3,6283,3292,2991,110.1
39004, 읍부,035001, 30세,2018,1437,859,578,148.6,1091,603,488,123.6
39004, 읍부,035002, 31세,2018,1520,865,655,132.1,1189,641,548,117
39004, 읍부,035003, 32세,2018,1539,835,704,118.6,1205,611,594,102.9
39004, 읍부,035004, 33세,2018,1629,899,730,123.2,1297,667,630,105.9
39004, 읍부,035005, 34세,2018,1772,965,807,119.6,1501,770,731,105.3
39004, 읍부,040,35~39세,2018,11062,5849,5213,112.2,9750,4990,4760,104.8
39004, 읍부,040001, 35세,2018,1894,1029,865,119,1619,843,776,108.6
39004, 읍부,040002, 36세,2018,2195,1180,1015,116.3,1905,978,927,105.5
39004, 읍부,040003, 37세,2018,2300,1215,1085,112,2019,1037,982,105.6
39004, 읍부,040004, 38세,2018,2333,1216,1117,108.9,2093,1056,1037,101.8
39004, 읍부,040005, 39세,2018,2340,1209,1131,106.9,2114,1076,1038,103.7
39004, 읍부,045,40~44세,2018,11304,6202,5102,121.6,10511,5716,4795,119.2
39004, 읍부,045001, 40세,2018,2077,1126,951,118.4,1887,1005,882,113.9
39004, 읍부,045002, 41세,2018,2187,1202,985,122,2041,1109,932,119
39004, 읍부,045003, 42세,2018,2166,1201,965,124.5,1989,1089,900,121
39004, 읍부,045004, 43세,2018,2299,1248,1051,118.7,2157,1162,995,116.8
39004, 읍부,045005, 44세,2018,2575,1425,1150,123.9,2437,1351,1086,124.4
39004, 읍부,050,45~49세,2018,12660,6988,5672,123.2,12147,6696,5451,122.8
39004, 읍부,050001, 45세,2018,2413,1310,1103,118.8,2293,1244,1049,118.6
39004, 읍부,050002, 46세,2018,2526,1390,1136,122.4,2406,1320,1086,121.5
39004, 읍부,050003, 47세,2018,2735,1525,1210,126,2637,1469,1168,125.8
39004, 읍부,050004, 48세,2018,2502,1393,1109,125.6,2413,1340,1073,124.9
39004, 읍부,050005, 49세,2018,2484,1370,1114,123,2398,1323,1075,123.1
39004, 읍부,055,50~54세,2018,12049,6561,5488,119.6,11707,6384,5323,119.9
39004, 읍부,055001, 50세,2018,2578,1410,1168,120.7,2485,1360,1125,120.9
39004, 읍부,055002, 51세,2018,2305,1253,1052,119.1,2232,1214,1018,119.3
39004, 읍부,055003, 52세,2018,2462,1347,1115,120.8,2393,1309,1084,120.8
39004, 읍부,055004, 53세,2018,2331,1247,1084,115,2280,1221,1059,115.3
39004, 읍부,055005, 54세,2018,2373,1304,1069,122,2317,1280,1037,123.4
39004, 읍부,060,55~59세,2018,12319,6411,5908,108.5,12070,6283,5787,108.6
39004, 읍부,060001, 55세,2018,2530,1352,1178,114.8,2474,1323,1151,114.9
39004, 읍부,060002, 56세,2018,2486,1288,1198,107.5,2422,1254,1168,107.4
39004, 읍부,060003, 57세,2018,2404,1243,1161,107.1,2367,1223,1144,106.9
39004, 읍부,060004, 58세,2018,2579,1337,1242,107.6,2524,1307,1217,107.4
39004, 읍부,060005, 59세,2018,2320,1191,1129,105.5,2283,1176,1107,106.2
39004, 읍부,065,60~64세,2018,10373,5350,5023,106.5,10181,5264,4917,107.1
39004, 읍부,065001, 60세,2018,2245,1180,1065,110.8,2199,1162,1037,112.1
39004, 읍부,065002, 61세,2018,2189,1147,1042,110.1,2148,1129,1019,110.8
39004, 읍부,065003, 62세,2018,2031,1048,983,106.6,1995,1031,964,107
39004, 읍부,065004, 63세,2018,2161,1067,1094,97.5,2133,1057,1076,98.2
39004, 읍부,065005, 64세,2018,1747,908,839,108.2,1706,885,821,107.8
39004, 읍부,070,65~69세,2018,7089,3447,3642,94.6,7001,3407,3594,94.8
39004, 읍부,070001, 65세,2018,1424,708,716,98.9,1401,693,708,97.9
39004, 읍부,070002, 66세,2018,1562,764,798,95.7,1549,760,789,96.3
39004, 읍부,070003, 67세,2018,1378,693,685,101.2,1362,686,676,101.5
39004, 읍부,070004, 68세,2018,1286,587,699,84,1271,580,691,83.9
39004, 읍부,070005, 69세,2018,1439,695,744,93.4,1418,688,730,94.2
39004, 읍부,075,70~74세,2018,6742,3192,3550,89.9,6710,3171,3539,89.6
39004, 읍부,075001, 70세,2018,1463,727,736,98.8,1455,724,731,99
39004, 읍부,075002, 71세,2018,1481,723,758,95.4,1470,716,754,95
39004, 읍부,075003, 72세,2018,1363,641,722,88.8,1360,638,722,88.4
39004, 읍부,075004, 73세,2018,1219,566,653,86.7,1214,563,651,86.5
39004, 읍부,075005, 74세,2018,1216,535,681,78.6,1211,530,681,77.8
39004, 읍부,080,75~79세,2018,6263,2580,3683,70.1,6255,2577,3678,70.1
39004, 읍부,080001, 75세,2018,1224,519,705,73.6,1222,517,705,73.3
39004, 읍부,080002, 76세,2018,1318,593,725,81.8,1316,593,723,82
39004, 읍부,080003, 77세,2018,1314,538,776,69.3,1312,537,775,69.3
39004, 읍부,080004, 78세,2018,1207,449,758,59.2,1206,449,757,59.3
39004, 읍부,080005, 79세,2018,1200,481,719,66.9,1199,481,718,67
39004, 읍부,085,80~84세,2018,4699,1580,3119,50.7,4685,1573,3112,50.5
39004, 읍부,085001, 80세,2018,1130,413,717,57.6,1128,413,715,57.8
39004, 읍부,085002, 81세,2018,979,347,632,54.9,976,346,630,54.9
39004, 읍부,085003, 82세,2018,901,301,600,50.2,896,298,598,49.8
39004, 읍부,085004, 83세,2018,832,272,560,48.6,831,272,559,48.7
39004, 읍부,085005, 84세,2018,857,247,610,40.5,854,244,610,40
39004, 읍부,090,85~89세,2018,2589,591,1998,29.6,2585,590,1995,29.6
39004, 읍부,090001, 85세,2018,773,203,570,35.6,771,202,569,35.5
39004, 읍부,090002, 86세,2018,636,145,491,29.5,635,145,490,29.6
39004, 읍부,090003, 87세,2018,426,97,329,29.5,425,97,328,29.6
39004, 읍부,090004, 88세,2018,440,81,359,22.6,440,81,359,22.6
39004, 읍부,090005, 89세,2018,314,65,249,26.1,314,65,249,26.1
39004, 읍부,095,90~94세,2018,686,107,579,18.5,684,106,578,18.3
39004, 읍부,095001, 90세,2018,227,38,189,20.1,227,38,189,20.1
39004, 읍부,095002, 91세,2018,186,21,165,12.7,185,21,164,12.8
39004, 읍부,095003, 92세,2018,119,27,92,29.3,118,26,92,28.3
39004, 읍부,095004, 93세,2018,99,10,89,11.2,99,10,89,11.2
39004, 읍부,095005, 94세,2018,55,11,44,25,55,11,44,25
39004, 읍부,100,95~99세,2018,376,32,344,9.3,375,32,343,9.3
39004, 읍부,100001, 95세,2018,165,13,152,8.6,165,13,152,8.6
39004, 읍부,100002, 96세,2018,97,13,84,15.5,97,13,84,15.5
39004, 읍부,100003, 97세,2018,56,X,53,5.7,56,X,53,5.7
39004, 읍부,100004, 98세,2018,36,X,33,9.1,36,X,33,9.1
39004, 읍부,100005, 99세,2018,22,X,22,0,21,X,21,0
39004, 읍부,101,100세이상,2018,34,X,33,3,34,X,33,3
39004, 읍부,102,15세미만,2018,18766,9833,8933,110.1,18284,9594,8690,110.4
39004, 읍부,103,15~64세,2018,100529,55036,45493,121,92027,49278,42749,115.3
39004, 읍부,104,65세이상,2018,28478,11530,16948,68,28329,11457,16872,67.9
39004, 읍부,086,85세이상,2018,3685,731,2954,24.7,3678,729,2949,24.7
39004, 읍부,126,평균연령,2018,44.5,42.5,46.7,,45.3,43.4,47.3,
39004, 읍부,127,중위연령,2018,45.8,44,47.9,,47.2,45.7,48.8,
39005, 면부,000,합계,2018,35323,18331,16992,107.9,33305,16969,16336,103.9
39005, 면부,005,0~4세,2018,1093,531,562,94.5,1083,524,559,93.7
39005, 면부,005001, 0세,2018,181,89,92,96.7,178,86,92,93.5
39005, 면부,005002, 1세,2018,209,95,114,83.3,207,94,113,83.2
39005, 면부,005003, 2세,2018,221,98,123,79.7,220,98,122,80.3
39005, 면부,005004, 3세,2018,245,122,123,99.2,242,120,122,98.4
39005, 면부,005005, 4세,2018,237,127,110,115.5,236,126,110,114.5
39005, 면부,010,5~9세,2018,1356,717,639,112.2,1345,714,631,113.2
39005, 면부,010001, 5세,2018,258,143,115,124.3,257,142,115,123.5
39005, 면부,010002, 6세,2018,280,141,139,101.4,279,141,138,102.2
39005, 면부,010003, 7세,2018,294,153,141,108.5,291,153,138,110.9
39005, 면부,010004, 8세,2018,274,157,117,134.2,272,157,115,136.5
39005, 면부,010005, 9세,2018,250,123,127,96.9,246,121,125,96.8
39005, 면부,015,10~14세,2018,1203,660,543,121.5,1192,658,534,123.2
39005, 면부,015001, 10세,2018,278,146,132,110.6,273,146,127,115
39005, 면부,015002, 11세,2018,268,155,113,137.2,267,155,112,138.4
39005, 면부,015003, 12세,2018,208,118,90,131.1,206,116,90,128.9
39005, 면부,015004, 13세,2018,223,109,114,95.6,223,109,114,95.6
39005, 면부,015005, 14세,2018,226,132,94,140.4,223,132,91,145.1
39005, 면부,020,15~19세,2018,1317,684,633,108.1,1290,670,620,108.1
39005, 면부,020001, 15세,2018,229,111,118,94.1,225,109,116,94
39005, 면부,020002, 16세,2018,242,141,101,139.6,238,139,99,140.4
39005, 면부,020003, 17세,2018,296,147,149,98.7,293,146,147,99.3
39005, 면부,020004, 18세,2018,307,152,155,98.1,305,151,154,98.1
39005, 면부,020005, 19세,2018,243,133,110,120.9,229,125,104,120.2
39005, 면부,025,20~24세,2018,1989,1127,862,130.7,1712,933,779,119.8
39005, 면부,025001, 20세,2018,322,189,133,142.1,303,181,122,148.4
39005, 면부,025002, 21세,2018,362,200,162,123.5,323,173,150,115.3
39005, 면부,025003, 22세,2018,415,230,185,124.3,348,186,162,114.8
39005, 면부,025004, 23세,2018,417,229,188,121.8,351,181,170,106.5
39005, 면부,025005, 24세,2018,473,279,194,143.8,387,212,175,121.1
39005, 면부,030,25~29세,2018,2228,1290,938,137.5,1797,963,834,115.5
39005, 면부,030001, 25세,2018,475,275,200,137.5,392,206,186,110.8
39005, 면부,030002, 26세,2018,480,286,194,147.4,395,223,172,129.7
39005, 면부,030003, 27세,2018,447,262,185,141.6,366,196,170,115.3
39005, 면부,030004, 28세,2018,427,244,183,133.3,335,179,156,114.7
39005, 면부,030005, 29세,2018,399,223,176,126.7,309,159,150,106
39005, 면부,035,30~34세,2018,1812,1070,742,144.2,1385,772,613,125.9
39005, 면부,035001, 30세,2018,350,207,143,144.8,260,149,111,134.2
39005, 면부,035002, 31세,2018,350,215,135,159.3,262,148,114,129.8
39005, 면부,035003, 32세,2018,357,207,150,138,269,148,121,122.3
39005, 면부,035004, 33세,2018,379,222,157,141.4,291,156,135,115.6
39005, 면부,035005, 34세,2018,376,219,157,139.5,303,171,132,129.5
39005, 면부,040,35~39세,2018,2389,1327,1062,125,2069,1101,968,113.7
39005, 면부,040001, 35세,2018,431,244,187,130.5,363,198,165,120
39005, 면부,040002, 36세,2018,450,256,194,132,377,199,178,111.8
39005, 면부,040003, 37세,2018,488,278,210,132.4,438,242,196,123.5
39005, 면부,040004, 38세,2018,506,286,220,130,434,236,198,119.2
39005, 면부,040005, 39세,2018,514,263,251,104.8,457,226,231,97.8
39005, 면부,045,40~44세,2018,2509,1482,1027,144.3,2321,1367,954,143.3
39005, 면부,045001, 40세,2018,456,267,189,141.3,410,240,170,141.2
39005, 면부,045002, 41세,2018,512,279,233,119.7,468,253,215,117.7
39005, 면부,045003, 42세,2018,521,308,213,144.6,481,287,194,147.9
39005, 면부,045004, 43세,2018,466,286,180,158.9,436,265,171,155
39005, 면부,045005, 44세,2018,554,342,212,161.3,526,322,204,157.8
39005, 면부,050,45~49세,2018,2887,1689,1198,141,2756,1607,1149,139.9
39005, 면부,050001, 45세,2018,541,324,217,149.3,515,305,210,145.2
39005, 면부,050002, 46세,2018,566,344,222,155,531,321,210,152.9
39005, 면부,050003, 47세,2018,620,347,273,127.1,595,329,266,123.7
39005, 면부,050004, 48세,2018,562,323,239,135.1,539,313,226,138.5
39005, 면부,050005, 49세,2018,598,351,247,142.1,576,339,237,143
39005, 면부,055,50~54세,2018,2926,1614,1312,123,2852,1578,1274,123.9
39005, 면부,055001, 50세,2018,639,357,282,126.6,619,346,273,126.7
39005, 면부,055002, 51세,2018,549,282,267,105.6,532,272,260,104.6
39005, 면부,055003, 52세,2018,577,323,254,127.2,562,320,242,132.2
39005, 면부,055004, 53세,2018,589,332,257,129.2,574,323,251,128.7
39005, 면부,055005, 54세,2018,572,320,252,127,565,317,248,127.8
39005, 면부,060,55~59세,2018,3098,1653,1445,114.4,3038,1623,1415,114.7
39005, 면부,060001, 55세,2018,661,362,299,121.1,645,354,291,121.6
39005, 면부,060002, 56세,2018,638,337,301,112,617,326,291,112
39005, 면부,060003, 57세,2018,598,321,277,115.9,589,316,273,115.8
39005, 면부,060004, 58세,2018,600,322,278,115.8,593,319,274,116.4
39005, 면부,060005, 59세,2018,601,311,290,107.2,594,308,286,107.7
39005, 면부,065,60~64세,2018,2784,1388,1396,99.4,2751,1370,1381,99.2
39005, 면부,065001, 60세,2018,608,317,291,108.9,599,310,289,107.3
39005, 면부,065002, 61세,2018,594,300,294,102,587,298,289,103.1
39005, 면부,065003, 62세,2018,569,284,285,99.6,562,280,282,99.3
39005, 면부,065004, 63세,2018,529,260,269,96.7,526,257,269,95.5
39005, 면부,065005, 64세,2018,484,227,257,88.3,477,225,252,89.3
39005, 면부,070,65~69세,2018,1973,974,999,97.5,1961,968,993,97.5
39005, 면부,070001, 65세,2018,388,184,204,90.2,386,182,204,89.2
39005, 면부,070002, 66세,2018,417,208,209,99.5,410,205,205,100
39005, 면부,070003, 67세,2018,377,206,171,120.5,375,205,170,120.6
39005, 면부,070004, 68세,2018,396,189,207,91.3,395,189,206,91.7
39005, 면부,070005, 69세,2018,395,187,208,89.9,395,187,208,89.9
39005, 면부,075,70~74세,2018,1811,853,958,89,1809,852,957,89
39005, 면부,075001, 70세,2018,432,217,215,100.9,432,217,215,100.9
39005, 면부,075002, 71세,2018,375,182,193,94.3,375,182,193,94.3
39005, 면부,075003, 72세,2018,353,169,184,91.8,353,169,184,91.8
39005, 면부,075004, 73세,2018,309,144,165,87.3,307,143,164,87.2
39005, 면부,075005, 74세,2018,342,141,201,70.1,342,141,201,70.1
39005, 면부,080,75~79세,2018,1717,686,1031,66.5,1713,683,1030,66.3
39005, 면부,080001, 75세,2018,328,130,198,65.7,328,130,198,65.7
39005, 면부,080002, 76세,2018,374,173,201,86.1,371,171,200,85.5
39005, 면부,080003, 77세,2018,388,155,233,66.5,388,155,233,66.5
39005, 면부,080004, 78세,2018,303,115,188,61.2,302,114,188,60.6
39005, 면부,080005, 79세,2018,324,113,211,53.6,324,113,211,53.6
39005, 면부,085,80~84세,2018,1321,423,898,47.1,1321,423,898,47.1
39005, 면부,085001, 80세,2018,327,104,223,46.6,327,104,223,46.6
39005, 면부,085002, 81세,2018,276,86,190,45.3,276,86,190,45.3
39005, 면부,085003, 82세,2018,249,92,157,58.6,249,92,157,58.6
39005, 면부,085004, 83세,2018,255,85,170,50,255,85,170,50
39005, 면부,085005, 84세,2018,214,56,158,35.4,214,56,158,35.4
39005, 면부,090,85~89세,2018,649,142,507,28,649,142,507,28
39005, 면부,090001, 85세,2018,196,50,146,34.2,196,50,146,34.2
39005, 면부,090002, 86세,2018,152,40,112,35.7,152,40,112,35.7
39005, 면부,090003, 87세,2018,113,18,95,18.9,113,18,95,18.9
39005, 면부,090004, 88세,2018,101,18,83,21.7,101,18,83,21.7
39005, 면부,090005, 89세,2018,87,16,71,22.5,87,16,71,22.5
39005, 면부,095,90~94세,2018,158,16,142,11.3,158,16,142,11.3
39005, 면부,095001, 90세,2018,52,8,44,18.2,52,8,44,18.2
39005, 면부,095002, 91세,2018,44,5,39,12.8,44,5,39,12.8
39005, 면부,095003, 92세,2018,27,X,25,8,27,X,25,8
39005, 면부,095004, 93세,2018,21,X,20,5,21,X,20,5
39005, 면부,095005, 94세,2018,14,X,14,0,14,X,14,0
39005, 면부,100,95~99세,2018,93,X,89,4.5,93,X,89,4.5
39005, 면부,100001, 95세,2018,56,X,54,3.7,56,X,54,3.7
39005, 면부,100002, 96세,2018,17,X,15,13.3,17,X,15,13.3
39005, 면부,100003, 97세,2018,11,X,11,0,11,X,11,0
39005, 면부,100004, 98세,2018,5,X,5,0,5,X,5,0
39005, 면부,100005, 99세,2018,X,X,X,0,X,X,X,0
39005, 면부,101,100세이상,2018,10,X,9,11.1,10,X,9,11.1
39005, 면부,102,15세미만,2018,3652,1908,1744,109.4,3620,1896,1724,110
39005, 면부,103,15~64세,2018,23939,13324,10615,125.5,21971,11984,9987,120
39005, 면부,104,65세이상,2018,7732,3099,4633,66.9,7714,3089,4625,66.8
39005, 면부,086,85세이상,2018,910,163,747,21.8,910,163,747,21.8
39005, 면부,126,평균연령,2018,46.5,44.3,48.9,,47.2,45.1,49.4,
39005, 면부,127,중위연령,2018,48.1,45.9,51,,49.5,47.5,52,
39003, 동부,000,합계,2018,475186,238289,236897,100.6,461050,230837,230213,100.3
39003, 동부,005,0~4세,2018,22839,11773,11066,106.4,22620,11656,10964,106.3
39003, 동부,005001, 0세,2018,3940,2050,1890,108.5,3897,2028,1869,108.5
39003, 동부,005002, 1세,2018,4230,2189,2041,107.3,4172,2164,2008,107.8
39003, 동부,005003, 2세,2018,4699,2449,2250,108.8,4655,2425,2230,108.7
39003, 동부,005004, 3세,2018,4864,2493,2371,105.1,4832,2476,2356,105.1
39003, 동부,005005, 4세,2018,5106,2592,2514,103.1,5064,2563,2501,102.5
39003, 동부,010,5~9세,2018,26374,13510,12864,105,26237,13436,12801,105
39003, 동부,010001, 5세,2018,5049,2565,2484,103.3,5013,2543,2470,103
39003, 동부,010002, 6세,2018,5638,2830,2808,100.8,5613,2816,2797,100.7
39003, 동부,010003, 7세,2018,5386,2762,2624,105.3,5365,2751,2614,105.2
39003, 동부,010004, 8세,2018,5279,2766,2513,110.1,5254,2749,2505,109.7
39003, 동부,010005, 9세,2018,5022,2587,2435,106.2,4992,2577,2415,106.7
39003, 동부,015,10~14세,2018,26260,13660,12600,108.4,26157,13605,12552,108.4
39003, 동부,015001, 10세,2018,5226,2685,2541,105.7,5199,2670,2529,105.6
39003, 동부,015002, 11세,2018,5603,2881,2722,105.8,5582,2870,2712,105.8
39003, 동부,015003, 12세,2018,5094,2611,2483,105.2,5075,2602,2473,105.2
39003, 동부,015004, 13세,2018,4994,2689,2305,116.7,4973,2679,2294,116.8
39003, 동부,015005, 14세,2018,5343,2794,2549,109.6,5328,2784,2544,109.4
39003, 동부,020,15~19세,2018,28751,15058,13693,110,28334,14839,13495,110
39003, 동부,020001, 15세,2018,5541,2882,2659,108.4,5521,2873,2648,108.5
39003, 동부,020002, 16세,2018,5378,2844,2534,112.2,5360,2833,2527,112.1
39003, 동부,020003, 17세,2018,6079,3212,2867,112,6030,3192,2838,112.5
39003, 동부,020004, 18세,2018,6401,3312,3089,107.2,6280,3250,3030,107.3
39003, 동부,020005, 19세,2018,5352,2808,2544,110.4,5143,2691,2452,109.7
39003, 동부,025,20~24세,2018,30853,16632,14221,117,28619,15335,13284,115.4
39003, 동부,025001, 20세,2018,5725,3142,2583,121.6,5348,2936,2412,121.7
39003, 동부,025002, 21세,2018,6225,3511,2714,129.4,5796,3263,2533,128.8
39003, 동부,025003, 22세,2018,6117,3338,2779,120.1,5666,3065,2601,117.8
39003, 동부,025004, 23세,2018,6329,3290,3039,108.3,5833,3000,2833,105.9
39003, 동부,025005, 24세,2018,6457,3351,3106,107.9,5976,3071,2905,105.7
39003, 동부,030,25~29세,2018,30191,15623,14568,107.2,27564,14127,13437,105.1
39003, 동부,030001, 25세,2018,6486,3349,3137,106.8,5997,3040,2957,102.8
39003, 동부,030002, 26세,2018,6454,3422,3032,112.9,5959,3118,2841,109.8
39003, 동부,030003, 27세,2018,5968,3091,2877,107.4,5489,2823,2666,105.9
39003, 동부,030004, 28세,2018,5790,3014,2776,108.6,5198,2688,2510,107.1
39003, 동부,030005, 29세,2018,5493,2747,2746,100,4921,2458,2463,99.8
39003, 동부,035,30~34세,2018,29478,14993,14485,103.5,27058,13745,13313,103.2
39003, 동부,035001, 30세,2018,5344,2773,2571,107.9,4818,2482,2336,106.3
39003, 동부,035002, 31세,2018,5764,2905,2859,101.6,5191,2648,2543,104.1
39003, 동부,035003, 32세,2018,5808,2991,2817,106.2,5328,2731,2597,105.2
39003, 동부,035004, 33세,2018,6046,3079,2967,103.8,5640,2861,2779,103
39003, 동부,035005, 34세,2018,6516,3245,3271,99.2,6081,3023,3058,98.9
39003, 동부,040,35~39세,2018,39539,19862,19677,100.9,37662,18933,18729,101.1
39003, 동부,040001, 35세,2018,7187,3574,3613,98.9,6826,3397,3429,99.1
39003, 동부,040002, 36세,2018,8130,4063,4067,99.9,7699,3851,3848,100.1
39003, 동부,040003, 37세,2018,8098,4111,3987,103.1,7739,3915,3824,102.4
39003, 동부,040004, 38세,2018,8118,4124,3994,103.3,7755,3947,3808,103.7
39003, 동부,040005, 39세,2018,8006,3990,4016,99.4,7643,3823,3820,100.1
39003, 동부,045,40~44세,2018,38009,19311,18698,103.3,36769,18734,18035,103.9
39003, 동부,045001, 40세,2018,6955,3439,3516,97.8,6633,3284,3349,98.1
39003, 동부,045002, 41세,2018,7393,3705,3688,100.5,7130,3594,3536,101.6
39003, 동부,045003, 42세,2018,7400,3871,3529,109.7,7183,3768,3415,110.3
39003, 동부,045004, 43세,2018,7661,3897,3764,103.5,7436,3797,3639,104.3
39003, 동부,045005, 44세,2018,8600,4399,4201,104.7,8387,4291,4096,104.8
39003, 동부,050,45~49세,2018,44384,22478,21906,102.6,43459,21966,21493,102.2
39003, 동부,050001, 45세,2018,8723,4343,4380,99.2,8509,4224,4285,98.6
39003, 동부,050002, 46세,2018,8999,4517,4482,100.8,8825,4424,4401,100.5
39003, 동부,050003, 47세,2018,9314,4756,4558,104.3,9116,4642,4474,103.8
39003, 동부,050004, 48세,2018,8834,4460,4374,102,8644,4359,4285,101.7
39003, 동부,050005, 49세,2018,8514,4402,4112,107.1,8365,4317,4048,106.6
39003, 동부,055,50~54세,2018,38164,19617,18547,105.8,37537,19291,18246,105.7
39003, 동부,055001, 50세,2018,8358,4263,4095,104.1,8212,4179,4033,103.6
39003, 동부,055002, 51세,2018,7664,3959,3705,106.9,7542,3897,3645,106.9
39003, 동부,055003, 52세,2018,7824,4086,3738,109.3,7710,4032,3678,109.6
39003, 동부,055004, 53세,2018,7184,3684,3500,105.3,7054,3612,3442,104.9
39003, 동부,055005, 54세,2018,7134,3625,3509,103.3,7019,3571,3448,103.6
39003, 동부,060,55~59세,2018,35556,17895,17661,101.3,35074,17655,17419,101.4
39003, 동부,060001, 55세,2018,7602,3830,3772,101.5,7472,3774,3698,102.1
39003, 동부,060002, 56세,2018,7106,3647,3459,105.4,7019,3598,3421,105.2
39003, 동부,060003, 57세,2018,7131,3540,3591,98.6,7051,3500,3551,98.6
39003, 동부,060004, 58세,2018,7226,3644,3582,101.7,7126,3592,3534,101.6
39003, 동부,060005, 59세,2018,6491,3234,3257,99.3,6406,3191,3215,99.3
39003, 동부,065,60~64세,2018,27552,13703,13849,98.9,27135,13523,13612,99.3
39003, 동부,065001, 60세,2018,6078,3075,3003,102.4,5993,3043,2950,103.2
39003, 동부,065002, 61세,2018,5865,2922,2943,99.3,5776,2881,2895,99.5
39003, 동부,065003, 62세,2018,5591,2794,2797,99.9,5501,2755,2746,100.3
39003, 동부,065004, 63세,2018,5560,2714,2846,95.4,5480,2679,2801,95.6
39003, 동부,065005, 64세,2018,4458,2198,2260,97.3,4385,2165,2220,97.5
39003, 동부,070,65~69세,2018,17616,8380,9236,90.7,17408,8293,9115,91
39003, 동부,070001, 65세,2018,3730,1768,1962,90.1,3685,1745,1940,89.9
39003, 동부,070002, 66세,2018,3901,1892,2009,94.2,3858,1879,1979,94.9
39003, 동부,070003, 67세,2018,3346,1606,1740,92.3,3290,1582,1708,92.6
39003, 동부,070004, 68세,2018,3373,1590,1783,89.2,3344,1578,1766,89.4
39003, 동부,070005, 69세,2018,3266,1524,1742,87.5,3231,1509,1722,87.6
39003, 동부,075,70~74세,2018,14861,6952,7909,87.9,14748,6897,7851,87.8
39003, 동부,075001, 70세,2018,3498,1671,1827,91.5,3468,1656,1812,91.4
39003, 동부,075002, 71세,2018,3312,1530,1782,85.9,3287,1519,1768,85.9
39003, 동부,075003, 72세,2018,2798,1293,1505,85.9,2772,1280,1492,85.8
39003, 동부,075004, 73세,2018,2643,1251,1392,89.9,2627,1241,1386,89.5
39003, 동부,075005, 74세,2018,2610,1207,1403,86,2594,1201,1393,86.2
39003, 동부,080,75~79세,2018,11357,4845,6512,74.4,11313,4826,6487,74.4
39003, 동부,080001, 75세,2018,2426,1096,1330,82.4,2412,1087,1325,82
39003, 동부,080002, 76세,2018,2553,1098,1455,75.5,2546,1096,1450,75.6
39003, 동부,080003, 77세,2018,2355,1013,1342,75.5,2346,1009,1337,75.5
39003, 동부,080004, 78세,2018,2053,858,1195,71.8,2049,857,1192,71.9
39003, 동부,080005, 79세,2018,1970,780,1190,65.5,1960,777,1183,65.7
39003, 동부,085,80~84세,2018,7638,2815,4823,58.4,7614,2802,4812,58.2
39003, 동부,085001, 80세,2018,1770,723,1047,69.1,1767,723,1044,69.3
39003, 동부,085002, 81세,2018,1681,632,1049,60.2,1673,627,1046,59.9
39003, 동부,085003, 82세,2018,1441,515,926,55.6,1436,513,923,55.6
39003, 동부,085004, 83세,2018,1423,488,935,52.2,1417,484,933,51.9
39003, 동부,085005, 84세,2018,1323,457,866,52.8,1321,455,866,52.5
39003, 동부,090,85~89세,2018,3935,958,2977,32.2,3919,952,2967,32.1
39003, 동부,090001, 85세,2018,1176,334,842,39.7,1171,333,838,39.7
39003, 동부,090002, 86세,2018,858,222,636,34.9,854,221,633,34.9
39003, 동부,090003, 87세,2018,707,184,523,35.2,705,184,521,35.3
39003, 동부,090004, 88세,2018,669,129,540,23.9,665,126,539,23.4
39003, 동부,090005, 89세,2018,525,89,436,20.4,524,88,436,20.2
39003, 동부,095,90~94세,2018,1186,165,1021,16.2,1181,164,1017,16.1
39003, 동부,095001, 90세,2018,403,52,351,14.8,402,51,351,14.5
39003, 동부,095002, 91세,2018,290,48,242,19.8,289,48,241,19.9
39003, 동부,095003, 92세,2018,218,27,191,14.1,217,27,190,14.2
39003, 동부,095004, 93세,2018,156,18,138,13,155,18,137,13.1
39003, 동부,095005, 94세,2018,119,20,99,20.2,118,20,98,20.4
39003, 동부,100,95~99세,2018,583,56,527,10.6,583,56,527,10.6
39003, 동부,100001, 95세,2018,255,23,232,9.9,255,23,232,9.9
39003, 동부,100002, 96세,2018,146,16,130,12.3,146,16,130,12.3
39003, 동부,100003, 97세,2018,98,8,90,8.9,98,8,90,8.9
39003, 동부,100004, 98세,2018,49,7,42,16.7,49,7,42,16.7
39003, 동부,100005, 99세,2018,35,X,33,6.1,35,X,33,6.1
39003, 동부,101,100세이상,2018,60,X,57,5.3,59,X,57,3.5
39003, 동부,102,15세미만,2018,75473,38943,36530,106.6,75014,38697,36317,106.6
39003, 동부,103,15~64세,2018,342477,175172,167305,104.7,329211,168148,161063,104.4
39003, 동부,104,65세이상,2018,57236,24174,33062,73.1,56825,23992,32833,73.1
39003, 동부,086,85세이상,2018,5764,1182,4582,25.8,5742,1174,4568,25.7
39003, 동부,126,평균연령,2018,39.6,38.5,40.7,,39.8,38.7,40.9,
39003, 동부,127,중위연령,2018,40.5,39.5,41.5,,40.9,39.9,41.9,
39010, 제주시,000,합계,2018,482932,243656,239276,101.8,465700,233760,231940,100.8
39010, 제주시,005,0~4세,2018,22137,11478,10659,107.7,21910,11358,10552,107.6
39010, 제주시,005001, 0세,2018,3832,1980,1852,106.9,3785,1956,1829,106.9
39010, 제주시,005002, 1세,2018,4043,2115,1928,109.7,3990,2093,1897,110.3
39010, 제주시,005003, 2세,2018,4531,2350,2181,107.7,4482,2326,2156,107.9
39010, 제주시,005004, 3세,2018,4733,2469,2264,109.1,4700,2448,2252,108.7
39010, 제주시,005005, 4세,2018,4998,2564,2434,105.3,4953,2535,2418,104.8
39010, 제주시,010,5~9세,2018,26122,13455,12667,106.2,25977,13377,12600,106.2
39010, 제주시,010001, 5세,2018,5041,2598,2443,106.3,5005,2573,2432,105.8
39010, 제주시,010002, 6세,2018,5545,2775,2770,100.2,5517,2761,2756,100.2
39010, 제주시,010003, 7세,2018,5358,2747,2611,105.2,5337,2738,2599,105.3
39010, 제주시,010004, 8세,2018,5164,2730,2434,112.2,5136,2712,2424,111.9
39010, 제주시,010005, 9세,2018,5014,2605,2409,108.1,4982,2593,2389,108.5
39010, 제주시,015,10~14세,2018,25620,13368,12252,109.1,25499,13294,12205,108.9
39010, 제주시,015001, 10세,2018,5104,2624,2480,105.8,5074,2607,2467,105.7
39010, 제주시,015002, 11세,2018,5464,2814,2650,106.2,5437,2798,2639,106
39010, 제주시,015003, 12세,2018,4967,2566,2401,106.9,4945,2555,2390,106.9
39010, 제주시,015004, 13세,2018,4875,2628,2247,117,4854,2613,2241,116.6
39010, 제주시,015005, 14세,2018,5210,2736,2474,110.6,5189,2721,2468,110.3
39010, 제주시,020,15~19세,2018,28426,14949,13477,110.9,27850,14664,13186,111.2
39010, 제주시,020001, 15세,2018,5439,2825,2614,108.1,5414,2814,2600,108.2
39010, 제주시,020002, 16세,2018,5189,2776,2413,115,5164,2763,2401,115.1
39010, 제주시,020003, 17세,2018,5921,3088,2833,109,5851,3062,2789,109.8
39010, 제주시,020004, 18세,2018,6269,3283,2986,109.9,6115,3201,2914,109.8
39010, 제주시,020005, 19세,2018,5608,2977,2631,113.2,5306,2824,2482,113.8
39010, 제주시,025,20~24세,2018,31704,17379,14325,121.3,28856,15537,13319,116.7
39010, 제주시,025001, 20세,2018,6025,3302,2723,121.3,5557,3030,2527,119.9
39010, 제주시,025002, 21세,2018,6376,3633,2743,132.4,5862,3322,2540,130.8
39010, 제주시,025003, 22세,2018,6287,3452,2835,121.8,5722,3081,2641,116.7
39010, 제주시,025004, 23세,2018,6394,3413,2981,114.5,5754,2983,2771,107.7
39010, 제주시,025005, 24세,2018,6622,3579,3043,117.6,5961,3121,2840,109.9
39010, 제주시,030,25~29세,2018,30592,16250,14342,113.3,27139,14072,13067,107.7
39010, 제주시,030001, 25세,2018,6681,3545,3136,113,5980,3063,2917,105
39010, 제주시,030002, 26세,2018,6484,3559,2925,121.7,5805,3109,2696,115.3
39010, 제주시,030003, 27세,2018,6068,3210,2858,112.3,5428,2818,2610,108
39010, 제주시,030004, 28세,2018,5831,3097,2734,113.3,5092,2638,2454,107.5
39010, 제주시,030005, 29세,2018,5528,2839,2689,105.6,4834,2444,2390,102.3
39010, 제주시,035,30~34세,2018,29569,15306,14263,107.3,26650,13629,13021,104.7
39010, 제주시,035001, 30세,2018,5385,2830,2555,110.8,4755,2447,2308,106
39010, 제주시,035002, 31세,2018,5758,2976,2782,107,5103,2647,2456,107.8
39010, 제주시,035003, 32세,2018,5819,3027,2792,108.4,5228,2682,2546,105.3
39010, 제주시,035004, 33세,2018,6089,3160,2929,107.9,5557,2833,2724,104
39010, 제주시,035005, 34세,2018,6518,3313,3205,103.4,6007,3020,2987,101.1
39010, 제주시,040,35~39세,2018,39746,20158,19588,102.9,37428,18885,18543,101.8
39010, 제주시,040001, 35세,2018,7188,3646,3542,102.9,6730,3391,3339,101.6
39010, 제주시,040002, 36세,2018,8138,4141,3997,103.6,7612,3836,3776,101.6
39010, 제주시,040003, 37세,2018,8077,4119,3958,104.1,7619,3859,3760,102.6
39010, 제주시,040004, 38세,2018,8228,4214,4014,105,7780,3961,3819,103.7
39010, 제주시,040005, 39세,2018,8115,4038,4077,99,7687,3838,3849,99.7
39010, 제주시,045,40~44세,2018,38338,19737,18601,106.1,36877,18987,17890,106.1
39010, 제주시,045001, 40세,2018,7094,3561,3533,100.8,6719,3366,3353,100.4
39010, 제주시,045002, 41세,2018,7511,3851,3660,105.2,7219,3709,3510,105.7
39010, 제주시,045003, 42세,2018,7341,3909,3432,113.9,7067,3769,3298,114.3
39010, 제주시,045004, 43세,2018,7735,3935,3800,103.6,7466,3798,3668,103.5
39010, 제주시,045005, 44세,2018,8657,4481,4176,107.3,8406,4345,4061,107
39010, 제주시,050,45~49세,2018,44618,22813,21805,104.6,43558,22215,21343,104.1
39010, 제주시,050001, 45세,2018,8771,4427,4344,101.9,8527,4291,4236,101.3
39010, 제주시,050002, 46세,2018,9003,4571,4432,103.1,8796,4451,4345,102.4
39010, 제주시,050003, 47세,2018,9343,4789,4554,105.2,9112,4659,4453,104.6
39010, 제주시,050004, 48세,2018,8858,4512,4346,103.8,8647,4396,4251,103.4
39010, 제주시,050005, 49세,2018,8643,4514,4129,109.3,8476,4418,4058,108.9
39010, 제주시,055,50~54세,2018,38859,20193,18666,108.2,38176,19835,18341,108.1
39010, 제주시,055001, 50세,2018,8488,4369,4119,106.1,8333,4287,4046,106
39010, 제주시,055002, 51세,2018,7778,4044,3734,108.3,7639,3971,3668,108.3
39010, 제주시,055003, 52세,2018,7977,4226,3751,112.7,7850,4162,3688,112.9
39010, 제주시,055004, 53세,2018,7331,3792,3539,107.1,7195,3714,3481,106.7
39010, 제주시,055005, 54세,2018,7285,3762,3523,106.8,7159,3701,3458,107
39010, 제주시,060,55~59세,2018,36430,18468,17962,102.8,35883,18196,17687,102.9
39010, 제주시,060001, 55세,2018,7797,3999,3798,105.3,7650,3932,3718,105.8
39010, 제주시,060002, 56세,2018,7338,3727,3611,103.2,7217,3664,3553,103.1
39010, 제주시,060003, 57세,2018,7249,3642,3607,101,7166,3595,3571,100.7
39010, 제주시,060004, 58세,2018,7351,3737,3614,103.4,7242,3683,3559,103.5
39010, 제주시,060005, 59세,2018,6695,3363,3332,100.9,6608,3322,3286,101.1
39010, 제주시,065,60~64세,2018,28371,14246,14125,100.9,27915,14049,13866,101.3
39010, 제주시,065001, 60세,2018,6252,3191,3061,104.2,6155,3152,3003,105
39010, 제주시,065002, 61세,2018,6077,3090,2987,103.4,5983,3048,2935,103.9
39010, 제주시,065003, 62세,2018,5628,2815,2813,100.1,5530,2770,2760,100.4
39010, 제주시,065004, 63세,2018,5822,2858,2964,96.4,5739,2825,2914,96.9
39010, 제주시,065005, 64세,2018,4592,2292,2300,99.7,4508,2254,2254,100
39010, 제주시,070,65~69세,2018,18101,8690,9411,92.3,17875,8591,9284,92.5
39010, 제주시,070001, 65세,2018,3797,1828,1969,92.8,3745,1798,1947,92.3
39010, 제주시,070002, 66세,2018,4016,1957,2059,95,3979,1944,2035,95.5
39010, 제주시,070003, 67세,2018,3468,1687,1781,94.7,3406,1660,1746,95.1
39010, 제주시,070004, 68세,2018,3440,1617,1823,88.7,3403,1603,1800,89.1
39010, 제주시,070005, 69세,2018,3380,1601,1779,90,3342,1586,1756,90.3
39010, 제주시,075,70~74세,2018,15653,7324,8329,87.9,15546,7265,8281,87.7
39010, 제주시,075001, 70세,2018,3595,1735,1860,93.3,3571,1723,1848,93.2
39010, 제주시,075002, 71세,2018,3451,1602,1849,86.6,3424,1587,1837,86.4
39010, 제주시,075003, 72세,2018,3063,1421,1642,86.5,3040,1408,1632,86.3
39010, 제주시,075004, 73세,2018,2718,1289,1429,90.2,2701,1278,1423,89.8
39010, 제주시,075005, 74세,2018,2826,1277,1549,82.4,2810,1269,1541,82.3
39010, 제주시,080,75~79세,2018,12645,5290,7355,71.9,12607,5273,7334,71.9
39010, 제주시,080001, 75세,2018,2686,1168,1518,76.9,2672,1159,1513,76.6
39010, 제주시,080002, 76세,2018,2697,1188,1509,78.7,2692,1188,1504,79
39010, 제주시,080003, 77세,2018,2628,1121,1507,74.4,2620,1116,1504,74.2
39010, 제주시,080004, 78세,2018,2317,921,1396,66,2315,921,1394,66.1
39010, 제주시,080005, 79세,2018,2317,892,1425,62.6,2308,889,1419,62.6
39010, 제주시,085,80~84세,2018,8923,3148,5775,54.5,8896,3134,5762,54.4
39010, 제주시,085001, 80세,2018,2125,827,1298,63.7,2121,827,1294,63.9
39010, 제주시,085002, 81세,2018,1905,696,1209,57.6,1898,693,1205,57.5
39010, 제주시,085003, 82세,2018,1740,586,1154,50.8,1732,582,1150,50.6
39010, 제주시,085004, 83세,2018,1611,559,1052,53.1,1606,555,1051,52.8
39010, 제주시,085005, 84세,2018,1542,480,1062,45.2,1539,477,1062,44.9
39010, 제주시,090,85~89세,2018,4878,1142,3736,30.6,4863,1137,3726,30.5
39010, 제주시,090001, 85세,2018,1418,377,1041,36.2,1414,376,1038,36.2
39010, 제주시,090002, 86세,2018,1088,269,819,32.8,1084,268,816,32.8
39010, 제주시,090003, 87세,2018,868,226,642,35.2,865,226,639,35.4
39010, 제주시,090004, 88세,2018,852,154,698,22.1,848,151,697,21.7
39010, 제주시,090005, 89세,2018,652,116,536,21.6,652,116,536,21.6
39010, 제주시,095,90~94세,2018,1396,195,1201,16.2,1392,195,1197,16.3
39010, 제주시,095001, 90세,2018,454,61,393,15.5,454,61,393,15.5
39010, 제주시,095002, 91세,2018,364,57,307,18.6,362,57,305,18.7
39010, 제주시,095003, 92세,2018,252,36,216,16.7,252,36,216,16.7
39010, 제주시,095004, 93세,2018,187,17,170,10,186,17,169,10.1
39010, 제주시,095005, 94세,2018,139,24,115,20.9,138,24,114,21.1
39010, 제주시,100,95~99세,2018,735,65,670,9.7,734,65,669,9.7
39010, 제주시,100001, 95세,2018,333,27,306,8.8,333,27,306,8.8
39010, 제주시,100002, 96세,2018,180,18,162,11.1,180,18,162,11.1
39010, 제주시,100003, 97세,2018,113,9,104,8.7,113,9,104,8.7
39010, 제주시,100004, 98세,2018,70,9,61,14.8,70,9,61,14.8
39010, 제주시,100005, 99세,2018,39,X,37,5.4,38,X,36,5.6
39010, 제주시,101,100세이상,2018,69,X,67,3,69,X,67,3
39010, 제주시,102,15세미만,2018,73879,38301,35578,107.7,73386,38029,35357,107.6
39010, 제주시,103,15~64세,2018,346653,179499,167154,107.4,330332,170069,160263,106.1
39010, 제주시,104,65세이상,2018,62400,25856,36544,70.8,61982,25662,36320,70.7
39010, 제주시,086,85세이상,2018,7078,1404,5674,24.7,7058,1399,5659,24.7
39010, 제주시,126,평균연령,2018,40.2,39,41.5,,40.5,39.2,41.7,
39010, 제주시,127,중위연령,2018,41.1,39.9,42.3,,41.7,40.6,42.8,
39020, 서귀포시,000,합계,2018,175350,89363,85987,103.9,167295,84375,82920,101.8
39020, 서귀포시,005,0~4세,2018,7017,3576,3441,103.9,6803,3465,3338,103.8
39020, 서귀포시,005001, 0세,2018,1127,568,559,101.6,1094,552,542,101.8
39020, 서귀포시,005002, 1세,2018,1326,672,654,102.8,1267,646,621,104
39020, 서귀포시,005003, 2세,2018,1488,776,712,109,1443,748,695,107.6
39020, 서귀포시,005004, 3세,2018,1576,798,778,102.6,1531,776,755,102.8
39020, 서귀포시,005005, 4세,2018,1500,762,738,103.3,1468,743,725,102.5
39020, 서귀포시,010,5~9세,2018,8551,4396,4155,105.8,8401,4330,4071,106.4
39020, 서귀포시,010001, 5세,2018,1581,780,801,97.4,1551,766,785,97.6
39020, 서귀포시,010002, 6세,2018,1772,937,835,112.2,1740,922,818,112.7
39020, 서귀포시,010003, 7세,2018,1809,958,851,112.6,1777,945,832,113.6
39020, 서귀포시,010004, 8세,2018,1732,891,841,105.9,1698,877,821,106.8
39020, 서귀포시,010005, 9세,2018,1657,830,827,100.4,1635,820,815,100.6
39020, 서귀포시,015,10~14세,2018,8444,4411,4033,109.4,8328,4363,3965,110
39020, 서귀포시,015001, 10세,2018,1821,926,895,103.5,1784,912,872,104.6
39020, 서귀포시,015002, 11세,2018,1818,917,901,101.8,1798,906,892,101.6
39020, 서귀포시,015003, 12세,2018,1616,866,750,115.5,1595,855,740,115.5
39020, 서귀포시,015004, 13세,2018,1549,817,732,111.6,1525,808,717,112.7
39020, 서귀포시,015005, 14세,2018,1640,885,755,117.2,1626,882,744,118.5
39020, 서귀포시,020,15~19세,2018,8275,4349,3926,110.8,8177,4295,3882,110.6
39020, 서귀포시,020001, 15세,2018,1576,840,736,114.1,1562,833,729,114.3
39020, 서귀포시,020002, 16세,2018,1688,902,786,114.8,1676,895,781,114.6
39020, 서귀포시,020003, 17세,2018,1867,1008,859,117.3,1857,1003,854,117.4
39020, 서귀포시,020004, 18세,2018,1886,928,958,96.9,1872,922,950,97.1
39020, 서귀포시,020005, 19세,2018,1258,671,587,114.3,1210,642,568,113
39020, 서귀포시,025,20~24세,2018,9001,5136,3865,132.9,8048,4475,3573,125.2
39020, 서귀포시,025001, 20세,2018,1467,891,576,154.7,1378,846,532,159
39020, 서귀포시,025002, 21세,2018,1779,1076,703,153.1,1633,976,657,148.6
39020, 서귀포시,025003, 22세,2018,1808,1042,766,136,1608,900,708,127.1
39020, 서귀포시,025004, 23세,2018,1924,1021,903,113.1,1692,856,836,102.4
39020, 서귀포시,025005, 24세,2018,2023,1106,917,120.6,1737,897,840,106.8
39020, 서귀포시,030,25~29세,2018,10196,5603,4593,122,8624,4477,4147,108
39020, 서귀포시,030001, 25세,2018,2103,1144,959,119.3,1815,917,898,102.1
39020, 서귀포시,030002, 26세,2018,2191,1219,972,125.4,1866,973,893,109
39020, 서귀포시,030003, 27세,2018,1987,1083,904,119.8,1697,871,826,105.4
39020, 서귀포시,030004, 28세,2018,2005,1097,908,120.8,1671,878,793,110.7
39020, 서귀포시,030005, 29세,2018,1910,1060,850,124.7,1575,838,737,113.7
39020, 서귀포시,035,30~34세,2018,9618,5180,4438,116.7,8076,4180,3896,107.3
39020, 서귀포시,035001, 30세,2018,1746,1009,737,136.9,1414,787,627,125.5
39020, 서귀포시,035002, 31세,2018,1876,1009,867,116.4,1539,790,749,105.5
39020, 서귀포시,035003, 32세,2018,1885,1006,879,114.4,1574,808,766,105.5
39020, 서귀포시,035004, 33세,2018,1965,1040,925,112.4,1671,851,820,103.8
39020, 서귀포시,035005, 34세,2018,2146,1116,1030,108.3,1878,944,934,101.1
39020, 서귀포시,040,35~39세,2018,13244,6880,6364,108.1,12053,6139,5914,103.8
39020, 서귀포시,040001, 35세,2018,2324,1201,1123,106.9,2078,1047,1031,101.6
39020, 서귀포시,040002, 36세,2018,2637,1358,1279,106.2,2369,1192,1177,101.3
39020, 서귀포시,040003, 37세,2018,2809,1485,1324,112.2,2577,1335,1242,107.5
39020, 서귀포시,040004, 38세,2018,2729,1412,1317,107.2,2502,1278,1224,104.4
39020, 서귀포시,040005, 39세,2018,2745,1424,1321,107.8,2527,1287,1240,103.8
39020, 서귀포시,045,40~44세,2018,13484,7258,6226,116.6,12724,6830,5894,115.9
39020, 서귀포시,045001, 40세,2018,2394,1271,1123,113.2,2211,1163,1048,111
39020, 서귀포시,045002, 41세,2018,2581,1335,1246,107.1,2420,1247,1173,106.3
39020, 서귀포시,045003, 42세,2018,2746,1471,1275,115.4,2586,1375,1211,113.5
39020, 서귀포시,045004, 43세,2018,2691,1496,1195,125.2,2563,1426,1137,125.4
39020, 서귀포시,045005, 44세,2018,3072,1685,1387,121.5,2944,1619,1325,122.2
39020, 서귀포시,050,45~49세,2018,15313,8342,6971,119.7,14804,8054,6750,119.3
39020, 서귀포시,050001, 45세,2018,2906,1550,1356,114.3,2790,1482,1308,113.3
39020, 서귀포시,050002, 46세,2018,3088,1680,1408,119.3,2966,1614,1352,119.4
39020, 서귀포시,050003, 47세,2018,3326,1839,1487,123.7,3236,1781,1455,122.4
39020, 서귀포시,050004, 48세,2018,3040,1664,1376,120.9,2949,1616,1333,121.2
39020, 서귀포시,050005, 49세,2018,2953,1609,1344,119.7,2863,1561,1302,119.9
39020, 서귀포시,055,50~54세,2018,14280,7599,6681,113.7,13920,7418,6502,114.1
39020, 서귀포시,055001, 50세,2018,3087,1661,1426,116.5,2983,1598,1385,115.4
39020, 서귀포시,055002, 51세,2018,2740,1450,1290,112.4,2667,1412,1255,112.5
39020, 서귀포시,055003, 52세,2018,2886,1530,1356,112.8,2815,1499,1316,113.9
39020, 서귀포시,055004, 53세,2018,2773,1471,1302,113,2713,1442,1271,113.5
39020, 서귀포시,055005, 54세,2018,2794,1487,1307,113.8,2742,1467,1275,115.1
39020, 서귀포시,060,55~59세,2018,14543,7491,7052,106.2,14299,7365,6934,106.2
39020, 서귀포시,060001, 55세,2018,2996,1545,1451,106.5,2941,1519,1422,106.8
39020, 서귀포시,060002, 56세,2018,2892,1545,1347,114.7,2841,1514,1327,114.1
39020, 서귀포시,060003, 57세,2018,2884,1462,1422,102.8,2841,1444,1397,103.4
39020, 서귀포시,060004, 58세,2018,3054,1566,1488,105.2,3001,1535,1466,104.7
39020, 서귀포시,060005, 59세,2018,2717,1373,1344,102.2,2675,1353,1322,102.3
39020, 서귀포시,065,60~64세,2018,12338,6195,6143,100.8,12152,6108,6044,101.1
39020, 서귀포시,065001, 60세,2018,2679,1381,1298,106.4,2636,1363,1273,107.1
39020, 서귀포시,065002, 61세,2018,2571,1279,1292,99,2528,1260,1268,99.4
39020, 서귀포시,065003, 62세,2018,2563,1311,1252,104.7,2528,1296,1232,105.2
39020, 서귀포시,065004, 63세,2018,2428,1183,1245,95,2400,1168,1232,94.8
39020, 서귀포시,065005, 64세,2018,2097,1041,1056,98.6,2060,1021,1039,98.3
39020, 서귀포시,070,65~69세,2018,8577,4111,4466,92.1,8495,4077,4418,92.3
39020, 서귀포시,070001, 65세,2018,1745,832,913,91.1,1727,822,905,90.8
39020, 서귀포시,070002, 66세,2018,1864,907,957,94.8,1838,900,938,95.9
39020, 서귀포시,070003, 67세,2018,1633,818,815,100.4,1621,813,808,100.6
39020, 서귀포시,070004, 68세,2018,1615,749,866,86.5,1607,744,863,86.2
39020, 서귀포시,070005, 69세,2018,1720,805,915,88,1702,798,904,88.3
39020, 서귀포시,075,70~74세,2018,7761,3673,4088,89.8,7721,3655,4066,89.9
39020, 서귀포시,075001, 70세,2018,1798,880,918,95.9,1784,874,910,96
39020, 서귀포시,075002, 71세,2018,1717,833,884,94.2,1708,830,878,94.5
39020, 서귀포시,075003, 72세,2018,1451,682,769,88.7,1445,679,766,88.6
39020, 서귀포시,075004, 73세,2018,1453,672,781,86,1447,669,778,86
39020, 서귀포시,075005, 74세,2018,1342,606,736,82.3,1337,603,734,82.2
39020, 서귀포시,080,75~79세,2018,6692,2821,3871,72.9,6674,2813,3861,72.9
39020, 서귀포시,080001, 75세,2018,1292,577,715,80.7,1290,575,715,80.4
39020, 서귀포시,080002, 76세,2018,1548,676,872,77.5,1541,672,869,77.3
39020, 서귀포시,080003, 77세,2018,1429,585,844,69.3,1426,585,841,69.6
39020, 서귀포시,080004, 78세,2018,1246,501,745,67.2,1242,499,743,67.2
39020, 서귀포시,080005, 79세,2018,1177,482,695,69.4,1175,482,693,69.6
39020, 서귀포시,085,80~84세,2018,4735,1670,3065,54.5,4724,1664,3060,54.4
39020, 서귀포시,085001, 80세,2018,1102,413,689,59.9,1101,413,688,60
39020, 서귀포시,085002, 81세,2018,1031,369,662,55.7,1027,366,661,55.4
39020, 서귀포시,085003, 82세,2018,851,322,529,60.9,849,321,528,60.8
39020, 서귀포시,085004, 83세,2018,899,286,613,46.7,897,286,611,46.8
39020, 서귀포시,085005, 84세,2018,852,280,572,49,850,278,572,48.6
39020, 서귀포시,090,85~89세,2018,2295,549,1746,31.4,2290,547,1743,31.4
39020, 서귀포시,090001, 85세,2018,727,210,517,40.6,724,209,515,40.6
39020, 서귀포시,090002, 86세,2018,558,138,420,32.9,557,138,419,32.9
39020, 서귀포시,090003, 87세,2018,378,73,305,23.9,378,73,305,23.9
39020, 서귀포시,090004, 88세,2018,358,74,284,26.1,358,74,284,26.1
39020, 서귀포시,090005, 89세,2018,274,54,220,24.5,273,53,220,24.1
39020, 서귀포시,095,90~94세,2018,634,93,541,17.2,631,91,540,16.9
39020, 서귀포시,095001, 90세,2018,228,37,191,19.4,227,36,191,18.8
39020, 서귀포시,095002, 91세,2018,156,17,139,12.2,156,17,139,12.2
39020, 서귀포시,095003, 92세,2018,112,20,92,21.7,110,19,91,20.9
39020, 서귀포시,095004, 93세,2018,89,12,77,15.6,89,12,77,15.6
39020, 서귀포시,095005, 94세,2018,49,7,42,16.7,49,7,42,16.7
39020, 서귀포시,100,95~99세,2018,317,27,290,9.3,317,27,290,9.3
39020, 서귀포시,100001, 95세,2018,143,11,132,8.3,143,11,132,8.3
39020, 서귀포시,100002, 96세,2018,80,13,67,19.4,80,13,67,19.4
39020, 서귀포시,100003, 97세,2018,52,X,50,4,52,X,50,4
39020, 서귀포시,100004, 98세,2018,20,X,19,5.3,20,X,19,5.3
39020, 서귀포시,100005, 99세,2018,22,X,22,0,22,X,22,0
39020, 서귀포시,101,100세이상,2018,35,X,32,9.4,34,X,32,6.3
39020, 서귀포시,102,15세미만,2018,24012,12383,11629,106.5,23532,12158,11374,106.9
39020, 서귀포시,103,15~64세,2018,120292,64033,56259,113.8,112877,59341,53536,110.8
39020, 서귀포시,104,65세이상,2018,31046,12947,18099,71.5,30886,12876,18010,71.5
39020, 서귀포시,086,85세이상,2018,3281,672,2609,25.8,3272,667,2605,25.6
39020, 서귀포시,126,평균연령,2018,43.5,42,45.1,,43.9,42.4,45.4,
39020, 서귀포시,127,중위연령,2018,44.9,43.7,46.4,,45.9,44.8,47.1,
